TAG	TEXT	COMMENT
FB_BUILDABRAWL001	Wählt Euer erstes Kartenchaos!	
FB_BUILDABRAWL002	Wählt Euer zweites Kartenchaos!	
FB_ELO_GREATERSPIRITS	Wählt einen großen Bonus!	
FB_ELO_SPIRITS	Wählt einen Bonus!	
GALAKROND_ONCE	Zum Aufwerten einmal Galakrond <b>ermächtigen</b>.	
GALAKROND_TWICE	Zum Aufwerten zweimal Galakrond <b>ermächtigen</b>.	
GAMEPLAY_AI_OPPONENT_NAME	Gastwirt	
GAMEPLAY_AMETHYST_SPELLSTONE_1	<i>(Zum Aufwerten Schaden durch eigene Karten erleiden.)</i>	
GAMEPLAY_AMETHYST_SPELLSTONE_2	<i>(Zum Aufwerten Schaden durch eigene Karten erleiden.)</i>	
GAMEPLAY_AMETHYST_SPELLSTONE_3	<i>(Zum Aufwerten Schaden durch eigene Karten erleiden.)</i>	
GAMEPLAY_BACON_ALTERNATE_PLAYER_NAME	{0}	0=character hero name
GAMEPLAY_BACON_BUY_TUTORIAL	Zieht den Diener, um ihn zu kaufen.	
GAMEPLAY_BACON_COIN_TUTORIAL_1	Diener kosten <b>immer</b> 3 Gold.	
GAMEPLAY_BACON_COIN_TUTORIAL_2	Ungenutztes Gold geht verloren.	
GAMEPLAY_BACON_COMBAT_BODY_TUTORIAL	Diener, die den Kampf überleben, erhöhen Euren Schaden.\n\nJe höher ihre Gasthausstufe, desto höher der Schaden!	
GAMEPLAY_BACON_COMBAT_BUTTON_TUTORIAL	OK!	
GAMEPLAY_BACON_COMBAT_END_TURN_BUTTON_TEXT	Kampf	
GAMEPLAY_BACON_COMBAT_PHASE_NAME	Kampf	
GAMEPLAY_BACON_COMBAT_TITLE_TUTORIAL	Kampfschaden	
GAMEPLAY_BACON_CONFIRM_BUTTON_TUTORIAL	OK!	
GAMEPLAY_BACON_DRAGBUY_BODY_TUTORIAL	Zieht Diener zu Eurem\nHelden, um sie für\n<b>3 Gold</b> zu kaufen.\n\nStellt eine Armee auf, um Eure Gegner zu vernichten!	
GAMEPLAY_BACON_DRAGBUY_BUTTON_TUTORIAL	Kaufen	
GAMEPLAY_BACON_DRAGBUY_TITLE_TUTORIAL	Diener kaufen	
GAMEPLAY_BACON_DRAGBUY_TRIPLE_TUTORIAL	Wenn Ihr diesen Diener kauft, erhaltet Ihr einen Drilling!	
GAMEPLAY_BACON_DRAGBUY_TUTORIAL	Zieht den Diener zu Eurem Helden.	
GAMEPLAY_BACON_DRAGSELL_BODY_TUTORIAL	Zieht Diener zu Eurem Barkeeper, um sie zu verkaufen.\n\nDas schafft Platz und Ihr erhaltet zum Ausgleich 1 Gold!	
GAMEPLAY_BACON_DRAGSELL_BUTTON_TUTORIAL	Verkaufen	
GAMEPLAY_BACON_DRAGSELL_TITLE_TUTORIAL	Diener verkaufen	
GAMEPLAY_BACON_DRAGSELL_TUTORIAL	Zieht einen Diener hierher, um ihn zu verkaufen.	
GAMEPLAY_BACON_ENEMY_MINION_TUTORIAL	Wählt einen Diener aus.	
GAMEPLAY_BACON_FREEZE_TUTORIAL	Friert Diener ein, damit sie in der nächsten Runde wieder verfügbar sind.	
GAMEPLAY_BACON_MINION_MOVE_TUTORIAL	Zieht Diener nach rechts, um sie neu anzuordnen.	
GAMEPLAY_BACON_MINION_UPGRADE_TAVERN_TUTORIAL	Wertet das Gasthaus auf!	
GAMEPLAY_BACON_MULLIGAN_AVAILABLE_RACES	Dienertypen in diesem Spiel: {0}, {1}, {2}, {3}, {4}	0=first race, 1=second race, 2=third race, 3=fourth race, 4=fifth race
GAMEPLAY_BACON_MULLIGAN_CHOOSE_HERO_BANNER	Wählt Euren Helden	
GAMEPLAY_BACON_MULLIGAN_WAITING_BANNER	{0}/{1} Spieler bereit	0=number of players ready, 1=number of players in game
GAMEPLAY_BACON_MULLIGAN_WAITING_BANNER_SUBTITLE	Verbleibende Zeit	
GAMEPLAY_BACON_PLAY_MINION_TUTORIAL	Spielt ihn aus!	
GAMEPLAY_BACON_RECENT_COMBATS	Letzte Kämpfe	
GAMEPLAY_BACON_RECENT_UPGRADE	Aktuelle Aufwertung	
GAMEPLAY_BACON_RECRUIT_REMINDER_TUTORIAL	Wählt einen Diener.	
GAMEPLAY_BACON_RECRUIT_REMINDER_TUTORIAL_2	Kauft einen Diener.	
GAMEPLAY_BACON_REFRESH_TUTORIAL	Findet neue Rekruten.	
GAMEPLAY_BACON_REFRESH_UPGRADE_TUTORIAL	Findet bessere Rekruten!	
GAMEPLAY_BACON_SHOP_END_TURN_BUTTON_TEXT	Rekrutieren	
GAMEPLAY_BACON_SHOP_PHASE_NAME	Rekrutieren	
GAMEPLAY_BACON_TAVERN_PASS_IN_GAME_HELP	Schaltet Schlachtfeldboni frei, um diesen Helden auszuwählen.	
GAMEPLAY_BACON_TAVERN_TIER	Gasthaus[d]stufe	
GAMEPLAY_BACON_TEXT_EMOTE_GREETINGS	Grüße	
GAMEPLAY_BACON_TEXT_EMOTE_INVALID	...	
GAMEPLAY_BACON_TEXT_EMOTE_OOPS	Ups	
GAMEPLAY_BACON_TEXT_EMOTE_SORRY	Tut mir leid	
GAMEPLAY_BACON_TEXT_EMOTE_THANKS	Danke	
GAMEPLAY_BACON_TEXT_EMOTE_THREATEN	!!!	
GAMEPLAY_BACON_TEXT_EMOTE_WELL_PLAYED	Gut gespielt	
GAMEPLAY_BACON_TEXT_EMOTE_WOW	Wow	
GAMEPLAY_BACON_TRIPLE_BODY_TUTORIAL	Wenn Ihr 3 gleiche Diener habt, verschmelzen sie zu einem stärkeren goldenen Exemplar des Dieners.\n\nSpielt ihn aus, um eine Belohnung zu erhalten!	
GAMEPLAY_BACON_TRIPLE_BUTTON_TUTORIAL	Kombinieren	
GAMEPLAY_BACON_TRIPLE_TITLE_TUTORIAL	Aufwertung zum Drilling	
GAMEPLAY_BACON_TRIPLES_ICON	Drillinge	
GAMEPLAY_BACON_WIN_STREAK_ICON	Sieges[d]serie	
GAMEPLAY_BURNED_CARDS_HISTORY_TEXT	Wenn Ihr mit voller Hand eine Karte zieht, wird sie vernichtet.	
GAMEPLAY_BURNED_CARDS_TITLE	Verbrannte Karten	
GAMEPLAY_CHOOSE_ONE	Wählt aus:	will be displayed for card choices e.g. tracking
GAMEPLAY_CHOOSE_ONE_ADAPT_ALL_MINIONS	Wählt einen Bonus für all Eure Diener:	
GAMEPLAY_CHOOSE_ONE_ADAPT_ALL_MURLOCS	Wählt einen Bonus für all Eure Murlocs:	
GAMEPLAY_CHOOSE_ONE_ADAPT_ALL_RECRUITS	Wählt einen Bonus für all Eure Rekruten:	
GAMEPLAY_CHOOSE_ONE_HERO_POWER	Wählt aus:	will be displayed for choosing a Hero Power e.g. Sir Finley Mrrgglton
GAMEPLAY_CHOOSE_ONE_WINNER	Erratet den Sieger!	
GAMEPLAY_COIN_TOSS_LOST	Ihr erhaltet eine weitere Karte.	
GAMEPLAY_COIN_TOSS_WON	Ihr seid zuerst dran.	
GAMEPLAY_COPY_DEATHRATTLE	Todesröcheln von {0} kopiert	
GAMEPLAY_COST_0	Kostet (0)	
GAMEPLAY_COST_1	Kostet (1)	
GAMEPLAY_COST_2	Kostet (2)	
GAMEPLAY_COST_3	Kostet (3)	
GAMEPLAY_COST_4	Kostet (4)	
GAMEPLAY_COST_5	Kostet (5)	
GAMEPLAY_COST_6	Kostet (6)	
GAMEPLAY_COST_7	Kostet (7)	
GAMEPLAY_COST_8	Kostet (8)	
GAMEPLAY_COST_9	Kostet (9)	
GAMEPLAY_DIAMOND_SPELLSTONE_1	<i>(Zum Aufwerten 4_Zauber wirken.)</i>	
GAMEPLAY_DIAMOND_SPELLSTONE_2	<i>(Zum Aufwerten 3_weitere Zauber wirken.)</i>	
GAMEPLAY_DIAMOND_SPELLSTONE_3	<i>(Zum Aufwerten 2_weitere Zauber wirken.)</i>	
GAMEPLAY_DIAMOND_SPELLSTONE_4	<i>(Zum Aufwerten 1_weiteren Zauber wirken.)</i>	
GAMEPLAY_DISCONNECT_BODY	Spiel abgeschlossen und gespeichert! Bitte starten Sie Hearthstone neu, um fortzufahren.	
GAMEPLAY_DISCONNECT_BODY_RESET	Spiel abgeschlossen und gespeichert! Verbindung zu den Hearthstone-Servern wird wiederhergestellt.	
GAMEPLAY_DISCONNECT_HEADER	Verbindung unterbrochen	
GAMEPLAY_DISCOVER_JUGGERNAUT	Wählt einen feindlichen Kapitän ...	
GAMEPLAY_DISCOVER_MYSTERY	Was Euer Gegner wohl gewählt hat?	
GAMEPLAY_DISCOVER_OVERRIDE_EXPLORER_RETRAINING	Neue Heldenfähigkeit wählen	
GAMEPLAY_DISCOVER_OVERRIDE_FRIENDLY_SMITH	Mit +2/+2 hinzufügen	
GAMEPLAY_DISCOVER_OVERRIDE_HIRING_REPLACEMENTS	Ersetzen durch	
GAMEPLAY_DISCOVER_OVERRIDE_KINDLE	Aus Deck entfernen	
GAMEPLAY_DISCOVER_OVERRIDE_PARTY_OF_FOUR	Feindlichen Dienertyp wählen	
GAMEPLAY_DISCOVER_OVERRIDE_RECRUIT_A_VETERAN	Hinzufügen	
GAMEPLAY_DISCOVER_OVERRIDE_RIDDLE_OF_THE_SPHINX	Raten	
GAMEPLAY_DISCOVER_OVERRIDE_STUDY_BREAK	Neue Starthandkarte	
GAMEPLAY_DISCOVER_OVERRIDE_THE_UPPER_HAND	Kosten verringern	
GAMEPLAY_DONE_TURN	FERTIG	
GAMEPLAY_EMOTE_LABEL_DISABLED_EMOTES	...	
GAMEPLAY_EMOTE_LABEL_FIREWORKS	Wow	
GAMEPLAY_EMOTE_LABEL_GREETINGS	Grüße	
GAMEPLAY_EMOTE_LABEL_OOPS	Ups	
GAMEPLAY_EMOTE_LABEL_SORRY	Tut mir leid	
GAMEPLAY_EMOTE_LABEL_THANKS	Danke	
GAMEPLAY_EMOTE_LABEL_THREATEN	Drohung	
GAMEPLAY_EMOTE_LABEL_WELL_PLAYED	Gut gespielt	
GAMEPLAY_EMOTE_LABEL_WOW	Wow	
GAMEPLAY_EMOTE_SQUELCH	Emotes aus	
GAMEPLAY_EMOTE_UNSQUELCH	Emotes an	
GAMEPLAY_ENCHANTMENT_MULTIPLIER_HEADER	{0}x {1}	0= integer > 1, 1= enchantment name
GAMEPLAY_END_OF_GAME_DEFEAT	Niederlage!	
GAMEPLAY_END_OF_GAME_DEFEAT_MAYBE	Niederlage?	
GAMEPLAY_END_OF_GAME_PLACE_1	1. Platz!!!	
GAMEPLAY_END_OF_GAME_PLACE_2	2. Platz!!	
GAMEPLAY_END_OF_GAME_PLACE_3	3. Platz!	
GAMEPLAY_END_OF_GAME_PLACE_4	4. Platz!	
GAMEPLAY_END_OF_GAME_PLACE_5	5. Platz	
GAMEPLAY_END_OF_GAME_PLACE_6	6. Platz	
GAMEPLAY_END_OF_GAME_PLACE_7	7. Platz	
GAMEPLAY_END_OF_GAME_PLACE_8	8. Platz	
GAMEPLAY_END_OF_GAME_RATING	Wertung	
GAMEPLAY_END_OF_GAME_TIE	Unentschieden!	
GAMEPLAY_END_OF_GAME_TIE_ESCAPED	Entkommen!	
GAMEPLAY_END_OF_GAME_VICTORY	Sieg!	
GAMEPLAY_END_OF_GAME_VICTORY_MAYBE	Sieg?	
GAMEPLAY_END_TURN	FERTIG	
GAMEPLAY_END_TURN_BUTTON_COUNTDOWN	{0} Sek.	0 = An integer of the number of seconds left in the turn.
GAMEPLAY_ENEMY_TURN	 GEGNER 	
GAMEPLAY_ERROR_PLAY_REJECTED	Zu spät! Euer Zug ist vorbei.	
GAMEPLAY_FATIGUE_HISTORY_TEXT	Der Versuch, Karten aus einem leeren Deck zu ziehen, fügt dem Helden zunehmenden Schaden zu.	
GAMEPLAY_FATIGUE_TEXT	Keine Karten mehr! Erleidet {0} Schaden.	
GAMEPLAY_FATIGUE_TITLE	Erschöpfung	
GAMEPLAY_GOLDHERO_WINS	Siege!	
GAMEPLAY_HIDDEN_PLAYER_NAME	Ihr	
GAMEPLAY_HISTORY_CREATED_BY	Hervorgerufen durch\n{0}	0=name of a card
GAMEPLAY_JASPER_SPELLSTONE_1	<i>(Zum Aufwerten 3_Rüstung erhalten.)</i>	
GAMEPLAY_JASPER_SPELLSTONE_2	\n<i>(Zum Aufwerten noch 2_Rüstung erhalten.)</i>	
GAMEPLAY_JASPER_SPELLSTONE_3	\n<i>(Zum Aufwerten noch 1_Rüstung erhalten.)</i>	
GAMEPLAY_LOOT_526d_DARKNESS_1	Erwacht, wenn Euer Gegner 3 Kerzen zieht!	
GAMEPLAY_LOOT_526d_DARKNESS_2	Erwacht, wenn Euer Gegner 2 weitere Kerzen zieht!	
GAMEPLAY_LOOT_526d_DARKNESS_3	Erwacht, wenn Euer Gegner eine weitere Kerze zieht!	
GAMEPLAY_MANA_COUNTER	{0}/{1}	0=unused mana 1=current total mana
GAMEPLAY_MISSING_OPPONENT_NAME	Euer Gegner	
GAMEPLAY_MOBILE_BATTLECRY_CANCELED	Kampfschrei abgebrochen.	
GAMEPLAY_MOBILE_TARGETING_CANCELED	Zielwahl abgebrochen.	
GAMEPLAY_MULLIGAN_BEST_PLACE	Bestes Ergebnis: {0} Platz	0=The ordinal number (like 1st, 2nd, 3rd, etc), taken from ORDINAL_1, ORDINAL_2, etc.
GAMEPLAY_MULLIGAN_REPLACE	ERSETZT	
GAMEPLAY_MULLIGAN_STARTING_HAND	Starthand	
GAMEPLAY_MULLIGAN_SUBTITLE	   Karten behalten oder ersetzen   	
GAMEPLAY_MULLIGAN_WAITING	Gegner wählt noch aus ...	
GAMEPLAY_NEXT_TURN	ZUSATZZUG	
GAMEPLAY_ONYX_SPELLSTONE_1	<i>(Zum Aufwerten 3 <b>Todesröcheln</b>-Karten ausspielen.)</i>	
GAMEPLAY_ONYX_SPELLSTONE_2	\n<i>(Zum Aufwerten 2 weitere <b>Todesröcheln</b>-Karten ausspielen.)</i>	
GAMEPLAY_ONYX_SPELLSTONE_3	\n<i>(Zum Aufwerten 1 weitere <b>Todesröcheln</b>-Karte ausspielen.)</i>	
GAMEPLAY_PEARL_SPELLSTONE_1	<i>(Zum Aufwerten 3_Leben wiederherstellen.)</i>	
GAMEPLAY_PEARL_SPELLSTONE_2	<i>(Zum Aufwerten noch 2_Leben wiederherstellen.)</i>	
GAMEPLAY_PEARL_SPELLSTONE_3	<i>(Zum Aufwerten noch 1_Leben wiederherstellen.)</i>	
GAMEPLAY_PlayErrors_REQ_ATTACK_GREATER_THAN_0	Ein Charakter ohne Angriffswert kann nicht angreifen.	
GAMEPLAY_PlayErrors_REQ_ATTACKER_CAN_ATTACK	Dieser Charakter kann nicht angreifen.	
GAMEPLAY_PlayErrors_REQ_ATTACKER_NOT_FROZEN	Eingefrorene Charaktere können nicht angreifen.	
GAMEPLAY_PlayErrors_REQ_BOUGHT_MINION_THIS_TURN	Ihr habt diesen Zug noch keine Diener gekauft.	
GAMEPLAY_PlayErrors_REQ_CAN_BE_ATTACKED	Charakter kann nicht angegriffen werden.	
GAMEPLAY_PlayErrors_REQ_CAN_BE_TARGETED_BY_BATTLECRIES	Kann nicht als Ziel von Kampfschreien gewählt werden.	
GAMEPLAY_PlayErrors_REQ_CAN_BE_TARGETED_BY_COMBOS	Kann nicht als Ziel von Combos gewählt werden.	
GAMEPLAY_PlayErrors_REQ_CAN_BE_TARGETED_BY_HERO_POWERS	Kann nicht als Ziel von Heldenfähigkeiten gewählt werden.	
GAMEPLAY_PlayErrors_REQ_CAN_BE_TARGETED_BY_OPPONENTS	Charakter kann nicht als Ziel gewählt werden.	
GAMEPLAY_PlayErrors_REQ_CAN_BE_TARGETED_BY_SPELLS	Kann nicht als Ziel von Zaubern gewählt werden.	
GAMEPLAY_PlayErrors_REQ_CANNOT_PLAY_THIS	Das könnt Ihr nicht tun.	
GAMEPLAY_PlayErrors_REQ_CHARGE_TARGET	Wählt einen Charakter mit Ansturm aus.	
GAMEPLAY_PlayErrors_REQ_DAMAGED_TARGET	Wählt einen verletzten Charakter aus.	
GAMEPLAY_PlayErrors_REQ_DRAG_TO_PLAY	Muss zu einem Ziel gezogen werden.	
GAMEPLAY_PlayErrors_REQ_ENCHANTED_TARGET	Wählt einen verzauberten Charakter aus.	
GAMEPLAY_PlayErrors_REQ_ENEMY_TARGET	Wählt einen Feind aus.	
GAMEPLAY_PlayErrors_REQ_ENEMY_TARGET_NOT_IMMUNE	Dieser Charakter ist immun.	
GAMEPLAY_PlayErrors_REQ_ENEMY_WEAPON_EQUIPPED	Euer Gegner muss eine Waffe haben.	
GAMEPLAY_PlayErrors_REQ_ENOUGH_COIN	Nicht genug Gold.	
GAMEPLAY_PlayErrors_REQ_ENOUGH_HEALTH	Nicht genug Leben.	
GAMEPLAY_PlayErrors_REQ_ENOUGH_MANA	Nicht genug Mana.	
GAMEPLAY_PlayErrors_REQ_ENTIRE_ENTOURAGE_NOT_IN_PLAY	Ihr verfügt bereits über ein Totem jedes Typs.	
GAMEPLAY_PlayErrors_REQ_FRIENDLY_DEATHRATTLE_MINION_DIED_THIS_GAME	In diesem Spiel sind keine befreundeten Diener mit Todesröcheln gestorben.	
GAMEPLAY_PlayErrors_REQ_FRIENDLY_MINION_DIED_THIS_GAME	In diesem Spiel sind keine befreundeten Diener gestorben.	
GAMEPLAY_PlayErrors_REQ_FRIENDLY_MINION_DIED_THIS_TURN	In diesem Zug sind keine befreundeten Diener gestorben.	
GAMEPLAY_PlayErrors_REQ_FRIENDLY_MINION_OF_RACE_DIED_THIS_TURN	In diesem Zug sind keine entsprechenden befreundeten Diener gestorben.	
GAMEPLAY_PlayErrors_REQ_FRIENDLY_MINION_OF_RACE_IN_HAND	Ihr habt keine entsprechenden Diener auf der Hand.	
GAMEPLAY_PlayErrors_REQ_FRIENDLY_MINIONS_OF_RACE_DIED_THIS_GAME	In diesem Spiel sind keine entsprechenden befreundeten Diener gestorben.	
GAMEPLAY_PlayErrors_REQ_FRIENDLY_REBORN_MINION_DIED_THIS_GAME	In diesem Spiel sind keine befreundeten Diener mit Wiederkehr gestorben.	
GAMEPLAY_PlayErrors_REQ_FRIENDLY_TARGET	Wählt einen befreundeten Charakter aus.	
GAMEPLAY_PlayErrors_REQ_FROZEN_TARGET	Wählt einen eingefrorenen Charakter aus.	
GAMEPLAY_PlayErrors_REQ_HAND_NOT_FULL	Eure Hand ist voll.	
GAMEPLAY_PlayErrors_REQ_HAS_OVERLOADED_MANA	Benötigt überladene Manakristalle.	
GAMEPLAY_PlayErrors_REQ_HERO_OR_MINION_TARGET	Ihr müsst einen Charakter als Ziel wählen.	
GAMEPLAY_PlayErrors_REQ_HERO_TARGET	Ihr müsst einen Helden als Ziel wählen.	
GAMEPLAY_PlayErrors_REQ_LEGENDARY_TARGET	Ihr müsst einen legendären Diener als Ziel wählen.	
GAMEPLAY_PlayErrors_REQ_MAX_QUESTS	Ihr könnt nur {0} |4(Quest,Quests) haben.	
GAMEPLAY_PlayErrors_REQ_MAX_SECRETS	Ihr könnt nur {0} |4(Geheimnis,Geheimnisse) haben.	
GAMEPLAY_PlayErrors_REQ_MINIMUM_ENEMY_MINIONS	Der Gegner muss über mindestens {0} Diener verfügen.	
GAMEPLAY_PlayErrors_REQ_MINIMUM_TOTAL_MINIONS	Es müssen sich mindestens {0} Diener auf dem Schlachtfeld befinden.	
GAMEPLAY_PlayErrors_REQ_MINION_CAP	Ihr habt die maximale Anzahl an Dienern erreicht.	
GAMEPLAY_PlayErrors_REQ_MINION_CAP_IF_TARGET_AVAILABLE	Ihr habt die maximale Anzahl an Dienern erreicht.	
GAMEPLAY_PlayErrors_REQ_MINION_DIED_THIS_GAME	In diesem Spiel sind keine Diener gestorben.	
GAMEPLAY_PlayErrors_REQ_MINION_OR_ENEMY_HERO	Wählt einen Diener oder den feindlichen Helden aus.	
GAMEPLAY_PlayErrors_REQ_MINION_SLOT_OR_MANA_CRYSTAL_SLOT	Ihr habt die maximale Anzahl an Dienern\nund Manakristallen erreicht.	
GAMEPLAY_PlayErrors_REQ_MINION_TARGET	Wählt einen Diener aus.	
GAMEPLAY_PlayErrors_REQ_MUST_PLAY_OTHER_CARD_FIRST	Ihr müsst zuerst eine Karte ausspielen.	
GAMEPLAY_PlayErrors_REQ_MUST_TARGET_TAUNTER	Ihr müsst einen Diener mit Spott als Ziel wählen.	
GAMEPLAY_PlayErrors_REQ_NONSELF_TARGET	Der Diener kann sich nicht selbst als Ziel wählen.	
GAMEPLAY_PlayErrors_REQ_NONSTEALTH_ENEMY_TARGET	Verstohlene Charaktere können nicht als Ziel gewählt oder angegriffen werden.	
GAMEPLAY_PlayErrors_REQ_NOT_DISABLED_HERO_POWER	Eure Heldenfähigkeit ist deaktiviert.	
GAMEPLAY_PlayErrors_REQ_NOT_EXHAUSTED_ACTIVATE	Dieser Charakter hat bereits angegriffen.	
GAMEPLAY_PlayErrors_REQ_NOT_EXHAUSTED_HERO_POWER	Heldenfähigkeiten können nur einmal pro Runde eingesetzt werden.	
GAMEPLAY_PlayErrors_REQ_NOT_LEGENDARY_TARGET	Ihr könnt keinen legendären Diener als Ziel wählen.	
GAMEPLAY_PlayErrors_REQ_NOT_MINION_DORMANT	Dieser Diener ist inaktiv.	
GAMEPLAY_PlayErrors_REQ_NOT_MINION_JUST_PLAYED	Diener können nicht in dem Zug angreifen,\nin dem sie ausgespielt wurden.	
GAMEPLAY_PlayErrors_REQ_NUM_MINION_SLOTS	Ihr habt zu viele Diener, um diese Karte auszuspielen.	
GAMEPLAY_PlayErrors_REQ_OPPONENT_PLAYED_CARDS_THIS_GAME	Euer Gegner hat keine Karten ausgespielt.	
GAMEPLAY_PlayErrors_REQ_SECRET_ZONE_CAP	Ihr könnt nur {0} Geheimnisse und Quests haben.	
GAMEPLAY_PlayErrors_REQ_SOLD_MINION_THIS_TURN	Ihr habt diesen Zug noch keine Diener verkauft.	
GAMEPLAY_PlayErrors_REQ_STEALTHED_TARGET	Wählt einen verstohlenen Charakter aus.	
GAMEPLAY_PlayErrors_REQ_SUBCARD_IS_PLAYABLE	Keine dieser Optionen ist gültig.	
GAMEPLAY_PlayErrors_REQ_TARGET_ATTACKED_THIS_TURN	Ihr müsst einen Charakter als Ziel wählen, der bereits angegriffen hat.	
GAMEPLAY_PlayErrors_REQ_TARGET_EXACT_COST	Wählt einen Diener aus, der ({0}) kostet.	
GAMEPLAY_PlayErrors_REQ_TARGET_FOR_COMBO	Ihr könnt das nicht tun, ohne ein Ziel zu wählen.	
GAMEPLAY_PlayErrors_REQ_TARGET_FOR_NO_COMBO	Ihr könnt das nicht tun, ohne ein Ziel zu wählen.	
GAMEPLAY_PlayErrors_REQ_TARGET_IF_AVAILABE_AND_ELEMENTAL_PLAYED_LAST_TURN	Ihr könnt das nicht tun, ohne ein Ziel zu wählen.	
GAMEPLAY_PlayErrors_REQ_TARGET_IF_AVAILABLE	Ihr könnt das nicht tun, ohne ein Ziel zu wählen.	
GAMEPLAY_PlayErrors_REQ_TARGET_IF_AVAILABLE_AND_DRAGON_IN_HAND	Ihr könnt das nicht tun, ohne ein Ziel zu wählen.	
GAMEPLAY_PlayErrors_REQ_TARGET_IF_AVAILABLE_AND_MINIMUM_FRIENDLY_MINIONS	Ihr könnt das nicht tun, ohne ein Ziel zu wählen.	
GAMEPLAY_PlayErrors_REQ_TARGET_IF_AVAILABLE_AND_MINIMUM_FRIENDLY_SECRETS	Ihr könnt das nicht tun, ohne ein Ziel zu wählen.	
GAMEPLAY_PlayErrors_REQ_TARGET_IF_AVAILABLE_AND_PLAYER_HEALTH_CHANGED_THIS_TURN	Ihr könnt das nicht tun, ohne ein Ziel zu wählen.	
GAMEPLAY_PlayErrors_REQ_TARGET_MAGNET	Es gibt einen Diener, den Ihr als Ziel wählen müsst.	
GAMEPLAY_PlayErrors_REQ_TARGET_MAX_ATTACK	Wählt einen Charakter mit max. {0} Angriff aus.	
GAMEPLAY_PlayErrors_REQ_TARGET_MIN_ATTACK	Wählt einen Charakter mit mind. {0} Angriff aus.	
GAMEPLAY_PlayErrors_REQ_TARGET_MUST_HAVE_TAG	Wählt ein anderes Ziel.	
GAMEPLAY_PlayErrors_REQ_TARGET_NON_TRIPLED_MINION	Kann nicht auf goldene Diener angewendet werden.	
GAMEPLAY_PlayErrors_REQ_TARGET_NOT_DAMAGEABLE_ONLY_BY_WEAPONS	Dieser Charakter kann nur mit Waffen verletzt werden.	
GAMEPLAY_PlayErrors_REQ_TARGET_NOT_DORMANT	Dieser Diener ist inaktiv.	
GAMEPLAY_PlayErrors_REQ_TARGET_NOT_HAVE_TAG	Wählt ein anderes Ziel.	
GAMEPLAY_PlayErrors_REQ_TARGET_NOT_VAMPIRE	Dieser Diener ist bereits ein Vampir.	
GAMEPLAY_PlayErrors_REQ_TARGET_TAUNTER_CHARACTER	Ein Charakter mit Spott ist im Weg.	
GAMEPLAY_PlayErrors_REQ_TARGET_TAUNTER_MINION	Ein Diener mit Spott ist im Weg.	
GAMEPLAY_PlayErrors_REQ_TARGET_TO_ATTACK	Es gibt nichts anzugreifen.	
GAMEPLAY_PlayErrors_REQ_TARGET_TO_PLAY	Ihr könnt das nicht tun, ohne ein Ziel zu wählen.	
GAMEPLAY_PlayErrors_REQ_TARGET_WITH_BATTLECRY	Wählt einen Charakter mit Kampfschrei aus.	
GAMEPLAY_PlayErrors_REQ_TARGET_WITH_DEATHRATTLE	Wählt einen Charakter mit Todesröcheln aus.	
GAMEPLAY_PlayErrors_REQ_TARGET_WITH_RACE	Das ist nicht der korrekte Dienertyp.	
GAMEPLAY_PlayErrors_REQ_TRADEABLE	Euer Deck muss mindestens eine Karte haben.	
GAMEPLAY_PlayErrors_REQ_TWO_OF_A_KIND	Braucht einen potenziellen Drilling.	
GAMEPLAY_PlayErrors_REQ_UNDAMAGED_TARGET	Ihr müsst einen unverletzten Charakter als Ziel wählen.	
GAMEPLAY_PlayErrors_REQ_UNIQUE_SECRET	Diese Karte ist schon im Spiel	
GAMEPLAY_PlayErrors_REQ_WEAPON_EQUIPPED	Ihr müsst über eine Waffe verfügen.	
GAMEPLAY_QUESTLINE_PART_1	Teil I	
GAMEPLAY_QUESTLINE_PART_2	Teil II	
GAMEPLAY_QUESTLINE_PART_3	Teil III	
GAMEPLAY_QUESTLINE_PART_4	Letzte Belohnung	
GAMEPLAY_RESTART_PUZZLES	RÄTSEL WIRD GELADEN ...	
GAMEPLAY_RUBY_SPELLSTONE_1	<i>(Zum Aufwerten 2_Elementare ausspielen.)</i>	
GAMEPLAY_RUBY_SPELLSTONE_2	<i>(Zum Aufwerten 1_weiteren Elementar ausspielen.)</i>	
GAMEPLAY_SAPPHIRE_SPELLSTONE_1	<i>(Zum Aufwerten 3_Manakristalle <b>überladen</b>.)</i>	
GAMEPLAY_SAPPHIRE_SPELLSTONE_2	<i>(Zum Aufwerten 2_weitere Manakristalle <b>überladen</b>.)</i>	
GAMEPLAY_SAPPHIRE_SPELLSTONE_3	<i>(Zum Aufwerten 1_weiteren Manakristall <b>überladen</b>.)</i>	
GAMEPLAY_SCORE_SCREEN_TITLE_CONGRATS	Herzlichen Glückwunsch!	
GAMEPLAY_SECRET_BANNER_TITLE	Geheimnis!	
GAMEPLAY_SECRET_DESC	Bleibt verborgen, bis eine geheime Aktion ausgeführt wurde ... Seid vorsichtig!	
GAMEPLAY_SECRET_NAME	Geheimnis	
GAMEPLAY_SECRET_NAME_HUNTER	Jägergeheimnis	
GAMEPLAY_SECRET_NAME_MAGE	Magiergeheimnis	
GAMEPLAY_SECRET_NAME_PALADIN	Paladingeheimnis	
GAMEPLAY_SECRET_NAME_ROGUE	Schurkengeheimnis	
GAMEPLAY_SEPARATOR	,	
GAMEPLAY_SPECTATOR_DISCONNECT_BODY	Ihre Verbindung wurde unterbrochen. Bitte starten Sie Hearthstone neu, um fortzufahren, und wechseln Sie wenn nötig erneut in den Zuschauermodus.	
GAMEPLAY_SPECTATOR_DISCONNECT_BODY_RESET	Ihre Verbindung wurde unterbrochen und wird wiederhergestellt. Bitte wechseln Sie wenn nötig erneut in den Zuschauermodus.	
GAMEPLAY_TOOLTIP_BACON_AVAILABLE_RACES_DESC	{0}, {1}, {2}, {3}, {4}	0=first race, 1=second race, 2=third race, 3=fourth race, 4=fifth race
GAMEPLAY_TOOLTIP_BACON_AVAILABLE_RACES_HEADLINE	In diesem Spiel:	
GAMEPLAY_TOOLTIP_BACON_DARKMOON_PRIZES_DESC	Noch {0} |4(Zug,Züge), bis Ihr einen Dunkelmond-Preis <b>entdecken</b> könnt!	
GAMEPLAY_TOOLTIP_BACON_DARKMOON_PRIZES_HEADLINE	Dunkelmond-Preise	
GAMEPLAY_TOOLTIP_BACON_GOLD	Mit Eurem Gold könnt Ihr Diener kaufen.	
GAMEPLAY_TOOLTIP_BACON_UNAVAILABLE_RACES_HEADLINE	Nicht in diesem Spiel:	
GAMEPLAY_TOOLTIP_DECK_DESCRIPTION	Ihr habt {0} |4(Karte,Karten) in Eurem Deck.	
GAMEPLAY_TOOLTIP_DECK_HEADLINE	Deck	
GAMEPLAY_TOOLTIP_ENEMYDECK_DESC	Euer Gegner hat {0} |4(Karte,Karten) in seinem Deck.	
GAMEPLAY_TOOLTIP_ENEMYDECK_HEADLINE	Gegnerisches Deck	
GAMEPLAY_TOOLTIP_ENEMYHAND_DESC	Euer Gegner hat {0} |4(Karte,Karten) auf der Hand.	0= number of cards in hand.
GAMEPLAY_TOOLTIP_ENEMYHAND_DESC_SINGLE	Euer Gegner hat {0} |4(Karte,Karten) auf der Hand.	0= number of cards in hand.
GAMEPLAY_TOOLTIP_ENEMYHAND_DESC_TUT	Die Hand Eures Gegners. Spieler ziehen jede Runde eine weitere Karte.	
GAMEPLAY_TOOLTIP_ENEMYHAND_HEADLINE	Gegnerische Hand	
GAMEPLAY_TOOLTIP_ENEMYOVERLOAD_DESC	{0} |4(Manakristall,Manakristalle) <b>überladen</b>	0= number of overloaded mana crystals.
GAMEPLAY_TOOLTIP_ENEMYOVERLOAD_HEADLINE	Überladung des Gegners	
GAMEPLAY_TOOLTIP_FATIGUE_DECK_DESCRIPTION	Ihr habt keine Karten mehr! Von nun an werdet Ihr jedes Mal Schaden erleiden, wenn Ihr versucht, eine Karte zu ziehen.	
GAMEPLAY_TOOLTIP_FATIGUE_DECK_HEADLINE	Erschöpft	
GAMEPLAY_TOOLTIP_FATIGUE_ENEMYDECK_DESCRIPTION	Euer Gegner hat keine Karten mehr! Von nun an wird er jedes Mal Schaden erleiden, wenn er versucht, eine Karte zu ziehen.	
GAMEPLAY_TOOLTIP_FATIGUE_ENEMYDECK_HEADLINE	Erschöpft	
GAMEPLAY_TOOLTIP_HAND_DESCRIPTION	Ihr habt {0} |4(Karte,Karten) auf der Hand.	
GAMEPLAY_TOOLTIP_HAND_FULL_DESCRIPTION	Ihr habt {0} |4(Karte,Karten) auf der Hand! Eure Hand ist voll.	
GAMEPLAY_TOOLTIP_HAND_FULL_HEADLINE	Volle Hand	
GAMEPLAY_TOOLTIP_HAND_HEADLINE	Hand	
GAMEPLAY_TOOLTIP_MANA_COIN_DESCRIPTION	Gebt Eure Goldstücke für Karten aus, um Euer Deck zu verändern.	
GAMEPLAY_TOOLTIP_MANA_COIN_HEADLINE	Goldstücke	
GAMEPLAY_TOOLTIP_MANA_DESCRIPTION	Wenn Euer Zug beginnt, erhaltet Ihr einen neuen Manakristall und verbrauchte Manakristalle werden wieder aufgefüllt.	
GAMEPLAY_TOOLTIP_MANA_HEADLINE	Manakristalle	
GAMEPLAY_TOOLTIP_MANA_LOCKED_DESCRIPTION	{0} |4(Manakristall,Manakristalle) im letzten Zug <b>überladen</b>	0= number of overloaded mana crystals.
GAMEPLAY_TOOLTIP_MANA_LOCKED_HEADLINE	Gesperrte Manakristalle	
GAMEPLAY_TOOLTIP_MANA_OVERLOAD_DESCRIPTION	{0} |4(Manakristall,Manakristalle) <b>überladen</b>	0= number of overloaded mana crystals.
GAMEPLAY_TOOLTIP_MANA_OVERLOAD_HEADLINE	Überladung	
GAMEPLAY_TOT_109t_STASIS_DRAGON_1	Erwacht nach zwei Zügen mit <b>Eifer</b>.	
GAMEPLAY_TOT_109t_STASIS_DRAGON_2	Erwacht im nächsten Zug mit <b>Eifer</b>.	
GAMEPLAY_TRLA_TROLL_SHRINE_1	Wird in 3 Zügen\nwiederbelebt.	
GAMEPLAY_TRLA_TROLL_SHRINE_2	Wird in 2 Zügen\nwiederbelebt.	
GAMEPLAY_TRLA_TROLL_SHRINE_3	Wird in 1 Zug\nwiederbelebt.	
GAMEPLAY_UNDATAKAH1	{0}	
GAMEPLAY_UNDATAKAH2	{0} und {1}	
GAMEPLAY_UNDATAKAH3	{0}, {1} und {2}	
GAMEPLAY_UNKNOWN_CREATED_BY	eine andere Karte	
GAMEPLAY_WIN_REWARD_PROGRESS	Siege {0}/{1}	
GAMEPLAY_YOUR_TURN	Euer Zug	
