TAG	TEXT	COMMENT
PRESENCE_ADVENTURE_MODE_BOH	Liest im Buch der Helden	
PRESENCE_ADVENTURE_MODE_BOM	Liest im Buch der Söldner	
PRESENCE_ADVENTURE_MODE_BOT	Besichtigt das Geheimlabor	
PRESENCE_ADVENTURE_MODE_BRM_CLASS_CHALLENGE	Klassenherausf. (Schwarzfels)	
PRESENCE_ADVENTURE_MODE_BRM_HEROIC	Der Schwarzfels (Heroisch)	
PRESENCE_ADVENTURE_MODE_BRM_NORMAL	Der Schwarzfels	
PRESENCE_ADVENTURE_MODE_BTA	Betritt die Höllenfeuerprobe	
PRESENCE_ADVENTURE_MODE_BTA_HEROIC	Betritt Höllenfeuerherausf.	
PRESENCE_ADVENTURE_MODE_BTP	Erlebt Illidans Vergangenheit!	
PRESENCE_ADVENTURE_MODE_DAL	Plant einen Coup	
PRESENCE_ADVENTURE_MODE_DRG	Kämpft um die Drachenöde	
PRESENCE_ADVENTURE_MODE_GIL	Bereitet sich auf Monsterjagd vor	
PRESENCE_ADVENTURE_MODE_ICC_NORMAL	Dringt in Eiskrone ein	
PRESENCE_ADVENTURE_MODE_KAR_CLASS_CHALLENGE	Klassenherausf. (Karazhan)	
PRESENCE_ADVENTURE_MODE_KAR_HEROIC	Karazhan (Heroisch)	
PRESENCE_ADVENTURE_MODE_KAR_NORMAL	Karazhan	
PRESENCE_ADVENTURE_MODE_LOE_CLASS_CHALLENGE	Klassenherausf. (Forscherliga)	
PRESENCE_ADVENTURE_MODE_LOE_HEROIC	Die Forscherliga (Heroisch)	
PRESENCE_ADVENTURE_MODE_LOE_NORMAL	Die Forscherliga	
PRESENCE_ADVENTURE_MODE_LOOT	Bereitet sich auf Schatzjagd vor	
PRESENCE_ADVENTURE_MODE_NAXX_CLASS_CHALLENGE	Klassenherausf. (Naxxramas)	
PRESENCE_ADVENTURE_MODE_NAXX_HEROIC	Naxxramas (Heroisch)	
PRESENCE_ADVENTURE_MODE_NAXX_NORMAL	Naxxramas	
PRESENCE_ADVENTURE_MODE_RETURNING_PLAYER_CHALLENGE	Herausf. für Wiedereinsteiger	
PRESENCE_ADVENTURE_MODE_TRL	Bereitet sich auf Trollarena vor	
PRESENCE_ADVENTURE_MODE_ULD	Plant eine Expedition	
PRESENCE_SCENARIO_BOH_FIGHT_01	Überredet Erzmagier Antonidas	
PRESENCE_SCENARIO_BOH_FIGHT_02	Führt Prinz Kael’thas vor	
PRESENCE_SCENARIO_BOH_FIGHT_03	Streitet mit Prinz Arthas	
PRESENCE_SCENARIO_BOH_FIGHT_04	Beruhigt Grommash Höllschrei	
PRESENCE_SCENARIO_BOH_FIGHT_05	Überlistet Archimonde	
PRESENCE_SCENARIO_BOH_FIGHT_06	Verteidigt Theramore	
PRESENCE_SCENARIO_BOH_FIGHT_07	Stellt Thrall zur Rede	
PRESENCE_SCENARIO_BOH_FIGHT_08	Vertreibt die Sonnenhäscher	
PRESENCE_SCENARIO_BOH10_FIGHT_01	Trifft einen Prinzen	
PRESENCE_SCENARIO_BOH10_FIGHT_02	Stiehlt von Tichondrius	
PRESENCE_SCENARIO_BOH10_FIGHT_03	Plündert das Grabmal des Sargeras	
PRESENCE_SCENARIO_BOH10_FIGHT_04	Streitet mit Malfurion	
PRESENCE_SCENARIO_BOH10_FIGHT_05	Rettet die Scherbenwelt	
PRESENCE_SCENARIO_BOH10_FIGHT_06	Beleidigt Anub’arak	
PRESENCE_SCENARIO_BOH10_FIGHT_07	Duelliert sich mit Arthas	
PRESENCE_SCENARIO_BOH10_FIGHT_08	Wird von Akama verraten	
PRESENCE_SCENARIO_BOH2_FIGHT_01	Drängt zum Handeln	
PRESENCE_SCENARIO_BOH2_FIGHT_02	Überzeugt den Kriegshäuptling	
PRESENCE_SCENARIO_BOH2_FIGHT_03	Freundet sich mit Misha an	
PRESENCE_SCENARIO_BOH2_FIGHT_04	Stellt Mogrins Ehre wieder her	
PRESENCE_SCENARIO_BOH2_FIGHT_05	Stellt mit Jaina Nachforschungen an	
PRESENCE_SCENARIO_BOH2_FIGHT_06	Rettet Baine Bluthuf	
PRESENCE_SCENARIO_BOH2_FIGHT_07	Schlägt Daelins Invasion zurück	
PRESENCE_SCENARIO_BOH2_FIGHT_08	Rettet die Mok’Nathal	
PRESENCE_SCENARIO_BOH3_FIGHT_01	Spricht mit der Großmutter	
PRESENCE_SCENARIO_BOH3_FIGHT_02	Streitet mit Rehgar	
PRESENCE_SCENARIO_BOH3_FIGHT_03	Erobert Nordend	
PRESENCE_SCENARIO_BOH3_FIGHT_04	Löscht Feuer in Orgrimmar	
PRESENCE_SCENARIO_BOH3_FIGHT_05	Kämpft in einem Mak’gora	
PRESENCE_SCENARIO_BOH3_FIGHT_06	Greift Theramore an	
PRESENCE_SCENARIO_BOH3_FIGHT_07	Läutet die Götterglocke	
PRESENCE_SCENARIO_BOH3_FIGHT_08	Wird in Orgrimmar belagert	
PRESENCE_SCENARIO_BOH4_FIGHT_01	Beeindruckt Erzbischof Faol	
PRESENCE_SCENARIO_BOH4_FIGHT_02	Verteidigt Lordaeron	
PRESENCE_SCENARIO_BOH4_FIGHT_03	Duelliert sich mit Varok Saurfang	
PRESENCE_SCENARIO_BOH4_FIGHT_04	Zerstört das Dunkle Portal	
PRESENCE_SCENARIO_BOH4_FIGHT_05	Rettet Bürger vor dem Klingenmeister	
PRESENCE_SCENARIO_BOH4_FIGHT_06	Rettet Herdweiler	
PRESENCE_SCENARIO_BOH4_FIGHT_07	Nimmt den langen Weg nach Stratholme	
PRESENCE_SCENARIO_BOH4_FIGHT_08	Konfrontiert Arthas	
PRESENCE_SCENARIO_BOH5_FIGHT_01	Enttäuscht Varian	
PRESENCE_SCENARIO_BOH5_FIGHT_02	Überzeugt Jaina	
PRESENCE_SCENARIO_BOH5_FIGHT_03	Handelt Frieden mit Moira aus	
PRESENCE_SCENARIO_BOH5_FIGHT_04	Lernt von Velen	
PRESENCE_SCENARIO_BOH5_FIGHT_05	Entkommt Nazgrim	
PRESENCE_SCENARIO_BOH5_FIGHT_06	Löst die Rätsel des Affenkönigs	
PRESENCE_SCENARIO_BOH5_FIGHT_07	Führt den Schlaghammer der Harmonie	
PRESENCE_SCENARIO_BOH5_FIGHT_08	Kämpft um Lordaeron	
PRESENCE_SCENARIO_BOH6_FIGHT_01	Trainiert für die Arena	
PRESENCE_SCENARIO_BOH6_FIGHT_02	Gibt vor Helka an	
PRESENCE_SCENARIO_BOH6_FIGHT_03	Konfrontiert Assassinen	
PRESENCE_SCENARIO_BOH6_FIGHT_04	Wird von einem Dämon besessen	
PRESENCE_SCENARIO_BOH6_FIGHT_05	Übt sich in Diplomatie	
PRESENCE_SCENARIO_BOH6_FIGHT_06	Verhört Garona	
PRESENCE_SCENARIO_BOH6_FIGHT_07	Stellt sich dem Schattenhammer	
PRESENCE_SCENARIO_BOH6_FIGHT_08	Wird im Rabenholdtanwesen eingeweiht	
PRESENCE_SCENARIO_BOH7_FIGHT_01	Macht Schwarzmoor reich	
PRESENCE_SCENARIO_BOH7_FIGHT_02	Wird zum Schamanen	
PRESENCE_SCENARIO_BOH7_FIGHT_03	Spricht mit einem Fremden	
PRESENCE_SCENARIO_BOH7_FIGHT_04	Bekämpft Mannoroth	
PRESENCE_SCENARIO_BOH7_FIGHT_05	Schlägt Archimonde zurück	
PRESENCE_SCENARIO_BOH7_FIGHT_06	Gebietet Todesschwinge Einhalt	
PRESENCE_SCENARIO_BOH7_FIGHT_07	Hält Jaina auf	
PRESENCE_SCENARIO_BOH7_FIGHT_08	Degradiert Garrosh	
PRESENCE_SCENARIO_BOH8_FIGHT_01	Wird unterwiesen	
PRESENCE_SCENARIO_BOH8_FIGHT_02	Bekämpft die Brennende Legion	
PRESENCE_SCENARIO_BOH8_FIGHT_03	In einem Bruderstreit	
PRESENCE_SCENARIO_BOH8_FIGHT_04	Rettet Nordrassil	
PRESENCE_SCENARIO_BOH8_FIGHT_05	In einem weiteren Bruderstreit	
PRESENCE_SCENARIO_BOH8_FIGHT_06	Bekämpft den Smaragdgrünen Alptraum	
PRESENCE_SCENARIO_BOH8_FIGHT_07	Bewacht den Hyjal	
PRESENCE_SCENARIO_BOH8_FIGHT_08	Verteidigt Teldrassil	
PRESENCE_SCENARIO_BOH9_FIGHT_01	Wird aus dem Klan verstoßen	
PRESENCE_SCENARIO_BOH9_FIGHT_02	Fleht am Thron der Elemente um Hilfe	
PRESENCE_SCENARIO_BOH9_FIGHT_03	Trifft Ner’zhul	
PRESENCE_SCENARIO_BOH9_FIGHT_04	Liefert die Horde der Verderbnis aus	
PRESENCE_SCENARIO_BOH9_FIGHT_05	Wird von Medivh rekrutiert	
PRESENCE_SCENARIO_BOH9_FIGHT_06	Überlebt Orgrims Zorn	
PRESENCE_SCENARIO_BOH9_FIGHT_07	Holt Teron’gor zurück	
PRESENCE_SCENARIO_BOH9_FIGHT_08	Durchsucht das Grabmal des Sargeras	
PRESENCE_SCENARIO_BOM_FIGHT_01	Kämpft gegen Bru’kan	
PRESENCE_SCENARIO_BOM_FIGHT_02	Treibt sich mit Guff herum	
PRESENCE_SCENARIO_BOM_FIGHT_03	Zähmt einen nekrotischen Nichtsnutz	
PRESENCE_SCENARIO_BOM_FIGHT_04	Jagt eine seltene Kreatur	
PRESENCE_SCENARIO_BOM_FIGHT_05	Erbeutet Splitter	
PRESENCE_SCENARIO_BOM_FIGHT_06	Kämpft gegen Doppelzopf	
PRESENCE_SCENARIO_BOM_FIGHT_07	Findet Feegly	
PRESENCE_SCENARIO_BOM_FIGHT_08	Stellt sich Garrosh	
PRESENCE_SCENARIO_BOM2_FIGHT_01	Beobachtet Wachposten	
PRESENCE_SCENARIO_BOM2_FIGHT_02	Schlägt Serena in die Flucht	
PRESENCE_SCENARIO_BOM2_FIGHT_03	Lernt die örtliche Fauna kennen	
PRESENCE_SCENARIO_BOM2_FIGHT_04	Erfüllt die Tagesquote	
PRESENCE_SCENARIO_BOM2_FIGHT_05	Stiehlt einen Schredder	
PRESENCE_SCENARIO_BOM2_FIGHT_06	Begeht einen Einbruch	
PRESENCE_SCENARIO_BOM2_FIGHT_07	Macht acht Arme platt	
PRESENCE_SCENARIO_BOM2_FIGHT_08	Hält einen Lichtsplitter	
PRESENCE_SCENARIO_BOM3_FIGHT_01	Hilft Hamuul	
PRESENCE_SCENARIO_BOM3_FIGHT_02	Sucht einen Felsspalt	
PRESENCE_SCENARIO_BOM3_FIGHT_03	Bekämpft Kolkar	
PRESENCE_SCENARIO_BOM3_FIGHT_04	Rettet Schnappkiefer	
PRESENCE_SCENARIO_BOM3_FIGHT_05	Sucht eine Gruppe	
PRESENCE_SCENARIO_BOM3_FIGHT_06	Bekämpft Giftzahnlords	
PRESENCE_SCENARIO_BOM3_FIGHT_07	Misst sich mit Mutanus	
PRESENCE_SCENARIO_BOM3_FIGHT_08	Verhandelt mit Naralex	
PRESENCE_SCENARIO_BOM4_FIGHT_01	Beschützt einen Paladin	
PRESENCE_SCENARIO_BOM4_FIGHT_02	Attackiert Außenseiter	
PRESENCE_SCENARIO_BOM4_FIGHT_03	Probt für die Rache	
PRESENCE_SCENARIO_BOM4_FIGHT_04	Trommelt das Team zusammen	
PRESENCE_SCENARIO_BOM4_FIGHT_05	Bekämpft die Brennende Klinge	
PRESENCE_SCENARIO_BOM4_FIGHT_06	Kampiert mit Kazakus	
PRESENCE_SCENARIO_BOM4_FIGHT_07	Ficht mit Feuerklinge	
PRESENCE_SCENARIO_BOM4_FIGHT_08	Trotzt Tamsin	
PRESENCE_SCENARIO_BOM5_FIGHT_01	Blickt mit Kurtrus zurück	
PRESENCE_SCENARIO_BOM5_FIGHT_02	Feilscht mit Haizahn	
PRESENCE_SCENARIO_BOM5_FIGHT_03	Stürmt Sturmwind	
PRESENCE_SCENARIO_BOM5_FIGHT_04	Fetzt sich mit Freunden	
PRESENCE_SCENARIO_BOM5_FIGHT_05	Bekämpft einen Käsehändler	
PRESENCE_SCENARIO_BOM5_FIGHT_06	Setzt Xyrella zu	
PRESENCE_SCENARIO_BOM5_FIGHT_07	Entfesselt Anetheron	
PRESENCE_SCENARIO_BOM5_FIGHT_08	Verderbt Cornelius	
PRESENCE_SCENARIO_BOM6_FIGHT_01	Übt mit der Schwester den Kampf	
PRESENCE_SCENARIO_BOM6_FIGHT_02	Duelliert sich mit einem Dämonenjäger	
PRESENCE_SCENARIO_BOM6_FIGHT_03	Kehrt nach Hause zurück	
PRESENCE_SCENARIO_BOM6_FIGHT_04	Schützt den Zwergendistrikt	
PRESENCE_SCENARIO_BOM6_FIGHT_05	Befreit einen Freund	
PRESENCE_SCENARIO_BOM6_FIGHT_06	Bläst zum Angriff auf Anetheron	
PRESENCE_SCENARIO_BOM6_FIGHT_07	Mischt eine Monstrosität auf	
PRESENCE_SCENARIO_BOM6_FIGHT_08	Stellt sich Tamsin	
PRESENCE_SCENARIO_BOM7_FIGHT_01	Kämpft gegen Bob	
PRESENCE_SCENARIO_BOM7_FIGHT_02	Entlarvt den Verräter	
PRESENCE_SCENARIO_BOM7_FIGHT_03	Kümmert sich um Hogger	
PRESENCE_SCENARIO_BOM7_FIGHT_04	Bricht aus	
PRESENCE_SCENARIO_BOM7_FIGHT_05	Steigt in die Todesminen hinab	
PRESENCE_SCENARIO_BOM7_FIGHT_06	Plättet Handlanger Pein	
PRESENCE_SCENARIO_BOM7_FIGHT_07	Kocht mit Krümel	
PRESENCE_SCENARIO_BOM7_FIGHT_08	Eliminiert Edwin	
PRESENCE_SCENARIO_BOTA_CLEAR_BOOM	Grübelt über einem Rätsel	
PRESENCE_SCENARIO_BOTA_CLEAR_PUZZLE_1	Grübelt über einem Rätsel	
PRESENCE_SCENARIO_BOTA_CLEAR_PUZZLE_2	Grübelt über einem Rätsel	
PRESENCE_SCENARIO_BOTA_CLEAR_PUZZLE_3	Grübelt über einem Rätsel	
PRESENCE_SCENARIO_BOTA_CLEAR_PUZZLE_4	Grübelt über einem Rätsel	
PRESENCE_SCENARIO_BOTA_LETHAL_BOOM	Grübelt über einem Rätsel	
PRESENCE_SCENARIO_BOTA_LETHAL_PUZZLE_1	Grübelt über einem Rätsel	
PRESENCE_SCENARIO_BOTA_LETHAL_PUZZLE_2	Grübelt über einem Rätsel	
PRESENCE_SCENARIO_BOTA_LETHAL_PUZZLE_3	Grübelt über einem Rätsel	
PRESENCE_SCENARIO_BOTA_LETHAL_PUZZLE_4	Grübelt über einem Rätsel	
PRESENCE_SCENARIO_BOTA_MIRROR_BOOM	Grübelt über einem Rätsel	
PRESENCE_SCENARIO_BOTA_MIRROR_PUZZLE_1	Grübelt über einem Rätsel	
PRESENCE_SCENARIO_BOTA_MIRROR_PUZZLE_2	Grübelt über einem Rätsel	
PRESENCE_SCENARIO_BOTA_MIRROR_PUZZLE_3	Grübelt über einem Rätsel	
PRESENCE_SCENARIO_BOTA_MIRROR_PUZZLE_4	Grübelt über einem Rätsel	
PRESENCE_SCENARIO_BOTA_SURVIVAL_BOOM	Grübelt über einem Rätsel	
PRESENCE_SCENARIO_BOTA_SURVIVAL_PUZZLE_1	Grübelt über einem Rätsel	
PRESENCE_SCENARIO_BOTA_SURVIVAL_PUZZLE_2	Grübelt über einem Rätsel	
PRESENCE_SCENARIO_BOTA_SURVIVAL_PUZZLE_3	Grübelt über einem Rätsel	
PRESENCE_SCENARIO_BOTA_SURVIVAL_PUZZLE_4	Grübelt über einem Rätsel	
PRESENCE_SCENARIO_BRM_CLASS_CHALLENGE_DRUID	Druidenherausf. (Schwarzfels)	
PRESENCE_SCENARIO_BRM_CLASS_CHALLENGE_HUNTER	Jägerherausf. (Schwarzfels)	
PRESENCE_SCENARIO_BRM_CLASS_CHALLENGE_MAGE	Magierherausf. (Schwarzfels)	
PRESENCE_SCENARIO_BRM_CLASS_CHALLENGE_PALADIN	Paladinherausf. (Schwarzfels)	
PRESENCE_SCENARIO_BRM_CLASS_CHALLENGE_PRIEST	Priesterherausf. (Schwarzfels)	
PRESENCE_SCENARIO_BRM_CLASS_CHALLENGE_ROGUE	Schurkenherausf. (Schwarzfels)	
PRESENCE_SCENARIO_BRM_CLASS_CHALLENGE_SHAMAN	Schamanenherausf. (Schwarzfels)	
PRESENCE_SCENARIO_BRM_CLASS_CHALLENGE_WARLOCK	Hexenmeisterherausf. (Schwarzfels)	
PRESENCE_SCENARIO_BRM_CLASS_CHALLENGE_WARRIOR	Kriegerherausf. (Schwarzfels)	
PRESENCE_SCENARIO_BRM_HEROIC_SCENARIO_ATRAMEDES	Atramedes (Heroisch)	
PRESENCE_SCENARIO_BRM_HEROIC_SCENARIO_BARON_GEDDON	Baron Geddon (Heroisch)	
PRESENCE_SCENARIO_BRM_HEROIC_SCENARIO_CHROMAGGUS	Chromaggus (Heroisch)	
PRESENCE_SCENARIO_BRM_HEROIC_SCENARIO_DARK_IRON_ARENA	Dunkeleisenarena (Heroisch)	feel free to shorten long translations since the UI may squeeze text into a tiny (unreadable) font size when text is too long. this string is shown in the Friends List.
PRESENCE_SCENARIO_BRM_HEROIC_SCENARIO_DRAKKISATH	General Drakkisath (Heroisch)	
PRESENCE_SCENARIO_BRM_HEROIC_SCENARIO_GARR	Garr (Heroisch)	
PRESENCE_SCENARIO_BRM_HEROIC_SCENARIO_GRIM_GUZZLER	Zum Grimmigen Säufer (Heroisch)	
PRESENCE_SCENARIO_BRM_HEROIC_SCENARIO_MAJORDOMO	Ragnaros (Heroisch)	feel free to shorten long translations to 'Heroic Ragnaros' since the UI may squeeze text into a tiny (unreadable) font size when text is too long. this string is shown in the Friends List.
PRESENCE_SCENARIO_BRM_HEROIC_SCENARIO_MALORIAK	Maloriak (Heroisch)	
PRESENCE_SCENARIO_BRM_HEROIC_SCENARIO_NEFARIAN	Victor Nefarius (Heroisch)	feel free to shorten long translations to 'Heroic Nefarius' since the UI may squeeze text into a tiny (unreadable) font size when text is too long. this string is shown in the Friends List.
PRESENCE_SCENARIO_BRM_HEROIC_SCENARIO_OMNOTRON	Omnotron (Heroisch)	
PRESENCE_SCENARIO_BRM_HEROIC_SCENARIO_OMOKK	Hochlord Omokk (Heroisch)	
PRESENCE_SCENARIO_BRM_HEROIC_SCENARIO_RAZORGORE	Feuerkralle (Heroisch)	
PRESENCE_SCENARIO_BRM_HEROIC_SCENARIO_REND_BLACKHAND	Rend Schwarzfaust (Heroisch)	
PRESENCE_SCENARIO_BRM_HEROIC_SCENARIO_THAURISSAN	Thaurissan (Heroisch)	feel free to shorten long translations to 'Heroic Thaurissan' since the UI may squeeze text into a tiny (unreadable) font size when text is too long. this string is shown in the Friends List.
PRESENCE_SCENARIO_BRM_HEROIC_SCENARIO_VAELASTRASZ	Vaelastrasz (Heroisch)	
PRESENCE_SCENARIO_BRM_HEROIC_SCENARIO_ZOMBIE_NEF	Nefarian (Heroisch)	
PRESENCE_SCENARIO_BRM_NORMAL_SCENARIO_ATRAMEDES	Kämpft gegen Atramedes	
PRESENCE_SCENARIO_BRM_NORMAL_SCENARIO_BARON_GEDDON	Kämpft gegen Baron Geddon	
PRESENCE_SCENARIO_BRM_NORMAL_SCENARIO_CHROMAGGUS	Kämpft gegen Chromaggus	
PRESENCE_SCENARIO_BRM_NORMAL_SCENARIO_DARK_IRON_ARENA	Kämpft in Dunkeleisenarena	feel free to shorten long translations since the UI may squeeze text into a tiny (unreadable) font size when text is too long. this string is shown in the Friends List.
PRESENCE_SCENARIO_BRM_NORMAL_SCENARIO_DRAKKISATH	Kämpft gegen Drakkisath	
PRESENCE_SCENARIO_BRM_NORMAL_SCENARIO_GARR	Kämpft gegen Garr	
PRESENCE_SCENARIO_BRM_NORMAL_SCENARIO_GRIM_GUZZLER	Kämpft im Grimmigen Säufer	
PRESENCE_SCENARIO_BRM_NORMAL_SCENARIO_MAJORDOMO	Kämpft gegen Ragnaros	feel free to shorten long translations to 'Battling Ragnaros' since the UI may squeeze text into a tiny (unreadable) font size when text is too long. this string is shown in the Friends List.
PRESENCE_SCENARIO_BRM_NORMAL_SCENARIO_MALORIAK	Kämpft gegen Maloriak	
PRESENCE_SCENARIO_BRM_NORMAL_SCENARIO_NEFARIAN	Kämpft gegen Nefarius	feel free to shorten long translations to 'Battling Nefarius' since the UI may squeeze text into a tiny (unreadable) font size when text is too long. this string is shown in the Friends List.
PRESENCE_SCENARIO_BRM_NORMAL_SCENARIO_OMNOTRON	Kämpft gegen Omnotron	
PRESENCE_SCENARIO_BRM_NORMAL_SCENARIO_OMOKK	Kämpft gegen Omokk	
PRESENCE_SCENARIO_BRM_NORMAL_SCENARIO_RAZORGORE	Kämpft gegen Feuerkralle	
PRESENCE_SCENARIO_BRM_NORMAL_SCENARIO_REND_BLACKHAND	Kämpft gegen Schwarzfaust	
PRESENCE_SCENARIO_BRM_NORMAL_SCENARIO_THAURISSAN	Kämpft gegen Thaurissan	feel free to shorten long translations to 'Battling Thaurissan' since the UI may squeeze text into a tiny (unreadable) font size when text is too long. this string is shown in the Friends List.
PRESENCE_SCENARIO_BRM_NORMAL_SCENARIO_VAELASTRASZ	Kämpft gegen Vaelastrasz	
PRESENCE_SCENARIO_BRM_NORMAL_SCENARIO_ZOMBIE_NEF	Kämpft gegen Nefarian	
PRESENCE_SCENARIO_BTA_COIN_01_INQUISITOR_DAKREL	Erkundet die Höllenfeuerhalbinsel	
PRESENCE_SCENARIO_BTA_COIN_02_XUR_GOTH	Erkundet die Höllenfeuerhalbinsel	
PRESENCE_SCENARIO_BTA_COIN_03_ZIXOR	Erkundet die Höllenfeuerhalbinsel	
PRESENCE_SCENARIO_BTA_COIN_04_BALTHARAK	Erkundet die Höllenfeuerhalbinsel	
PRESENCE_SCENARIO_BTA_COIN_05_KANRETHAD_PRIME	Durchquert die Zangarmarschen	
PRESENCE_SCENARIO_BTA_COIN_06_BURGRAK_CRUELCHAIN	Durchquert die Zangarmarschen	
PRESENCE_SCENARIO_BTA_COIN_07_FELSTORM_RUN	Durchquert die Zangarmarschen	
PRESENCE_SCENARIO_BTA_COIN_08_MOTHER_SHAHRAZ	Durchquert die Zangarmarschen	
PRESENCE_SCENARIO_BTA_COIN_09_SHAL_JA_OUTCAST	Trainiert im Schwarzen Tempel	
PRESENCE_SCENARIO_BTA_COIN_10_KARNUK_OUTCAST	Trainiert im Schwarzen Tempel	
PRESENCE_SCENARIO_BTA_COIN_11_JEK_HAZ	Trainiert im Schwarzen Tempel	
PRESENCE_SCENARIO_BTA_COIN_12_MAGTHERIDON_PRIME	Trainiert im Schwarzen Tempel	
PRESENCE_SCENARIO_BTA_COIN_13_GOK_AMOK	Kämpft um den Nethersturm	
PRESENCE_SCENARIO_BTA_COIN_14_FLIKK	Kämpft um den Nethersturm	
PRESENCE_SCENARIO_BTA_COIN_15_BADUU_CORRUPTED	Kämpft um den Nethersturm	
PRESENCE_SCENARIO_BTA_COIN_16_MECHA_JARAXXUS	Kämpft um den Nethersturm	
PRESENCE_SCENARIO_BTA_COIN_17_ILLIDAN_STORMRAGE	Entscheidet Schicksal der Scherbenwelt	
PRESENCE_SCENARIO_BTA_HEROIC_COIN_01_KAZZAK	Bekämpft die Stärksten der Scherbenwelt	
PRESENCE_SCENARIO_BTA_HEROIC_COIN_02_GRUUL	Bekämpft die Stärksten der Scherbenwelt	
PRESENCE_SCENARIO_BTA_HEROIC_COIN_03_MAGTHERIDON	Bekämpft die Stärksten der Scherbenwelt	
PRESENCE_SCENARIO_BTA_HEROIC_COIN_04_SUPREMUS	Bekämpft die Stärksten der Scherbenwelt	
PRESENCE_SCENARIO_BTA_HEROIC_COIN_05_TERON_GOREFIEND	Bekämpft die Stärksten der Scherbenwelt	
PRESENCE_SCENARIO_BTA_HEROIC_COIN_06_MOTHER_SHARAZ	Bekämpft die Stärksten der Scherbenwelt	
PRESENCE_SCENARIO_BTA_HEROIC_COIN_07_LADY_VASHJ	Bekämpft die Stärksten der Scherbenwelt	
PRESENCE_SCENARIO_BTA_HEROIC_COIN_08_KAELTHAS	Bekämpft die Stärksten der Scherbenwelt	
PRESENCE_SCENARIO_BTA_HEROIC_COIN_09_ILLIDAN	Bekämpft die Stärksten der Scherbenwelt	
PRESENCE_SCENARIO_BTP_COIN_01_AZZINOTH	Wehrt die Brennende Legion ab!	
PRESENCE_SCENARIO_BTP_COIN_02_XAVIUS	Wechselt die Seiten!	
PRESENCE_SCENARIO_BTP_COIN_03_MANNOROTH	Schlägt Dämonen zurück!	
PRESENCE_SCENARIO_BTP_COIN_04_CENARIUS	Wehrt sich gegen Anschuldigungen!	
PRESENCE_SCENARIO_DALA_01_BANK	Überfällt die Bank von Dalaran	
PRESENCE_SCENARIO_DALA_01_BANK_HEROIC	Überfällt die Bank von Dalaran	
PRESENCE_SCENARIO_DALA_02_VIOLET_HOLD	Befreit die Violette Festung	
PRESENCE_SCENARIO_DALA_02_VIOLET_HOLD_HEROIC	Befreit die Violette Festung	
PRESENCE_SCENARIO_DALA_03_STREETS	Stiftet Chaos in den Straßen	
PRESENCE_SCENARIO_DALA_03_STREETS_HEROIC	Stiftet Chaos in den Straßen	
PRESENCE_SCENARIO_DALA_04_UNDERBELLY	Infiltriert die Schattenseite	
PRESENCE_SCENARIO_DALA_04_UNDERBELLY_HEROIC	Infiltriert die Schattenseite	
PRESENCE_SCENARIO_DALA_05_CITADEL	Erobert die Violette Zitadelle	
PRESENCE_SCENARIO_DALA_05_CITADEL_HEROIC	Erobert die Violette Zitadelle	
PRESENCE_SCENARIO_DALA_TAVERN	Besucht Dalarans Kneipen	
PRESENCE_SCENARIO_DALA_TAVERN_HEROIC	Besucht Dalarans Kneipen	
PRESENCE_SCENARIO_DRGA_EVIL_CHAPTER_01_COIN_01	Kämpft um die Drachenöde	
PRESENCE_SCENARIO_DRGA_EVIL_CHAPTER_01_COIN_01_HEROIC	Kämpft um die Drachenöde	
PRESENCE_SCENARIO_DRGA_EVIL_CHAPTER_01_COIN_02	Kämpft um die Drachenöde	
PRESENCE_SCENARIO_DRGA_EVIL_CHAPTER_01_COIN_02_HEROIC	Kämpft um die Drachenöde	
PRESENCE_SCENARIO_DRGA_EVIL_CHAPTER_01_COIN_03	Kämpft um die Drachenöde	
PRESENCE_SCENARIO_DRGA_EVIL_CHAPTER_01_COIN_03_HEROIC	Kämpft um die Drachenöde	
PRESENCE_SCENARIO_DRGA_EVIL_CHAPTER_02_COIN_01	Kämpft um die Drachenöde	
PRESENCE_SCENARIO_DRGA_EVIL_CHAPTER_02_COIN_01_HEROIC	Kämpft um die Drachenöde	
PRESENCE_SCENARIO_DRGA_EVIL_CHAPTER_02_COIN_02	Kämpft um die Drachenöde	
PRESENCE_SCENARIO_DRGA_EVIL_CHAPTER_02_COIN_02_HEROIC	Kämpft um die Drachenöde	
PRESENCE_SCENARIO_DRGA_EVIL_CHAPTER_02_COIN_03	Kämpft um die Drachenöde	
PRESENCE_SCENARIO_DRGA_EVIL_CHAPTER_02_COIN_03_HEROIC	Kämpft um die Drachenöde	
PRESENCE_SCENARIO_DRGA_EVIL_CHAPTER_03_COIN_01	Kämpft um die Drachenöde	
PRESENCE_SCENARIO_DRGA_EVIL_CHAPTER_03_COIN_01_HEROIC	Kämpft um die Drachenöde	
PRESENCE_SCENARIO_DRGA_EVIL_CHAPTER_03_COIN_02	Kämpft um die Drachenöde	
PRESENCE_SCENARIO_DRGA_EVIL_CHAPTER_03_COIN_02_HEROIC	Kämpft um die Drachenöde	
PRESENCE_SCENARIO_DRGA_EVIL_CHAPTER_03_COIN_03	Kämpft um die Drachenöde	
PRESENCE_SCENARIO_DRGA_EVIL_CHAPTER_03_COIN_03_HEROIC	Kämpft um die Drachenöde	
PRESENCE_SCENARIO_DRGA_EVIL_CHAPTER_04_COIN_01	Kämpft um die Drachenöde	
PRESENCE_SCENARIO_DRGA_EVIL_CHAPTER_04_COIN_01_HEROIC	Kämpft um die Drachenöde	
PRESENCE_SCENARIO_DRGA_EVIL_CHAPTER_04_COIN_02	Kämpft um die Drachenöde	
PRESENCE_SCENARIO_DRGA_EVIL_CHAPTER_04_COIN_02_HEROIC	Kämpft um die Drachenöde	
PRESENCE_SCENARIO_DRGA_EVIL_CHAPTER_04_COIN_03	Kämpft um die Drachenöde	
PRESENCE_SCENARIO_DRGA_EVIL_CHAPTER_04_COIN_03_HEROIC	Kämpft um die Drachenöde	
PRESENCE_SCENARIO_DRGA_GOOD_CHAPTER_01_COIN_01	Kämpft um die Drachenöde	
PRESENCE_SCENARIO_DRGA_GOOD_CHAPTER_01_COIN_01_HEROIC	Kämpft um die Drachenöde	
PRESENCE_SCENARIO_DRGA_GOOD_CHAPTER_01_COIN_02	Kämpft um die Drachenöde	
PRESENCE_SCENARIO_DRGA_GOOD_CHAPTER_01_COIN_02_HEROIC	Kämpft um die Drachenöde	
PRESENCE_SCENARIO_DRGA_GOOD_CHAPTER_01_COIN_03	Kämpft um die Drachenöde	
PRESENCE_SCENARIO_DRGA_GOOD_CHAPTER_01_COIN_03_HEROIC	Kämpft um die Drachenöde	
PRESENCE_SCENARIO_DRGA_GOOD_CHAPTER_02_COIN_01	Kämpft um die Drachenöde	
PRESENCE_SCENARIO_DRGA_GOOD_CHAPTER_02_COIN_01_HEROIC	Kämpft um die Drachenöde	
PRESENCE_SCENARIO_DRGA_GOOD_CHAPTER_02_COIN_02	Kämpft um die Drachenöde	
PRESENCE_SCENARIO_DRGA_GOOD_CHAPTER_02_COIN_02_HEROIC	Kämpft um die Drachenöde	
PRESENCE_SCENARIO_DRGA_GOOD_CHAPTER_02_COIN_03	Kämpft um die Drachenöde	
PRESENCE_SCENARIO_DRGA_GOOD_CHAPTER_02_COIN_03_HEROIC	Kämpft um die Drachenöde	
PRESENCE_SCENARIO_DRGA_GOOD_CHAPTER_03_COIN_01	Kämpft um die Drachenöde	
PRESENCE_SCENARIO_DRGA_GOOD_CHAPTER_03_COIN_01_HEROIC	Kämpft um die Drachenöde	
PRESENCE_SCENARIO_DRGA_GOOD_CHAPTER_03_COIN_02	Kämpft um die Drachenöde	
PRESENCE_SCENARIO_DRGA_GOOD_CHAPTER_03_COIN_02_HEROIC	Kämpft um die Drachenöde	
PRESENCE_SCENARIO_DRGA_GOOD_CHAPTER_03_COIN_03	Kämpft um die Drachenöde	
PRESENCE_SCENARIO_DRGA_GOOD_CHAPTER_03_COIN_03_HEROIC	Kämpft um die Drachenöde	
PRESENCE_SCENARIO_DRGA_GOOD_CHAPTER_04_COIN_01	Kämpft um die Drachenöde	
PRESENCE_SCENARIO_DRGA_GOOD_CHAPTER_04_COIN_01_HEROIC	Kämpft um die Drachenöde	
PRESENCE_SCENARIO_DRGA_GOOD_CHAPTER_04_COIN_02	Kämpft um die Drachenöde	
PRESENCE_SCENARIO_DRGA_GOOD_CHAPTER_04_COIN_02_HEROIC	Kämpft um die Drachenöde	
PRESENCE_SCENARIO_DRGA_GOOD_CHAPTER_04_COIN_03	Kämpft um die Drachenöde	
PRESENCE_SCENARIO_DRGA_GOOD_CHAPTER_04_COIN_03_HEROIC	Kämpft um die Drachenöde	
PRESENCE_SCENARIO_GIL_BONUS_CHALLENGE	Kämpft gegen Hagatha	
PRESENCE_SCENARIO_GIL_DUNGEON	Auf Monsterjagd	
PRESENCE_SCENARIO_ICC_NORMAL_DEATHWHISPER	Kämpft gegen Lady Todeswisper	
PRESENCE_SCENARIO_ICC_NORMAL_FINALE	Kämpft gegen den Lichkönig	
PRESENCE_SCENARIO_ICC_NORMAL_LANATHEL	Kämpft gegen Lana’thel	
PRESENCE_SCENARIO_ICC_NORMAL_LICHKING	Verliert gegen den Lichkönig	
PRESENCE_SCENARIO_ICC_NORMAL_MARROWGAR	Kämpft gegen Mark’gar	
PRESENCE_SCENARIO_ICC_NORMAL_PUTRICIDE	Kämpft gegen Seuchenmord	
PRESENCE_SCENARIO_ICC_NORMAL_SAURFANG	Kämpft gegen Saurfang	
PRESENCE_SCENARIO_ICC_NORMAL_SINDRAGOSA	Kämpft gegen Sindragosa	
PRESENCE_SCENARIO_KAR_CLASS_CHALLENGE_DRUID	Druidenherausf. (Karazhan)	
PRESENCE_SCENARIO_KAR_CLASS_CHALLENGE_HUNTER	Jägerherausf. (Karazhan)	
PRESENCE_SCENARIO_KAR_CLASS_CHALLENGE_MAGE	Magierherausf. (Karazhan)	
PRESENCE_SCENARIO_KAR_CLASS_CHALLENGE_PALADIN	Paladinherausf. (Karazhan)	
PRESENCE_SCENARIO_KAR_CLASS_CHALLENGE_PRIEST	Priesterherausf. (Karazhan)	
PRESENCE_SCENARIO_KAR_CLASS_CHALLENGE_ROGUE	Schurkenherausf. (Karazhan)	
PRESENCE_SCENARIO_KAR_CLASS_CHALLENGE_SHAMAN	Schamanenherausf. (Karazhan)	
PRESENCE_SCENARIO_KAR_CLASS_CHALLENGE_WARLOCK	Hexenmeisterherausf. (Karazhan)	
PRESENCE_SCENARIO_KAR_CLASS_CHALLENGE_WARRIOR	Kriegerherausf. (Karazhan)	
PRESENCE_SCENARIO_KAR_HEROIC_ARAN	Arans Schemen (Heroisch)	
PRESENCE_SCENARIO_KAR_HEROIC_CHESS	Schach (Heroisch)	
PRESENCE_SCENARIO_KAR_HEROIC_CRONE	Die böse Hexe (Heroisch)	
PRESENCE_SCENARIO_KAR_HEROIC_CURATOR	Der Kurator (Heroisch)	
PRESENCE_SCENARIO_KAR_HEROIC_ILLHOOF	Siechhuf (Heroisch)	
PRESENCE_SCENARIO_KAR_HEROIC_JULIANNE	Julianne (Heroisch)	
PRESENCE_SCENARIO_KAR_HEROIC_MIRROR	Zauberspiegel (Heroisch)	
PRESENCE_SCENARIO_KAR_HEROIC_NETHERSPITE	Nethergroll (Heroisch)	
PRESENCE_SCENARIO_KAR_HEROIC_NIGHTBANE	Schrecken der Nacht (Heroisch)	
PRESENCE_SCENARIO_KAR_HEROIC_PANTRY	Tafelsilbergolem (Heroisch)	
PRESENCE_SCENARIO_KAR_HEROIC_PORTALS	Befreit Medivh! (Heroisch)	
PRESENCE_SCENARIO_KAR_HEROIC_PROLOGUE	Malchezaar (Heroisch)	
PRESENCE_SCENARIO_KAR_HEROIC_WOLF	Der große böse Wolf (Heroisch)	
PRESENCE_SCENARIO_KAR_NORMAL_ARAN	Kämpft gegen Arans Schemen	
PRESENCE_SCENARIO_KAR_NORMAL_CHESS	Spielt Schach	
PRESENCE_SCENARIO_KAR_NORMAL_CRONE	Kämpft gegen die böse Hexe	
PRESENCE_SCENARIO_KAR_NORMAL_CURATOR	Kämpft gegen den Kurator	
PRESENCE_SCENARIO_KAR_NORMAL_ILLHOOF	Kämpft gegen Siechhuf	
PRESENCE_SCENARIO_KAR_NORMAL_JULIANNE	Kämpft gegen Julianne	
PRESENCE_SCENARIO_KAR_NORMAL_MIRROR	Kämpft gegen den Zauberspiegel	
PRESENCE_SCENARIO_KAR_NORMAL_NETHERSPITE	Kämpft gegen Nethergroll	
PRESENCE_SCENARIO_KAR_NORMAL_NIGHTBANE	Kämpft gegen Schrecken der Nacht	
PRESENCE_SCENARIO_KAR_NORMAL_PANTRY	Kämpft gegen den Tafelsilbergolem	
PRESENCE_SCENARIO_KAR_NORMAL_PORTALS	Befreit Medivh	
PRESENCE_SCENARIO_KAR_NORMAL_PROLOGUE	Kämpft gegen Malchezaar	
PRESENCE_SCENARIO_KAR_NORMAL_WOLF	Kämpft gegen den großen bösen Wolf	
PRESENCE_SCENARIO_LOE_CLASS_CHALLENGE_DRUID	Druidenherausf. (Forscherliga)	
PRESENCE_SCENARIO_LOE_CLASS_CHALLENGE_HUNTER	Jägerherausf. (Forscherliga)	
PRESENCE_SCENARIO_LOE_CLASS_CHALLENGE_MAGE	Magierherausf. (Forscherliga)	
PRESENCE_SCENARIO_LOE_CLASS_CHALLENGE_PALADIN	Paladinherausf. (Forscherliga)	
PRESENCE_SCENARIO_LOE_CLASS_CHALLENGE_PRIEST	Priesterherausf. (Forscherliga)	
PRESENCE_SCENARIO_LOE_CLASS_CHALLENGE_ROGUE	Schurkenherausf. (Forscherliga)	
PRESENCE_SCENARIO_LOE_CLASS_CHALLENGE_SHAMAN	Schamanenherausf. (Forscherliga)	
PRESENCE_SCENARIO_LOE_CLASS_CHALLENGE_WARLOCK	Hexenmeisterherausf. (Forscherliga)	
PRESENCE_SCENARIO_LOE_CLASS_CHALLENGE_WARRIOR	Kriegerherausf. (Forscherliga)	
PRESENCE_SCENARIO_LOE_HEROIC_ARCHAEDAS	Archaedas (Heroisch)	
PRESENCE_SCENARIO_LOE_HEROIC_GIANTFIN	Riesenflosse (Heroisch)	
PRESENCE_SCENARIO_LOE_HEROIC_LADY_NAZJAR	Lady Naz’jar (Heroisch)	
PRESENCE_SCENARIO_LOE_HEROIC_MINE_CART	Rasante Lorenfahrt (Heroisch)	
PRESENCE_SCENARIO_LOE_HEROIC_RAFAAM_1	Meisterdieb Rafaam (Heroisch)	
PRESENCE_SCENARIO_LOE_HEROIC_RAFAAM_2	Rafaam entfesselt (Heroisch)	
PRESENCE_SCENARIO_LOE_HEROIC_SCARVASH	Häuptling Scarvash (Heroisch)	
PRESENCE_SCENARIO_LOE_HEROIC_SKELESAURUS	Skelesaurus Hex (Heroisch)	
PRESENCE_SCENARIO_LOE_HEROIC_SLITHERSPEAR	Lord Schlängelspeer (Heroisch)	
PRESENCE_SCENARIO_LOE_HEROIC_STEEL_SENTINEL	Stählerner Wächter (Heroisch)	
PRESENCE_SCENARIO_LOE_HEROIC_SUN_RAIDER_PHAERIX	Sonnendieb Phaerix (Heroisch)	
PRESENCE_SCENARIO_LOE_HEROIC_TEMPLE_ESCAPE	Flucht aus dem Tempel (Heroisch)	
PRESENCE_SCENARIO_LOE_HEROIC_ZINAAR	Zinaar (Heroisch)	
PRESENCE_SCENARIO_LOE_NORMAL_ARCHAEDAS	Kämpft gegen Archaedas	
PRESENCE_SCENARIO_LOE_NORMAL_GIANTFIN	Kämpft gegen Riesenflosse	
PRESENCE_SCENARIO_LOE_NORMAL_LADY_NAZJAR	Kämpft gegen Lady Naz’jar	
PRESENCE_SCENARIO_LOE_NORMAL_MINE_CART	Rasante Lorenfahrt	
PRESENCE_SCENARIO_LOE_NORMAL_RAFAAM_1	Kämpft gegen Meisterdieb Rafaam	
PRESENCE_SCENARIO_LOE_NORMAL_RAFAAM_2	Kämpft gegen Rafaam entfesselt	
PRESENCE_SCENARIO_LOE_NORMAL_SCARVASH	Kämpft gegen Scarvash	
PRESENCE_SCENARIO_LOE_NORMAL_SKELESAURUS	Kämpft gegen Skelesaurus Hex	
PRESENCE_SCENARIO_LOE_NORMAL_SLITHERSPEAR	Kämpft gegen Schlängelspeer	
PRESENCE_SCENARIO_LOE_NORMAL_STEEL_SENTINEL	Kämpft gegen Stählernen Wächter	
PRESENCE_SCENARIO_LOE_NORMAL_SUN_RAIDER_PHAERIX	Kämpft gegen Phaerix	
PRESENCE_SCENARIO_LOE_NORMAL_TEMPLE_ESCAPE	Flucht aus dem Tempel	
PRESENCE_SCENARIO_LOE_NORMAL_ZINAAR	Kämpft gegen Zinaar	
PRESENCE_SCENARIO_LOOT_DUNGEON	Auf Schatzjagd	
PRESENCE_SCENARIO_NAXX_CLASS_CHALLENGE_DRUID	Druidenherausf. (Naxxramas)	
PRESENCE_SCENARIO_NAXX_CLASS_CHALLENGE_HUNTER	Jägerherausf. (Naxxramas)	
PRESENCE_SCENARIO_NAXX_CLASS_CHALLENGE_MAGE	Magierherausf. (Naxxramas)	
PRESENCE_SCENARIO_NAXX_CLASS_CHALLENGE_PALADIN	Paladinherausf. (Naxxramas)	
PRESENCE_SCENARIO_NAXX_CLASS_CHALLENGE_PRIEST	Priesterherausf. (Naxxramas)	
PRESENCE_SCENARIO_NAXX_CLASS_CHALLENGE_ROGUE	Schurkenherausf. (Naxxramas)	
PRESENCE_SCENARIO_NAXX_CLASS_CHALLENGE_SHAMAN	Schamanenherausf. (Naxxramas)	
PRESENCE_SCENARIO_NAXX_CLASS_CHALLENGE_WARLOCK	Hexenmeisterherausf. (Naxxramas)	
PRESENCE_SCENARIO_NAXX_CLASS_CHALLENGE_WARRIOR	Kriegerherausf. (Naxxramas)	
PRESENCE_SCENARIO_NAXX_HEROIC_SCENARIO_ANUBREKHAN	Anub’Rekhan (Heroisch)	
PRESENCE_SCENARIO_NAXX_HEROIC_SCENARIO_FAERLINA	Faerlina (Heroisch)	feel free to shorten long translations to 'Heroic Faerlina' since the UI may squeeze text into a tiny (unreadable) font size when text is too long. this string is shown in the Friends List.
PRESENCE_SCENARIO_NAXX_HEROIC_SCENARIO_GLUTH	Gluth (Heroisch)	
PRESENCE_SCENARIO_NAXX_HEROIC_SCENARIO_GOTHIK	Gothik (Heroisch)	feel free to shorten long translations to 'Heroic Gothik' since the UI may squeeze text into a tiny (unreadable) font size when text is too long. this string is shown in the Friends List.
PRESENCE_SCENARIO_NAXX_HEROIC_SCENARIO_GROBBULUS	Grobbulus (Heroisch)	
PRESENCE_SCENARIO_NAXX_HEROIC_SCENARIO_HEIGAN	Heigan (Heroisch)	feel free to shorten long translations to 'Heroic Heigan' since the UI may squeeze text into a tiny (unreadable) font size when text is too long. this string is shown in the Friends List.
PRESENCE_SCENARIO_NAXX_HEROIC_SCENARIO_HORSEMEN	Die Vier Reiter (Heroisch)	
PRESENCE_SCENARIO_NAXX_HEROIC_SCENARIO_KELTHUZAD	Kel’Thuzad (Heroisch)	
PRESENCE_SCENARIO_NAXX_HEROIC_SCENARIO_LOATHEB	Loatheb (Heroisch)	
PRESENCE_SCENARIO_NAXX_HEROIC_SCENARIO_MAEXXNA	Maexxna (Heroisch)	
PRESENCE_SCENARIO_NAXX_HEROIC_SCENARIO_NOTH	Noth (Heroisch)	feel free to shorten long translations to 'Heroic Noth' since the UI may squeeze text into a tiny (unreadable) font size when text is too long. this string is shown in the Friends List.
PRESENCE_SCENARIO_NAXX_HEROIC_SCENARIO_PATCHWERK	Flickwerk (Heroisch)	
PRESENCE_SCENARIO_NAXX_HEROIC_SCENARIO_RAZUVIOUS	Razuvious (Heroisch)	feel free to shorten long translations to 'Heroic Razuvious' since the UI may squeeze text into a tiny (unreadable) font size when text is too long. this string is shown in the Friends List.
PRESENCE_SCENARIO_NAXX_HEROIC_SCENARIO_SAPPHIRON	Saphiron (Heroisch)	
PRESENCE_SCENARIO_NAXX_HEROIC_SCENARIO_THADDIUS	Thaddius (Heroisch)	
PRESENCE_SCENARIO_NAXX_NORMAL_SCENARIO_ANUBREKHAN	Kämpft gegen Anub’Rekhan	
PRESENCE_SCENARIO_NAXX_NORMAL_SCENARIO_FAERLINA	Kämpft gegen Faerlina	feel free to shorten long translations to 'Battling Faerlina' since the UI may squeeze text into a tiny (unreadable) font size when text is too long. this string is shown in the Friends List.
PRESENCE_SCENARIO_NAXX_NORMAL_SCENARIO_GLUTH	Kämpft gegen Gluth	
PRESENCE_SCENARIO_NAXX_NORMAL_SCENARIO_GOTHIK	Kämpft gegen Gothik	feel free to shorten long translations to 'Battling Gothik' since the UI may squeeze text into a tiny (unreadable) font size when text is too long. this string is shown in the Friends List.
PRESENCE_SCENARIO_NAXX_NORMAL_SCENARIO_GROBBULUS	Kämpft gegen Grobbulus	
PRESENCE_SCENARIO_NAXX_NORMAL_SCENARIO_HEIGAN	Kämpft gegen Heigan	feel free to shorten long translations to 'Battling Heigan' since the UI may squeeze text into a tiny (unreadable) font size when text is too long. this is string shown in the Friends List.
PRESENCE_SCENARIO_NAXX_NORMAL_SCENARIO_HORSEMEN	Kämpft gegen die Vier Reiter	
PRESENCE_SCENARIO_NAXX_NORMAL_SCENARIO_KELTHUZAD	Kämpft gegen Kel’Thuzad	
PRESENCE_SCENARIO_NAXX_NORMAL_SCENARIO_LOATHEB	Kämpft gegen Loatheb	
PRESENCE_SCENARIO_NAXX_NORMAL_SCENARIO_MAEXXNA	Kämpft gegen Maexxna	
PRESENCE_SCENARIO_NAXX_NORMAL_SCENARIO_NOTH	Kämpft gegen Noth	feel free to shorten long translations to 'Battling Noth' since the UI may squeeze text into a tiny (unreadable) font size when text is too long. this string is shown in the Friends List.
PRESENCE_SCENARIO_NAXX_NORMAL_SCENARIO_PATCHWERK	Kämpft gegen Flickwerk	
PRESENCE_SCENARIO_NAXX_NORMAL_SCENARIO_RAZUVIOUS	Kämpft gegen Razuvious	feel free to shorten long translations to 'Battling Razuvious' since the UI may squeeze text into a tiny (unreadable) font size when text is too long. this string is shown in the Friends List.
PRESENCE_SCENARIO_NAXX_NORMAL_SCENARIO_SAPPHIRON	Kämpft gegen Saphiron	
PRESENCE_SCENARIO_NAXX_NORMAL_SCENARIO_THADDIUS	Kämpft gegen Thaddius	
PRESENCE_SCENARIO_RETURNING_PLAYER_CHALLENGE_1	Herausf. für Wiedereinsteiger	
PRESENCE_SCENARIO_RETURNING_PLAYER_CHALLENGE_2	Herausf. für Wiedereinsteiger	
PRESENCE_SCENARIO_RETURNING_PLAYER_CHALLENGE_3	Herausf. für Wiedereinsteiger	
PRESENCE_SCENARIO_TRL_DUNGEON	Kämpft in der Trollarena	
PRESENCE_SCENARIO_ULD_01_CITY	Erkundet die Verlorene Stadt	
PRESENCE_SCENARIO_ULD_01_CITY_HEROIC	Erkundet die Verlorene Stadt	
PRESENCE_SCENARIO_ULD_02_DESERT	Verirrt sich in der Wüste	
PRESENCE_SCENARIO_ULD_02_DESERT_HEROIC	Verirrt sich in der Wüste	
PRESENCE_SCENARIO_ULD_03_TOMB	Erforscht Gräber	
PRESENCE_SCENARIO_ULD_03_TOMB_HEROIC	Erforscht Gräber	
PRESENCE_SCENARIO_ULD_04_HALLS	Erkundet Hallen	
PRESENCE_SCENARIO_ULD_04_HALLS_HEROIC	Erkundet Hallen	
PRESENCE_SCENARIO_ULD_05_SANCTUM	Kämpft im Sanktum	
PRESENCE_SCENARIO_ULD_05_SANCTUM_HEROIC	Kämpft im Sanktum	
PRESENCE_SCENARIO_ULD_TAVERN	Stöbert auf dem Basar	
PRESENCE_SCENARIO_ULD_TAVERN_HEROIC	Stöbert auf dem Basar	
PRESENCE_STATUS_ADVENTURE_CHOOSING_MODE	Denkt über Soloabenteuer nach	
PRESENCE_STATUS_ADVENTURE_SCENARIO_PLAYING_GAME	{0}	{0} replaced with the specific scenario string, via PRESENCE_SCENARIO_NAXX_*
PRESENCE_STATUS_ADVENTURE_SCENARIO_SELECT	{0}	{0} replaced with the adventure mode, via PRESENCE_ADVENTURE_MODE_*, e.g. Naxxramas (Heroic) -- (originally i wanted it to say "Mission Select: Naxxramas Class Challenge" but this got too long for the UI element.)
PRESENCE_STATUS_ARENA_FORGE	Stellt ein Arenadeck zusammen	
PRESENCE_STATUS_ARENA_GAME	Duelliert sich in der Arena	
PRESENCE_STATUS_ARENA_IDLE	In der Arena	
PRESENCE_STATUS_ARENA_PURCHASE	Denkt über Arenarunde nach	
PRESENCE_STATUS_ARENA_QUEUE	Auf Gegnersuche in der Arena	
PRESENCE_STATUS_ARENA_REWARD	Streicht einen Arenagewinn ein	
PRESENCE_STATUS_BATTLEGROUNDS_GAME	Kämpft auf dem Schlachtfeld!	
PRESENCE_STATUS_BATTLEGROUNDS_QUEUE	Auf Gegnersuche (Schlachtfeld)	
PRESENCE_STATUS_BATTLEGROUNDS_SCREEN	Auf dem Schlachtfeld	
PRESENCE_STATUS_COLLECTION	Geht die Sammlung durch	
PRESENCE_STATUS_CRAFTING	Stellt Karten her	
PRESENCE_STATUS_DECKEDITOR	Erstellt ein Deck	
PRESENCE_STATUS_DUELS_FORGE	Erstellt ein Duelldeck	
PRESENCE_STATUS_DUELS_GAME	Trägt ein EPISCHES Duell aus	
PRESENCE_STATUS_DUELS_IDLE	Startet ein Duell	
PRESENCE_STATUS_DUELS_PURCHASE	Denkt über eine Duellrunde nach	
PRESENCE_STATUS_DUELS_QUEUE	Auf Gegnersuche (Duelle)	
PRESENCE_STATUS_DUELS_REWARD	Streicht einen Duellgewinn ein	
PRESENCE_STATUS_FIRESIDE_BRAWL_SCREEN	Startet ein Fireside-Chaos	
PRESENCE_STATUS_FRIENDLY_DECKPICKER	Beginnt Duell mit einem Freund	
PRESENCE_STATUS_FRIENDLY_GAME	Duelliert sich mit einem Freund	
PRESENCE_STATUS_HUB	Im Hauptmenü	
PRESENCE_STATUS_LOGIN	Startet das Spiel	
PRESENCE_STATUS_MERCENARIES_COLLECTION	Durchsucht die Söldnersammlung	
PRESENCE_STATUS_MERCENARIES_FRIENDLY_GAME	Duelliert sich mit einem Freund im Söldnermodus	
PRESENCE_STATUS_MERCENARIES_FRIENDLY_LOBBY	Beginnt Duell mit einem Freund	
PRESENCE_STATUS_MERCENARIES_GAME	Kämpft in einem Söldnermatch	
PRESENCE_STATUS_MERCENARIES_MAP	Erkundet eine Söldnerkarte	
PRESENCE_STATUS_MERCENARIES_PLAY_SCREEN	Wählt ein Söldnerteam aus	
PRESENCE_STATUS_MERCENARIES_QUEUE	Auf Gegnersuche (Söldner)	
PRESENCE_STATUS_MERCENARIES_TEAM_EDITOR	Stellt ein Söldnerteam auf	
PRESENCE_STATUS_MERCENARIES_VILLAGE	Im Söldnerdorf	
PRESENCE_STATUS_MERCENARIES_VILLAGE_BUILDING_MANAGER	In der Söldnerwerkstatt	
PRESENCE_STATUS_MERCENARIES_VILLAGE_MAILBOX	Am Söldnerbriefkasten	
PRESENCE_STATUS_MERCENARIES_VILLAGE_PVE_BOUNTIES	An der Söldnerkopfgeldtafel	
PRESENCE_STATUS_MERCENARIES_VILLAGE_PVE_ZONES	Am Söldnerreisepunkt	
PRESENCE_STATUS_MERCENARIES_VILLAGE_PVP	Bei der Söldnerkampfgrube	
PRESENCE_STATUS_MERCENARIES_VILLAGE_TASKBOARD	An der Söldneraufgabentafel	
PRESENCE_STATUS_PACKOPENING	Öffnet Kartenpackungen	
PRESENCE_STATUS_PLAY_CASUAL_CLASSIC	Kämpft im ungewerteten Klassikformat	
PRESENCE_STATUS_PLAY_CASUAL_STANDARD	Kämpft im ungewerteten Standardformat	
PRESENCE_STATUS_PLAY_CASUAL_WILD	Kämpft im ungewerteten wilden Format	
PRESENCE_STATUS_PLAY_DECKPICKER	Im traditionellen Hearthstone	
PRESENCE_STATUS_PLAY_GAME	Kämpft im traditionellen Hearthstone	
PRESENCE_STATUS_PLAY_QUEUE	Auf Gegnersuche	
PRESENCE_STATUS_PLAY_RANKED_CLASSIC	Kämpft im gewerteten Klassikformat	
PRESENCE_STATUS_PLAY_RANKED_STANDARD	Kämpft im gewerteten Standardformat	
PRESENCE_STATUS_PLAY_RANKED_WILD	Kämpft im gewerteten wilden Format	
PRESENCE_STATUS_PRACTICE_DECKPICKER	Im Modus „Üben“	
PRESENCE_STATUS_PRACTICE_GAME	Übt gegen den Gastwirt	
PRESENCE_STATUS_QUESTLOG	Sieht sich das Questlog an	
PRESENCE_STATUS_SPECTATING_GAME_ADVENTURE_BRM_CLASS_CHALLENGE	Schaut Klassenherausf. zu (Schwarzfels)	
PRESENCE_STATUS_SPECTATING_GAME_ADVENTURE_BRM_HEROIC	Zuschauer im Schwarzfels (Heroisch)	
PRESENCE_STATUS_SPECTATING_GAME_ADVENTURE_BRM_NORMAL	Zuschauer im Schwarzfels	
PRESENCE_STATUS_SPECTATING_GAME_ADVENTURE_ICC_NORMAL	Zuschauer am Frostthron	
PRESENCE_STATUS_SPECTATING_GAME_ADVENTURE_KAR_CLASS_CHALLENGE	Schaut Klassenherausf. zu (Karazhan)	
PRESENCE_STATUS_SPECTATING_GAME_ADVENTURE_KAR_HEROIC	Zuschauer in Karazhan (Heroisch)	
PRESENCE_STATUS_SPECTATING_GAME_ADVENTURE_KAR_NORMAL	Zuschauer in Karazhan	
PRESENCE_STATUS_SPECTATING_GAME_ADVENTURE_LOE_CLASS_CHALLENGE	Schaut Klassenherausf. zu (Forscherliga)	
PRESENCE_STATUS_SPECTATING_GAME_ADVENTURE_LOE_HEROIC	Zuschauer in der Forscherliga (Heroisch)	
PRESENCE_STATUS_SPECTATING_GAME_ADVENTURE_LOE_NORMAL	Zuschauer in der Forscherliga	
PRESENCE_STATUS_SPECTATING_GAME_ADVENTURE_NAXX_CLASS_CHALLENGE	Schaut Klassenherausf. zu (Naxxramas)	
PRESENCE_STATUS_SPECTATING_GAME_ADVENTURE_NAXX_HEROIC	Zuschauer in Naxxramas (Heroisch)	
PRESENCE_STATUS_SPECTATING_GAME_ADVENTURE_NAXX_NORMAL	Zuschauer in Naxxramas	
PRESENCE_STATUS_SPECTATING_GAME_ARENA	Zuschauer in der Arena	
PRESENCE_STATUS_SPECTATING_GAME_BATTLEGROUNDS	Zuschauer beim Schlachtfeld	
PRESENCE_STATUS_SPECTATING_GAME_BOH	Schaut beim Buch der Helden zu	
PRESENCE_STATUS_SPECTATING_GAME_BOM	Schaut beim Buch der Söldner zu	
PRESENCE_STATUS_SPECTATING_GAME_BOT	Zuschauer im Geheimlabor	
PRESENCE_STATUS_SPECTATING_GAME_BTA	Schaut bei Höllenfeuerprobe zu	
PRESENCE_STATUS_SPECTATING_GAME_BTA_HEROIC	Schaut Höllenfeuerherausf. zu	
PRESENCE_STATUS_SPECTATING_GAME_BTP	Sieht sich den Prolog an	
PRESENCE_STATUS_SPECTATING_GAME_DAL	Zuschauer in Dalaran	
PRESENCE_STATUS_SPECTATING_GAME_DAL_HEROIC	Zuschauer in Dalaran	
PRESENCE_STATUS_SPECTATING_GAME_DRG	Schaut in der Drachenöde zu	
PRESENCE_STATUS_SPECTATING_GAME_DRG_HEROIC	Schaut in der Drachenöde zu	
PRESENCE_STATUS_SPECTATING_GAME_DUELS	Schaut einem Duell zu	
PRESENCE_STATUS_SPECTATING_GAME_FRIENDLY	Schaut Freundesherausforderung zu	
PRESENCE_STATUS_SPECTATING_GAME_GIL	Schaut bei Monsterjagd zu	
PRESENCE_STATUS_SPECTATING_GAME_GIL_BONUS_CHALLENGE	Schaut Kampf gegen Hagatha zu	
PRESENCE_STATUS_SPECTATING_GAME_LOOT	Schaut bei Schatzjagd zu	
PRESENCE_STATUS_SPECTATING_GAME_MERCENARIES	Zuschauer bei einem Söldnermatch	
PRESENCE_STATUS_SPECTATING_GAME_PLAY	Schaut im traditionellen Hearthstone zu	
PRESENCE_STATUS_SPECTATING_GAME_PRACTICE	Zuschauer im Modus „Üben“	
PRESENCE_STATUS_SPECTATING_GAME_RETURNING_PLAYER_CHALLENGE	Schaut Herausf. für Wiedereinsteiger zu	
PRESENCE_STATUS_SPECTATING_GAME_TAVERN_BRAWL	Zuschauer beim Kartenchaos	
PRESENCE_STATUS_SPECTATING_GAME_TRL	Zuschauer in der Trollarena	
PRESENCE_STATUS_SPECTATING_GAME_TUTORIAL	Zuschauer im Tutorial	
PRESENCE_STATUS_SPECTATING_GAME_ULD	Zuschauer in den Gräbern	
PRESENCE_STATUS_SPECTATING_GAME_ULD_HEROIC	Zuschauer in den Gräbern	
PRESENCE_STATUS_STORE	Besucht den Shop	
PRESENCE_STATUS_TAVERN_BRAWL_DECKEDITOR	Erstellt ein Kartenchaos-Deck	
PRESENCE_STATUS_TAVERN_BRAWL_FRIENDLY_GAME	In Kartenchaos mit Freund	
PRESENCE_STATUS_TAVERN_BRAWL_FRIENDLY_WAITING	Beginnt Kartenchaos mit Freund	
PRESENCE_STATUS_TAVERN_BRAWL_GAME	Duelliert sich im Kartenchaos	
PRESENCE_STATUS_TAVERN_BRAWL_QUEUE	Auf Gegnersuche (Kartenchaos)	
PRESENCE_STATUS_TAVERN_BRAWL_SCREEN	Startet ein Kartenchaos	
PRESENCE_STATUS_TUTORIAL_GAME	Duelliert sich mit {0}	0 = PRESENCE_TUTORIAL_*
PRESENCE_STATUS_TUTORIAL_PREGAME	Startet das Spiel zum ersten Mal	
PRESENCE_STATUS_VIEWING_JOURNAL	Studiert das Tagebuch	
PRESENCE_STATUS_WAIT_FOR_OPPONENT_RECONNECT	Wartet auf Neuverbindung des Gegners	
PRESENCE_STATUS_WELCOMEQUESTS	Begutachtet neue Quests	
PRESENCE_TUTORIAL_CHO	Lehrensucher Cho	
PRESENCE_TUTORIAL_HEMET	Hemet Nesingwary	
PRESENCE_TUTORIAL_HOGGER	Hogger	
PRESENCE_TUTORIAL_ILLIDAN	Illidan Sturmgrimm	
PRESENCE_TUTORIAL_MILLHOUSE	Millhaus Manasturm	
PRESENCE_TUTORIAL_MUKLA	König Mukla	
