TAG	TEXT	COMMENT
ChromaggusBoss_Death_1	嗚啊啊啊！	
ChromaggusBoss_EmoteResponse_1	*低吼*	
ChromaggusBoss_Start_1	大吼！	
GiantRat_LOOTA_BOSS_18h_DefeatPlayer	*吱*	
GiantRat_LOOTA_BOSS_18h_EmoteResponse	*吱*	
GILA_BOSS_65h_Gobbles_DefeatPlayer	*吼叫*	
GILA_BOSS_65h_Gobbles_EmoteResponse	*吼叫*	
GILA_BOSS_65h_Gobbles_Intro	*吼叫*	
LOE_07_MINE_CART_EMOTES	*匡噹*	
LOOTA_BOSS_21h_GnoshTheGreatWorm_EmoteResponse	<吼>	
LOOTA_BOSS_47h_Lava_FilledRoom_Emote	<怒>	
LOOTA_BOSS_52h_TreasureVault_Emote	<鏗噹>	
OnyxiaBoss_Death_1	嗚啊啊啊！	
OnyxiaBoss_EmoteResponse_1	*低吼*	
OnyxiaBoss_Start_1	大吼！	
POPUP_FROST_BRAWL	小心疲倦！下個回合結束時，誰的生命值比較高，誰就是贏家！	
POPUP_FROST_BRAWL_ARMOR	這次亂鬥不准躲在護甲後面！	
TheMothergloop_LOOTA_BOSS_24h_EmoteResponse	<咕嚕>	
TrappedRoom_LOOTA_BOSS_48h_EmoteResponse	<鏘>	
VO_Ahune_Male_Elemental_Brawl_01	爽啊！打爆拉格納羅斯！	
VO_Ahune_Male_Elemental_Brawl_02	現在誰比較強啊，著火的蠢貨？	
VO_Ahune_Male_Elemental_Brawl_03	這就是我的復仇！	
VO_Ahune_Male_Elemental_Brawl_04	現在誰是 「艾澤拉斯冒險者擊殺排行榜」的第一名啊？	
VO_Ahune_Male_Elemental_Brawl_05	看看誰才是蟲子啊！	
VO_Ahune_Male_Elemental_Brawl_07	冰石溶化了！	
VO_Ahune_Male_Elemental_Brawl_08	看誰消滅最多蠢貨！	
VO_Ahune_Male_Elemental_Brawl_11	表現很好！	
VO_Ahune_Male_Elemental_Brawl_15	你要更努力消滅拉格納羅斯！	
VO_Ahune_Male_Elemental_Brawl_16	哇！你真的很討厭拉格納羅斯！	
VO_Ahune_Male_Elemental_Brawl_18	凍死吧，蠢貨！	
VO_Ahune_Male_Elemental_Brawl_20	玩得不錯，兄弟！我們差點就解決對手了。	
VO_Ahune_Male_Elemental_Brawl_25	我們辦到了！了不起啊，兄弟！	
VO_AHUNE_Male_Elemental_HSFireFestival_02	沒錯！我和拉格納羅斯會一起上場，打垮你！	
VO_AHUNE_Male_Elemental_HSFireFestival_04	兄弟，我真的很喜歡你這個節慶。	
VO_AHUNE_Male_Elemental_HSFireFestival_05	兄弟，你很會說笑喔！	
VO_Aran_Male_Shade_AranCrackle_01	哼，我以前用轟雷的時候，每次都是6點傷害。	
VO_Aran_Male_Shade_AranDeath_02	不要！不要…！	
VO_Aran_Male_Shade_AranEmoteResponse_01	出去！出去！	
VO_Aran_Male_Shade_AranHeroPower_01	燒吧，你們這些無賴！	
VO_Aran_Male_Shade_AranMedivhSkin_01	麥迪文？沒有，沒有…我沒有打擾客人…	
VO_Aran_Male_Shade_AranOpen_01	我來教你什麼叫做禮貌！	
VO_Aran_Male_Shade_AranSpell_03	滾回冰冷的黑暗！	
VO_Aran_Male_Shade_AranSpell_04	主人是很強大…但我也不是好惹的！	
VO_Aran_Male_Shade_AranTrons_02	不要！不要！可怕的噪音！可怕的「哈囉」！	
VO_Aran_Male_Shade_AranTurn1_01	不准在我的塔裡大聲放音樂！	
VO_Aran_Male_Shade_AranTurn5_01	我可不是什麼小丑！我是聶拉斯·埃蘭！	
VO_Barnes_Male_Human_FinalNazraTurn5_02	救命啊！我們沒香蕉了！穆克拉沒香蕉吃在發脾氣了！	
VO_Barnes_Male_Human_JulianneTurn5_01	沒有觀眾，怎麼叫戲劇？沒有戲劇，怎麼叫派對？	
VO_Barnes_Male_Human_JulianneWin_01	這一幕結束了！還有兩幕！	
VO_Barnes_Male_Human_Wing2Intro_02	歡迎來到劇院！我是舞台經理巴奈斯。要救麥迪文的話，傳送門就在樓上，但是！你一定要留下來看我們的表演！	
VO_Barnes_Male_Human_WolfBigMinion_01	喔，外婆，你的手下真大隻！	
VO_Barnes_Male_Human_WolfClaws_01	別擔心！大爪子只是裝飾！	
VO_Barnes_Male_Human_WolfTurn5_01	我最喜歡觀眾參與的橋段了！快逃啊，客人！快逃！	
VO_Barnes_Male_Human_WolfTurn9_01	哈哈！真是精采的表演！甚至比上禮拜的巨魔追殺令還好看！	
VO_Barnes_Male_Human_WolfWin_01	啊！大結局要來了！	
VO_BigBadWolf_Male_Worgen_WolfBigMinion_01	這樣才打得死你！	
VO_BigBadWolf_Male_Worgen_WolfDeath_01	我被抓到了？不…	
VO_BigBadWolf_Male_Worgen_WolfDireWolfAlpha_01	*吼叫*	
VO_BigBadWolf_Male_Worgen_WolfDireWolfAlpha_02	*吼叫*	
VO_BigBadWolf_Male_Worgen_WolfEmoteResponse_01	嗯...好吃…	
VO_BigBadWolf_Male_Worgen_WolfOpen_01	快逃啊，小女孩！快逃！	
VO_BigBadWolf_Male_Worgen_WolfScarletCrusader_01	噢，血色十字軍，你的小紅帽呢？ 	
VO_BigBadWolf_Male_Worgen_WolfTurn1_01	看看你的手下，在我面前畏畏縮縮的樣子。	
VO_BlackKing_Male_ChessPiece_ChessEmoteGreetings_01	隨時奉陪。	
VO_BlackKing_Male_ChessPiece_ChessEmoteOops_01	…真的嗎？	
VO_BlackKing_Male_ChessPiece_ChessEmoteSorry_01	這是必要的犧牲。	
VO_BlackKing_Male_ChessPiece_ChessEmoteThanks	不客氣。	
VO_BlackKing_Male_ChessPiece_ChessEmoteThanks_01	不客氣。	
VO_BlackKing_Male_ChessPiece_ChessEmoteThreaten_01	我只要再3手。	
VO_BlackKing_Male_ChessPiece_ChessEmoteWellPlayed_01	還沒呢。	
VO_BlackKing_Male_ChessPiece_ChessEmoteWow_01	那當然。	
VO_BlackKing_Male_ChessPiece_ChessOpen_01	誰都不准過！	
VO_BOSS_AYA_Female_Pandaren_BC_0_Jade_Golem_02	魔像越多越好！	
VO_BOSS_AYA_Female_Pandaren_BC_0_Jade_Golem_03	嘻嘻嘻！上啊，我的大軍！	
VO_BOSS_AYA_Female_Pandaren_BC_0_Jade_Golem_04	再來！再來！	
VO_BOSS_AYA_Female_Pandaren_BC_2_1st_Turn_Start_01	哼，加基森是我的才對！	
VO_BOSS_AYA_Female_Pandaren_BC_2_2nd_Turn_Start_01	加基森是玉蓮幫的，玉蓮幫是我的！	
VO_BOSS_AYA_Female_Pandaren_BC_2_Arms_Dealing1_01	又是武器，你不膩我都膩了！	
VO_BOSS_AYA_Female_Pandaren_BC_2_Fill1_01	喔～你一定會愛死這個…	
VO_BOSS_AYA_Female_Pandaren_BC_2_Fill2_01	才不要咧，我喜歡這裡，我要留下來！	
VO_BOSS_AYA_Female_Pandaren_BC_2_Goons_Win_01	不行不行不行！這樣不行！	
VO_BOSS_AYA_Female_Pandaren_BC_2_Goons_Winning_02	或許你應該閉嘴！	
VO_BOSS_AYA_Female_Pandaren_BC_2_Jade_Win_01	玉蓮幫又贏啦！我就是強！	
VO_BOSS_AYA_Female_Pandaren_BC_2_Lotus_Winning_01	嘻嘻，再來玩嘛，再來玩嘛！	
VO_BOSS_AYA_Female_Pandaren_BC_3_1st_Turn_Start_01	加基森真的太棒了！我想要！	
VO_BOSS_AYA_Female_Pandaren_BC_3_1st_Turn_Start_02	嘻嘻嘻…沒問題…	
VO_BOSS_AYA_Female_Pandaren_BC_3_2nd_Turn_Start_01	天啊，你們黑謀會的人有夠無聊…	
VO_BOSS_AYA_Female_Pandaren_BC_3_Fill1_01	嘿，卡卡，今天天氣不錯喔？	
VO_BOSS_AYA_Female_Pandaren_BC_3_Fill2_01	喔，真是的。卡卡，放輕鬆，找點樂子嘛。	
VO_BOSS_AYA_Female_Pandaren_BC_3_Jade_Golem3_01	嘻嘻嘻！	
VO_BOSS_AYA_Female_Pandaren_BC_3_Kabal_Winning_01	一定是因為你太無聊了。	
VO_BOSS_AYA_Female_Pandaren_BC_3_Kabal_Wins_01	不可能！不可能不可能不可能不可能！	
VO_BOSS_AYA_Female_Pandaren_BC_3_Lotus_Winning_01	噢，怎麼啦，卡卡？你好像有點受傷啊！	
VO_BOSS_AYA_Female_Pandaren_BC_3_Lotus_Wins_01	嘿，真有趣。謝謝你陪我玩，卡卡！	
VO_BOSS_AYA_Female_Pandaren_BC_3_Potion1_02	管你什麼藥水，快過來跟我打一場！	
VO_BOSS_AYA_Female_Pandaren_BC_3_Potion3_01	這什麼鬼東西！好噁心！	
VO_BOSS_AYA_Female_Pandaren_Concede_01	啊，不好玩…	
VO_BOSS_AYA_Female_Pandaren_Greetings_01	嗨，你好啊！	
VO_BOSS_AYA_Female_Pandaren_Oops_01	哎呀！	
VO_BOSS_AYA_Female_Pandaren_START_01	把魔像準備好！	
VO_BOSS_AYA_Female_Pandaren_Thanks_02	謝謝你啦！	
VO_BOSS_AYA_Female_Pandaren_Threaten_02	嗯，看來你得死了。	
VO_BOSS_AYA_Female_Pandaren_Well_Played_01	好棒喔！	
VO_BOSS_AYA_Female_Pandaren_Wow_02	哇喔!	
VO_BOSS_CHO_Male_Ogre_BC_1_1st_Turn_Start_01	因為是汙手黨的！	
VO_BOSS_CHO_Male_Ogre_BC_1_Fill2_01	兄弟們上啊！	
VO_BOSS_CHO_Male_Ogre_BC_2_Fill1_01	這女的瘋瘋的！	
VO_BOSS_CHO_Male_Ogre_Concede_01	好吧…慢著，是你的錯才對！	
VO_BOSS_CHO_Male_Ogre_Oops_02	弄錯了。	
VO_BOSS_CHO_Male_Ogre_Thanks_01	謝謝。	
VO_BOSS_HAN_Male_Ogre_BC_0_Arms_Dealing_01	有東西…從車上掉下來了，嘿嘿…	
VO_BOSS_HAN_Male_Ogre_BC_0_Arms_Dealing_02	快叫兄弟！	
VO_BOSS_HAN_Male_Ogre_BC_0_Arms_Dealing_03	叫兄弟們抄傢伙，準備上啊！	
VO_BOSS_HAN_Male_Ogre_BC_0_Arms_Dealing_04	汙手黨最講義氣！	
VO_BOSS_HAN_Male_Ogre_BC_1_1st_Turn_Start_01	卡札克斯，這幾條街可是很危險啊。	
VO_BOSS_HAN_Male_Ogre_BC_1_2nd_Turn_Start_01	加基森是汙手黨的！	
VO_BOSS_HAN_Male_Ogre_BC_1_2nd_Turn_Start_02	很好很好……不過加基森還是汙手黨的。	
VO_BOSS_HAN_Male_Ogre_BC_1_Fill1_01	帶著你的藥水快滾吧！	
VO_BOSS_HAN_Male_Ogre_BC_1_Fill2_01	阿辛，叫兄弟來，給這個食人妖一點教訓。	test
VO_BOSS_HAN_Male_Ogre_BC_1_Goons_Win_01	抱歉，卡札克斯。這只是生意	
VO_BOSS_HAN_Male_Ogre_BC_1_Goons_Winning_01	嘿，看來你出了點意外啊，卡札克斯…	
VO_BOSS_HAN_Male_Ogre_BC_1_Kabal_Win_02	我會找你…算帳的…卡札克斯。	
VO_BOSS_HAN_Male_Ogre_BC_1_Kabal_Winning_02	嘿，不錯呦，老頭子。	
VO_BOSS_HAN_Male_Ogre_BC_1_Potion1_01	你知道嗎？我從來就不喜歡什麼藥水…	
VO_BOSS_HAN_Male_Ogre_BC_1_Potion2_01	噢！看清楚別亂丟！	
VO_BOSS_HAN_Male_Ogre_BC_2_1st_Turn_Start_01	加基森是我們的！滾開，小丫頭！	
VO_BOSS_HAN_Male_Ogre_BC_2_1st_Turn_Start_04	是嗎？我們汙手黨對這想法有點意見…	
VO_BOSS_HAN_Male_Ogre_BC_2_Fill1_01	我不喜歡你的眼神，阿雅。	
VO_BOSS_HAN_Male_Ogre_BC_2_Goons_Win_01	休息一下，阿雅。嘿嘿，這樣才能快點長大。	
VO_BOSS_HAN_Male_Ogre_BC_2_Goons_Winning_01	或許你應該重新考慮一下你的處境？	
VO_BOSS_HAN_Male_Ogre_BC_2_Jade_Golem2_01	這些東西弄得我煩死了。	
VO_BOSS_HAN_Male_Ogre_BC_2_Lotus_Win_01	啊。加基森是…我們的…	
VO_BOSS_HAN_Male_Ogre_BC_2_Lotus_Winning_01	啊，誰來把這個屁孩趕走。	
VO_BOSS_HAN_Male_Ogre_Concede_01	這都是你害的！	
VO_BOSS_HAN_Male_Ogre_Greetings_01	歡迎來到加基森，小鬼。	
VO_BOSS_HAN_Male_Ogre_INTRO_PACK_OPEN_7	嘿嘿嘿…看看這個帥哥是誰啊？	
VO_BOSS_HAN_Male_Ogre_Oops_01	那可不妙。	
VO_BOSS_HAN_Male_Ogre_START_01	你踩到我們的地盤了。	
VO_BOSS_HAN_Male_Ogre_Thanks_01	你表現得不錯。	test
VO_BOSS_HAN_Male_Ogre_Threaten_01	你不該拒絕的。	
VO_BOSS_HAN_Male_Ogre_Well_Played_02	我承認，你還蠻厲害的。	
VO_BOSS_HAN_Male_Ogre_WOW_01	不賴嘛。	
VO_BOSS_KAZAKUS_Male_Troll_BC_0_Potion_01	啊，真是神清氣爽！	
VO_BOSS_KAZAKUS_Male_Troll_BC_0_Potion_02	喝吧！	
VO_BOSS_KAZAKUS_Male_Troll_BC_0_Potion_04	喝光吧…哈哈哈哈…	
VO_BOSS_KAZAKUS_Male_Troll_BC_0_Potion_05	是甚麼滋味啊？	
VO_BOSS_KAZAKUS_Male_Troll_BC_1_1st_Turn_Start_01	宏辛，加基森是我的！	
VO_BOSS_KAZAKUS_Male_Troll_BC_1_2nd_Turn_Start_01	黑謀會的人到處都是。加基森歸我管。	
VO_BOSS_KAZAKUS_Male_Troll_BC_1_Arms_Dealing1_01	哼，污手黨的懦夫。有種就快點出來！	
VO_BOSS_KAZAKUS_Male_Troll_BC_1_Fill1_01	黑謀會掌握了無窮的力量。	
VO_BOSS_KAZAKUS_Male_Troll_BC_1_Goons_Win_01	我一定會回來，然後變得更強！	
VO_BOSS_KAZAKUS_Male_Troll_BC_1_Goons_Winning_01	啊！去死吧，宏辛！	
VO_BOSS_KAZAKUS_Male_Troll_BC_1_Kabal_Win_01	沒問題，我等著。	
VO_BOSS_KAZAKUS_Male_Troll_BC_1_Kabal_Winning_01	宏辛，你的氣數已盡！	
VO_BOSS_KAZAKUS_Male_Troll_BC_3_1st_Turn_Start_01	哈哈哈哈…但你要先打敗我才行。	
VO_BOSS_KAZAKUS_Male_Troll_BC_3_Fill1_01	不准那樣叫我，沒禮貌的小鬼！	
VO_BOSS_KAZAKUS_Male_Troll_BC_3_Fill2_01	向黑謀會的力量屈服吧！	
VO_BOSS_KAZAKUS_Male_Troll_BC_3_Jade_Golem2_01	沒禮貌的丫頭，居然敢嘲笑最厲害的加基森老大？	
VO_BOSS_KAZAKUS_Male_Troll_BC_3_Jade_Golem3_01	沒教養的丫頭！我受夠那些魔像了。	
VO_BOSS_KAZAKUS_Male_Troll_BC_3_Kabal_Winning_01	小丫頭，你的精神不太好啊！	
VO_BOSS_KAZAKUS_Male_Troll_BC_3_Kabal_Winning_02	什麼？沒教養的小鬼！我就是你的末日！	test
VO_BOSS_KAZAKUS_Male_Troll_BC_3_Kabal_Wins_01	哈哈！又一個敵人敗在黑謀會的力量之下！	
VO_BOSS_KAZAKUS_Male_Troll_BC_3_Lotus_Winning_01	臭屁的小鬼…	
VO_BOSS_KAZAKUS_Male_Troll_BC_3_Lotus_Wins_01	蠢丫頭，你等著瞧吧！	
VO_BOSS_KAZAKUS_Male_Troll_BC_3_Potion1_01	嚐嚐黑謀會藥水的厲害！	
VO_BOSS_KAZAKUS_Male_Troll_Concede_01	我才是…黑街的…霸主…	
VO_BOSS_KAZAKUS_Male_Troll_Greetings_02	你好啊，蠢貨！	test
VO_BOSS_KAZAKUS_Male_Troll_Mirror_Start_01	你蠻有本事的。	
VO_BOSS_KAZAKUS_Male_Troll_Oops_01	計算錯誤…	
VO_BOSS_KAZAKUS_Male_Troll_START_01	法力在呼喚…	
VO_BOSS_KAZAKUS_Male_Troll_Thanks_01	多謝你啊，下人。	
VO_BOSS_KAZAKUS_Male_Troll_Threaten_01	加基森是我的！	
VO_BOSS_KAZAKUS_Male_Troll_Well_Played_02	你真是潛力無窮…	
VO_BOSS_KAZAKUS_Male_Troll_Wow_01	好強的力量！	
VO_BOTA_BOSS_01h_Male_Gnome_EmoteResponse_02	你知道嗎，有個可以講話的對象真不錯。	
VO_BOTA_BOSS_01h_Male_Gnome_EmoteResponse_03	現在的科學研究變得好沒人情味呀。	
VO_BOTA_BOSS_01h_Male_Gnome_EmoteResponse_04	你有辦法一邊談話一邊複製嗎？	
VO_BOTA_BOSS_01h_Male_Gnome_EmoteResponse_05	別擔心，你不必複製我說的話。	
VO_BOTA_BOSS_01h_Male_Gnome_Idle_01	希望你知道自己在幹嘛。	
VO_BOTA_BOSS_01h_Male_Gnome_Idle_02	我們再想一想…想清楚一點。	
VO_BOTA_BOSS_01h_Male_Gnome_Idle_03	我們再想一想…想清楚一點。	
VO_BOTA_BOSS_01h_Male_Gnome_Idle_04	*緊張地哼歌*	
VO_BOTA_BOSS_01h_Male_Gnome_Idle_05	*緊張地哼歌*	
VO_BOTA_BOSS_01h_Male_Gnome_Idle_06	你確定要這樣做嗎？	
VO_BOTA_BOSS_01h_Male_Gnome_Idle_07	嘿，聽我說，兄弟。嘿，夥計…	
VO_BOTA_BOSS_01h_Male_Gnome_Idle_08	我幹嘛自願參加啊？	
VO_BOTA_BOSS_01h_Male_Gnome_Idle_09	你…想要試試那個，對不對？噢…	
VO_BOTA_BOSS_01h_Male_Gnome_Idle_10	希望那樣會行得通…	
VO_BOTA_BOSS_01h_Male_Gnome_Idle_11	呃…給的錢還夠過日子啦。而且有不錯的醫療保險。	
VO_BOTA_BOSS_01h_Male_Gnome_Intro_01	那就開始吧。我去把手下準備好。	
VO_BOTA_BOSS_01h_Male_Gnome_Puzzle_01	小心這個火焰！	
VO_BOTA_BOSS_01h_Male_Gnome_Puzzle_02	雖然這是你的工作，可是這個世界真的需要更多個我嗎？	
VO_BOTA_BOSS_01h_Male_Gnome_Puzzle_03	還不算太糟！記得要完整複製我的獨特魅力！	
VO_BOTA_BOSS_01h_Male_Gnome_Puzzle_04	你的表現高於我的預期！尤其是體驗過上個助理以後…	
VO_BOTA_BOSS_01h_Male_Gnome_Puzzle_06	就快好了！複製體363號一定會很完美！	
VO_BOTA_BOSS_01h_Male_Gnome_Restart_01	小心！我可是很纖細的。	
VO_BOTA_BOSS_01h_Male_Gnome_Restart_02	不要把我玩壞掉！	
VO_BOTA_BOSS_01h_Male_Gnome_Restart_03	呼…謝謝。總覺得…有哪裡不太對勁。	
VO_BOTA_BOSS_01h_Male_Gnome_Return_01	你來啦！我把手下都照顧得好好的。	
VO_BOTA_BOSS_03h_Female_Human_Complete_01	你還真是厲害！你可以幫露娜的忙，她最近陷入了困境！	
VO_BOTA_BOSS_03h_Female_Human_EmoteResponse_01	我這輩子都被數學給包圍了。真的…	
VO_BOTA_BOSS_03h_Female_Human_EmoteResponse_03	把你和我加在一起？不太可能。	
VO_BOTA_BOSS_03h_Female_Human_EmoteResponse_04	請專心解決眼前的問題。	
VO_BOTA_BOSS_03h_Female_Human_Idle_01	但是如果你那麼做的話…嗯…	
VO_BOTA_BOSS_03h_Female_Human_Idle_02	要是你…不行…不行…不行…不行…	
VO_BOTA_BOSS_03h_Female_Human_Idle_03	喔！要是你…不行…	
VO_BOTA_BOSS_03h_Female_Human_Idle_04	那樣根本就行不通啊…對吧？	
VO_BOTA_BOSS_03h_Female_Human_Idle_05	怎麼加都不對…那可以用減的嗎？	
VO_BOTA_BOSS_03h_Female_Human_Idle_06	所以答案應該是三…抱歉，我吵到你了嗎？	
VO_BOTA_BOSS_03h_Female_Human_Idle_07	也許該進行典範轉移了…	
VO_BOTA_BOSS_03h_Female_Human_Idle_08	認真想…好好動腦。	
VO_BOTA_BOSS_03h_Female_Human_Intro_01	把四進位…得到二十七？呃…可以借用你的腦袋嗎？	
VO_BOTA_BOSS_03h_Female_Human_Puzzle_02	這些數字好像怎麼算都不對啊…	
VO_BOTA_BOSS_03h_Female_Human_Puzzle_03	這個問題已經卡了我好幾個小時了。	
VO_BOTA_BOSS_03h_Female_Human_Puzzle_05	別忘了運算的順序！	
VO_BOTA_BOSS_03h_Female_Human_Restart_01	別擔心！我有帶橡皮擦。	
VO_BOTA_BOSS_03h_Female_Human_Restart_02	回到1的平方根	
VO_BOTA_BOSS_03h_Female_Human_Return_01	我們有見過嗎？喔，對！你之前幫過我！	
VO_BOTA_BOSS_03h_Female_Human_Whoops_01	計算錯誤！	
VO_BOTA_BOSS_04h_Female_Draenei_Complete_01	謝謝你。呼…總算可以把你還給澤瑞克了。	
VO_BOTA_BOSS_04h_Female_Draenei_EmoteResponse_01	你的聲音，讓我想到超新星。很吵。	
VO_BOTA_BOSS_04h_Female_Draenei_EmoteResponse_02	為什麼爆爆博士每次找來的都是這麼多話。	
VO_BOTA_BOSS_04h_Female_Draenei_EmoteResponse_03	你也跟澤瑞克說了這麼多廢話嗎？我現在了解他的心情了。	
VO_BOTA_BOSS_04h_Female_Draenei_Idle_01	這就是我沒有雇用檔案管理員的下場。	
VO_BOTA_BOSS_04h_Female_Draenei_Idle_03	我好懷念他們閃爍的美麗星光…	
VO_BOTA_BOSS_04h_Female_Draenei_Idle_04	裡頭暗藏著一種模式，你要更深入一點。	
VO_BOTA_BOSS_04h_Female_Draenei_Idle_05	還有好多解法值得探索。	
VO_BOTA_BOSS_04h_Female_Draenei_Idle_07	真正的美麗就在對稱之間。	
VO_BOTA_BOSS_04h_Female_Draenei_Idle_08	我美麗的星座啊…	
VO_BOTA_BOSS_04h_Female_Draenei_Idle_09	希望有一天我能親眼見到星裔，他們是如此的壯觀美麗！	
VO_BOTA_BOSS_04h_Female_Draenei_Intro_01	你總算來了！走吧，我們有好多工作要忙。	
VO_BOTA_BOSS_04h_Female_Draenei_Puzzle_01	在他們壞掉前…是多麼美麗啊！修好他們吧！	
VO_BOTA_BOSS_04h_Female_Draenei_Puzzle_02	對稱，是了解宇宙的關鍵！	
VO_BOTA_BOSS_04h_Female_Draenei_Puzzle_03	無窮無盡的可能。	
VO_BOTA_BOSS_04h_Female_Draenei_Puzzle_04	星辰必須正確排列。	
VO_BOTA_BOSS_04h_Female_Draenei_Puzzle_05	要模仿真實的東西真的好難。	
VO_BOTA_BOSS_04h_Female_Draenei_Puzzle_06	還有太多東西等待發掘。	
VO_BOTA_BOSS_04h_Female_Draenei_Restart_01	你的光芒熄滅了。重新點亮吧。	
VO_BOTA_BOSS_04h_Female_Draenei_Restart_02	正如天上繁星生於宇宙塵埃，我等亦將重生…或是多一次機會。	
VO_BOTA_BOSS_04h_Female_Draenei_Restart_03	星辰的光芒會照亮正確道路。希望…這次會照到。	
VO_BOTA_BOSS_04h_Female_Draenei_Restart_05	艾爾加隆，請賜下您的祝福。我們一定會成功。	
VO_BOTA_BOSS_04h_Female_Draenei_Return_01	啊！我算過了，你有百分之八十七的機率會再回來。	
VO_BOTA_BOSS_05h_Male_Ethereal_Complete_01	太棒了！你學得真快。讓我們來看看你真正的本事吧。	
VO_BOTA_BOSS_05h_Male_Ethereal_Complete_02	太神奇了！我一定會跟爆爆博士說幾句你的好話。	
VO_BOTA_BOSS_05h_Male_Ethereal_Complete_03	太神奇了！我一定會跟爆爆博士說幾句你的好話。	
VO_BOTA_BOSS_05h_Male_Ethereal_EmoteResponse_01	原封不動還給你。	
VO_BOTA_BOSS_05h_Male_Ethereal_EmoteResponse_02	一字不差收到了。	
VO_BOTA_BOSS_05h_Male_Ethereal_Idle_03	你先前的成果，跟這個比起來都不算什麼。	
VO_BOTA_BOSS_05h_Male_Ethereal_Idle_04	唯一重要的，就是我完美的複製體…	
VO_BOTA_BOSS_05h_Male_Ethereal_Idle_05	你一定辦得到。我對你有信心。	
VO_BOTA_BOSS_05h_Male_Ethereal_Idle_07	啊…呃…我…我知道答案…我只是很好奇你會怎麼做…	
VO_BOTA_BOSS_05h_Male_Ethereal_Idle_08	別放棄，你已經有了相當不錯的進展…	
VO_BOTA_BOSS_05h_Male_Ethereal_Idle_09	該為我的複製體取什麼名字呢？用數字編號沒辦法表達我的獨特…	
VO_BOTA_BOSS_05h_Male_Ethereal_Idle_10	我會變成…至尊澤瑞克！	
VO_BOTA_BOSS_05h_Male_Ethereal_Idle_11	永生不朽，就在我的掌握之中！呃…差不多啦…	
VO_BOTA_BOSS_05h_Male_Ethereal_Intro_01	接下來，你要複製我。	
VO_BOTA_BOSS_05h_Male_Ethereal_Puzzle_01	絕對比地精跟明星來得複雜。	
VO_BOTA_BOSS_05h_Male_Ethereal_Puzzle_02	我知道、我知道。要複製這麼接近完美的東西真的很困難。	
VO_BOTA_BOSS_05h_Male_Ethereal_Puzzle_03	優秀的藝術家會複製。偉大的藝術家會複製跟貼上。	
VO_BOTA_BOSS_05h_Male_Ethereal_Restart_01	我只接受完美。	
VO_BOTA_BOSS_05h_Male_Ethereal_Restart_02	答案就在那裡。努力尋找。	
VO_BOTA_BOSS_05h_Male_Ethereal_Restart_03	一切都必須完全相同。	
VO_BOTA_BOSS_05h_Male_Ethereal_Restart_04	你不能失敗。我們一定要成功。	
VO_BOTA_BOSS_05h_Male_Ethereal_Restart_05	你不能失敗。我們一定要成功。	
VO_BOTA_BOSS_05h_Male_Ethereal_Restart_06	必須完全一致，不論是多麼小的細節。	
VO_BOTA_BOSS_05h_Male_Ethereal_Return_01	我很佩服你的毅力。	
VO_BOTA_BOSS_05h_Male_Ethereal_Stuck_02	不是每條道路都會通向完美。再試一次。	
VO_BOTA_BOSS_05h_Male_Ethereal_Stuck_03	我看得出來，你腦袋裡的齒輪正在高速運轉。再試一次吧。	
VO_BOTA_BOSS_05h_Male_Ethereal_Stuck_04	不是每個人都一樣完美…我還在努力改善這一點。	
VO_BOTA_BOSS_05h_Male_Ethereal_Stuck_05	休息一下，好好回想，然後再來一遍。	
VO_BOTA_BOSS_05h_Male_Ethereal_Tutorial_01	非常好。接下來， 複製一個跟受試者的手下，一模一樣的複製體。	
VO_BOTA_BOSS_05h_Male_Ethereal_Tutorial_03	表現不錯！複製地精很容易…通常啦。	
VO_BOTA_BOSS_05h_Male_Ethereal_Tutorial_04	有些手下或許能夠立刻攻擊。要小心。	
VO_BOTA_BOSS_05h_Male_Ethereal_Tutorial_05	有時候，解法可能不太明顯。請保持開放的態度。	
VO_BOTA_BOSS_05h_Male_Ethereal_Tutorial_06	不是每個狀況都得用上全部的工具。有些反而會誤導你。	
VO_BOTA_BOSS_05h_Male_Ethereal_UI_01	你有追求完美的決心嗎？複製，就是追求完美一致的科學。	
VO_BOTA_BOSS_05h_Male_Ethereal_UI_04	你的合約寫明了我要跟露娜共用你。真是浪費。	
VO_BOTA_BOSS_05h_Male_Ethereal_UI_05	你跟露娜的助理混得夠久了。快點去幫她，然後回來。	
VO_BOTA_BOSS_05h_Male_Ethereal_UI_06	你已經練習過了，接下來就是正經事了：複製我。	
VO_BOTA_BOSS_06h_Male_Goblin_EmoteResponse_01	綠手指？我有好幾根呢！	
VO_BOTA_BOSS_06h_Male_Goblin_EmoteResponse_02	你也是水果鑑賞家？弗洛普的水果是最棒的。	
VO_BOTA_BOSS_06h_Male_Goblin_EmoteResponse_03	行了行了，樹不會叫的。	
VO_BOTA_BOSS_06h_Male_Goblin_Idle_01	這些手下…居然霸佔了如此肥沃的土壤！	
VO_BOTA_BOSS_06h_Male_Goblin_Idle_02	靈心瓜，雪李，熊歌果，天桃…	
VO_BOTA_BOSS_06h_Male_Goblin_Idle_03	西部荒野蘋果，吉爾尼斯南瓜，贊達拉櫛瓜…	
VO_BOTA_BOSS_06h_Male_Goblin_Idle_04	凍原莓果，金皮葡萄，喔…還有荊棘谷香蕉！	
VO_BOTA_BOSS_06h_Male_Goblin_Idle_05	光用想的我就開始流口水了…	
VO_BOTA_BOSS_06h_Male_Goblin_Idle_06	太陽都快下山了，會日照不足！咦，慢著，我們是在地底下…	
VO_BOTA_BOSS_06h_Male_Goblin_Idle_07	啊，這些可憐的樹汁…	
VO_BOTA_BOSS_06h_Male_Goblin_Intro_01	我把纏住的管子解開了，老闆！	
VO_BOTA_BOSS_06h_Male_Goblin_PlaySap_01	悶棍很適合對付那些頑強的手下。	
VO_BOTA_BOSS_06h_Male_Goblin_Puzzle_01	雖然他們都是朋友，但還是非走不可！我們需要整個場地。	
VO_BOTA_BOSS_06h_Male_Goblin_Puzzle_02	有些厚臉皮的手下真的很愛賴著不走。	
VO_BOTA_BOSS_06h_Male_Goblin_Puzzle_03	喔！喔！說不定我們可以引發連鎖反應！	
VO_BOTA_BOSS_06h_Male_Goblin_Restart_01	繼續加油！想想看，我們可以種出多少美味的水果啊！	
VO_BOTA_BOSS_06h_Male_Goblin_Restart_02	別擔心，反正管子又不會憑空消失。	
VO_BOTA_BOSS_06h_Male_Goblin_Restart_03	哇，他們還真是在這裡落地生根了啊。	
VO_BOTA_BOSS_06h_Male_Goblin_Restart_04	纏得亂七八糟的。我們再試一次吧！	
VO_BOTA_BOSS_06h_Male_Goblin_Restart_05	啊，別太沮喪，我支持你。	
VO_BOTA_BOSS_06h_Male_Goblin_Return_01	狀況就跟你離開的時候一樣！	
VO_BOTA_BOSS_07h_Male_Ooze_Complete_01	太好了。很快就能看到我們努力的果實。	
VO_BOTA_BOSS_07h_Male_Ooze_Complete_02	太黏答答啦！哈哈！接下來，莫莉根博士可能會需要你的協助。	
VO_BOTA_BOSS_07h_Male_Ooze_EmoteResponse_01	把力氣留下來準備收割！	
VO_BOTA_BOSS_07h_Male_Ooze_EmoteResponse_03	哇，小嫩芽，好好扎根吧。	
VO_BOTA_BOSS_07h_Male_Ooze_EmoteResponse_04	嗯，也祝你黏糊糊！	
VO_BOTA_BOSS_07h_Male_Ooze_Idle_01	我真心希望，能用非暴力的方式除掉這些手下…	
VO_BOTA_BOSS_07h_Male_Ooze_Idle_02	要是我們有幾根香蕉的話…	
VO_BOTA_BOSS_07h_Male_Ooze_Idle_03	所有的工具都在這裡。但是…我們要怎麼使用呢？	
VO_BOTA_BOSS_07h_Male_Ooze_Idle_05	得把他們全部都挪開…嗯…	
VO_BOTA_BOSS_07h_Male_Ooze_Idle_06	想一想，我們能用這些作物餵飽多少張嘴啊…	
VO_BOTA_BOSS_07h_Male_Ooze_Idle_07	我的黏液是哪裡來的？那是商業機密！	
VO_BOTA_BOSS_07h_Male_Ooze_Idle_09	經常對植物說鼓勵的話，據說有助於他們生長。	
VO_BOTA_BOSS_07h_Male_Ooze_Intro_01	歡迎來到我的溫室！	
VO_BOTA_BOSS_07h_Male_Ooze_Puzzle_01	不能浪費寶貴的黏液！幫我把這個垃圾解決掉。	
VO_BOTA_BOSS_07h_Male_Ooze_Puzzle_02	這些都是之前實驗留下來的。把他們…趕走。	
VO_BOTA_BOSS_07h_Male_Ooze_Puzzle_03	這些手下都不是蔬菜！把他們全部清掉！	
VO_BOTA_BOSS_07h_Male_Ooze_Restart_01	有付出就有收穫，我們終身學習。	
VO_BOTA_BOSS_07h_Male_Ooze_Restart_02	我們心中已經種下了種子，我相信它一定會綻放。	
VO_BOTA_BOSS_07h_Male_Ooze_Restart_03	小心一點，我們一定會成功的。	
VO_BOTA_BOSS_07h_Male_Ooze_Restart_04	我們的努力，假以時日一定會萌芽。	
VO_BOTA_BOSS_07h_Male_Ooze_Restart_05	我們可以慢慢來，就像草木的生長一樣。	
VO_BOTA_BOSS_07h_Male_Ooze_Return_01	你回來了！準備好要工作了嗎？	
VO_BOTA_BOSS_07h_Male_Ooze_Stuck_01	這裡被佔據了，恐怕得花上好一番工夫來清理。	
VO_BOTA_BOSS_07h_Male_Ooze_Stuck_02	強大的敵方手下能用來清掉好幾個你自己的手下。	
VO_BOTA_BOSS_07h_Male_Ooze_Stuck_03	實驗是科學發展的主要推手！不要害怕嘗試新的東西。	
VO_BOTA_BOSS_07h_Male_Ooze_Stuck_04	善用所有工具。新點子說不定就會冒出來。	
VO_BOTA_BOSS_07h_Male_Ooze_Tutorial_02	我需要你清光場上的每一個手下！	
VO_BOTA_BOSS_07h_Male_Ooze_Tutorial_03	太棒了咈！我們就要栽培出美味的新品種靈心瓜了。 	
VO_BOTA_BOSS_07h_Male_Ooze_Tutorial_04	雖然我提供了許多道具，但不是每樣都能派上用場。	
VO_BOTA_BOSS_07h_Male_Ooze_Tutorial_06	黏糊糊啊！我們要怎樣除掉那些東西？	
VO_BOTA_BOSS_07h_Male_Ooze_Tutorial_07	有些手下可以立刻攻擊。好好善用他們。	
VO_BOTA_BOSS_07h_Male_Ooze_UI_01	嘿！你在發什麼呆？我們還有作物要種！	
VO_BOTA_BOSS_07h_Male_Ooze_UI_02	很好的開始！等你準備好，我就要噴灑黏液了。	
VO_BOTA_BOSS_08h_Female_Eredar_Complete_01	優秀的表現！說不定莫莉根博士會用得上你的智慧！	
VO_BOTA_BOSS_08h_Female_Eredar_EmoteResponse_01	靈魂伴侶？恐怕不行。	
VO_BOTA_BOSS_08h_Female_Eredar_EmoteResponse_02	你該不會真的以為，光用講的就能叫這些手下放棄靈魂吧？	
VO_BOTA_BOSS_08h_Female_Eredar_EmoteResponse_03	一輩子都跟受盡折磨的靈魂為伍，下場就是你會開始產生幻聽…	
VO_BOTA_BOSS_08h_Female_Eredar_Idle_01	要整理這些靈魂應該很困難…	
VO_BOTA_BOSS_08h_Female_Eredar_Idle_02	別擔心，這都是為了大家好。真的！	
VO_BOTA_BOSS_08h_Female_Eredar_Idle_03	附近還漂浮著好多沒利用到的能量…	
VO_BOTA_BOSS_08h_Female_Eredar_Idle_04	要是我們能過濾和精煉這些靈魂…	
VO_BOTA_BOSS_08h_Female_Eredar_Idle_05	靈魂也有重量嗎？真是奇怪…	
VO_BOTA_BOSS_08h_Female_Eredar_Idle_06	我們可不可以…不行不行…那樣太危險了。	
VO_BOTA_BOSS_08h_Female_Eredar_Idle_07	我們竟然這幾年才開始把他們存進靈魂石。	
VO_BOTA_BOSS_08h_Female_Eredar_Idle_08	不然你以為爆爆博士是怎麼維持這裡的電力和燈光的？	
VO_BOTA_BOSS_08h_Female_Eredar_Idle_09	還有好多好多我們不知道的知識…	
VO_BOTA_BOSS_08h_Female_Eredar_Intro_01	該準備幫這些電池充電了。	
VO_BOTA_BOSS_08h_Female_Eredar_PlayAnima_01	裡面的靈魂被設定為沒有「威脅」就自動退出。	
VO_BOTA_BOSS_08h_Female_Eredar_PlayHorror_01	好可怕！好恐懼！…我剛做好的指甲裂了。	
VO_BOTA_BOSS_08h_Female_Eredar_PlayWeakness_01	他們的肉體雖然虛弱，靈魂卻依然強大！	
VO_BOTA_BOSS_08h_Female_Eredar_Puzzle_01	弗洛普收割作物，我們收割靈魂。其實非常相似。	
VO_BOTA_BOSS_08h_Female_Eredar_Puzzle_02	手下之中還有手下，這樣算雙倍的靈魂價值嗎？	
VO_BOTA_BOSS_08h_Female_Eredar_Puzzle_03	這些傢伙相當頑強。我們得想辦法克服他們的特殊能力。	
VO_BOTA_BOSS_08h_Female_Eredar_PuzzleALT_01	把牌桌上的手下都清掉，但是靈魂要留給我。我還有…別的計畫。	
VO_BOTA_BOSS_08h_Female_Eredar_Restart_01	我們得一口氣收到足夠的靈魂才行。再試一次。	
VO_BOTA_BOSS_08h_Female_Eredar_Restart_02	嗯…靈魂還不夠多。	
VO_BOTA_BOSS_08h_Female_Eredar_Restart_03	先歸還他們的靈魂才能重來。我們得一口氣拿走全部的靈魂才行。	
VO_BOTA_BOSS_08h_Female_Eredar_Restart_04	繼續努力！收割靈魂雖然辛苦，但尖叫聲讓人超滿足。	
VO_BOTA_BOSS_08h_Female_Eredar_Restart_05	千萬不要放棄！…是說，要是你放棄了，我們或許會改用你的靈魂來…	
VO_BOTA_BOSS_08h_Female_Eredar_Return_01	你也得充電嗎？	
VO_BOTA_BOSS_09h_Female_Banshee_Complete_01	或許活人並沒有我想的那麼糟…做得好。	
VO_BOTA_BOSS_09h_Female_Banshee_EmoteResponse_01	收割我自己？我是女妖，不是靈魂。	
VO_BOTA_BOSS_09h_Female_Banshee_EmoteResponse_02	我知道我們女妖的尖嘯很出名，但是你可以正常講話就好。	
VO_BOTA_BOSS_09h_Female_Banshee_EmoteResponse_03	給我一個不該當場收割你靈魂的理由！	
VO_BOTA_BOSS_09h_Female_Banshee_Idle_01	效率就是關鍵，盡可能發揮你的優勢。	
VO_BOTA_BOSS_09h_Female_Banshee_Idle_02	要是我們能把夠多的靈魂壓縮到一個容器裡…	
VO_BOTA_BOSS_09h_Female_Banshee_Idle_03	這些都是高品質的靈魂，請小心處理。	
VO_BOTA_BOSS_09h_Female_Banshee_Idle_04	這個工作十分重要。	
VO_BOTA_BOSS_09h_Female_Banshee_Idle_05	這個工作十分重要。	
VO_BOTA_BOSS_09h_Female_Banshee_Idle_06	你絕對不會相信，有多少人在申請的時候以為我們在談的是鞋子…	
VO_BOTA_BOSS_09h_Female_Banshee_Idle_07	嗯…	
VO_BOTA_BOSS_09h_Female_Banshee_Intro_01	動手吧，我們沒有時間可以浪費了。	
VO_BOTA_BOSS_09h_Female_Banshee_PlayDefile_01	啊！尖叫聲！	
VO_BOTA_BOSS_09h_Female_Banshee_PlayTicking_01	多麼可愛的手下啊。如此的…有效率。	
VO_BOTA_BOSS_09h_Female_Banshee_Puzzle_01	我的工作肯定會更複雜，你有辦法處理嗎？	
VO_BOTA_BOSS_09h_Female_Banshee_Puzzle_02	你也看見了，這些手下頑強地抓著靈魂不放。	
VO_BOTA_BOSS_09h_Female_Banshee_Puzzle_03	我沒辦法忍受這麼多的…呼吸…把他們全部消滅！	
VO_BOTA_BOSS_09h_Female_Banshee_Puzzle_04	啊…活著的東西。結束他們。	
VO_BOTA_BOSS_09h_Female_Banshee_Puzzle_05	我找來了不少傑出的人才。現在，吞噬他們的靈魂！	
VO_BOTA_BOSS_09h_Female_Banshee_Restart_01	這樣行不通。重新再來！	
VO_BOTA_BOSS_09h_Female_Banshee_Restart_02	我們需要更多能量。	
VO_BOTA_BOSS_09h_Female_Banshee_Restart_03	這些靈魂非常珍貴。我們一個也不能浪費。	
VO_BOTA_BOSS_09h_Female_Banshee_Restart_04	他們充滿活力的眼神讓我一直冒冷汗...如果我會流汗的話。	
VO_BOTA_BOSS_09h_Female_Banshee_Restart_05	如果你也是吃這行飯的，他們看起來就都沒有差別了。	
VO_BOTA_BOSS_09h_Female_Banshee_Return_01	摸夠魚了沒。快點繼續工作吧。	
VO_BOTA_BOSS_09h_Female_Banshee_UI_01	新來的嗎？去找我的助理，她會帶你開始。	
VO_BOTA_BOSS_09h_Female_Banshee_UI_02	非常好。幫我清掉這些頑固的手下。	
VO_BOTA_BOSS_10h_Male_NightElf_Complete_01	我想…這樣應該可以了…我得去躺一下。	
VO_BOTA_BOSS_10h_Male_NightElf_EmoteResponse_01	想換的話，我隨時可以跟你換！其實還蠻好玩的！真的！	
VO_BOTA_BOSS_10h_Male_NightElf_EmoteResponse_02	雖然我很想幫你，但我最好還是閉緊嘴巴…	
VO_BOTA_BOSS_10h_Male_NightElf_EmoteResponse_03	喔我不只害到自己，還害到你…	
VO_BOTA_BOSS_10h_Male_NightElf_EmoteResponse_04	我覺得，你已經沒辦法拒絕實驗了。	
VO_BOTA_BOSS_10h_Male_NightElf_Idle_01	第十二頁：參與者自願放棄所有法律資源…	
VO_BOTA_BOSS_10h_Male_NightElf_Idle_02	當事故發生時，參與者必須將所有資產贈與爆爆博士…	
VO_BOTA_BOSS_10h_Male_NightElf_Idle_03	受毒者必須活過至少十份毒劑方可領取酬勞…	
VO_BOTA_BOSS_10h_Male_NightElf_Idle_04	第三十六頁：在任何情況下均不得與人共享商業機密…呿…	
VO_BOTA_BOSS_10h_Male_NightElf_Idle_06	可能導致的副作用包括：腹痛、噁心…掉髮?!	
VO_BOTA_BOSS_10h_Male_NightElf_Idle_08	這份同意書可在任何時候、或因任何理由進行修改？喔！拜託！	
VO_BOTA_BOSS_10h_Male_NightElf_Idle_09	我應該好好讀完整份同意書…	
VO_BOTA_BOSS_10h_Male_NightElf_Idle_10	看清楚小字？整份同意書字都超小的啊！	
VO_BOTA_BOSS_10h_Male_NightElf_Idle_11	這就是我一直叫人家簽的東西？天啊…	
VO_BOTA_BOSS_10h_Male_NightElf_Intro_01	立刻成為毒藥測試員！在這裡簽名就可以了…	
VO_BOTA_BOSS_10h_Male_NightElf_Lethal_01	好痛！	
VO_BOTA_BOSS_10h_Male_NightElf_Lethal_02	嗚！會瘀青。	
VO_BOTA_BOSS_10h_Male_NightElf_Lethal_03	好了好了！我受不了了！	
VO_BOTA_BOSS_10h_Male_NightElf_Lethal_04	喔-噢-啊！住手住手！我快不行了。	
VO_BOTA_BOSS_10h_Male_NightElf_Lethal_05	喔喔喔喔喔！夠了夠了。	
VO_BOTA_BOSS_10h_Male_NightElf_Lethal_06	嗚…呃…效果…太強了。	
VO_BOTA_BOSS_10h_Male_NightElf_Lethal_08	拜託把這個…從實驗項目…拿掉…	
VO_BOTA_BOSS_10h_Male_NightElf_Puzzle_01	什麼？我是受試者？等等，我看一下同意書…	
VO_BOTA_BOSS_10h_Male_NightElf_Puzzle_02	我看過這個實驗。應該不會太恐怖…吧？	
VO_BOTA_BOSS_10h_Male_NightElf_Puzzle_03	我不該老實簽名的…	
VO_BOTA_BOSS_10h_Male_NightElf_Restart_01	感覺還不夠強，但是不要放棄！	
VO_BOTA_BOSS_10h_Male_NightElf_Restart_02	藥效越強，表示我們可以領到越多的錢，對吧？	
VO_BOTA_BOSS_10h_Male_NightElf_Restart_03	有點痛，但是我覺得應該還可以更厲害才對！	
VO_BOTA_BOSS_10h_Male_NightElf_Restart_04	明明應該要有立可白啊…	
VO_BOTA_BOSS_10h_Male_NightElf_Restart_05	如果你要重來的話，我這邊還有很多同意書…	
VO_BOTA_BOSS_10h_Male_NightElf_Restart_06	至少，我的忍耐力會越來越強…	
VO_BOTA_BOSS_10h_Male_NightElf_Return_01	立刻成為毒藥…喔，是你啊。你已經簽過了。	
VO_BOTA_BOSS_12h_Female_WaterSpirit_Complete_01	你辦到了！我帶你去見伊雷特拉，不過，小心別被她掃到颱風尾啦。	
VO_BOTA_BOSS_12h_Female_WaterSpirit_EmoteResponse_01	浪我潮你揮揮手！	
VO_BOTA_BOSS_12h_Female_WaterSpirit_EmoteResponse_02	哦，謝謝！你的友善能幫我度過低潮。	
VO_BOTA_BOSS_12h_Female_WaterSpirit_EmoteResponse_03	噁心…你的口水噴到我了。	
VO_BOTA_BOSS_12h_Female_WaterSpirit_Idle_01	啦啦啦啦…	
VO_BOTA_BOSS_12h_Female_WaterSpirit_Idle_02	*哼歌*	
VO_BOTA_BOSS_12h_Female_WaterSpirit_Idle_03	虛空風暴這邊的閃電真是漂亮！	
VO_BOTA_BOSS_12h_Female_WaterSpirit_Idle_04	我會追上她的，我一定可以！	
VO_BOTA_BOSS_12h_Female_WaterSpirit_Idle_05	嗯…水是非常好的導體…	
VO_BOTA_BOSS_12h_Female_WaterSpirit_Idle_06	你覺得，你可以幫她做出…驚天動地的新發現嗎？嘻嘻。	
VO_BOTA_BOSS_12h_Female_WaterSpirit_Idle_07	嘻嘻，你還在等什麼？	
VO_BOTA_BOSS_12h_Female_WaterSpirit_Idle_08	要是你有再多一點點的法力…嗯…	
VO_BOTA_BOSS_12h_Female_WaterSpirit_Idle_09	伊雷特拉說我的<b>衝擊抗性</b>很高，我想這應該是一件好事。	
VO_BOTA_BOSS_12h_Female_WaterSpirit_Intro_01	你是來找伊雷特拉的嗎？她真的很棒，對不對？	
VO_BOTA_BOSS_12h_Female_WaterSpirit_Lethal_01	呵呵呵，會癢耶！	
VO_BOTA_BOSS_12h_Female_WaterSpirit_Lethal_02	嘩啦嘩啦嘩啦～	
VO_BOTA_BOSS_12h_Female_WaterSpirit_Lethal_04	*噴水聲*	
VO_BOTA_BOSS_12h_Female_WaterSpirit_Lethal_05	呃喔…	
VO_BOTA_BOSS_12h_Female_WaterSpirit_Lethal_06	我的肚子裡好像有漩渦。	
VO_BOTA_BOSS_12h_Female_WaterSpirit_PlayHealingRain_01	治癒之雨是要怎樣…喔！	
VO_BOTA_BOSS_12h_Female_WaterSpirit_Puzzle_01	你幫我向她證明我有多強悍，我就幫你介紹。一言為定？	
VO_BOTA_BOSS_12h_Female_WaterSpirit_Puzzle_03	伊雷特拉真的太強了！要是連這個都承受不了，我永遠都別想追上她。	
VO_BOTA_BOSS_12h_Female_WaterSpirit_Puzzle_05	我最愛早上清新的雨水味道。	
VO_BOTA_BOSS_12h_Female_WaterSpirit_Restart_01	我要承受更多傷害，才能讓伊雷特拉刮目相看。	
VO_BOTA_BOSS_12h_Female_WaterSpirit_Restart_02	我很不想戳破你的泡泡，可是我們好像卡住了。	
VO_BOTA_BOSS_12h_Female_WaterSpirit_Restart_03	再試一次吧！我們一定可以證明給她看！	
VO_BOTA_BOSS_12h_Female_WaterSpirit_Restart_04	別擔心，總有一天我會跟她一樣！	
VO_BOTA_BOSS_12h_Female_WaterSpirit_Restart_05	喔，我們可以做得更好！	
VO_BOTA_BOSS_12h_Female_WaterSpirit_Restart_06	加油！加油！我們再試一次！	
VO_BOTA_BOSS_12h_Female_WaterSpirit_Restart_07	再來充個電？好啊！	
VO_BOTA_BOSS_12h_Female_WaterSpirit_Restart_08	我比外表更強悍！儘管來吧！	
VO_BOTA_BOSS_12h_Female_WaterSpirit_Return_01	你也去充電嗎？啊，我們繼續吧！	
VO_BOTA_BOSS_13h_Female_Elemental_Complete_01	啊…呼…謝謝，你真是一場及時雨。我覺得好多了。	
VO_BOTA_BOSS_13h_Female_Elemental_EmoteResponse_01	喔，太風～狂了！	
VO_BOTA_BOSS_13h_Female_Elemental_EmoteResponse_02	啊～少在那邊風言風語了。	
VO_BOTA_BOSS_13h_Female_Elemental_EmoteResponse_03	我看你是雷聲大雨點小。	
VO_BOTA_BOSS_13h_Female_Elemental_Idle_01	過多的能量…害我暴躁如雷！	
VO_BOTA_BOSS_13h_Female_Elemental_Idle_02	風暴會向我臣服！	
VO_BOTA_BOSS_13h_Female_Elemental_Idle_03	科學玩得太過火了嗎？	
VO_BOTA_BOSS_13h_Female_Elemental_Idle_04	有人在說…雷霆之怒嗎！？沒有？喔好吧…我…我以為有人在說。	
VO_BOTA_BOSS_13h_Female_Elemental_Idle_05	有人在說…雷霆之怒嗎！？沒有？喔好吧…我…我以為有人在說。	
VO_BOTA_BOSS_13h_Female_Elemental_Idle_06	卡住了嗎？等靈感來了就會一帆風～順了！哈哈！	
VO_BOTA_BOSS_13h_Female_Elemental_Idle_07	仔細觀察。難題遲早會風～平浪靜！哈哈哈哈！	
VO_BOTA_BOSS_13h_Female_Elemental_Idle_08	如果我玩爆牌，那就是...風爆牌！哈哈，這個哏真不錯！	
VO_BOTA_BOSS_13h_Female_Elemental_Intro_01	這力量…太強大了！	
VO_BOTA_BOSS_13h_Female_Elemental_PlayVolcano_01	不對不對！天氣現象都是從天空落到地面，不是從地面噴上天空！	
VO_BOTA_BOSS_13h_Female_Elemental_Puzzle_01	我吸收太多虛空風暴能量，我承受不住了！	
VO_BOTA_BOSS_13h_Female_Elemental_Puzzle_02	能量突然湧現…快採取行動！	
VO_BOTA_BOSS_13h_Female_Elemental_Puzzle_03	你有辦法化解…這個嗎？	
VO_BOTA_BOSS_13h_Female_Elemental_Puzzle_04	我超載了整個實驗室！哈哈哈哈！誰快來阻止我！	
VO_BOTA_BOSS_13h_Female_Elemental_Puzzle_06	看我呼風喚雨的本事！呼風，喚雨，哈哈哈哈！	
VO_BOTA_BOSS_13h_Female_Elemental_Puzzle_07	氣象預報，今天會有午後雷陣…我！哈哈哈！	
VO_BOTA_BOSS_13h_Female_Elemental_Restart_01	閃電「真的」會擊中兩次，甚至三次。千萬不要保留。	
VO_BOTA_BOSS_13h_Female_Elemental_Restart_02	把你電慘了！電慘了！哈哈！	
VO_BOTA_BOSS_13h_Female_Elemental_Restart_03	被閃電給慘電了嗎？	
VO_BOTA_BOSS_13h_Female_Elemental_Restart_04	我必須儲存這股動能。	
VO_BOTA_BOSS_13h_Female_Elemental_Restart_05	風向真的很難掌握，對吧？對吧！喔呼！	
VO_BOTA_BOSS_13h_Female_Elemental_Restart_06	崩潰了嗎？真是晴天霹靂啊，哈哈！	
VO_BOTA_BOSS_13h_Female_Elemental_Return_01	你去哪裡了？我需要你！	
VO_BOTA_BOSS_14h_Female_Undead_EmoteResponse_01	你的心死得比我還徹底。	
VO_BOTA_BOSS_14h_Female_Undead_EmoteResponse_02	最需要麻痺毒藥的時候，偏偏找不到。	
VO_BOTA_BOSS_14h_Female_Undead_EmoteResponse_03	你打算一直念、念到我去死嗎？你的舌頭有塗毒藥嗎？	
VO_BOTA_BOSS_14h_Female_Undead_Idle_01	反正我已經爛在這裡了。	
VO_BOTA_BOSS_14h_Female_Undead_Idle_02	死金是非常奇特的元素，它會扭曲人的心智。	
VO_BOTA_BOSS_14h_Female_Undead_Idle_03	很有趣的做法…我應該沒有這樣試過。	
VO_BOTA_BOSS_14h_Female_Undead_Idle_04	有好多種應用方式。武器…毒藥…更多的武器…	
VO_BOTA_BOSS_14h_Female_Undead_Idle_05	把這個用在活人身上會怎麼樣呢？	
VO_BOTA_BOSS_14h_Female_Undead_Idle_06	實驗新的元素真是叫人興奮啊！	
VO_BOTA_BOSS_14h_Female_Undead_Idle_07	不要有任何保留。我已經死了。	
VO_BOTA_BOSS_14h_Female_Undead_Intro_01	該準備實測這個「死金」元素了。	
VO_BOTA_BOSS_14h_Female_Undead_Lethal_01	嗯…真是帶勁。	
VO_BOTA_BOSS_14h_Female_Undead_Lethal_02	痛苦。我已經好久沒感受到這種滋味了。	
VO_BOTA_BOSS_14h_Female_Undead_Lethal_03	幸好我早就死了。	
VO_BOTA_BOSS_14h_Female_Undead_Lethal_04	有點取巧，但是做得不錯。	
VO_BOTA_BOSS_14h_Female_Undead_Lethal_05	啊！我才剛想到一件事情。	
VO_BOTA_BOSS_14h_Female_Undead_Puzzle_01	副作用嚇不了我，因為我已經死了。	
VO_BOTA_BOSS_14h_Female_Undead_Puzzle_02	親自動手做研究，最有效率	
VO_BOTA_BOSS_14h_Female_Undead_Puzzle_04	啊…武器。我喜歡你的風格。	
VO_BOTA_BOSS_14h_Female_Undead_Restart_01	如此珍貴的資源不能隨便浪費。	
VO_BOTA_BOSS_14h_Female_Undead_Restart_02	請再試一次。	
VO_BOTA_BOSS_14h_Female_Undead_Restart_03	我來重設實驗。	
VO_BOTA_BOSS_14h_Female_Undead_Restart_04	有好多東西要試！	
VO_BOTA_BOSS_14h_Female_Undead_Restart_05	再一次！再來一次！	
VO_BOTA_BOSS_14h_Female_Undead_Restart_06	正確的決定。準備重新開始。	
VO_BOTA_BOSS_14h_Female_Undead_Return_01	還好這東西沒有半衰期。我們繼續吧。	
VO_BOTA_BOSS_14h_Female_Undead_Tutorial_01	我們先從基礎的疼痛耐受度試驗開始，試著讓他失去意識。	
VO_BOTA_BOSS_14h_Female_Undead_Tutorial_04	有些手下可以立刻攻擊。又快又痛。	
VO_BOTA_BOSS_14h_Female_Undead_Tutorial_05	最傑出的科學家都願意犧牲。	
VO_BOTA_BOSS_14h_Female_Undead_Tutorial_06	要是你遇到問題，那就實驗！這正是我們的工作。	
VO_BOTA_BOSS_14h_Female_Undead_UI_01	對我的「死金」研究有興趣嗎？去找我的招募助理吧。	
VO_BOTA_BOSS_14h_Female_Undead_UI_03	我最近在試驗一種叫做「死金」的元素。來吧，我們一起來試試。	
VO_BOTA_BOSS_14h_Female_Undead_UI_04	看來伊雷特拉又要爆炸了。麻煩你過去「幫」她一下。	
VO_BOTA_BOSS_14h_Female_Undead_UI_05	再慢吞吞，到時候就沒有伊雷特拉可以幫了。	
VO_BOTA_BOSS_15h_Female_Night Elf_Puzzle_01	喔！這一定會超好玩的！	
VO_BOTA_BOSS_15h_Female_Night Elf_Puzzle_03	辛苦工作一天以後，好好幫自己上點藥膏和繃帶真是舒服。	
VO_BOTA_BOSS_15h_Female_NightElf_EmoteResponse_01	看來你的脾氣也蠻火爆的嘛。	
VO_BOTA_BOSS_15h_Female_NightElf_EmoteResponse_02	工作已經排到爆滿了！	
VO_BOTA_BOSS_15h_Female_NightElf_Idle_01	要是我點燃這個引信…	
VO_BOTA_BOSS_15h_Female_NightElf_Idle_02	可以幫那個手下多綁幾綑煙火嗎？	
VO_BOTA_BOSS_15h_Female_NightElf_Idle_03	如果我把火藥的用量加倍…	
VO_BOTA_BOSS_15h_Female_NightElf_Idle_04	弗拉克是怎樣弄出那麼多顏色的？	
VO_BOTA_BOSS_15h_Female_NightElf_Idle_05	你有辦法…跑得比它還快嗎？	
VO_BOTA_BOSS_15h_Female_NightElf_Idle_06	這個真的挺厲害的…還好被炸的不是我。	
VO_BOTA_BOSS_15h_Female_NightElf_Intro_01	你是新的受試者嗎？我要點燃引信囉！	
VO_BOTA_BOSS_15h_Female_NightElf_Puzzle_03	辛苦工作一天以後，好好幫自己上點藥膏和繃帶真是舒服。	
VO_BOTA_BOSS_15h_Female_NightElf_Restart_01	如果沒有第一次就成功的話…	
VO_BOTA_BOSS_15h_Female_NightElf_Restart_03	再試一次還會不會痛呢？	
VO_BOTA_BOSS_15h_Female_NightElf_Restart_04	萬一它在你的臉上炸開了…嗯…那就重來吧。	
VO_BOTA_BOSS_15h_Female_NightElf_Restart_05	我們再來試一次吧。	
VO_BOTA_BOSS_15h_Female_NightElf_Restart_06	那樣行不通嗎？嗯…	
VO_BOTA_BOSS_15h_Female_NightElf_Restart_07	只要一個火花…	
VO_BOTA_BOSS_15h_Female_NightElf_Return_01	你又回來找樂子了！	
VO_BOTA_BOSS_16h_Male_Goblin_Complete_01	嘿，你辦到了！好，下一個就是…我！	
VO_BOTA_BOSS_16h_Male_Goblin_Complete_02	哇！真是太精采了！你剛剛爆炸的樣子…壯觀啊！	
VO_BOTA_BOSS_16h_Male_Goblin_EmoteResponse_01	你要打爆我嗎？哈，看我怎麼打爆你！	
VO_BOTA_BOSS_16h_Male_Goblin_EmoteResponse_02	哇！大家都說我很火爆，你才是吧…	
VO_BOTA_BOSS_16h_Male_Goblin_EmoteResponse_03	哼！你才是火爆的人吧…	
VO_BOTA_BOSS_16h_Male_Goblin_Idle_01	嗯…嗯哼…唉…	
VO_BOTA_BOSS_16h_Male_Goblin_Idle_02	呃啊！快來點爆炸！	
VO_BOTA_BOSS_16h_Male_Goblin_Idle_03	呿…才炸掉三個實習生，就開始有安全守則了。	
VO_BOTA_BOSS_16h_Male_Goblin_Idle_04	呿…才炸掉三個笨蛋實習生，就開始要遵守安全管制了。	
VO_BOTA_BOSS_16h_Male_Goblin_Idle_05	可以點火了嗎？還不行…那...現在可以了嗎？	
VO_BOTA_BOSS_16h_Male_Goblin_Idle_06	要怎樣才能看到艾澤拉斯明天的太陽呢？咦，不對，我們是在外域。	
VO_BOTA_BOSS_16h_Male_Goblin_Idle_07	你有沒有試過…呃…多疊一些護甲？我想不到別的主意了。	
VO_BOTA_BOSS_16h_Male_Goblin_Idle_08	那個正常來講應該已經燒完的引信到哪裡去了？我好想它啊	
VO_BOTA_BOSS_16h_Male_Goblin_Idle_09	選哪個…選哪個…	
VO_BOTA_BOSS_16h_Male_Goblin_Intro_01	我可是爆爆大師！而且我還有拿到碩士學位！	
VO_BOTA_BOSS_16h_Male_Goblin_PlayDrywhisker_01	噢，原來你送我手下就是為了這個。	
VO_BOTA_BOSS_16h_Male_Goblin_Puzzle_02	你要怎樣才能活下來呢？我等不及要看好戲囉！	
VO_BOTA_BOSS_16h_Male_Goblin_PuzzleA_01	布瑞娜的東西根本比不上我的毀滅力量！	
VO_BOTA_BOSS_16h_Male_Goblin_PuzzleB_01	我的這些….呃，煙火...對，沒錯。我沒有在弄炸彈什麼的。真的。	
VO_BOTA_BOSS_16h_Male_Goblin_Restart_01	這幾發煙火我就隨便射掉，然後再去拿新的。	
VO_BOTA_BOSS_16h_Male_Goblin_Restart_02	啞彈？可惡！我去倉庫再拿些新的出來。	
VO_BOTA_BOSS_16h_Male_Goblin_Restart_03	對啦…我也同意。反正我們需要更多火藥。	
VO_BOTA_BOSS_16h_Male_Goblin_Restart_04	我等不及要看到爆爆了！不是我老闆，我是說煙火。	
VO_BOTA_BOSS_16h_Male_Goblin_Restart_05	這個引信也太～長了吧。	
VO_BOTA_BOSS_16h_Male_Goblin_Restart_06	多麼焦急的等待。	
VO_BOTA_BOSS_16h_Male_Goblin_Restart_07	多麼焦急的……………...等待。	
VO_BOTA_BOSS_16h_Male_Goblin_Return_01	啊，回來啦！怎麼樣…「轉進」結束了嗎？	
VO_BOTA_BOSS_16h_Male_Goblin_Stuck_01	唉…能怎麼辦呢？就是再來一次啊！	
VO_BOTA_BOSS_16h_Male_Goblin_Stuck_02	如果你還沒準備好，跟我們說一聲就行了。反正時間很多，慢慢來沒關係。	
VO_BOTA_BOSS_16h_Male_Goblin_Stuck_03	你要確定撐得住才行，我們不能再失去實習生了…	
VO_BOTA_BOSS_16h_Male_Goblin_Stuck_04	我還沒準備好看到火花亂飛。還沒好啦。	
VO_BOTA_BOSS_16h_Male_Goblin_Tutorial_01	我們在測試新的煙火。用你的臉來測試。盡量不要死，好嗎？	
VO_BOTA_BOSS_16h_Male_Goblin_Tutorial_02	別擔心，我們會盡可能在你準備好以後才點火。	
VO_BOTA_BOSS_16h_Male_Goblin_Tutorial_04	你永遠預料不到，哪些手下會派上用場。	
VO_BOTA_BOSS_16h_Male_Goblin_Tutorial_06	要是生命值全滿那就太無趣了！刺激一點才好玩！	
VO_BOTA_BOSS_16h_Male_Goblin_UI_01	來喔，都來喔！快來精彩的爆爆測試場。	
VO_BOTA_BOSS_16h_Male_Goblin_UI_02	想要重火力嗎？來這裡就對了！	
VO_BOTA_BOSS_17h_Male_Mech_Complete_01	目標依然存在。授予實驗室存取權。	
VO_BOTA_BOSS_17h_Male_Mech_EmoteResponse_01	此裝置的語音辨識系統已關閉。	
VO_BOTA_BOSS_17h_Male_Mech_EmoteResponse_02	此為視網膜辨識裝置。並非語音辨識裝置。	
VO_BOTA_BOSS_17h_Male_Mech_EmoteResponse_03	啟動自我毀滅程序。哈。哈。開個玩笑。	
VO_BOTA_BOSS_17h_Male_Mech_Idle_01	進行計算…	
VO_BOTA_BOSS_17h_Male_Mech_Idle_02	搜尋解決方案…	
VO_BOTA_BOSS_17h_Male_Mech_Idle_03	分析情境…	
VO_BOTA_BOSS_17h_Male_Mech_Idle_04	進行直譯…	
VO_BOTA_BOSS_17h_Male_Mech_Idle_05	切換至太陽能供電…	
VO_BOTA_BOSS_17h_Male_Mech_Idle_06	雷射充能中…	
VO_BOTA_BOSS_17h_Male_Mech_Idle_07	雷射充能中…	
VO_BOTA_BOSS_17h_Male_Mech_Intro_01	啟動：測試協定3C。系統開機…	
VO_BOTA_BOSS_17h_Male_Mech_Puzzle_01	雷射系統運作中。請稍候…	
VO_BOTA_BOSS_17h_Male_Mech_Puzzle_03	鑽石淨度：百分之99.932無瑕。	
VO_BOTA_BOSS_17h_Male_Mech_Puzzle_04	重新充能雷射。請勿晃動。	
VO_BOTA_BOSS_17h_Male_Mech_Restart_01	刪除42號系統。	
VO_BOTA_BOSS_17h_Male_Mech_Restart_02	已重新啟動。	
VO_BOTA_BOSS_17h_Male_Mech_Restart_03	錯誤：3BT2。還原備份資料。	
VO_BOTA_BOSS_17h_Male_Mech_Restart_04	發現錯誤。進行修復…	
VO_BOTA_BOSS_17h_Male_Mech_Restart_05	傾印錯誤記錄檔…	
VO_BOTA_BOSS_17h_Male_Mech_Restart_06	還原資料快照。	
VO_BOTA_BOSS_17h_Male_Mech_Restart_07	拔除與重插…	
VO_BOTA_BOSS_17h_Male_Mech_Restart_08	指令：還原解析。	
VO_BOTA_BOSS_17h_Male_Mech_Return_01	回復測試場景。	
VO_BOTA_BOSS_18h_Male_Golem_Complete_01	你有光明璀璨的未來。	
VO_BOTA_BOSS_18h_Male_Golem_EmoteResponse_01	光說不練，是不行的。	
VO_BOTA_BOSS_18h_Male_Golem_EmoteResponse_02	我試過改用太陽能，可是虛空風暴這裡光照不足…	
VO_BOTA_BOSS_18h_Male_Golem_Idle_01	嗯，光線可以用光怪陸離的方式操作。	
VO_BOTA_BOSS_18h_Male_Golem_Idle_02	我相信爆爆博士的眼光。他一定會好好利用這個雷射。	
VO_BOTA_BOSS_18h_Male_Golem_Idle_03	靈光一閃可能還不夠，需要多閃幾下…	
VO_BOTA_BOSS_18h_Male_Golem_Idle_05	有很多方法可以把傷害吸光。	
VO_BOTA_BOSS_18h_Male_Golem_Idle_06	駕馭光能…帶來毀滅！	
VO_BOTA_BOSS_18h_Male_Golem_Idle_07	不要直視雷射光。	
VO_BOTA_BOSS_18h_Male_Golem_Idle_09	我們的雷射光也會讓小貓為之瘋狂。	
VO_BOTA_BOSS_18h_Male_Golem_Intro_02	我們實驗室擁有最厲害、最耀眼的…雷射光。	
VO_BOTA_BOSS_18h_Male_Golem_PlayMalGanis_01	比光還要永恆？我不這麼認為。	
VO_BOTA_BOSS_18h_Male_Golem_Puzzle_01	現在，你要測試我最新的…死光雷射。	
VO_BOTA_BOSS_18h_Male_Golem_Puzzle_02	不能光是及格就好，我們要再加強 。	
VO_BOTA_BOSS_18h_Male_Golem_Puzzle_03	太好了！我們的未來一片光明。	
VO_BOTA_BOSS_18h_Male_Golem_Puzzle_04	嗯...你被照射以後，反而更…容光煥發了。	
VO_BOTA_BOSS_18h_Male_Golem_Restart_01	好好思考，說不定能讓你靈光一閃。	
VO_BOTA_BOSS_18h_Male_Golem_Restart_02	我看見了一線曙光。你會成功的。	
VO_BOTA_BOSS_18h_Male_Golem_Restart_03	把光擋住可沒有用。	
VO_BOTA_BOSS_18h_Male_Golem_Restart_04	別動，你把光線斷路器弄壞了。	
VO_BOTA_BOSS_18h_Male_Golem_Restart_06	再來一次！	
VO_BOTA_BOSS_18h_Male_Golem_Return_01	你回來了！非常好。我們已經用光可以汽化的東西了。	
VO_BOTA_BOSS_18h_Male_Golem_UI_01	雖然你通過了弗拉克的實驗室。不過，我這裡可不是讓你來觀光的。	
VO_BOTA_BOSS_18h_Male_Golem_UI_02	夠了，光亮號。接下來要測試的是…更亮的東西。	
VO_BOTA_BOSS_20h_Male_Goblin_Clear_02	這個寶貝幾乎跟我一樣不穩定。只是幾乎啦。	
VO_BOTA_BOSS_20h_Male_Goblin_Failure_01	沒關係，科學不一定都是精密科學。	
VO_BOTA_BOSS_20h_Male_Goblin_Failure_02	不用擔心。這又不是什麼火箭科學。咦，難道真的是嗎？	
VO_BOTA_BOSS_20h_Male_Goblin_Failure_04	沒有人是完美的。除了我。這是我最嚴重的缺點。	
VO_BOTA_BOSS_20h_Male_Goblin_Failure_05	打起精神來！科學是奠基在錯誤之上，所以我的科學才這麼好。	
VO_BOTA_BOSS_20h_Male_Goblin_Failure_06	呵，好吧，看來失敗真的是一種選項。	
VO_BOTA_BOSS_20h_Male_Goblin_Idle_01	慢慢來，我知道這需要精細的操作。	
VO_BOTA_BOSS_20h_Male_Goblin_Idle_02	集中精神！集中精神！…我太大聲了嗎？	
VO_BOTA_BOSS_20h_Male_Goblin_Idle_03	喔！我考倒你了嗎？	
VO_BOTA_BOSS_20h_Male_Goblin_Idle_04	努力解決問題。要是解決不了，我通常會改用賄賂的。	
VO_BOTA_BOSS_20h_Male_Goblin_Idle_05	事前計畫是好習慣啦，但是我比較喜歡事後計畫，因為這樣一定能掌握結果。	
VO_BOTA_BOSS_20h_Male_Goblin_Idle_06	記住：每個答案都有一個問題。	
VO_BOTA_BOSS_20h_Male_Goblin_Lethal_01	想要打敗我？你的膽子可真大！…該怎樣把它從你身上取出來呢？	
VO_BOTA_BOSS_20h_Male_Goblin_Lethal_02	爆爆機器人…炸炸機器人…末日爆炸機器人！	
VO_BOTA_BOSS_20h_Male_Goblin_Mirror_01	魔鏡啊，魔鏡，誰是研究所裡面最聰明的人？	
VO_BOTA_BOSS_20h_Male_Goblin_Mirror_02	你真是超級幸運，竟然能目睹真正完美的存在，也就是我。	
VO_BOTA_BOSS_20h_Male_Goblin_Mirror_03	連我自己都不知道我在幹嘛，你要怎樣模仿我？好好想想喔！	
VO_BOTA_BOSS_20h_Male_Goblin_Mirror_04	喔糟糕！你竟然打敗了——嘿嘿，開玩笑的。我就知道你會那樣。沒用啦！	
VO_BOTA_BOSS_20h_Male_Goblin_One_Liner_01	你的腦袋真不錯！可以去測量室報到、量個頭圍先選個罐子嗎？喔，沒事，別擔心，沒什麼特別理由。	
VO_BOTA_BOSS_20h_Male_Goblin_One_Liner_02	被難倒了嗎？來點補腦食品！用真的腦做的，吃腦補腦！	
VO_BOTA_BOSS_20h_Male_Goblin_One_Liner_03	混沌！它不再是理論而已，我已經證明了！	
VO_BOTA_BOSS_20h_Male_Goblin_One_Liner_04	科學不是只有把東西炸掉那麼簡單。還要仔細觀察，東西到底是怎麼炸掉的。	
VO_BOTA_BOSS_20h_Male_Goblin_One_Liner_06	燒烤光束！威力無比強大的武器，而且在野餐的時候超級方便！	
VO_BOTA_BOSS_20h_Male_Goblin_One_Liner_08	根據爆不準定律，你牌堆中的卡牌都處於疊加狀態，直到被抽出為止。	
VO_BOTA_BOSS_20h_Male_Goblin_One_Liner_09	你知道，我這些傷疤是怎麼來的嗎…？	
VO_BOTA_BOSS_20h_Male_Goblin_One_Liner_10	…嘿，我是真的在問你。我這十年來的記憶都片片段段的。	
VO_BOTA_BOSS_20h_Male_Goblin_One_Liner_11	科學就是答案！…等等，問題是什麼？	
VO_BOTA_BOSS_20h_Male_Goblin_One_Liner_12	我的良心毫無汙點。因為從來沒有用過。	
VO_BOTA_BOSS_20h_Male_Goblin_One_Liner_13	我們有試過把單位從磅換成公斤。結果…超級大混亂！	
VO_BOTA_BOSS_20h_Male_Goblin_One_Liner_14	我也是偽造文件的高手…而且我有證明的文件。	
VO_BOTA_BOSS_20h_Male_Goblin_One_Liner_15	我設計的這套機甲非常驚人，尤其是驚人的搖晃程度。	
VO_BOTA_BOSS_20h_Male_Goblin_One_Liner_17	你知道我是誰嗎?!自大狂這個詞就是因為我才收進字典的！	
VO_BOTA_BOSS_20h_Male_Goblin_One_Liner_18	你的超級武器根本敵不過我的簡陋智慧！喔！不對，我說反了！	
VO_BOTA_BOSS_20h_Male_Goblin_One_Liner_19	我不禁要問：為什麼只碰撞粒子？我們可以碰撞好多東西。	
VO_BOTA_BOSS_20h_Male_Goblin_Survival_01	旋鈕最多只能轉到五，但我已經轉到十一了！	
VO_BOTA_BOSS_20h_Male_Goblin_Survival_02	上次我發射這個寶貝的時候，我失去了研究所一半的主管。超值得的。 	
VO_BOTA_BOSS_20h_Male_Goblin_Trigger_Mechathun_01	我們費盡苦心重組了古神的遺骸。這可是有原因的。	
VO_BOTA_BOSS_20h_Male_Goblin_Trigger_Thermaplug_01	麻瘋地精！唉噁！他們又小又綠！	
VO_BOTA_BOSS_20h_Male_Goblin_UI_Boom_Coin1_End_01	全都在我的計畫之內！應該算吧，反正計畫還沒寫完。	
VO_BOTA_BOSS_20h_Male_Goblin_UI_Boom_Coin1_Start_01	啊，朋友！歡迎來到爆爆博士的內心世界！別迷路了，這裡可是很扭曲的喔！	
VO_BOTA_BOSS_20h_Male_Goblin_UI_Boom_Coin2_End_01	我辛辛苦苦拿到爆爆博士學位，可不是為了看我做的東西全部被炸掉啊！	
VO_BOTA_BOSS_20h_Male_Goblin_UI_Boom_Coin2_Start_01	邊做邊想，就是完成一個精密的大計劃最重要的關鍵。	
VO_BOTA_BOSS_20h_Male_Goblin_UI_Boom_Coin3_End_01	不對！不對！不對！你不應該比我聰明！那是我的工作！	
VO_BOTA_BOSS_20h_Male_Goblin_UI_Boom_Coin3_Start_01	爆爆末日計畫即將完成！我們很快就會知道自己做出了什麼！	
VO_BOTA_BOSS_20h_Male_Goblin_UI_Boom_Coin4_Start_01	時間快不夠了！爆爆末日即將來臨！	
VO_BOTA_BOSS_20h_Male_Goblin_UI_Boom_Coin4_Victory_01	我只是想散播全面混亂、為超級狂妄的統治世界計畫鋪路…難道這樣錯了嗎？！	
VO_BOTA_BOSS_20h_Male_Goblin_UI_Boom_Coin4_Victory_02	呃啊！我的計畫全毀了！誰會想到靠這八個不穩定的邪惡超級天才，竟然會產生反效果？！	
VO_BOTA_BOSS_20h_Male_Goblin_UI_Intro_01	這裡是爆爆研究所！我們在為很壞的目標，做很好的研究。先來參觀一下吧？	
VO_BOTA_BOSS_20h_Male_Goblin_UI_Intro_02	這裡是爆爆研究所！跟我的屬下證明你的能耐，然後我們再來好好談一談。	
VO_BOTA_BOSS_20h_Male_Goblin_UI_Welcome_01	公開徵求：充滿研究熱情、具備高度道德彈性的「科學」研究人員。你要不要加入?!	
VO_BOTA_BOSS_20h_Male_Goblin_UI_Wing1_Complete_01	太好了！這樣我就不用像處理其他申請者一樣，用大砲請你走人了。	
VO_BOTA_BOSS_20h_Male_Goblin_UI_Wing2_Complete_01	你還挺聰明的！我們可以解剖你的腦袋嗎？喔，當然不是現在。哈哈！我再另外跟你約時間。	
VO_BOTA_BOSS_20h_Male_Goblin_UI_Wing3_Complete_01	做得好！希望你有把全部的研究紀錄都整理好，以後碎紙會更方便。	
VO_BOTA_BOSS_20h_Male_Goblin_UI_Wing4_Complete_01	了不起！我要給你爆爆末日計畫的最高存取權限！	
VO_BRANN_MITHRIL_ALT_02	真有趣，這些符文寫著守護者的密文，歷史可追溯到泰坦時代！	
VO_BRANN_WIN_07_ALT_07	總算擺脫了！杖頂就在下個房間！	
VO_BRM_027h_Death_63	呃啊！嗚啊！哇啊啊啊！	
VO_BRMA01_1_CARD_05	噢來吧，咱們給他們「熱烈歡迎」一下！	
VO_BRMA01_1_DEATH_09	噢，哈哈，什麼？這可不是我期望的發展啊。	
VO_BRMA01_1_ETC_06	是時候來點現場表演了！歡迎精英牛頭大佬！	
VO_BRMA01_1_HERO_POWER_04	哈哈哈！疊羅漢！	
VO_BRMA01_1_RESPONSE_03	哈哈哈…嗝！噢，不好意思！	
VO_BRMA01_1_START_01	歡迎來到黑鐵酒吧！	
VO_BRMA01_1_SUCCUBUS_08	娜瑪拉小姐！我們的「朋友」大概想喝點「東西」了。	
VO_BRMA01_1_TURN1_02	大夥兒！哈哈，看哪…有個客人上門了。	
VO_BRMA01_1_WARGOLEM_07	喔哈哈！你有麻煩了！法拉克斯！攻擊！	
VO_BRMA02_1_ALAKIR_34	喜歡玩昆蟲的元素領主來了：奧拉基爾！	
VO_BRMA02_1_ALEXSTRAZA_32	生命守縛者，龍后，黑鐵競技場的煞星，雅立史卓莎！	
VO_BRMA02_1_BEAST_22	他最愛的食物是地精，但偶爾也願意換換口味。歡迎：比斯巨獸！	
VO_BRMA02_1_BOOM_28	不想死就閃遠一點，因為下一位出場的是爆爆博士！	
VO_BRMA02_1_CAIRNE_20	為培養出完美接班人的牛頭人酋長歡呼吧！凱恩‧血蹄！	
VO_BRMA02_1_CHO_07	胖胖惹人愛的熊貓人要說故事了，歡迎：博學行者阿洲！	
VO_BRMA02_1_DEATH_38	*死亡*	
VO_BRMA02_1_DEATHWING_35	噢！矮人先生女士們！現在出場的是，獨一無二的…死亡之翼！	
VO_BRMA02_1_ETC_18	現在出場的是，傳說中的、神話中的，精英牛頭大佬！	
VO_BRMA02_1_FEUGEN_15	給伏晨來點掌聲吧！	
VO_BRMA02_1_FOEREAPER_29	他已經被調校成最大破壞模式。敵人收割者4000！	
VO_BRMA02_1_GEDDON_13	噢，競技場裡面越來越熱了！讓我們歡迎：迦頓男爵！	
VO_BRMA02_1_GELBIN_21	特別從新地精區趕過來的地精領袖：傑爾賓·梅卡托克！	
VO_BRMA02_1_GRUUL_31	他弒龍者的外號可不是叫假的！替戈魯爾鼓掌吧！	
VO_BRMA02_1_HERO_POWER_05	觀眾坐不住了！哈哈！	
VO_BRMA02_1_HOGGER_27	讓我們歡迎等級只有11的豺狼人傳奇：霍格！	
VO_BRMA02_1_ILLIDAN_23	有了兩把戰刃還要眼睛幹什嗎？歡迎：伊利丹·怒風！	
VO_BRMA02_1_LEVIATHAN_12	剛回廠保養，準備再次大展身手的烈焰戰輪！	
VO_BRMA02_1_LOATHEB_16	塞住鼻孔，摀住嘴巴，為腐臭的憎恨者歡呼吧！	
VO_BRMA02_1_MAEXXNA_24	大蜘蛛來了！她的名字是什麼來著？梅克絲娜！	
VO_BRMA02_1_MILLHOUSE_09	噢，有沒有搞錯。是誰讓他進來競技場的？	
VO_BRMA02_1_MOGOR_25	他不太會吵架，但沒幾個人敢跟他吵。巨魔莫古來了！	
VO_BRMA02_1_MUKLA_10	下一個，香蕉之王本人，穆克拉！	
VO_BRMA02_1_NOZDORMU_36	各位先生各位…唉呀，時間到了！	
VO_BRMA02_1_ONYXIA_33	在塵泥沼澤跟暴風城兩邊跑，忙碌的奧妮克希亞！	
VO_BRMA02_1_PAGLE_08	剛去釣魚回來的納特‧帕格！	
VO_BRMA02_1_RESPONSE_04	沒有人能夠跟這些傳說英雄對抗！	
VO_BRMA02_1_SNEED_30	我們下一位挑戰者正躲在一台老伐木機裡面！會是誰呢？	
VO_BRMA02_1_STALAGG_14	斯塔拉格能從競技場存活下來嗎？…讓我們看下去！	
VO_BRMA02_1_START_01	新的挑戰者！	
VO_BRMA02_1_SYLVANAS_19	她將親自為你燃燒永恆的怒火，讓我們歡迎希瓦娜斯‧風行者！	
VO_BRMA02_1_THALNOS_06	替瘦不啦機的血法師薩爾諾斯鼓掌鼓掌！	
VO_BRMA02_1_THAURISSAN_37	解完一大串任務才看得到的，索瑞森大帝！	
VO_BRMA02_1_TINKMASTER_11	替偉大的發明家鼓掌吧：技工大師歐沃斯巴克！	
VO_BRMA02_1_TOSHLEY_26	這位地精遠道而來，讓我們熱烈歡迎托斯利！	
VO_BRMA02_1_TURN1_02	矮人先生女士們！今天有好看的表演，就要開始囉！	
VO_BRMA02_1_TURN1_PT2_03	艾澤拉斯最強的傳說英雄輪番對上一個卑微的冒險者！	
VO_BRMA02_1_VOLJIN_17	請安靜一下！我們有位特別來賓，大酋長沃金！	
VO_BRMA03_1_CARD_04	我擁有拉格納羅斯賦予的無窮力量！	
VO_BRMA03_1_DEATH_09	呃啊啊啊啊！	
VO_BRMA03_1_HERO_POWER_06	死吧！	
VO_BRMA03_1_MOIRA_DEATH_05	不！茉艾拉！你會付出代價！	
VO_BRMA03_1_RESPONSE_03	閉嘴，不然我就讓你閉嘴！	
VO_BRMA03_1_START_01	黑鐵矮人絕不會倒下！	
VO_BRMA03_1_TURN1_02	嘿！別碰我老婆！	
VO_BRMA03_1_VS_RAG_07	不是吧！又是拉格納羅斯？	
VO_BRMA04_1_CARD_04	火誓者，上陣！	
VO_BRMA04_1_DEATH_06	呃啊啊啊啊！	
VO_BRMA04_1_HERO_POWER_05	岩漿！	
VO_BRMA04_1_RESPONSE_03	石頭才是王道。	
VO_BRMA04_1_START_01	用石頭砸死你。	
VO_BRMA04_1_TURN1_02	一起玩石頭。	
VO_BRMA05_1_CARD_05	滴答滴答，凡人！	
VO_BRMA05_1_DEATH_04	最後的服務…	
VO_BRMA05_1_HERO_POWER_06	燃燒吧！	
VO_BRMA05_1_RESPONSE_03	末日降臨！	
VO_BRMA05_1_START_01	燃燒吧！	
VO_BRMA05_1_TURN1_02	拉格納羅斯會吞噬你！	
VO_BRMA06_1_DEATH_04	我投降！我投降！	
VO_BRMA06_1_RESPONSE_03	你以為你已經贏了？或許該給你更痛苦的教訓！	
VO_BRMA06_1_START_01	沒有人能挑戰烈焰的權威！	
VO_BRMA06_1_SUMMON_RAG_05	看哪，炎魔拉格納羅斯！他比這個世界本身還要古老！	
VO_BRMA06_1_TURN1_02_ALT	獵殺他們！	
VO_BRMA06_3_INTRO_01	太早了！你太早叫醒我了，埃克索圖斯！	
VO_BRMA06_3_RESPONSE_03	為什麼要入侵這裡！	
VO_BRMA06_3_TURN1_02	凡人蟲子們！你們膽敢踏入我的領域？	
VO_BRMA07_1_CARD_04	砸死你！	
VO_BRMA07_1_DEATH_06	噢！！！	
VO_BRMA07_1_HERO_POWER_05	我砸！你死！	
VO_BRMA07_1_RESPONSE_03	啊！我砸！	
VO_BRMA07_1_START_01	我會砸死你！	
VO_BRMA07_1_TURN1_02	砸死，還是敲死？ 真難以抉擇！	
VO_BRMA08_1_CARD_05	我會守護黑石塔！	
VO_BRMA08_1_DEATH_06	呃！啊！！！	
VO_BRMA08_1_RESPONSE_04	為什麼？！告訴我為什麼？我本來覺得你很不錯的。	
VO_BRMA08_1_START_01	你在這裡做什麼？	
VO_BRMA08_1_TURN1_03	奈法利斯領主！我以為他是幫我們解決拉格納羅斯的人！	
VO_BRMA08_1_TURN1_ALT_02	你是來幫我消滅世上凡人的嗎？	
VO_BRMA09_1_CARD_05	黑石塔是我們的！	
VO_BRMA09_1_DEATH_11	嘎啊啊！！！	
VO_BRMA09_1_HERO_POWER1_06	打開閘門！	
VO_BRMA09_1_HERO_POWER2_07	殺死後面那個傢伙！	
VO_BRMA09_1_HERO_POWER3_08	專心打英雄，蠢貨！	
VO_BRMA09_1_HERO_POWER4_09	我們一起上就所向披靡！	
VO_BRMA09_1_RESPONSE_04	哈哈哈哈！	
VO_BRMA09_1_START_01	我們是正統的部落！	
VO_BRMA09_1_TURN1_03	你爬錯山了！	
VO_BRMA09_1_TURN1_ALT_02	沒有人能阻擋我們！死吧！	
VO_BRMA10_1_DEATH_08	呃啊啊啊！	
VO_BRMA10_1_EGG_DEATH_1_05	蠢貨！這些蛋比你想像得還要珍貴！	
VO_BRMA10_1_EGG_DEATH_2_06	不！不要再破壞了！我要把你的頭砍下來！	
VO_BRMA10_1_EGG_DEATH_3_07	你會付出代價！	
VO_BRMA10_1_HERO_POWER_04	別碰那些蛋！	
VO_BRMA10_1_RESPONSE_03	我要把你打成蛋花湯！	
VO_BRMA10_1_START_01	看哪，我們全新龍族的腐化之蛋！	
VO_BRMA10_1_TURN1_02	這些蛋將會毀滅你！	
VO_BRMA11_1_ALEXSTRAZA_07	救我，生命守縛者！救我！	
VO_BRMA11_1_CARD_04	黑石氏族的狂怒，已經在我的血管中流動了！	
VO_BRMA11_1_DEATH_ALT_08	終於，痛苦結束了。	
VO_BRMA11_1_HERO_POWER_05	啊啊啊！毀滅！	
VO_BRMA11_1_KILL_PLAYER_06	請原諒我，朋友。我失敗了。	
VO_BRMA11_1_RESPONSE_03	你應該要在可以逃走前，趕快逃走，凡人！	
VO_BRMA11_1_START_01	快逃吧！在我失去控制前快逃吧！ 	
VO_BRMA11_1_TURN1_02	太遲了！ 奈法利安的腐化已經掌握了我！	
VO_BRMA13_1_DEATH_ALT_23	不！不！！！我會回來的！	
VO_BRMA13_1_DEATHWING_19	老爸？	
VO_BRMA13_1_HP_DRUID_14	德魯伊，大自然也將被我掌控！	
VO_BRMA13_1_HP_GENERIC_18	你的魔法將屬於我！	
VO_BRMA13_1_HP_HUNTER_12	獵人即將成為獵物！	
VO_BRMA13_1_HP_MAGE_11	法師，你應該小心使用你的魔法。	
VO_BRMA13_1_HP_PALADIN_07	聖騎士，聖光遺棄你了嗎？	
VO_BRMA13_1_HP_PRIEST_08	牧師，聖光現在將為我所用！	
VO_BRMA13_1_HP_ROGUE_15	盜賊，不要躲了，面對我吧！	
VO_BRMA13_1_HP_SHAMAN_13	薩滿，元素都將臣服於我。	
VO_BRMA13_1_HP_WARLOCK_10	術士，不要隨便去玩那些你不理解的法術。	
VO_BRMA13_1_HP_WARRIOR_09	戰士，你的力量就是你的弱點！	
VO_BRMA13_1_RESPONSE_05	我是這個地方的主人！	
VO_BRMA13_1_START_01	歡迎來到我的聖堂，英雄。	
VO_BRMA13_1_TURN1_PT1_02	看啊，奈法利安真正的力量！	
VO_BRMA13_1_TURN1_PT2_03	無限的法力！強化的龍鱗！	
VO_BRMA14_1_CARD_09	重新分配超載能量。	
VO_BRMA14_1_DEATH_08	防禦系統已被摧毀。動力關閉中…	
VO_BRMA14_1_HP1_03	雷電號已啟動。	
VO_BRMA14_1_HP2_04	烈毒號已啟動。	
VO_BRMA14_1_HP3_05	秘法號已啟動。	
VO_BRMA14_1_HP4_06	熔岩號已啟動。	
VO_BRMA14_1_HP5_07	防禦系統已啟動。	
VO_BRMA14_1_RESPONSE1_10	嗶。嗶。嗶。	
VO_BRMA14_1_RESPONSE2_11	嘗試連線中…	
VO_BRMA14_1_RESPONSE3_12	連線成功。下載作業系統更新檔。	
VO_BRMA14_1_RESPONSE4_13	更新完成。哈囉，哈囉，哈囉。	
VO_BRMA14_1_RESPONSE5_14	哈囉，哈囉，哈囉。	
VO_BRMA14_1_START_01	偵測到入侵者。	
VO_BRMA14_1_TURN1_02	主要防禦矩陣已啟動。	
VO_BRMA15_1_CARD_05	我的失敗品會敲響你們的喪鐘！	
VO_BRMA15_1_DEATH_04	啊啊啊！！！	
VO_BRMA15_1_HERO_POWER_06	混合攪拌，然後加熱！	
VO_BRMA15_1_RESPONSE_03	一點都不會浪費…	
VO_BRMA15_1_START_01	不能有干擾！	
VO_BRMA15_1_TURN1_02	不能讓主人等候！不能再失敗了！	
VO_BRMA16_1_CARD_04	你躲不掉的！	
VO_BRMA16_1_DEATH_06	呃啊啊啊！	
VO_BRMA16_1_GONG1_10	啊！那個聲音！	
VO_BRMA16_1_GONG2_11	不！如此接近！	
VO_BRMA16_1_GONG3_12	我的耳朵！	
VO_BRMA16_1_HERO_POWER_05	笨拙的腳步聲和臭味已經出賣了你！	
VO_BRMA16_1_RESPONSE_03	很好，繼續說，我正在找你。	
VO_BRMA16_1_START_01	我聽到你的心跳聲。	
VO_BRMA16_1_TRIGGER1_07	啊，我聽到你了…	
VO_BRMA16_1_TRIGGER2_08	我聽到腳步聲了。	
VO_BRMA16_1_TRIGGER3_09	我聽到你的心跳…你逃不掉了！	
VO_BRMA16_1_TURN1_02	死亡在黑暗裡等待著！	
VO_BRMA17_1_CARD_86	希望你會游泳…在滾燙的岩漿裡！	
VO_BRMA17_1_DEATH_97	啊啊啊！	
VO_BRMA17_1_DEATH_HEROIC_98	不！！！	
VO_BRMA17_1_DEATHWING_88	老爸？	
VO_BRMA17_1_HERO_POWER_87	我的暗影之焰活化了他們的骨頭！	
VO_BRMA17_1_NEF_AIR1_89	看我從上面噴火！  一點傷害只是個開始！	
VO_BRMA17_1_NEF_AIR2_90	兩顆火球！ 我從空中朝你噴火！	
VO_BRMA17_1_NEF_AIR3_91	這一次我只噴一顆火球，因為我下一個回合要給你來一點刺激的。	
VO_BRMA17_1_NEF_AIR4_92	呵呵！三顆火球從天而降！給我吃下去！	
VO_BRMA17_1_NEF_AIR5_93	從現在開始我只會吐一顆火球！	
VO_BRMA17_1_NEF_AIR6_94	騙你的！四顆火球！哇哈哈哈！！！	
VO_BRMA17_1_NEF_AIR7_95	這次我不會噴火球。不過你要準備好…	
VO_BRMA17_1_NEF_AIR8_96	二十顆火球！哇哈哈哈哈哈！！！	
VO_BRMA17_1_RESPONSE_85	凡人的心靈…真容易操弄。	
VO_BRMA17_1_RESURRECT1_82	我會從空中降下死亡！	
VO_BRMA17_1_RESURRECT2_83	我在空中的時候，下面有留給你一個驚喜喔！	
VO_BRMA17_1_RESURRECT3_84	看看我終極的傑作！起來吧，妹妹！起來吧，奧妮克希亞！	
VO_BRMA17_1_START_78	你來到了輝煌的終章！	
VO_BRMA17_1_TRANSFORM1_80	我試著當一個稱職的東道主，但你偏偏不肯好好的死掉！	
VO_BRMA17_1_TRANSFORM2_81	是時候拋下所有的偽裝，殺了你！	
VO_BRMA17_1_TURN1_79	我最終的創造正等著你，凡人。	
VO_COOP02_00	我會幫你們除掉血肉詛咒！	
VO_COOP02_02	一起擊敗齒輪大師梅卡佐德以獲得勝利！	
VO_COOP02_ABILITY_05	提高時脈速度！	
VO_COOP02_ABILITY_06	博學行者阿洲，你的複製大法別想得逞！	
VO_COOP03_01	我是這個地方的主人！	
VO_COOP03_02	不…不！我會摧毀你！	
VO_COOP03_03	凡人的心靈…真容易操弄…	
VO_COOP03_04	我試著當一個稱職的東道主，但你偏偏不肯好好的死掉！	
VO_COOP03_05	是時候拋下所有的偽裝，殺了你！	
VO_COOP03_06	牧師，聖光現在將為我所用！	
VO_COOP03_07	薩滿！元素都將臣服於我。	
VO_COOP03_08	哼哈哈哈…看啊，奈法利安真正的力量！	
VO_COOP03_09	哈哈哈哈…你來到了輝煌的終章！	
VO_Crone_Female_Troll_CroneDeath_02	不！我會抓到你！我要抓…	
VO_Crone_Female_Troll_CroneEmoteResponse_02	啊哈哈哈哈！	
VO_Crone_Female_Troll_CroneFlyingMonkeys_01	把她抓過來！	
VO_Crone_Female_Troll_CroneHeroPower_02	嘻嘻嘻！	
VO_Crone_Female_Troll_CroneOpen_01	逃吧，可愛的女孩！	
VO_Curator_Male_ArcaneGolem_CuratorArcaneGolem_01	有趣。真是驚人的相似性。	
VO_Curator_Male_ArcaneGolem_CuratorBeasts_01	館長對野獸過敏。	
VO_Curator_Male_ArcaneGolem_CuratorDemons_01	展覽廳沒有收藏惡魔。	
VO_Curator_Male_ArcaneGolem_CuratorDragons_01	不需要清理龍類排泄物了。	
VO_Curator_Male_ArcaneGolem_CuratorEmoteResponse_01	無法處理你的要求。	
VO_Curator_Male_ArcaneGolem_CuratorHarrison_02	偵測到竊賊！哈里遜·瓊斯禁止進入。	
VO_Curator_Male_ArcaneGolem_CuratorMechs_01	重新編輯助理程式。	
VO_Curator_Male_ArcaneGolem_CuratorMedivhSkin_01	麥迪文的假冒者。關鍵線索：缺少瘋狂的眼神。	
VO_Curator_Male_ArcaneGolem_CuratorMurlocs_01	小型魚類生物可以自由進出。	
VO_Curator_Male_ArcaneGolem_CuratorPirates_01	海盜派對開始了errrrr	
VO_Curator_Male_ArcaneGolem_CuratorReno_02	偵測到竊賊！里諾‧傑克森禁止進入。	
VO_Curator_Male_ArcaneGolem_CuratorTurn1_01	館長具有管理展覽廳的必要配備。	
VO_Curator_Male_ArcaneGolem_CuratorTurn5_01	請遵守展覽廳的規定。	
VO_Curator_Male_ArcaneGolem_CuratorTurn9_01	嘉賓請待在展覽廳內。	
VO_Curator_Male_ArcaneGolem_IllhoofKilrekResponse_01	館長不關心這件事。召喚是禁止事項。	
VO_Curator_Male_ArcaneGolem_IllhoofSenseDemons_01	偵測到大量惡魔。	
VO_Curator_Male_ArcaneGolem_IllhoofTurn1_01	禁止進行召喚儀式。	
VO_Curator_Male_ArcaneGolem_IllhoofTurn5_01	儀式會對居民造成傷害，不允許惡魔繼續進行。	
VO_Curator_Male_ArcaneGolem_IllhoofWin_01	館長感謝你，展覽廳會恢復原貌。	
VO_Curator_Male_ArcaneGolem_NightbaneCorruption_01	不！不允許展覽廳受到腐化！	
VO_Curator_Male_ArcaneGolem_NightbaneTour_01	夜禍本名為阿坎納苟斯，失控的魔法扭曲了他的心智。	
VO_Curator_Male_ArcaneGolem_NightbaneTour_02	在你左側是埃蘭的雕像，在你右側是力量之燈。	
VO_Curator_Male_ArcaneGolem_NightbaneTurn1_01	不受控的展覽品會帶來危險。必須要把這些展覽品帶回展覽廳。	
VO_Curator_Male_ArcaneGolem_NightbaneTurn3_01	必須救回展示生物，之後你就可以通過。	
VO_Curator_Male_ArcaneGolem_NightbaneUnstablePortal_01	嘉賓請務必小心。這頭龍害怕不穩定的魔法。	
VO_Curator_Male_ArcaneGolem_NightbaneWin_01	需要額外協助。	
VO_Curator_Neither_ArcaneGolem_CuratorDeath_04	關機中…	
VO_Curator_Neither_ArcaneGolem_CuratorOpen_01	請勿觸碰展覽品。	
VO_ELISE_LOE16_ALT_1_FIRST_HALF_02	拉法姆在法杖充能時是無敵的。	
VO_ELISE_LOE16_ALT_1_SECOND_HALF_03	充能完成後我們會有段時間可以反擊，但是得同時應付他召喚的怪物！	
VO_ELISE_WEIRD_DECK_05	抱歉，牌不是很好。那是去年為了打聯賽組的，之後就沒動過了。	
VO_EMOTE_HERO_TBKTRAF_KT_DRAWING_BOARD	看來又得重新計畫了。	
VO_EMOTE_HERO_TBKTRAF_KT_GLOAT	跪地求饒吧。	
VO_EMOTE_HERO_TBKTRAF_KT_MINIONS_SERVANTS	僕從們，侍衛們，隸屬於黑暗與寒冷的戰士們…	
VO_FP1_014t_EnterPlay_01	感受痛苦的滋味！	
VO_FP1_031_Attack_07	待宰的羊們…	
VO_FP1_031_EnterPlay_06	天譴軍團會消滅你們！	
VO_GIL_504_Female_Orc_TUT_LootSelect2_01	誰敢傷害我的手下？	
VO_GIL_504_Female_Orc_TUT_Victory_Generic_01	你的勝利毫無意義。我已經和這座森林合而為一，想阻止我可沒那麼容易。	
VO_GIL_504_Female_Orc_TUT_Victory1_01	要剷除黑巫森林可沒那麼容易…其他人也會跟你一樣順利嗎？	
VO_GIL_504_Female_Orc_TUT_Victory2_01	已經有兩位英雄闖過黑巫森林了，但是你還沒找到我。	
VO_GIL_504_Female_Orc_TUT_Victory3_01	你離我越來越近了，但是你最後的勇士也能勝過我嗎？	
VO_GIL_504_Female_Orc_TUT_Victory4_01	今晚就做個了結吧。過來找我，見證這座森林最恐怖的景象！	
VO_GIL_504_Female_Orc_UI_Monster_Azlina_02	喔，可憐的阿薩琳娜迷路了！不過他一定能找到出路的。	
VO_GIL_504_Female_Orc_UI_Monster_Baran_01	巴朗原本是個溫柔的傢伙…只可惜，我需要他的眼睛！	
VO_GIL_504_Female_Orc_UI_Monster_Brushwood_Cent_01	這個德魯伊原本很強大，但也很容易因為憤怒而扭曲。	
VO_GIL_504_Female_Orc_UI_Monster_Chupacabran_01	卓柏卡布朗！我可是費了好一番功夫才收服它。	
VO_GIL_504_Female_Orc_UI_Monster_Cragtorr_01	面對大地的苦痛之怒！克雷托！起來吧！	
VO_GIL_504_Female_Orc_UI_Monster_Crowskin_01	葛琳達，解決他，所有的教徒就都歸你管。	
VO_GIL_504_Female_Orc_UI_Monster_DrSezavo_01	你們就像疾病一樣，塞札沃能治治你們。	
VO_GIL_504_Female_Orc_UI_Monster_Experiment3C_01	嗯…奇怪，那可不是我的手下。	
VO_GIL_504_Female_Orc_UI_Monster_Face_Collector_01	你的臉會是他最新的收藏品！	
VO_GIL_504_Female_Orc_UI_Monster_Gnarlroot_01	古老幽魂，聽我號令！用樹根和藤蔓消滅所有敵人！	
VO_GIL_504_Female_Orc_UI_Monster_Griselda_01	葛薩爾妲和我作對，而她付出了代價。	
VO_GIL_504_Female_Orc_UI_Monster_Groddo_01	喔！格魯多！我被丟在那裡等死的時候，是它保護了我。	
VO_GIL_504_Female_Orc_UI_Monster_Grubb_01	就連我也控制不了格羅布。	
VO_GIL_504_Female_Orc_UI_Monster_Grum_01	古老的泥土、傷痛的大地！起來破壞他們的旅店和家園！	
VO_GIL_504_Female_Orc_UI_Monster_Gustave_01	古斯塔夫！乖，要留一些肉給你的主人喔。	
VO_GIL_504_Female_Orc_UI_Monster_Hannigul_01	漢尼古爾曾經為鎮子除掉所有鼠輩…包括你這樣的鼠輩。	
VO_GIL_504_Female_Orc_UI_Monster_Havnixx_01	赫尼克斯知道你在想什麼，你的恐懼，就是他的大餐。	
VO_GIL_504_Female_Orc_UI_Monster_Infinite_Toki_01	愛管閒事的地精，準備受死吧！說不定，你們早就彼此認識了呢？	
VO_GIL_504_Female_Orc_UI_Monster_Ivan_01	艾凡曾經是你們的人，但現在他是我的了。	
VO_GIL_504_Female_Orc_UI_Monster_Lord_Godfrey_01	高佛雷！我們說好了，這傢伙是你的了！	
VO_GIL_504_Female_Orc_UI_Monster_Lovers_01	這是愛情故事。這是鬼故事。這是你滅亡的故事。	
VO_GIL_504_Female_Orc_UI_Monster_Mistwraith_01	深沉的黑夜、幽暗的樹林，迴盪的低語…	
VO_GIL_504_Female_Orc_UI_Monster_Mute_01	無聲… 又致命…	
VO_GIL_504_Female_Orc_UI_Monster_Niira_01	別再玩啦，妮拉！解決敵人！	
VO_GIL_504_Female_Orc_UI_Monster_Raeth_01	並非所有被遺忘者都遺棄了這片樹林。有些選擇效忠我。	
VO_GIL_504_Female_Orc_UI_Monster_Rancel_01	朗瑟爾的瘟疫幫我塑造這座詛咒的森林。	
VO_GIL_504_Female_Orc_UI_Monster_Sazzmi_01	請留步聽她說個故事…然後永遠留下來。	
VO_GIL_504_Female_Orc_UI_Monster_Sephira_01	森林裡的規矩，就靠鷹身人姊妹的飛翼和利爪維護了。	
VO_GIL_504_Female_Orc_UI_Monster_Shivers_01	起來吧，席佛斯！復仇的時候到了，我為你送上吉爾尼斯公主！	
VO_GIL_504_Female_Orc_UI_Monster_Shudderwock_01	哮斗龍！難以應付的可怕怪物…看別人被他打真是有趣。	
VO_GIL_504_Female_Orc_UI_Monster_Splintergraft_01	恐懼和悲傷，森林在怒吼。枝椏和樹幹，森林要復仇！	
VO_GIL_504_Female_Orc_UI_Monster_Sthara_01	吉爾尼斯人會愛上我…等絲瑟拉改變他們的想法之後。	
VO_GIL_504_Female_Orc_UI_Monster_Vitus_01	本是你同胞，狠心遭放逐。來到我森林，意外得歸宿…	
VO_GIL_504_Female_Orc_UI_Monster_Wharrgarbl_01	我最喜歡魚人了…因為他們其實比較像青蛙。	
VO_GIL_598_Female_Human_SpecialSylvanas_01	妖女！你殺了我哥哥！	
VO_GIL_692_Male_Worgen_TUT_AdventureSelect_01	各位英雄！你們誰有勇氣冒險深入黑巫森林？	
VO_GIL_692_Male_Worgen_TUT_BossReveal1_01	有可怕的怪物在吉爾尼斯的森林裡作祟，把他們一個一個解決掉。	
VO_GIL_692_Male_Worgen_TUT_BossReveal2_01	越是深入這座森林，裡面的怪物就越是強大。	
VO_GIL_692_Male_Worgen_TUT_BossReveal3_01	哈嘉薩就是黑巫森林的邪惡源頭。找到她、阻止她！	
VO_GIL_692_Male_Worgen_TUT_BossReveal3ALT_01	這些怪物都是哈嘉薩的傑作。打敗他們，找出這女巫的行蹤！	
VO_GIL_692_Male_Worgen_TUT_CharacterSelect_01	我召集了一支精英隊伍，你們每個人都有獨特的才能。	
VO_GIL_692_Male_Worgen_TUT_Defeat1_01	只要在黑巫森林中敗北，就會失去你所編組的套牌。	
VO_GIL_692_Male_Worgen_TUT_FightBegin1Crowley_01	克羅雷！善用你的火砲，發揮最大的攻擊火力。	
VO_GIL_692_Male_Worgen_TUT_FightBegin1Shaw_01	狩獵開始了，肖爾。用你的獵犬去追捕敵人。	
VO_GIL_692_Male_Worgen_TUT_FightBegin1Tess_01	出發之後一切都得靠自己。儘量在戰場上尋找可用的法術。  	
VO_GIL_692_Male_Worgen_TUT_FightBegin1Tess_02	你是我僅剩的孩子，泰絲。萬事小心。	
VO_GIL_692_Male_Worgen_TUT_FightBegin1Toki_01	托奇，操控時間的能力讓你擁有過人的機運。	
VO_GIL_692_Male_Worgen_TUT_FightBegin2_01	這些…怪物…絕對不是自然的產物。有東西在腐化這座森林。	
VO_GIL_692_Male_Worgen_TUT_LootSelect1_01	強化套牌的戰力，讓你能深入危機重重的黑巫森林。	
VO_GIL_692_Male_Worgen_TUT_LootSelect2_02	你！你就是腐化這座森林的主謀？	
VO_GIL_692_Male_Worgen_TUT_TreasureSelect1_01	獵殺怪物可以獲得強大的獎勵。仔細選擇對你最有幫助的！	
VO_GIL_692_Male_Worgen_TUT_Victory_Final_01	成功了！森林的騷動逐漸平息，光明重返吉爾尼斯！	
VO_GILA_400h_Male_Human_EVENT_HAGATHA_ALMOSTDEAD_02	我可不會坐以待斃。	
VO_GILA_400h_Male_Human_EVENT_HAGATHA_INTRO_01	獵犬找到她了！哈嘉薩在這裡！	
VO_GILA_400h_Male_Human_EVENT_HAGATHA_LOWHEALTH_01	她受傷了。追上去。	
VO_GILA_400h_Male_Human_EVENT_HAGATHA_TURN4_01	我有忠心的獵犬。	
VO_GILA_400h_Male_Human_EVENT_IVAN_INTRO_01	艾凡！你竟然背叛了我們！	
VO_GILA_400h_Male_Human_EVENT_NEMESIS_INTRO_01	我終於找到你了，葛琳達！	
VO_GILA_400h_Male_Human_EVENT_NEMESIS_TURN2_01	為什麼？為什麼你要投靠哈嘉薩！	
VO_GILA_500h3_Female_Human_EVENT_HAGATHA_SUB_IN_01	去找掩護！這裡交給我。	
VO_GILA_500h3_Female_Human_EVENT_HAGATHA_TURN2_01	哈嘉薩，吉爾尼斯見識過比你更難纏的對手！	
VO_GILA_500h3_Female_Human_EVENT_HAGATHA_TURN4_01	女巫，離開這個地方！	
VO_GILA_500h3_Female_Human_EVENT_HAGATHA_WOUNDED_01	離開這座森林，我就饒你一命。	
VO_GILA_500h3_Female_Human_EVENT_IVAN_INTRO_01	艾凡！乖乖跟我走吧。	
VO_GILA_500h3_Female_Human_EVENT_NEMESIS_INTRO_01	席佛斯。我以為你已經死了。	
VO_GILA_500h3_Female_Human_EVENT_NEMESIS_TURN2_01	我會收拾我父親留下的殘局。	
VO_GILA_600h_Male_Worgen_EVENT_HAGATHA_SUB_IN_01	我鎖定你了，哈嘉薩。	
VO_GILA_600h_Male_Worgen_EVENT_HAGATHA_TURN2_01	這塊土地屬於吉爾尼斯。	
VO_GILA_600h_Male_Worgen_EVENT_HAGATHA_TURN4_01	至少我還有同胞。	
VO_GILA_600h_Male_Worgen_EVENT_HAGATHA_WOUNDED_01	那我就轟倒每一棵樹，把這裡夷為平地。	
VO_GILA_600h_Male_Worgen_EVENT_IVAN_INTRO_01	該死的叛徒，我總算找到你了。	
VO_GILA_600h_Male_Worgen_EVENT_NEMESIS_INTRO_01	高佛雷！你這叛徒！準備付出代價吧！	
VO_GILA_600h_Male_Worgen_EVENT_NEMESIS_TURN02_01	高佛雷，你人還沒死之前，就已經爛透了。	
VO_GILA_900h_Female_Gnome_EVENT_HAGATHA_ALMOST_DEAD_01	時間會治好所有傷痛。	
VO_GILA_900h_Female_Gnome_EVENT_HAGATHA_SUB_IN_01	去休息一下吧，這裡交給我。	
VO_GILA_900h_Female_Gnome_EVENT_HAGATHA_TURN2_01	我去過所有時間線，就是為了除掉你。	
VO_GILA_900h_Female_Gnome_EVENT_HAGATHA_WOUNDED_01	你的時間快結束了，女巫。	
VO_GILA_900h_Female_Gnome_EVENT_IVAN_INTRO_01	艾凡你完蛋了。我已經知道結局了。	
VO_GILA_900h_Female_Gnome_EVENT_NEMESIS_INTRO_B_01	這以前有…發生過嗎？	
VO_GILA_900h_Female_Gnome_EVENT_NEMESIS_TURN2_02	我到底以為我在做什麼!?	
VO_GILA_900h_Female_Gnome_EVENT_NEMESIS_TURN6_01	你來自未來？那我們到底誰會贏？ 	
VO_GILA_BOSS_20h_MangyWolf_DefeatPlayer	啊嗚嗚嗚！	
VO_GILA_BOSS_20h_MangyWolf_Emote	嘎嗚嗚嗚！	
VO_GILA_BOSS_20h_MangyWolf_Intro	哈嗚嗚嗚！	
VO_GILA_BOSS_21h_Rottooth_Emote	*吼聲*	
VO_GILA_BOSS_21h_Rottooth_Intro	*吼聲*	
VO_GILA_BOSS_21h_Rottooth_PlayerDefeat	*吼聲*	
VO_GILA_BOSS_22h_Male_Undead_Death_01	*慘叫*	
VO_GILA_BOSS_22h_Male_Undead_DefeatPlayer_01	太棒了。我終於有錢可以買刀鞘了！	
VO_GILA_BOSS_22h_Male_Undead_EmoteResponse_01	繼續叫吧，會有更多我的人過來。	
VO_GILA_BOSS_22h_Male_Undead_EmoteResponseTess_01	去跟席佛斯船長求饒吧，公主！	
VO_GILA_BOSS_22h_Male_Undead_EventPlaysCoin_01	我就知道你身上錢很多！	
VO_GILA_BOSS_22h_Male_Undead_EventPlaysShiv_01	你這招不錯。	
VO_GILA_BOSS_22h_Male_Undead_Intro_01	船長要我把你消失！	
VO_GILA_BOSS_22h_Male_Undead_IntroCrowley_01	自以為是指揮官啊？薪水高嗎？	
VO_GILA_BOSS_22h_Male_Undead_IntroTess_01	船長跟你有點過節啊，公主。	
VO_GILA_BOSS_23h_Male_Ettin_DefeatPlayer_01	我贏了，哈哈哈！\n(<i>我的手下咧？</i>)	
VO_GILA_BOSS_23h_Male_Ettin_EmoteResponse_02	我不喜歡你！\n(<i>我只有喜歡你一點點。</i>)	
VO_GILA_BOSS_23h_Male_Ettin_HeroPower_01	飛出去！	
VO_GILA_BOSS_23h_Male_Ettin_HeroPower_02	喝！	
VO_GILA_BOSS_23h_Male_Ettin_HeroPower_03	喝啊！	
VO_GILA_BOSS_23h_Male_Ettin_HeroPower_04	飛啊！	
VO_GILA_BOSS_23h_Male_Ettin_HeroPower_05	砸死他們！	
VO_GILA_BOSS_23h_Male_Ettin_Intro_01	你一定能丟很遠。\n(<i>好遠好遠！</i>)	
VO_GILA_BOSS_24h_Male_Bogbeast_DefeatPlayer_01	死了沉下去…爛了浮上來…	
VO_GILA_BOSS_24h_Male_Bogbeast_EmoteResponse_01	腐爛冒泡…腐爛冒泡…	
VO_GILA_BOSS_24h_Male_Bogbeast_EventPlaysSmallMinion_01	嘿哈哈哈…	
VO_GILA_BOSS_24h_Male_Bogbeast_EventPlaysSmallMinion_02	嘿嘿嘿哈哈…	
VO_GILA_BOSS_24h_Male_Bogbeast_EventPlaysSmallMinion_03	哈哈哈哈哈…	
VO_GILA_BOSS_24h_Male_Bogbeast_EventPlaysSmallMinion_04	錯誤…	
VO_GILA_BOSS_24h_Male_Bogbeast_HeroPower_01	我永遠不孤單。	
VO_GILA_BOSS_24h_Male_Bogbeast_HeroPower_02	沼澤有許多秘密。	
VO_GILA_BOSS_24h_Male_Bogbeast_HeroPower_04	看看是什麼浮出來了。	
VO_GILA_BOSS_24h_Male_Bogbeast_Intro_01	這是我的沼澤！這裡只有死人。	
VO_GILA_BOSS_25h_Male_Dwarf_DefeatPlayerALT_01	哈嘉薩在懸賞你的人頭，我要去領錢了。	
VO_GILA_BOSS_25h_Male_Dwarf_EmoteResponse_01	你繼續放話、我繼續放陷阱。	
VO_GILA_BOSS_25h_Male_Dwarf_EventPlayCompass_01	這東西不錯。我也想要一個。	
VO_GILA_BOSS_25h_Male_Dwarf_EventPlaysSecret_01	我放你也放。	
VO_GILA_BOSS_25h_Male_Dwarf_EventPlaysSecret_02	這招我見識過了。	
VO_GILA_BOSS_25h_Male_Dwarf_EventPlaysSecret_03	你自以為很聰明嗎？	
VO_GILA_BOSS_25h_Male_Dwarf_EventPlayToolsOfTheTrade_01	喂！有幾把武器是我的。	
VO_GILA_BOSS_25h_Male_Dwarf_EventPlayTrapper_01	你的手法也太粗糙了。	
VO_GILA_BOSS_25h_Male_Dwarf_EventTokiAbility_01	地精，我說了別耍花招！	
VO_GILA_BOSS_25h_Male_Dwarf_HeroPower_01	當心腳步。	
VO_GILA_BOSS_25h_Male_Dwarf_HeroPower_02	腳步放慢，小心啊。	
VO_GILA_BOSS_25h_Male_Dwarf_HeroPower_03	我永遠比你快一步。	
VO_GILA_BOSS_25h_Male_Dwarf_HeroPower_04	步步危機啊。	
VO_GILA_BOSS_25h_Male_Dwarf_Intro_01	你的人頭很值錢啊。	
VO_GILA_BOSS_25h_Male_Dwarf_IntroDarius_01	克羅雷，帶了大砲就以為自己很大尾嗎？	
VO_GILA_BOSS_25h_Male_Dwarf_IntroShaw_01	我跟你不一樣，肖爾。我不會讓自己困在過去裡頭。	
VO_GILA_BOSS_25h_Male_Dwarf_IntroTess_02	你也在我的名單上，泰絲。然後下個就是你老爸！	
VO_GILA_BOSS_25h_Male_Dwarf_IntroToki_01	地精，你別想耍花招！	
VO_GILA_BOSS_26h_Male_Tauren_Death_01	我的…地精…	
VO_GILA_BOSS_26h_Male_Tauren_DeathToki_01	太諷刺了！	
VO_GILA_BOSS_26h_Male_Tauren_DefeatPlayer_01	你應該塞不進我的袋子。	
VO_GILA_BOSS_26h_Male_Tauren_DefeatPlayerToki_01	收集到稀有地精的感覺最讚了。	
VO_GILA_BOSS_26h_Male_Tauren_EmoteResponse_01	我不要分給你！	
VO_GILA_BOSS_26h_Male_Tauren_EmoteResponseToki_01	嗯…又是個話很多的…	
VO_GILA_BOSS_26h_Male_Tauren_EventBurgle_01	你那邊有什麼地精嗎？	
VO_GILA_BOSS_26h_Male_Tauren_EventBurgle_03	你的口袋有地精嗎？	
VO_GILA_BOSS_26h_Male_Tauren_EventPlayClockworkAssistant_01	那是被淘汰的次級品。	
VO_GILA_BOSS_26h_Male_Tauren_EventPlayGattlingGunner_01	那是從哪裡弄來的？	
VO_GILA_BOSS_26h_Male_Tauren_EventPlaysClockwork_02	舊的型號，這年頭很少見了。	
VO_GILA_BOSS_26h_Male_Tauren_EventPlaysGnome_01	那個我也有！…可是忘記放在哪了。	
VO_GILA_BOSS_26h_Male_Tauren_EventPlaysGnome_02	那個還挺罕見的！	
VO_GILA_BOSS_26h_Male_Tauren_EventPlaysGnome_05	你的品味不錯。	
VO_GILA_BOSS_26h_Male_Tauren_EventPlaysGnome_06	我要把那個加入我的收藏。	
VO_GILA_BOSS_26h_Male_Tauren_EventPlaysLeper_01	這傢伙有點黏黏的。	
VO_GILA_BOSS_26h_Male_Tauren_EventPlaysMillhouse_02	這個地精從來不閉嘴！	
VO_GILA_BOSS_26h_Male_Tauren_EventPlaysThermaplugg_02	最有價值的地精！	
VO_GILA_BOSS_26h_Male_Tauren_EventSackOfGnomes_01	我都忘記裡面有什麼了。	
VO_GILA_BOSS_26h_Male_Tauren_EventSackOfGnomes_03	太多了，多到數不清楚。	
VO_GILA_BOSS_26h_Male_Tauren_EventSackOfGnomes_04	看看裡面有些什麼…	
VO_GILA_BOSS_26h_Male_Tauren_EventSackOfGnomes_05	這些都是剩下的。	
VO_GILA_BOSS_26h_Male_Tauren_EventSilence_03	安靜…	
VO_GILA_BOSS_26h_Male_Tauren_Intro_02	你是要來搶我的地精嗎？	
VO_GILA_BOSS_26h_Male_Tauren_IntroToki_02	喔，又可以多一個收藏了…	
VO_GILA_BOSS_27h_Male_Construct_Death_02	我們…總算…解脫了…	
VO_GILA_BOSS_27h_Male_Construct_DefeatPlayer_01	你…不是我的目標！	
VO_GILA_BOSS_27h_Male_Construct_EmoteResponse_01	咦啊嘎…抱歉，有時候我會克制不住。	
VO_GILA_BOSS_27h_Male_Construct_EventPlayDrBoom_02	爆爆博士?!不要抓我回實驗室！	
VO_GILA_BOSS_27h_Male_Construct_EventPlaySparePart_01	實驗室…有很多…這種零件…	
VO_GILA_BOSS_27h_Male_Construct_EventPlayUnstablePortal_01	虛空風暴的…實驗室…	
VO_GILA_BOSS_27h_Male_Construct_HeroPowerBeast_02	…我體內有一頭野獸…	
VO_GILA_BOSS_27h_Male_Construct_HeroPowerDemon_01	…多麼的…黑暗…	
VO_GILA_BOSS_27h_Male_Construct_HeroPowerDragon_01	…多麼壯麗的生物…	
VO_GILA_BOSS_27h_Male_Construct_HeroPowerGeneric_01	…又一個…	
VO_GILA_BOSS_27h_Male_Construct_HeroPowerMech_02	…金屬的心臟！	
VO_GILA_BOSS_27h_Male_Construct_HeroPowerMurloc_01	…更多的魚…	
VO_GILA_BOSS_27h_Male_Construct_HeroPowerPirate_01	…呀兒？	
VO_GILA_BOSS_27h_Male_Construct_Intro_01	很高興嚇到你。	
VO_GILA_BOSS_29h_Female_Satyr_DefeatPlayer_01	這片森林有它自己的音樂。	
VO_GILA_BOSS_29h_Female_Satyr_EmoteResponse_01	你還真是直接呢。	
VO_GILA_BOSS_29h_Female_Satyr_EventPlaysEnchantingTune_01	我的音樂是不是很誘人啊？	
VO_GILA_BOSS_29h_Female_Satyr_EventPlaysEnchantingTune_02	大家不能都當好朋友嗎？	
VO_GILA_BOSS_29h_Female_Satyr_EventPlaysEnchantingTune_03	來坐我這邊嘛！我又不會咬人。	
VO_GILA_BOSS_29h_Female_Satyr_EventPlaysOldMilitiaHorn_01	要一起演奏嗎？	
VO_GILA_BOSS_29h_Female_Satyr_EventPlaysSmallMinion_01	好可愛的小傢伙！	
VO_GILA_BOSS_29h_Female_Satyr_EventPlaysSmallMinion_02	你簡直跟我一樣可愛！嗯…	
VO_GILA_BOSS_29h_Female_Satyr_EventPlaysSmallMinion_03	好想一口吃了你！	
VO_GILA_BOSS_29h_Female_Satyr_HeroPower_01	小傢伙，跟我來！	
VO_GILA_BOSS_29h_Female_Satyr_HeroPower_02	一二三！跟著我！	
VO_GILA_BOSS_29h_Female_Satyr_HeroPower_03	來這邊！來這邊！	
VO_GILA_BOSS_29h_Female_Satyr_HeroPower_04	跟著我的音樂走。	
VO_GILA_BOSS_29h_Female_Satyr_HeroPower_05	相信我！我會照顧你！	
VO_GILA_BOSS_29h_Female_Satyr_Intro_01	終於有觀眾了！	
VO_GILA_BOSS_30h_Female_Gnome_DefeatPlayer_01	親愛的，天下沒有白吃的蘋果。	
VO_GILA_BOSS_30h_Female_Gnome_EmoteResponse_01	喔，已經太遲了。	
VO_GILA_BOSS_30h_Female_Gnome_EventBloodMagic_01	多麼脆弱、多麼虛弱。	
VO_GILA_BOSS_30h_Female_Gnome_EventBloodMagic_02	來嘗一口。	
VO_GILA_BOSS_30h_Female_Gnome_EventBloodMagic_04	再會啦！	
VO_GILA_BOSS_30h_Female_Gnome_EventBloodMagic_05	我的魔法，對誰都一樣。	
VO_GILA_BOSS_30h_Female_Gnome_EventBloodMagic_06	好吃吧？	
VO_GILA_BOSS_30h_Female_Gnome_Intro_01	要不要嘗一口啊？	
VO_GILA_BOSS_31h_Male_Treant_Death_01	*慘叫*	
VO_GILA_BOSS_31h_Male_Treant_DefeatPlayer_01	小小螞蟻，別想上樹。	
VO_GILA_BOSS_31h_Male_Treant_Emote Response_01	假如一棵樹在森林中打倒你，你會不會發出噪音？	
VO_GILA_BOSS_31h_Male_Treant_HeroPower_01	枝葉繁茂。	
VO_GILA_BOSS_31h_Male_Treant_HeroPower_02	開枝散葉。	
VO_GILA_BOSS_31h_Male_Treant_HeroPower_03	上吧，小樹苗。	
VO_GILA_BOSS_31h_Male_Treant_HeroPower_05	我的分枝。	
VO_GILA_BOSS_31h_Male_Treant_Intro_01	離開這裡，葉快葉好。	
VO_GILA_BOSS_32h_Female_Sprite_Death_01	不...好...玩！	
VO_GILA_BOSS_32h_Female_Sprite_DefeatPlayer_01	唉呦，我們再來玩嘛！哦喔…好吧…	
VO_GILA_BOSS_32h_Female_Sprite_EmoteResponse_01	好啦好啦，那個我們等一下再玩！	
VO_GILA_BOSS_32h_Female_Sprite_EventPlaysAoEBuff_01	你很會玩嘛！	
VO_GILA_BOSS_32h_Female_Sprite_EventPlaysAoEBuff_02	喔，你知道怎麼玩！	
VO_GILA_BOSS_32h_Female_Sprite_EventPlaysBigMinion_01	哇！你作弊！	
VO_GILA_BOSS_32h_Female_Sprite_EventPlaysBigMinion_02	哇！	
VO_GILA_BOSS_32h_Female_Sprite_HeroPower_01	快快長大！	
VO_GILA_BOSS_32h_Female_Sprite_HeroPower_02	快點！變大啊！	
VO_GILA_BOSS_32h_Female_Sprite_HeroPower_03	長高高！長高高！	
VO_GILA_BOSS_32h_Female_Sprite_HeroPower_04	哈哈，我覺得我快要贏了！	
VO_GILA_BOSS_32h_Female_Sprite_Intro_01	要來玩遊戲嗎？	
VO_GILA_BOSS_33h_Male_Mech_Attack_01	攻擊。	
VO_GILA_BOSS_33h_Male_Mech_Death_01	磁區…毀損…	
VO_GILA_BOSS_33h_Male_Mech_DefeatPlayer_01	錯誤：無剩餘目標。繼續巡邏。	
VO_GILA_BOSS_33h_Male_Mech_EmoteResponse_01	鐮刀說你好。	
VO_GILA_BOSS_33h_Male_Mech_EventPlayHarvestGolem_01	警告：目標無靈魂反應。	
VO_GILA_BOSS_33h_Male_Mech_EventWeaponKill_01	已收割。	
VO_GILA_BOSS_33h_Male_Mech_EventWeaponKill_02	升級。	
VO_GILA_BOSS_33h_Male_Mech_EventWeaponKill_03	已刪除。	
VO_GILA_BOSS_33h_Male_Mech_HeroPower_01	收割。	
VO_GILA_BOSS_33h_Male_Mech_HeroPower_02	充能。	
VO_GILA_BOSS_33h_Male_Mech_HeroPower_03	補充。	
VO_GILA_BOSS_33h_Male_Mech_HeroPower_04	循環。	
VO_GILA_BOSS_33h_Male_Mech_Intro_01	準備。開始。收割。	
VO_GILA_BOSS_34h_Male_Demon_DefeatPlayer_01	你的靈魂相當…強大。夠我享用幾個禮拜。	
VO_GILA_BOSS_34h_Male_Demon_EmoteResponse_01	希望你的靈魂不會這麼…囉嗦。	
VO_GILA_BOSS_34h_Male_Demon_HeroPower_01	太美味了。	
VO_GILA_BOSS_34h_Male_Demon_HeroPower_02	美味可口。	
VO_GILA_BOSS_34h_Male_Demon_HeroPower_03	你的臉色有點蒼白。	
VO_GILA_BOSS_34h_Male_Demon_HeroPower_04	讓我來減輕你的負擔。	
VO_GILA_BOSS_34h_Male_Demon_HeroPower_05	靈魂只是無用的負擔。	
VO_GILA_BOSS_34h_Male_Demon_Intro_01	很快，你就會變成一具空殼。	
VO_GILA_BOSS_35h_Male_Beast_DefeatPlayer	*吼聲*	
VO_GILA_BOSS_35h_Male_Beast_EmoteResponse	*吼聲*	
VO_GILA_BOSS_35h_Male_Beast_Intro	*吼聲*	
VO_GILA_BOSS_36h_Female_Human_Death_01	喔…嗚…呱呱！	
VO_GILA_BOSS_36h_Female_Human_DefeatPlayer_01	你顯然不是我的王子！	
VO_GILA_BOSS_36h_Female_Human_Emote Response_01	別廢話，快把嘴巴嘟起來。	
VO_GILA_BOSS_36h_Female_Human_EventHex_01	喔！真是太…迷人了！	
VO_GILA_BOSS_36h_Female_Human_EventHex_02	親愛的，我很清楚那是什麼感覺。	
VO_GILA_BOSS_36h_Female_Human_HeroPower_01	*親吻*	
VO_GILA_BOSS_36h_Female_Human_HeroPower_02	*親吻*	
VO_GILA_BOSS_36h_Female_Human_HeroPower_03	*親吻*	
VO_GILA_BOSS_36h_Female_Human_Intro_01	喔拜託，別再來了。	
VO_GILA_BOSS_37h_Male_Murloc_DefeatPlayer_01	...	
VO_GILA_BOSS_37h_Male_Murloc_EmoteResponse_01	…!	
VO_GILA_BOSS_37h_Male_Murloc_EventPlayMurlocHolmes_02	…? …!	
VO_GILA_BOSS_37h_Male_Murloc_EventPlayPlague_01	…!	
VO_GILA_BOSS_37h_Male_Murloc_EventPlayPlague_02	…!	
VO_GILA_BOSS_37h_Male_Murloc_EventPlayPlague_07	…!	
VO_GILA_BOSS_37h_Male_Murloc_HeroPower_01	…	
VO_GILA_BOSS_37h_Male_Murloc_HeroPower_02	…	
VO_GILA_BOSS_37h_Male_Murloc_HeroPower_03	…!	
VO_GILA_BOSS_37h_Male_Murloc_HeroPower_04	…	
VO_GILA_BOSS_37h_Male_Murloc_Intro_01	…	
VO_GILA_BOSS_38h_Male_Goblin_Death_01	永不...再會！	
VO_GILA_BOSS_38h_Male_Goblin_DefeatPlayer_01	烏鴉如是說。*嘎！*	
VO_GILA_BOSS_38h_Male_Goblin_EmoteResponse_01	你的鳥叫學得真爛。	
VO_GILA_BOSS_38h_Male_Goblin_EventBirdDead_01	你…你這沒良心的！	
VO_GILA_BOSS_38h_Male_Goblin_EventBirdDead_02	他們又沒有惹到你！	
VO_GILA_BOSS_38h_Male_Goblin_EventBirdDead_03	為什麼？他們只是鳥兒啊！	
VO_GILA_BOSS_38h_Male_Goblin_EventPlayBird_01	自由的飛翔吧！	
VO_GILA_BOSS_38h_Male_Goblin_EventPlayBird_02	看你鳥不鳥我！	
VO_GILA_BOSS_38h_Male_Goblin_EventPlayBird_03	啊，鳥兒乖乖。	
VO_GILA_BOSS_38h_Male_Goblin_EventPlayBird_04	有時候，我希望自己是一隻小小鳥。	
VO_GILA_BOSS_38h_Male_Goblin_EventPlayerPlayBird_01	這隻鳥不錯喔。	
VO_GILA_BOSS_38h_Male_Goblin_EventPlayerPlayBird_02	我為鳥兒戰鬥！	
VO_GILA_BOSS_38h_Male_Goblin_EventPlayNestingRoc_01	我…原本不是要叫這隻。	
VO_GILA_BOSS_38h_Male_Goblin_EventPlayNestingRoc_02	啊…差不多啦。	
VO_GILA_BOSS_38h_Male_Goblin_HeroPower_01	嘎！嘎！	
VO_GILA_BOSS_38h_Male_Goblin_HeroPower_02	嘎！…咳…咳…咳！	
VO_GILA_BOSS_38h_Male_Goblin_HeroPower_03	嘎！嘎！嘎！	
VO_GILA_BOSS_38h_Male_Goblin_Intro_01	要飛，還是要打？不如邊飛邊打！	
VO_GILA_BOSS_40h_Female_Treant_Death_01	樹…倒了…	
VO_GILA_BOSS_40h_Female_Treant_DefeatPlayer_01	來一個倒一個…我要收割了。	
VO_GILA_BOSS_40h_Female_Treant_EmoteResponse_01	砍。砍。	
VO_GILA_BOSS_40h_Female_Treant_EventPlaysAxe_01	多少同胞，在最壯盛的時候倒下…	
VO_GILA_BOSS_40h_Female_Treant_EventPlaysAxe_02	我的同胞還要受多少的苦？	
VO_GILA_BOSS_40h_Female_Treant_EventPlaysWoodsmansAxe_01	太可惡了！	
VO_GILA_BOSS_40h_Female_Treant_HeroPower_01	森林會吞噬他們。	
VO_GILA_BOSS_40h_Female_Treant_HeroPower_02	這片森林是活的。	
VO_GILA_BOSS_40h_Female_Treant_HeroPower_03	來吧，我們的時候到了。	
VO_GILA_BOSS_40h_Female_Treant_HeroPower_04	讓你知道我們的怨恨。	
VO_GILA_BOSS_40h_Female_Treant_Intro_01	你們要付出代價。	
VO_GILA_BOSS_41h_Female_HumanGhost_Death_01	親愛的…	
VO_GILA_BOSS_41h_Female_HumanGhost_DefeatPlayer_01	沒有人可以拆散我們。	
VO_GILA_BOSS_41h_Female_HumanGhost_EmoteResponse_01	不要打擾我們。	
VO_GILA_BOSS_41h_Female_HumanGhost_EventFatigue_01	親愛的…你去哪裡了？	
VO_GILA_BOSS_41h_Female_HumanGhost_EventFatigue_02	我感覺不到他的存在…	
VO_GILA_BOSS_41h_Female_HumanGhost_EventFatigueDeath_01	我們…終於自由了？謝謝你！	
VO_GILA_BOSS_41h_Female_HumanGhost_EventPlayRin_01	她會是…讓我們解脫的人嗎？	
VO_GILA_BOSS_41h_Female_HumanGhost_EventShuffle_01	你了解…我們的痛苦…是嗎？	
VO_GILA_BOSS_41h_Female_HumanGhost_EventShuffle_02	至死…不渝…	
VO_GILA_BOSS_41h_Female_HumanGhost_EventShuffle_03	你就跟我們一樣。	
VO_GILA_BOSS_41h_Female_HumanGhost_HeroPower_01	永不…分離…	
VO_GILA_BOSS_41h_Female_HumanGhost_HeroPower_02	回到我身邊！	
VO_GILA_BOSS_41h_Female_HumanGhost_HeroPower_03	不要走…	
VO_GILA_BOSS_41h_Female_HumanGhost_HeroPower_04	我要把你留在身邊。	
VO_GILA_BOSS_41h_Female_HumanGhost_Intro_01	親愛的，我們很快就要相見了。	
VO_GILA_BOSS_41h_Male_NightElf_Death_01	不…	
VO_GILA_BOSS_41h_Male_NightElf_DefeatPlayer_01	黑巫森林不需要你。	
VO_GILA_BOSS_41h_Male_NightElf_EmoteResponse_02	你的話動搖不了我。	
VO_GILA_BOSS_41h_Male_NightElf_EventHack_01	受苦吧！	
VO_GILA_BOSS_41h_Male_NightElf_EventHack_02	復仇！	
VO_GILA_BOSS_41h_Male_NightElf_EventHack_03	離開…這座…森林！	
VO_GILA_BOSS_41h_Male_NightElf_HeroPower_01	適者生存！	
VO_GILA_BOSS_41h_Male_NightElf_HeroPower_02	藤蔓與樹根啊！	
VO_GILA_BOSS_41h_Male_NightElf_HeroPower_03	來看看你的力量！	
VO_GILA_BOSS_41h_Male_NightElf_HeroPower_04	全面攻擊！	
VO_GILA_BOSS_41h_Male_NightElf_Intro_01	回頭吧，入侵者。	
VO_GILA_BOSS_42h_Male_Ogre_DefeatPlayer_01	你看不到結果，我也看不到。	
VO_GILA_BOSS_42h_Male_Ogre_EmoteResponse_01	你再講話！我就再踩！	
VO_GILA_BOSS_42h_Male_Ogre_EventHeroPowerEnemy_01	撞死你！	
VO_GILA_BOSS_42h_Male_Ogre_EventHeroPowerEnemy_02	我撞！	
VO_GILA_BOSS_42h_Male_Ogre_EventHeroPowerEnemy_03	我絕對不會失手！	
VO_GILA_BOSS_42h_Male_Ogre_EventHeroPowerFriendly_01	喔，好像撞錯了。	
VO_GILA_BOSS_42h_Male_Ogre_EventHeroPowerFriendly_02	好像撞壞東西了。	
VO_GILA_BOSS_42h_Male_Ogre_Intro_01	是誰？我聞到你的味道了！	
VO_GILA_BOSS_43h_Male_HumanGhost_DefeatPlayer_01	唉…又要挖墳了。	
VO_GILA_BOSS_43h_Male_HumanGhost_EmoteResponse_01	趕快…離開…	
VO_GILA_BOSS_43h_Male_HumanGhost_EventPlaysDeathrattle_01	死亡的聲音啊。	
VO_GILA_BOSS_43h_Male_HumanGhost_EventPlaysDeathrattle_02	死者有故事要說。	
VO_GILA_BOSS_43h_Male_HumanGhost_EventPlaysDeathrattle_03	我們其實沒差多少。	
VO_GILA_BOSS_43h_Male_HumanGhost_EventPlaysDeathrattle_04	進去吧…安息吧…	
VO_GILA_BOSS_43h_Male_HumanGhost_EventPlaysDeathrattle_05	不用幫它挖太深。	
VO_GILA_BOSS_43h_Male_HumanGhost_EventPlayStrokeOfMidnight_01	多麼懷念的鐘聲啊…	
VO_GILA_BOSS_43h_Male_HumanGhost_Intro_01	你不該這麼晚還待在外頭。	
VO_GILA_BOSS_44h_Male_Troll_Death_01	呃啊…	
VO_GILA_BOSS_44h_Male_Troll_DefeatPlayer_02	藥到命除！	
VO_GILA_BOSS_44h_Male_Troll_EmoteResponse_01	醫生說的永遠是對的。	
VO_GILA_BOSS_44h_Male_Troll_EventHeals_01	啊…	
VO_GILA_BOSS_44h_Male_Troll_EventHeals_02	啊…這次的很純…	
VO_GILA_BOSS_44h_Male_Troll_EventHeals_04	哈哈哈哈！嗯…	
VO_GILA_BOSS_44h_Male_Troll_EventPlayerHeals_03	嘿，你根本就做錯了。	
VO_GILA_BOSS_44h_Male_Troll_EventPlayerHeals_04	讓我來幫你啦。	
VO_GILA_BOSS_44h_Male_Troll_EventPlaysBandages_01	那批貨品質不錯啊。	
VO_GILA_BOSS_44h_Male_Troll_HeroPower_01	像蚊子叮一下而已。	
VO_GILA_BOSS_44h_Male_Troll_HeroPower_02	你怕打針嗎？	
VO_GILA_BOSS_44h_Male_Troll_HeroPower_03	快速、無痛…通常啦。	
VO_GILA_BOSS_44h_Male_Troll_HeroPower_04	什麼巫醫？哎～我是有照的。	
VO_GILA_BOSS_44h_Male_Troll_HeroPower_05	感覺還好吧？	
VO_GILA_BOSS_44h_Male_Troll_HeroPower_06	可能會有點痛喔。	
VO_GILA_BOSS_44h_Male_Troll_Intro_01	來，坐吧！告訴我你想要哪裡痛。	
VO_GILA_BOSS_45h_Female_Human_Death_02	*慘叫*	
VO_GILA_BOSS_45h_Female_Human_DefeatPlayer_01	你要是來當信眾會很有前途啊。	
VO_GILA_BOSS_45h_Female_Human_EmoteResponse_01	我們可以好好聊一聊。邊喝邊聊。	
VO_GILA_BOSS_45h_Female_Human_EventDrawsExtraCards_01	對！喝吧！	
VO_GILA_BOSS_45h_Female_Human_EventDrawsExtraCards_02	好喝嗎？	
VO_GILA_BOSS_45h_Female_Human_EventDrawsExtraCards_03	大口喝，繼續喝。	
VO_GILA_BOSS_45h_Female_Human_EventFirstDamage_01	你...不想加入嗎？	
VO_GILA_BOSS_45h_Female_Human_EventPlayHallowedWater_01	聖水？呃…那個味道真的有夠難喝的。	
VO_GILA_BOSS_45h_Female_Human_EventPlaysAcolyte_01	喔...我喜歡他。	
VO_GILA_BOSS_45h_Female_Human_EventPlaysHoarder_01	你可以等他走了再喝。	
VO_GILA_BOSS_45h_Female_Human_EventPlaysNovice_01	有新人來了。敬她一杯！	
VO_GILA_BOSS_45h_Female_Human_Intro_01	放下武器，加入我們。	
VO_GILA_BOSS_46h_Male_Worgen_DefeatPlayer_01	只有強者能夠生存。	
VO_GILA_BOSS_46h_Male_Worgen_EmoteResponse_01	你聞到了嗎？恐懼的味道。	
VO_GILA_BOSS_46h_Male_Worgen_EventPlayBloodMoon_01	啊嗚嗚嗚！	
VO_GILA_BOSS_46h_Male_Worgen_EventPlaysWorgen_01	沒用的東西。	
VO_GILA_BOSS_46h_Male_Worgen_EventPlaysWorgen_03	沒用的東西。	
VO_GILA_BOSS_46h_Male_Worgen_EventPlaysWorgen_06	你這個廢物。	
VO_GILA_BOSS_46h_Male_Worgen_EventPlayTrapper_02	面對你的怒火！	
VO_GILA_BOSS_46h_Male_Worgen_Intro_01	你還在獵殺我？	
VO_GILA_BOSS_47h_Male_Monster_Death_01	我的戲份...結束了！	
VO_GILA_BOSS_47h_Male_Monster_DefeatPlayer_01	英雄吞下肚，森林更恐怖～	
VO_GILA_BOSS_47h_Male_Monster_EmoteResponse_01	嘻嘻笑，咩咩叫！弱到爆，快點逃！	
VO_GILA_BOSS_47h_Male_Monster_HeroPower_01	加倍又加倍！	
VO_GILA_BOSS_47h_Male_Monster_HeroPower_02	代價付兩次，第一次、第二次！	
VO_GILA_BOSS_47h_Male_Monster_HeroPower_03	見面，再會。等等，再一遍。	
VO_GILA_BOSS_47h_Male_Monster_IntroALT_01	是誰來笑笑的哮斗龍咆哮的地方？	
VO_GILA_BOSS_48h_Female_Gnome_Death_01	你會害慘你自己的！	
VO_GILA_BOSS_48h_Female_Gnome_DefeatPlayer_01	總算把「我」給解決掉了。等等，是不是有點矛盾？	
VO_GILA_BOSS_48h_Female_Gnome_EmoteResponse_01	我就知道我會那樣說。	
VO_GILA_BOSS_48h_Female_Gnome_EventAlt_01	不對！我們再來一次。	
VO_GILA_BOSS_48h_Female_Gnome_EventAlt_02	我覺得事情應該是…這樣才對！	
VO_GILA_BOSS_48h_Female_Gnome_EventAlt_03	停止！開始倒帶！	
VO_GILA_BOSS_48h_Female_Gnome_EventPlayerAltTime_01	呃…這倒是第一次。	
VO_GILA_BOSS_48h_Female_Gnome_EventPlayerAltTime_02	哇，我們真的把時間線弄得超亂的。	
VO_GILA_BOSS_48h_Female_Gnome_EventPlayerTimeWarp_01	真的快昏頭了。	
VO_GILA_BOSS_48h_Female_Gnome_EventPlayerTimeWarp_02	提醒自己：避開這一戰。	
VO_GILA_BOSS_48h_Female_Gnome_EventPlayerTimeWarpToki_01	等等，你應該還不會才對！	
VO_GILA_BOSS_48h_Female_Gnome_EventPlayerTimeWarpToki_02	這邊我有印象！我上次有做過！	
VO_GILA_BOSS_48h_Female_Gnome_EventTimeWarp_01	再過幾年你就會學到這招了。	
VO_GILA_BOSS_48h_Female_Gnome_EventTimeWarp_02	費了好大功夫才想出這招。	
VO_GILA_BOSS_48h_Female_Gnome_EventTurn2_01	我一定要阻止我！趁我還有機會的時候！	
VO_GILA_BOSS_48h_Female_Gnome_EventTurn4_01	你絕對贏不了的！我知道我自己的所有招數！	
VO_GILA_BOSS_48h_Female_Gnome_EventTurn6_01	我們都很後悔你要做的事情。除非我先阻止你！	
VO_GILA_BOSS_48h_Female_Gnome_HeroPower_01	準備加速囉！	
VO_GILA_BOSS_48h_Female_Gnome_HeroPower_02	滴答滴答！	
VO_GILA_BOSS_48h_Female_Gnome_HeroPower_03	來做個了結吧。	
VO_GILA_BOSS_48h_Female_Gnome_Intro_01	啊，我們又見面了！這是第一次！	
VO_GILA_BOSS_48h_Female_Gnome_Intro_02	又是我？這是我們第二次交手了。	
VO_GILA_BOSS_48h_Female_Gnome_Intro_03	這是我們第三次交手了。放棄吧！	
VO_GILA_BOSS_48h_Female_Gnome_Intro_04	不要…一直回來煩我！拜託！	
VO_GILA_BOSS_48h_Female_Gnome_Intro_05	我們到底得耗在一起多少次啊?!	
VO_GILA_BOSS_48h_Female_Gnome_PlayerHeroPower_01	我以前怎麼會覺得那是好主意呢？	
VO_GILA_BOSS_48h_Female_Gnome_PlayerHeroPower_02	我以前還以為自己很聰明呢。	
VO_GILA_BOSS_48h_Female_Gnome_PlayerHeroPower_03	別又來了！	
VO_GILA_BOSS_48h_Female_Gnome_PlayerHeroPower_04	我真的受不了了。	
VO_GILA_BOSS_49h_Female_Undead_Death_01	腐爛的…心臟	
VO_GILA_BOSS_49h_Female_Undead_DefeatPlayer_01	要是加入我們你就不會死了…	
VO_GILA_BOSS_49h_Female_Undead_EmoteResponse_01	加入我們吧。每個星期五吃飯都不用錢！	
VO_GILA_BOSS_49h_Female_Undead_EventFaithfulDies_01	我需要那個傢伙！	
VO_GILA_BOSS_49h_Female_Undead_EventFaithfulDies_02	好幫手真是難心控。	
VO_GILA_BOSS_49h_Female_Undead_EventFaithfulDies_03	我不會忘記你的…不過你叫什麼名字？	
VO_GILA_BOSS_49h_Female_Undead_EventPact_01	加入我們…	
VO_GILA_BOSS_49h_Female_Undead_EventPact_02	又多了一位信徒！	
VO_GILA_BOSS_49h_Female_Undead_EventPact_03	過來我這裡… 很好…	
VO_GILA_BOSS_49h_Female_Undead_EventPact_05	我的信眾越來越多了。	
VO_GILA_BOSS_49h_Female_Undead_EventPlayBird_01	寧神花棘毒蜂刺，蜥蜴之足幼鴞翅。	
VO_GILA_BOSS_49h_Female_Undead_EventPlayCauldron_01	加倍加倍勞又累，熾熱烈火大鍋沸。	
VO_GILA_BOSS_49h_Female_Undead_EventPlayDragon_01	狼牙龍鱗要準備，地根草莖燉入味。	
VO_GILA_BOSS_49h_Female_Undead_EventPlayFaithful_01	孩子們，來啊。	
VO_GILA_BOSS_49h_Female_Undead_EventPlayFaithful_02	忠誠的信徒，現身吧…	
VO_GILA_BOSS_49h_Female_Undead_EventPlayFaithful_03	把你們的生命獻給我。	
VO_GILA_BOSS_49h_Female_Undead_EventPlayFaithful_04	忠心的追隨者啊！	
VO_GILA_BOSS_49h_Female_Undead_EventPlayFaithful_05	服侍我最後一次！	
VO_GILA_BOSS_49h_Female_Undead_EventPlayHex_01	青蛙之趾蠑螈目，蝙蝠之毛霧之觸。	
VO_GILA_BOSS_49h_Female_Undead_EventPlaySnake_01	猛烈毒蛇取其肉，滾燙大鍋煮至熟。	
VO_GILA_BOSS_49h_Female_Undead_EventPlayTreant_01	腐朽樹枝來攪拌，魔咒效果有夠讚。	
VO_GILA_BOSS_49h_Female_Undead_EventTurn02_01	要是你了解她的力量，肖爾，你也會像狗一樣搖尾乞憐。	
VO_GILA_BOSS_49h_Female_Undead_Intro_02	是你在找我，還是我讓你上鉤？	
VO_GILA_BOSS_50h_Male_Spirit_DefeatPlayer_01	寧願燃燒殆盡，也不緩緩消失…	
VO_GILA_BOSS_50h_Male_Spirit_EmoteResponse_01	呼吸…	
VO_GILA_BOSS_50h_Male_Spirit_EventPlaysEcho_01	好啊…	
VO_GILA_BOSS_50h_Male_Spirit_EventPlaysEcho_02	再來… 	
VO_GILA_BOSS_50h_Male_Spirit_EventPlaysEcho_03	還有…！ 	
VO_GILA_BOSS_50h_Male_Spirit_EventPlaysEcho_04	哼哼哈哈哈哈…	
VO_GILA_BOSS_50h_Male_Spirit_Intro_01	迷霧在呼喚…	
VO_GILA_BOSS_51h_Male_Undead_Death_01	呃啊！	
VO_GILA_BOSS_51h_Male_Undead_DefeatPlayer_01	喔！看來你是用不到這些錢了。	
VO_GILA_BOSS_51h_Male_Undead_EmoteResponse_01	給我閉嘴！	
VO_GILA_BOSS_51h_Male_Undead_EventPlayCoinPouch_01	快點，把錢給我。	
VO_GILA_BOSS_51h_Male_Undead_EventPlayMinion_01	嘿！那可是要抽稅的。	
VO_GILA_BOSS_51h_Male_Undead_EventPlayMinion_03	你有很多稅要交！	
VO_GILA_BOSS_51h_Male_Undead_EventPlayMinion_04	準備付錢吧，你跑不掉的。	
VO_GILA_BOSS_51h_Male_Undead_HeroPower_01	杯水車薪啊。	
VO_GILA_BOSS_51h_Male_Undead_HeroPower_02	欠債還錢。	
VO_GILA_BOSS_51h_Male_Undead_HeroPower_03	只是一點小錢而已。	
VO_GILA_BOSS_51h_Male_Undead_HeroPower_04	掏空、你的、口袋。	
VO_GILA_BOSS_51h_Male_Undead_Intro_01	你是不是還欠我錢啊。	
VO_GILA_BOSS_52h_Male_Human_DefeatPlayerALT_02	別想送我回監獄！門都沒有！	
VO_GILA_BOSS_52h_Male_Human_EmoteResponse_02	底下全都是煙灰而已啦…	
VO_GILA_BOSS_52h_Male_Human_EventPlayRoyalGift_02	嗚，真漂亮！要送我我也不介意喔。	
VO_GILA_BOSS_52h_Male_Human_EventPlayStealth_02	雙重標準！ 	
VO_GILA_BOSS_52h_Male_Human_EventPlayStealth_03	哼！你就可以潛行，啊我就是小偷。	
VO_GILA_BOSS_52h_Male_Human_EventTransform_01	你真的把我給惹毛了。	
VO_GILA_BOSS_52h_Male_Human_HeroPower_01	看不見！	
VO_GILA_BOSS_52h_Male_Human_HeroPower_02	我發誓，我沒有偷偷摸摸！	
VO_GILA_BOSS_52h_Male_Human_HeroPower_03	看我的城市迷彩！	
VO_GILA_BOSS_52h_Male_Human_HeroPower_04	只是抹上煤灰而已。	
VO_GILA_BOSS_52h_Male_Human_HeroPower_05	來塗點煤灰！	
VO_GILA_BOSS_52h_Male_Human_IntroALT_02	小偷?!我？喔拜託…	
VO_GILA_BOSS_52h2_Male_Worgen_EmoteResponse_02	你看這都是你逼我的！	
VO_GILA_BOSS_52h2_Male_Worgen_HeroPower_01	啊嗚嗚嗚！	
VO_GILA_BOSS_52h2_Male_Worgen_HeroPower_02	解決他們！	
VO_GILA_BOSS_52h2_Male_Worgen_HeroPower_03	釋放心中的野獸！	
VO_GILA_BOSS_54h_Male_Golem_DefeatPlayer_01	弄彎，折斷。敲開，打碎。	
VO_GILA_BOSS_54h_Male_Golem_EmoteResponse_01	樹木和石頭…才不管你…	
VO_GILA_BOSS_54h_Male_Golem_HeroPower_01	合而為一…	
VO_GILA_BOSS_54h_Male_Golem_HeroPower_02	黑巫森林的詛咒會擴散…	
VO_GILA_BOSS_54h_Male_Golem_HeroPower_03	夷為平地、播下種子。	
VO_GILA_BOSS_54h_Male_Golem_HeroPower_04	哈嘉薩的擁抱，讓我們更強壯。	
VO_GILA_BOSS_54h_Male_Golem_HeroPower_05	貫徹哈嘉薩的命令。	
VO_GILA_BOSS_54h_Male_Golem_Intro_01	滾動的石頭...不長青苔。	
VO_GILA_BOSS_55h_Female_NightElf_Death_01	誰...來拯救他們…？	
VO_GILA_BOSS_55h_Female_NightElf_DefeatPlayer_01	別哭…我會把你的靈魂送到安全的地方…	
VO_GILA_BOSS_55h_Female_NightElf_EmoteResponse_01	噓…不要那麼大聲！	
VO_GILA_BOSS_55h_Female_NightElf_EventAssimilation_01	你的…就是我的！	
VO_GILA_BOSS_55h_Female_NightElf_EventAssimilation_02	把他們的身體搶過來！	
VO_GILA_BOSS_55h_Female_NightElf_EventAssimilation_03	機會來了！	
VO_GILA_BOSS_55h_Female_NightElf_EventKillsWisp_02	不要！	
VO_GILA_BOSS_55h_Female_NightElf_EventKillsWisp_03	住手！	
VO_GILA_BOSS_55h_Female_NightElf_EventKillsWisp_04	我的孩子！	
VO_GILA_BOSS_55h_Female_NightElf_EventPlayCartographer_01	畫地圖的！她一定知道離開的路！	
VO_GILA_BOSS_55h_Female_NightElf_EventPlayCompass_01	說不定那可以幫我們找到離開的路！	
VO_GILA_BOSS_55h_Female_NightElf_HeroPower_01	孩子們，來啊。	
VO_GILA_BOSS_55h_Female_NightElf_HeroPower_02	啊…你們在這裡。	
VO_GILA_BOSS_55h_Female_NightElf_HeroPower_03	快點出來、快點出來…	
VO_GILA_BOSS_55h_Female_NightElf_Intro_01	哈嘉薩的詛咒會吞噬一切。我必須拯救我的孩子。	
VO_GILA_BOSS_56h_Male_Elemental_DefeatPlayer_01	你的臉為何如此哀傷呢？	
VO_GILA_BOSS_56h_Male_Elemental_EmoteResponse_01	我也正想這麼說。	
VO_GILA_BOSS_56h_Male_Elemental_EventTransformFace_02	完美的面具。	
VO_GILA_BOSS_56h_Male_Elemental_HeroPower_01	新的面具、新的臉孔。	
VO_GILA_BOSS_56h_Male_Elemental_HeroPower_02	新的臉孔、新的人物。	
VO_GILA_BOSS_56h_Male_Elemental_HeroPower_03	新的人物、新的生命。	
VO_GILA_BOSS_56h_Male_Elemental_HeroPower_05	不斷改變、不斷變換。	
VO_GILA_BOSS_56h_Male_Elemental_HeroPower_07	我們合為一體，我們就是全部。	
VO_GILA_BOSS_56h_Male_Elemental_HeroPower_09	你還記得，自己是誰嗎？	
VO_GILA_BOSS_56h_Male_Elemental_HeroPower_10	你只需要一個面具。	
VO_GILA_BOSS_56h_Male_Elemental_IntroALT_02	你和我，其實差別並不大。	
VO_GILA_BOSS_57h_Male_Undead_DefeatPlayer_01	時間一到，你會再回來的。	
VO_GILA_BOSS_57h_Male_Undead_EmoteResponse_01	我會向黑暗女王轉達你的致意。	
VO_GILA_BOSS_57h_Male_Undead_EventDesecrate_01	讓疫病帶走你。	
VO_GILA_BOSS_57h_Male_Undead_EventDesecrate_02	又一個踏進了墳墓。	
VO_GILA_BOSS_57h_Male_Undead_EventDesecrate_03	它會傳染。	
VO_GILA_BOSS_57h_Male_Undead_EventDesecrate_04	你很快就會加入他們。	
VO_GILA_BOSS_57h_Male_Undead_EventPlayHolyBook_01	就算念經也救不了你！	
VO_GILA_BOSS_57h_Male_Undead_EventShallowGraves_01	起來吧！	
VO_GILA_BOSS_57h_Male_Undead_EventShallowGraves_02	回來吧！	
VO_GILA_BOSS_57h_Male_Undead_EventShallowGraves_03	黑暗女王在呼喚你們！	
VO_GILA_BOSS_57h_Male_Undead_HeroPower_01	褻瀆。	
VO_GILA_BOSS_57h_Male_Undead_HeroPower_02	感染。	
VO_GILA_BOSS_57h_Male_Undead_HeroPower_03	大口吸。	
VO_GILA_BOSS_57h_Male_Undead_HeroPower_04	腐化會擴散。	
VO_GILA_BOSS_57h_Male_Undead_Intro_01	歡迎！來看看我挖出了什麼好東西。	
VO_GILA_BOSS_58h_Male_Giant_Death_01	呃啊…	
VO_GILA_BOSS_58h_Male_Giant_DefeatPlayer_01	好棒的小鎮！我要踩囉！	
VO_GILA_BOSS_58h_Male_Giant_DefeatPlayer_02	我要進城踩街囉！	
VO_GILA_BOSS_58h_Male_Giant_EmoteResponse_01	我要踩扁你！	
VO_GILA_BOSS_58h_Male_Giant_EventBigWeapon_01	你也要來拆房子？	
VO_GILA_BOSS_58h_Male_Giant_EventMinionReturn_01	找到你了！	
VO_GILA_BOSS_58h_Male_Giant_EventMinionReturn_02	你跑回來了！	
VO_GILA_BOSS_58h_Male_Giant_EventMinionReturn_03	嗨，又見面啦。	
VO_GILA_BOSS_58h_Male_Giant_HeroPower_01	快逃吧！	
VO_GILA_BOSS_58h_Male_Giant_HeroPower_02	呃…嗚！	
VO_GILA_BOSS_58h_Male_Giant_HeroPower_03	呵呵，你躲到哪裡去啦？	
VO_GILA_BOSS_58h_Male_Giant_HeroPower_04	呵呵-嘻-哈！	
VO_GILA_BOSS_58h_Male_Giant_HeroPower_05	你可以逃，不過你躲…起來了？	
VO_GILA_BOSS_58h_Male_Giant_Intro_01	好啊！通通打爛！	
VO_GILA_BOSS_59h_Male_Undead_DefeatPlayer_01	哼，你不過是個可悲的雜種。	
VO_GILA_BOSS_59h_Male_Undead_DefeatPlayer_02	再見了，老朋友。	
VO_GILA_BOSS_59h_Male_Undead_DefeatPlayer_03	這就是派來殺我的刺客？太可笑了。	
VO_GILA_BOSS_59h_Male_Undead_EmoteResponse_01	我帶槍你拿砲，到底誰才是懦夫？	
VO_GILA_BOSS_59h_Male_Undead_EventDeadlyShot_01	正中紅心！	
VO_GILA_BOSS_59h_Male_Undead_EventDeadlyShot_02	怎麼？我是給他一個痛快啊。	
VO_GILA_BOSS_59h_Male_Undead_EventQuickShot_01	我會的招式可多著呢。	
VO_GILA_BOSS_59h_Male_Undead_EventQuickShot_02	拔槍吧！	
VO_GILA_BOSS_59h_Male_Undead_EventTurn02_01	克羅雷，是我告訴葛雷邁恩把你在牢裡關到爛！	
VO_GILA_BOSS_59h_Male_Undead_HeroPowerKills_01	真是美好的回憶啊。	
VO_GILA_BOSS_59h_Male_Undead_HeroPowerKills_02	我都忘了這種感覺有多舒暢了！	
VO_GILA_BOSS_59h_Male_Undead_HeroPowerKills_03	啊哈哈哈哈！	
VO_GILA_BOSS_59h_Male_Undead_HeroPowerKills_04	哈哈哈！看世界燒成灰燼！	
VO_GILA_BOSS_59h_Male_Undead_HeroPowerKills_05	真希望我能這樣對付每個狼人。	
VO_GILA_BOSS_59h_Male_Undead_Intro_01	你的旅程會在痛苦中結束！	
VO_GILA_BOSS_59h_Male_Undead_IntroCrowley_01	克羅雷，你有資格說我嗎？	
VO_GILA_BOSS_60h_Male_HumanGhost_Death_02	被海浪…捲走…	
VO_GILA_BOSS_60h_Male_HumanGhost_DefeatPlayer_01	歡迎上船！直到永遠…哈哈哈哈！	
VO_GILA_BOSS_60h_Male_HumanGhost_EmoteResponseTess_01	小妞，你最好開始相信鬼故事。	
VO_GILA_BOSS_60h_Male_HumanGhost_EventBigWeapon_01	煞氣、帥氣。	
VO_GILA_BOSS_60h_Male_HumanGhost_EventBigWeapon_02	多麼漂亮的武器啊。	
VO_GILA_BOSS_60h_Male_HumanGhost_EventBigWeapon_03	有看過這麼厲害的傢伙嗎？	
VO_GILA_BOSS_60h_Male_HumanGhost_EventPlayerKingsblade_01	什麼…你也有一把？	
VO_GILA_BOSS_60h_Male_HumanGhost_EventPlayKingsblade_01	我為它找遍全世界。	
VO_GILA_BOSS_60h_Male_HumanGhost_EventPlayKingsblade_02	它一定會回到我身邊。	
VO_GILA_BOSS_60h_Male_HumanGhost_EventPlayKragg_02	為了天空捨棄大海？真是愚蠢。	
VO_GILA_BOSS_60h_Male_HumanGhost_EventPlayPatches_02	派奇！你好像衝得沒有以前快了啊！	
VO_GILA_BOSS_60h_Male_HumanGhost_EventPlayTuskarrRaider_01	這年頭什麼貨色都能當海盜…	
VO_GILA_BOSS_60h_Male_HumanGhost_EventTurn2_01	把你變成我的船員，就是最棒的復仇。	
VO_GILA_BOSS_60h_Male_HumanGhost_HeroPower_01	我的刀對我唱！我也對它唱！	
VO_GILA_BOSS_60h_Male_HumanGhost_HeroPower_07	白浪滔滔我不怕！	
VO_GILA_BOSS_60h_Male_HumanGhost_IntroTess_01	唉呀！原來是國王的寶貝女兒要來收拾我們。	
VO_GILA_BOSS_61h_Female_Orc_DefeatPlayer_01	我已和黑巫森林合而為一，我…永生不死！	
VO_GILA_BOSS_61h_Female_Orc_EmoteResponse_01	看看你自己的倒影、看看害死你自己的原因。	
VO_GILA_BOSS_61h_Female_Orc_EmoteResponseCrowley_01	克羅雷，你到底想要彌補什麼？	
VO_GILA_BOSS_61h_Female_Orc_EmoteResponseShaw_01	汪汪！你的狗吵死了！	
VO_GILA_BOSS_61h_Female_Orc_EmoteResponseTess_01	你的父母真的愛他們的孩子嗎？	
VO_GILA_BOSS_61h_Female_Orc_EmoteResponseToki_01	你是怎麼逃過地精綁票者的？	
VO_GILA_BOSS_61h_Female_Orc_EventCannonKill_01	該死的大砲！	
VO_GILA_BOSS_61h_Female_Orc_EventCannonKill_02	放炮大聲不代表聰明。	
VO_GILA_BOSS_61h_Female_Orc_EventCannonKill_03	鋼鐵會生鏽，就像血肉會腐爛。	
VO_GILA_BOSS_61h_Female_Orc_EventCannonKill_04	狗雜種，你是在大聲什麼啦?!	
VO_GILA_BOSS_61h_Female_Orc_EventCrowleyHagathaLow_01	只要這片樹林還在，我永遠不會死…	
VO_GILA_BOSS_61h_Female_Orc_EventCrowleyLow_01	克羅雷，我會把你的大砲跟你埋在一起的。	
VO_GILA_BOSS_61h_Female_Orc_EventCrowleyTurn2_01	是你們自己放棄的！我只是順手接收而已。	
VO_GILA_BOSS_61h_Female_Orc_EventCrowleyTurn4_01	就算在你的同胞之間，你也是個邊緣人。	
VO_GILA_BOSS_61h_Female_Orc_EventShawHoundKill_01	壞狗狗。	
VO_GILA_BOSS_61h_Female_Orc_EventShawHoundKill_02	該死的臭狗。	
VO_GILA_BOSS_61h_Female_Orc_EventShawLow_01	黑巫森林的詛咒會找上你。	
VO_GILA_BOSS_61h_Female_Orc_EventShawTurn2_01	這座森林中的生物都屬於我。	
VO_GILA_BOSS_61h_Female_Orc_EventShawTurn2_02	只要讓它們感受到我。	
VO_GILA_BOSS_61h_Female_Orc_EventShawTurn4_01	千百個黑暗幽魂在與你作對。	
VO_GILA_BOSS_61h_Female_Orc_EventSummonCrowskin_01	我的手下永生不死。	
VO_GILA_BOSS_61h_Female_Orc_EventSummonGodfrey_01	高佛雷，森林的幽魂呼喚你回來…	
VO_GILA_BOSS_61h_Female_Orc_EventTessHagathaLow_01	我就是這座森林。	
VO_GILA_BOSS_61h_Female_Orc_EventTessLow_01	你的屍骨會成為樹林的養分。	
VO_GILA_BOSS_61h_Female_Orc_EventTessScavenges_01	沒有任何東西能救得了你。	
VO_GILA_BOSS_61h_Female_Orc_EventTessScavenges_02	喔，繼續找吧，公主。	
VO_GILA_BOSS_61h_Female_Orc_EventTessScavenges_03	還在翻垃圾嗎？	
VO_GILA_BOSS_61h_Female_Orc_EventTessScavenges_04	垃圾堆是找不出黃金的。	
VO_GILA_BOSS_61h_Female_Orc_EventTessTurn2_01	這片森林將會吞沒你的城市。	
VO_GILA_BOSS_61h_Female_Orc_EventTessTurn4_01	這片土地早就死了！是我為它帶來了生命。它是我的！	
VO_GILA_BOSS_61h_Female_Orc_EventTokiHagathaLow_01	林間的幽魂會保護我。	
VO_GILA_BOSS_61h_Female_Orc_EventTokiHeroPower_01	…剛剛那是怎麼回事？	
VO_GILA_BOSS_61h_Female_Orc_EventTokiHeroPower_03	你這是在賭運氣。	
VO_GILA_BOSS_61h_Female_Orc_EventTokiHeroPower_04	幽魂知道你在做什麼。	
VO_GILA_BOSS_61h_Female_Orc_EventTokiHeroPower_05	總有一天，你的伎倆會害到自己。	
VO_GILA_BOSS_61h_Female_Orc_EventTokiLow_01	你的伎倆已經用光了，地精。	
VO_GILA_BOSS_61h_Female_Orc_EventTokiTurn2_01	地精…其實你和我一樣是怪物。	
VO_GILA_BOSS_61h_Female_Orc_EventTokiTurn4_01	你以為沒有人知道你的把戲嗎？我什麼都知道。	
VO_GILA_BOSS_61h_Female_Orc_Intro_01	黑巫森林因我而生！	
VO_GILA_BOSS_61h_Female_Orc_IntroCrowley_01	等我毀了你的大砲，這裡就能恢復寧靜了。	
VO_GILA_BOSS_61h_Female_Orc_IntroShaw_01	我會讓你的狗反咬主人的。	
VO_GILA_BOSS_61h_Female_Orc_IntroTess_01	回去吧，「公主」。告訴你父親，已經沒有希望了。	
VO_GILA_BOSS_61h_Female_Orc_IntroToki_01	就算你能改變命運，但是樹木和星辰不會忘記。	
VO_GILA_BOSS_62h_GustaveTheGutRipper_Emote	*吼聲*	
VO_GILA_BOSS_62h_GustaveTheGutRipper_Intro	*吼聲*	
VO_GILA_BOSS_62h_GustaveTheGutRipper_PlayerDefeat	*吼聲*	
VO_GILA_BOSS_63h_Female_Harpy_Death_01	我的…蛋…	
VO_GILA_BOSS_63h_Female_Harpy_DefeatPlayer_01	姊妹們！把屍體帶到我的鳥巢去。	
VO_GILA_BOSS_63h_Female_Harpy_EmoteResponse_01	這場對話如果再繼續下去恐怕會影響到你我之間的互動關係。	
VO_GILA_BOSS_63h_Female_Harpy_HeroPower_01	我也有！	
VO_GILA_BOSS_63h_Female_Harpy_HeroPower_02	你的魔法只會腐化這片森林。	
VO_GILA_BOSS_63h_Female_Harpy_HeroPower_03	蠢貨，我只會越來越強大。	
VO_GILA_BOSS_63h_Female_Harpy_Intro_01	不准再前進了。這是哈嘉薩的命令！	
VO_GILA_BOSS_64h_Male_Goblin_Death_01	慢－慢著！	
VO_GILA_BOSS_64h_Male_Goblin_DefeatPlayer_01	謝謝！謝謝！好了，該付我酬勞了…	
VO_GILA_BOSS_64h_Male_Goblin_EmoteResponse_01	我最喜歡和觀眾互動了。	
VO_GILA_BOSS_64h_Male_Goblin_EvenPlayCursedCurio_01	真漂亮！你在哪裡弄到的？	
VO_GILA_BOSS_64h_Male_Goblin_EventMCTech_01	喔嘿！不要偷學我的招式！	
VO_GILA_BOSS_64h_Male_Goblin_EventMindControl_01	想跟我比個高下是吧？	
VO_GILA_BOSS_64h_Male_Goblin_HeroPowerHandBig_01	你覺得有點睏了。	
VO_GILA_BOSS_64h_Male_Goblin_HeroPowerHandBig_03	眼皮越來越重、快睜不開眼睛了！	
VO_GILA_BOSS_64h_Male_Goblin_HeroPowerHandEmpty_01	Zzzz…Zzzz…	
VO_GILA_BOSS_64h_Male_Goblin_HeroPowerHandMedium_01	看著...我的眼睛！	
VO_GILA_BOSS_64h_Male_Goblin_HeroPowerHandMedium_02	看著這個懷錶…等一下，手冊上說下一步要怎麼做？	
VO_GILA_BOSS_64h_Male_Goblin_HeroPowerHandMedium_03	左右、左右、看著它擺盪！	
VO_GILA_BOSS_64h_Male_Goblin_HeroPowerHandSmall_01	…我剛剛在幹嘛？	
VO_GILA_BOSS_64h_Male_Goblin_HeroPowerHandSmall_02	你覺得…有點累了。	
VO_GILA_BOSS_64h_Male_Goblin_Intro_01	喔！有自願者？	
VO_GILA_BOSS_66h_Female_Undead_DefeatPlayer_01	…	
VO_GILA_BOSS_66h_Female_Undead_EmoteResponse_02	…	
VO_GILA_BOSS_66h_Female_Undead_EventPlayHorn_02	…	
VO_GILA_BOSS_66h_Female_Undead_HeroPower_01	…	
VO_GILA_BOSS_66h_Female_Undead_HeroPower_02	…	
VO_GILA_BOSS_66h_Female_Undead_HeroPower_03	…	
VO_GILA_BOSS_66h_Female_Undead_Intro_01	…	
VO_GILA_BOSS_67h_Male_Undead_DefeatPlayer_01	生命就像老鼠跑輪子。	
VO_GILA_BOSS_67h_Male_Undead_EmoteResponse_01	不要吱吱叫了！	
VO_GILA_BOSS_67h_Male_Undead_EventPlayRat_01	他們真的是很棒的寵物，對不對？而且還可以燉湯。	
VO_GILA_BOSS_67h_Male_Undead_EventPlayRat_02	多麼單純的小動物啊。就像你一樣。	
VO_GILA_BOSS_67h_Male_Undead_EventPlayRat_03	小心喔，他們咬人還是會痛的。	
VO_GILA_BOSS_67h_Male_Undead_EventPlayRatTrap_01	就這麼個箱子？太簡陋了吧！	
VO_GILA_BOSS_67h_Male_Undead_Intro_01	逮到你了！我抓老鼠的時候鼻子最靈了。	
VO_GILA_BOSS_68h_Male_Undead_DefeatPlayer_01	你竟然撐了這麼久！這是很棒的案例。	
VO_GILA_BOSS_68h_Male_Undead_EmoteResponse_01	你知道要製作瘟疫有多困難嗎？	
VO_GILA_BOSS_68h_Male_Undead_EventPlayPoison_01	竟然早我一步。	
VO_GILA_BOSS_68h_Male_Undead_EventPlayPoison_02	喔，致命的劇毒！	
VO_GILA_BOSS_68h_Male_Undead_EventPlayPoison_03	我喜歡你的風格。	
VO_GILA_BOSS_68h_Male_Undead_EventPlayPoison_04	可以借我研究一下嗎？	
VO_GILA_BOSS_68h_Male_Undead_Intro_01	把死人都帶過來！我需要他們。	
VO_HeadlessHorseman_Male_Human_HallowsEve_01	我在這裡，你這個蠢東西！	
VO_HeadlessHorseman_Male_Human_HallowsEve_02	傾聽，我的怨恨！感受，我的怒火！	
VO_HeadlessHorseman_Male_Human_HallowsEve_04	天日昏暗，烈火熊熊。命運之輪無情轉，萬般掙扎皆徒勞。	
VO_HeadlessHorseman_Male_Human_HallowsEve_07	火焰已熄，蕩然無存！我要親自出馬，將你葬入黑暗！	
VO_HeadlessHorseman_Male_Human_HallowsEve_08	你們竟如此渴望，看我血濺五步，只要我首級仍在，休想把我擊敗！	
VO_HeadlessHorseman_Male_Human_HallowsEve_10	啊哈哈哈哈哈！	
VO_HeadlessHorseman_Male_Human_HallowsEve_11	啊哈哈哈哈哈！	
VO_HeadlessHorseman_Male_Human_HallowsEve_12	喪鐘已響，死期將近！老弱婦孺都藏好！	
VO_HeadlessHorseman_Male_Human_HallowsEve_13	顫抖求饒，天罰降臨！眾生無一可倖免！	
VO_HeadlessHorseman_Male_Human_HallowsEve_17	啊哈哈…呃嗚嗚啊啊哼嗯…	
VO_HERO_02b_Male_Troll_Event_03	恭喜啊，勇士！	
VO_HERO_02b_Male_Troll_Event_09	下個禮拜記得回來進行新的挑戰！	
VO_HERO_02b_Male_Troll_Event_11	誰會是勇士中的勇士？	
VO_HERO_02b_Male_Troll_Troll_AdventureSelect_02	來啊！集合所有部族！敲響戰鼓！準備開始...大混戰！	
VO_HERO_02b_Male_Troll_Troll_Boss1Appear_01	要先打贏其他八個，才可以拿到最高榮耀。	
VO_HERO_02b_Male_Troll_Troll_Boss2Appear_01	你會越來越強，你的敵人也一樣。打得精彩一點，好嗎？	
VO_HERO_02b_Male_Troll_Troll_BountyBoard_01	所以你也想打？贏家可以全拿。\n輸家呢？再見。	
VO_HERO_02b_Male_Troll_Troll_CharacterSelect_01	有九個勇士，每個都有羅亞賜給他們的力量。但是冠軍只有一個。	
VO_HERO_02b_Male_Troll_Troll_Defeat_01	情況可能凶多吉少了。但是！你隨時可以再試一次。	
VO_HERO_02b_Male_Troll_Troll_EnemyShrineDead_01	很好、很好！破壞敵人的聖壇，中斷他們的力量。把握機會，解決對手！	
VO_HERO_02b_Male_Troll_Troll_EnemyShrineReturn_01	一段時間以後，敵人的聖壇會恢復。先想清楚，不然之後會輸。	
VO_HERO_02b_Male_Troll_Troll_Finale_01	只剩下兩個食人妖！誰才是最後的大贏家?!	
VO_HERO_02b_Male_Troll_Troll_Finale_02	這就是大決戰！最後的生死鬥！冠軍只有一個！	
VO_HERO_02b_Male_Troll_Troll_Finale_03	終於來了！迎接最後的決鬥！決定最後的冠軍！	
VO_HERO_02b_Male_Troll_Troll_Finale_04	全場觀眾都坐不住了！最後大決戰開打了！	
VO_HERO_02b_Male_Troll_Troll_Finale_05	下一場比賽的贏家就是冠軍！全力以赴，不要手下留情！	
VO_HERO_02b_Male_Troll_Troll_FinalWin_01	你征服了競技場。所有的食人妖、所有的羅亞，所有的榮耀，通通都是你的！	
VO_HERO_02b_Male_Troll_Troll_FirstTeammate_02	每次在競技場獲勝，就會有更多的人加入你。選擇你的獎勵吧！	
VO_HERO_02b_Male_Troll_Troll_FirstTeammateAlt_01	在競技場沒有人會獨自戰鬥。為你的陣營選一個盟友吧。	
VO_HERO_02b_Male_Troll_Troll_FirstWin_01	你贏了！你的羅亞獲勝了！你的名字會變成永遠的傳說！	
VO_HERO_02b_Male_Troll_Troll_FriendlyShrineDead_01	如果你的聖壇壞了，它的力量就沒有辦法保護你。	
VO_HERO_02b_Male_Troll_Troll_FriendlyShrineDisabled_01	你的聖壇會恢復的，但要等一段時間…如果你能活到那個時候！	
VO_HERO_02b_Male_Troll_Troll_Game1Begin_01	羅亞聖壇會給你強大的力量！好好保護它！	
VO_HERO_02b_Male_Troll_Troll_Game2Begin_01	記得：聖壇代表力量！好好保護自己的，狠狠摧毀敵人的！	
VO_HERO_02b_Male_Troll_Troll_ShrineBounce_01	別想弄走聖壇，它們一直都會在。	
VO_HERO_02b_Male_Troll_Troll_ShrineDestroy_01	不管你怎樣打、怎麼砸，聖壇都會恢復的。	
VO_HERO_02b_Male_Troll_Troll_ShrineTransform_01	你不可以把聖壇變形！羅亞知道你所有的詭計！	
VO_HERO_02b_Male_Troll_Troll_ShrineTutorial_01	選擇一個聖壇。它是你力量的源頭，比賽一開始就會在場上。	
VO_HERO_02b_Male_Troll_Troll_Treasure1_01	你的羅亞要賦予你力量！用它的法力強化你的聖壇，但是你要小心選擇！	
VO_HERO_02b_Male_Troll_Troll_UpgradeShrine_01	你的聖壇越來越強大了！你會需要它的…	
VO_HRW_DEBUG_01	1	
VO_HRW_DEBUG_02	2	
VO_HRW_DEBUG_03	3	
VO_HRW_DEBUG_04	4	
VO_HRW_DEBUG_05	5	
VO_HRW_TEST_00	I will cleanse you both of the Curse of Flesh！	
VO_HRW_TEST_01	Well done！  You've defeated the boss together.\n\nBoth players win！	
VO_HRW_TEST_02	Defeat Gearmaster Mechazod together to win！	
VO_HRW_TEST_ABILITY_00	Damaging a hero.	
VO_HRW_TEST_ABILITY_01	Destroying highest attack minion.	
VO_HRW_TEST_ABILITY_02	Throwing 3 bombs.	
VO_HRW_TEST_ABILITY_03	Damaging all other characters.	
VO_HRW_TEST_ABILITY_04	Gaining 2 attack.	
VO_HRW_TEST_ABILITY_05	Dealing damage to both heroes.	
VO_HRW_TEST_ABILITY_06	Silencing Lorewalker Cho. Permanently.	
VO_HRW_TEST_ABILITY_98	Target board full.  Clearing target board.	
VO_ICC_841_Female_Sanlayn_Death_02	但是...我們如此...契...合…	
VO_ICC01_Jaina_Female_Human_DrawsRager_01	有沒有搞錯啊！	
VO_ICC01_Jaina_Female_Human_JainaDKIntro_05	我聽見…死亡的低語…	
VO_ICC01_Jaina_Female_Human_PostDeath_02	我們必須…反抗…	
VO_ICC01_LichKing_Male_Human_EmoteResponse_01	我對你的哀求無動於衷。	
VO_ICC01_LichKing_Male_Human_EndOfTurn2_01	哈哈哈，這就是我的開局。	
VO_ICC01_LichKing_Male_Human_EndOfTurn2_02	而且這還不是我的快攻牌呢！	
VO_ICC01_LichKing_Male_Human_Idle_01	快啊，按結束回合，我才能結束你！	
VO_ICC01_LichKing_Male_Human_Intro_01	小心選牌，這是你最後的機會了。	
VO_ICC01_LichKing_Male_Human_JainaDKIntro_01	起來吧，法師，你的使命還沒完成。	
VO_ICC01_LichKing_Male_Human_JainaDKIntro_02	加入我的行列，讓生者顫抖，讓死者聽令。	
VO_ICC01_LichKing_Male_Human_JainaDKIntro_03	你會比死亡更令人恐懼…	
VO_ICC01_LichKing_Male_Human_JainaDKintro_06	去吧，勇士，把我門前的垃圾清理乾淨。	
VO_ICC01_LichKing_Male_Human_PlaysFrostmourne_01	你的排名會受難！	
VO_ICC01_LichKing_Male_Human_Turn1_01	我的起手牌真是超棒的…	
VO_ICC01_LichKing_Male_Human_Turn11_01	我的不死大軍任你號令。	
VO_ICC01_LichKing_Male_Human_Turn13_01	折磨他們。	
VO_ICC01_LichKing_Male_Human_Turn15_01	弱者才會有仁慈之心。	
VO_ICC01_LichKing_Male_Human_Turn2_02	見識我的力量。	
VO_ICC01_LichKing_Male_Human_Turn4_01	沒人救得了你。	
VO_ICC01_LichKing_Male_Human_Turn4_02	因為我的力量是最強的。	
VO_ICC01_LichKing_Male_Human_Turn5_01	誰都無法抗拒我。	
VO_ICC01_LichKing_Male_Human_Turn5_02	你也會臣服於我。	
VO_ICC01_Tirion_Male_Human_AFKay_01	別再混了！	
VO_ICC01_Tirion_Male_Human_EmoteResponse_02	你已經不是我認識的人了！	
VO_ICC01_Tirion_Male_Human_EndOfTurn4_01	撐下去，勇士！	
VO_ICC01_Tirion_Male_Human_EndOfTurn4_02	我相信上天會在關鍵時刻賜予你力量。	
VO_ICC01_Tirion_Male_Human_EndOfTurn4_03	相信上天會在關鍵時刻幫助你。	
VO_ICC01_Tirion_Male_Human_Flavor01_01	唉！我以後要找更厲害的冒險者…	
VO_ICC01_Tirion_Male_Human_Flavor02_01	珍娜，你變成怪物了？	
VO_ICC01_Tirion_Male_Human_Flavor03_01	巫妖王要為此付出代價！	
VO_ICC01_Tirion_Male_Human_JainaDKintro_05	發生什麼事了？你怎麼變成這樣？	
VO_ICC01_Tirion_Male_Human_PauseDeath_02	大家先別動！	
VO_ICC01_Tirion_Male_Human_PostDeath_01	英雄，你可以掌握自己的意志。勇敢反抗巫妖王的呼喚！	
VO_ICC01_Tirion_Male_Human_TerribleTank_01	你為什麼不嘲諷？	
VO_ICC01_Tirion_Male_Human_Turn2_01	別怕，勇士！我們在路上了。	
VO_ICC01_Tirion_Male_Human_Turn3_01	我們快到了！狀況如何？還好嗎？	
VO_ICC01_Tirion_Male_Human_Turn6_01	勇士，我們就要準備…	
VO_ICC01_Tirion_Male_Human_Turn6_02	什麼？	
VO_ICC01_Tirion_Male_Human_Turn8_01	你面對的是艾澤拉斯最強的冒險者們！	
VO_ICC04_LichKing_Male_Human_BreathNoMinion_01	什麼，沒有手下可以讓辛德拉苟莎冰凍了？真冷清啊。	
VO_ICC04_LichKing_Male_Human_Lose_01	你冰冷的遺體可以用來警告其他人…	
VO_ICC04_LichKing_Male_Human_Turn5_01	你應該在想：「要怎麼解決這些冰塊？」	
VO_ICC04_LichKing_Male_Human_Turn5_02	答案是：沒辦法！	
VO_ICC04_LichKing_Male_Human_Win_02	必須淨化整副套牌！	
VO_ICC04_Sindragosa_Female_Dragon_Bounce_01	不准逃！	
VO_ICC04_Sindragosa_Female_Dragon_BreathNoRoomLeft_01	你沒辦法躲在手下後面了。	
VO_ICC04_Sindragosa_Female_Dragon_Death_01	嗚啊啊啊！	
VO_ICC04_Sindragosa_Female_Dragon_EmoteResponse_01	我厭倦這些遊戲了！	
VO_ICC04_Sindragosa_Female_Dragon_Intro_01	你真是夠蠢了才會來到此地。	
VO_ICC04_Sindragosa_Female_Dragon_LichKing_01	我被背叛了！	
VO_ICC04_Sindragosa_Female_Dragon_Malygos_01	瑪里苟斯，我的舊愛！	
VO_ICC04_Sindragosa_Female_Dragon_PlayerPlaysMinion_02	想好要派誰出來送死了嗎？寒冷的死亡之手會奪走你們的性命。	
VO_ICC04_Sindragosa_Female_Dragon_SecondBreath_01	絕望吧！感受主人無限的力量吧！	
VO_ICC04_Sindragosa_Female_Dragon_Sindragosa_01	可恨的魔法背叛了我們！	
VO_ICC04_Sindragosa_Female_Dragon_Sindragosa_02	可恨的魔法背叛了我們！	
VO_ICC04_Sindragosa_Female_Dragon_TransformDK_01	我只效忠唯一的主人！	
VO_ICC04_Sindragosa_Female_Dragon_UnchainedMagic_02	你可悲的魔法會背叛你！	
VO_ICC04_Sindragosa_Female_Dragon_UnchainedMagic_04	受苦吧！	
VO_ICC05_Lanathel_Female_Sanlayn_BiteOoze_01	噁，你居然敢咬這種東西？	
VO_ICC05_Lanathel_Female_Sanlayn_BitePoisonous_01	吸完以後，記得把毒吐掉喔。	
VO_ICC05_Lanathel_Female_Sanlayn_BiteReminder_01	你是不是忘記了？無盡的饑渴可是會要命的！	
VO_ICC05_Lanathel_Female_Sanlayn_BiteReminderAcolyte_01	不要猶豫了。咬下去！喝他們的血！	
VO_ICC05_Lanathel_Female_Sanlayn_BiteShell_01	別咬碎牙齒啊。	
VO_ICC05_Lanathel_Female_Sanlayn_BiteSpikes_01	咬到那個一定很痛。	
VO_ICC05_Lanathel_Female_Sanlayn_BloodEssence_01	這裡有點太擠了。	
VO_ICC05_Lanathel_Female_Sanlayn_BloodEssence_02	沒料到這招吧？	
VO_ICC05_Lanathel_Female_Sanlayn_BloodEssence_03	來點變化好嗎？嗯？	
VO_ICC05_Lanathel_Female_Sanlayn_BloodPrince_01	叛徒！ 把你的假牙還我！	
VO_ICC05_Lanathel_Female_Sanlayn_BossBite_01	體驗我的飢渴！	
VO_ICC05_Lanathel_Female_Sanlayn_EmoteResponse_01	你在…挑逗我嗎？	
VO_ICC05_Lanathel_Female_Sanlayn_Intro_01	你做了一個…不明智…的選擇。	
VO_ICC05_Lanathel_Female_Sanlayn_LichKing_01	是你…！	
VO_ICC05_Lanathel_Female_Sanlayn_PlayerBiteAcolyte_01	噢，既美味，又危險！	
VO_ICC05_Lanathel_Female_Sanlayn_PlayerBloodBite_01	傻瓜，我早就是吸血鬼了！ 	
VO_ICC05_Lanathel_Female_Sanlayn_TransformDK_01	我就知道我喜歡你。	
VO_ICC05_Lanathel_Female_Sanlayn_Turn3_01	怎麼不來咬一口我的手下呢？	
VO_ICC05_Lanathel_Female_Sanlayn_Turn3_02	他們都睡著了…而且美味又可口！	
VO_ICC05_Lanathel_Female_Sanlayn_Wounded_01	就這樣？你只有這點能耐嗎？	
VO_ICC05_LichKing_Male_Human_BossBite_02	啊，被煞婪一族咬到了啊。	
VO_ICC05_LichKing_Male_Human_BossBite_03	當心無盡的飢渴。每一回合你都得吸血。	
VO_ICC05_LichKing_Male_Human_LichKing_02	這個首領會咬人。	
VO_ICC05_LichKing_Male_Human_Lose_01	不敢咬自己的手下嗎？冰冠城塞可不是讓你當好人的地方！	
VO_ICC05_LichKing_Male_Human_Win_01	菈娜薩爾…你該慶幸你的階級不會失去星星。	
VO_ICC06_LichKing_Male_Human_LichKing_02	公事公辦，瑪洛嘉。	
VO_ICC06_LichKing_Male_Human_Win_01	我要合成一個新的骸骨首領，最好還是金的。	
VO_ICC06_Marrowgar_Male_BoneWraith_Alexstraza_01	她偷舔我，那條龍居然偷舔我！	
VO_ICC06_Marrowgar_Male_BoneWraith_AncientOne_01	我沒有遺憾了！	
VO_ICC06_Marrowgar_Male_BoneWraith_AuchenaiSoulpriest_01	哈哈，靈魂牧師現在是我的了。等等，不對，快走開！快滾！	
VO_ICC06_Marrowgar_Male_BoneWraith_BigHeal_01	死亡是永恆不滅的…	
VO_ICC06_Marrowgar_Male_BoneWraith_Bonespike_01	唯一的出路只有死亡！	
VO_ICC06_Marrowgar_Male_BoneWraith_Bonespike_02	你逃不出主人的手掌心。	
VO_ICC06_Marrowgar_Male_BoneWraith_Bonespike_03	剝皮去肉，斷筋剔骨！	
VO_ICC06_Marrowgar_Male_BoneWraith_Bonespike_04	收割的時候到了。	
VO_ICC06_Marrowgar_Male_BoneWraith_Bonespike_05	好危險，好興奮！	
VO_ICC06_Marrowgar_Male_BoneWraith_BonespikePlayerHit_01	主人的憤怒在我身體中奔流！	
VO_ICC06_Marrowgar_Male_BoneWraith_BonespikeStolen_01	你這個…偷死人骨頭的！	
VO_ICC06_Marrowgar_Male_BoneWraith_Bonestorm_01	骸骨風暴！	
VO_ICC06_Marrowgar_Male_BoneWraith_Bonestorm_02	骸骨風暴！	
VO_ICC06_Marrowgar_Male_BoneWraith_Bonestorm_03	骸骨風暴！	
VO_ICC06_Marrowgar_Male_BoneWraith_Bonestorm_04	骸骨風暴！	
VO_ICC06_Marrowgar_Male_BoneWraith_Bonestorm_05	骸骨風暴！	
VO_ICC06_Marrowgar_Male_BoneWraith_BonestormFast_01	骸骨風暴。	
VO_ICC06_Marrowgar_Male_BoneWraith_Death_01	塵歸塵，土歸土…	
VO_ICC06_Marrowgar_Male_BoneWraith_DKTransform_01	對，擁抱你的命運，回應主人的呼喚！	
VO_ICC06_Marrowgar_Male_BoneWraith_EmoteResponse_01	蠢蛋，我根本沒耳朵！	
VO_ICC06_Marrowgar_Male_BoneWraith_Idle_01	嗯…	
VO_ICC06_Marrowgar_Male_BoneWraith_Intro_01	沒有人能進入主人的聖所！	
VO_ICC06_Marrowgar_Male_BoneWraith_LichKing_01	…主人？	
VO_ICC06_Marrowgar_Male_BoneWraith_Skeleton_01	呦！小骨頭！最近過得如何啊！	
VO_ICC07_LichKing_Male_Human_LichKing_02	我是個什麼事情都要管的老闆。	
VO_ICC07_LichKing_Male_Human_Lose_01	普崔希德，你的套牌真噁心，我太小看你了。	
VO_ICC07_LichKing_Male_Human_Win_02	普崔希德，真是太難看了。給我滾去獵人的卡牌吧，冰冠城塞不需要你。	
VO_ICC07_Putricide_Male_Undead_Aviana_01	你的科學比我的科學厲害！	
VO_ICC07_Putricide_Male_Undead_CloakedHuntress_01	根本是多此一舉啊。	
VO_ICC07_Putricide_Male_Undead_Death_01	壞消息…我大概... 撐不下去了...	
VO_ICC07_Putricide_Male_Undead_EaglehornBow_01	我也想要一把！	
VO_ICC07_Putricide_Male_Undead_EaterOfSecrets_01	不！我的秘密！我的傑作！	
VO_ICC07_Putricide_Male_Undead_EmoteResponse_01	這樣很沒禮貌喔。	
VO_ICC07_Putricide_Male_Undead_EquipWeapon_01	噢，天啊。	
VO_ICC07_Putricide_Male_Undead_EquipWeapon_02	我都忘了我有這東西。	
VO_ICC07_Putricide_Male_Undead_EquipWeapon_03	啊，這應該管用。	
VO_ICC07_Putricide_Male_Undead_EquipWeapon_04	這東西打哪來的？	
VO_ICC07_Putricide_Male_Undead_EquipWeapon_05	好危險，好興奮！	
VO_ICC07_Putricide_Male_Undead_EtherealArcanist_01	別相信以太人，你根本看不到他們在偷笑！	
VO_ICC07_Putricide_Male_Undead_FestergutDeath_01	喔，膿腸，你永遠都是我的最愛… 只輸給腐臉。	
VO_ICC07_Putricide_Male_Undead_Intro_02	大夥聽著，有好消息！我修好劇毒軟泥管了！	
VO_ICC07_Putricide_Male_Undead_LichKing_01	噢，老闆你居然在這裡。	
VO_ICC07_Putricide_Male_Undead_MysteriousChallenger_01	誰能比我更神秘！	
VO_ICC07_Putricide_Male_Undead_Ooze_01	嗚，軟泥耶～	
VO_ICC07_Putricide_Male_Undead_PhaseTransition_01	是觸手！噢天啊，它們好像有自己的意志。	
VO_ICC07_Putricide_Male_Undead_PhaseTransition_03	嗯，有意思...	
VO_ICC07_Putricide_Male_Undead_Putricide_02	蛤，對面那個是我嗎?	
VO_ICC07_Putricide_Male_Undead_Putricide_03	大夥，好消息！我來了！	
VO_ICC07_Putricide_Male_Undead_Putricide_04	才不是好消息，你這個長觸手的醜八怪！	
VO_ICC07_Putricide_Male_Undead_Rotface_01	腐臉！你壞壞！	
VO_ICC07_Putricide_Male_Undead_RotfaceDeath_01	不！腐臉！他是哪裡惹到你了？	
VO_ICC07_Putricide_Male_Undead_Scientist_01	你是不是在偷挖角我的實驗助理？	
VO_ICC07_Putricide_Male_Undead_Slime_01	大夥聽著，超級好消息！軟泥又開始流動了！	
VO_ICC07_Putricide_Male_Undead_TentaclesForArms_01	你選武器的品味很不錯嘛。	
VO_ICC07_Putricide_Male_Undead_TransformDK_01	哇，你剛剛去了美容沙龍嗎？	
VO_ICC07_Rotface_Male_Abomination_Rotface_02	腐臉想要！	
VO_ICC08_Anduin_Male_Human_Muted_02	嗯～嗯！	
VO_ICC08_Anduin_Male_Human_Muted_03	哼！哼！	
VO_ICC08_Anduin_Male_Human_Muted_06	嗯！哼！	
VO_ICC08_Anduin_Male_Human_Muted_07	嗯！哼！	
VO_ICC08_Anduin_Male_Human_Muted_11	嗯哼？	
VO_ICC08_Anduin_Male_Human_Muted_13	嗯哼…	
VO_ICC08_Anduin_Male_Human_WinA_01	世上永遠都需要一個…	
VO_ICC08_Anduin_Male_Human_WinB_01	巫妖王！	
VO_ICC08_Garrosh_Male_Orc_WinA_01	世上永遠都需要一個…	
VO_ICC08_Garrosh_Male_Orc_WinB_01	巫妖王！	
VO_ICC08_Guldan_Male_Orc_WinA_01	世上永遠都需要一個…	
VO_ICC08_Guldan_Male_Orc_WinB_01	巫妖王！	
VO_ICC08_Jaina_Female_Human_WinA_01	世上永遠都需要一個…	
VO_ICC08_Jaina_Female_Human_WinB_01	巫妖王！	
VO_ICC08_LichKing_Male_Human_Archmage Antonidas_01	我殺過你一次，老頭。我很樂意再來一次。	
VO_ICC08_LichKing_Male_Human_Arfas_01	壞狗狗！	
VO_ICC08_LichKing_Male_Human_Bolvar_01	要破壞這個人的意志並不容易。	
VO_ICC08_LichKing_Male_Human_Death_01	在我面前…只有…一片黑暗	
VO_ICC08_LichKing_Male_Human_DeathPunisher_01	作弊，這根本是作弊。	
VO_ICC08_LichKing_Male_Human_EmoteResponse_01	沒人可以命令我！	
VO_ICC08_LichKing_Male_Human_EndOfTurn4_01	沒有牌可以阻止我的勝利。	
VO_ICC08_LichKing_Male_Human_Frostmourne_01	感受霜之哀傷的飢渴…	
VO_ICC08_LichKing_Male_Human_Frostmourne_02	感受霜之哀傷的飢渴…你要吃點什麼嗎？	
VO_ICC08_LichKing_Male_Human_Frostmourne_07	見識霜之哀傷的力量。	
VO_ICC08_LichKing_Male_Human_GenericStart_03	我會分解你的套牌，打碎你的靈魂。	
VO_ICC08_LichKing_Male_Human_Horsemen_01	要是四騎士都到齊了，那你可就難看了。	
VO_ICC08_LichKing_Male_Human_Hunter_01	孤獨的獵人啊，沒有你那些小小的動物朋友，你拿什麼對付我？	
VO_ICC08_LichKing_Male_Human_Illidan_01	惡魔，冰封王座是我的，滾開。	
VO_ICC08_LichKing_Male_Human_IndestructableWeapon_01	可惜啊，那沒用。	
VO_ICC08_LichKing_Male_Human_Intro_01	你受到的折磨會成為傳說，但是你的排名不會。	
VO_ICC08_LichKing_Male_Human_Intro_02	到最後，所有人都會服侍我。	
VO_ICC08_LichKing_Male_Human_Intro_03	那堆沒用的東西，就是你的套牌？	
VO_ICC08_LichKing_Male_Human_Intro_04	我是開始，也是終結。我是…全新的…主流牌！	
VO_ICC08_LichKing_Male_Human_Intro_06	你以為我會對你這種貨色手下留情嗎？	
VO_ICC08_LichKing_Male_Human_Intro_07	這就是你的牌嗎？它們在喊救命啊。	
VO_ICC08_LichKing_Male_Human_Intro_08	你的痛苦哀嚎，就是我傳說實力的證明。	
VO_ICC08_LichKing_Male_Human_Intro_09	你的原動力真的是正義感嗎？\n我很懷疑…	
VO_ICC08_LichKing_Male_Human_Kelthuzad_01	克爾蘇加德！你跑錯棚了吧！	
VO_ICC08_LichKing_Male_Human_Lanathel_01	菈娜薩爾你這叛徒，真是不出我所料啊。	
VO_ICC08_LichKing_Male_Human_LichKing_01	帥哥，你好啊。	
VO_ICC08_LichKing_Male_Human_LichKing_02	我真是帥死人了。	
VO_ICC08_LichKing_Male_Human_LichKingMuted_01	等等，你不能…	
VO_ICC08_LichKing_Male_Human_LichKingMutedResponse_01	嗯哼哼哼。	
VO_ICC08_LichKing_Male_Human_LichKingMutedResponse_02	哼哼，哼哼！	
VO_ICC08_LichKing_Male_Human_LichKingMutedResponse_03	嗯，嗯嗯！	
VO_ICC08_LichKing_Male_Human_LichKingMutedResponse_04	嗯哼嗯嗯…	
VO_ICC08_LichKing_Male_Human_LilLich_01	我愛死他了。	
VO_ICC08_LichKing_Male_Human_Lose_03	和我一起加入黑暗吧…	
VO_ICC08_LichKing_Male_Human_Mage_01	法師，唯有我掌握了冰寒的死亡之力！	
VO_ICC08_LichKing_Male_Human_MageSpellReflect_01	這遊戲是沒有人在測試嗎？	
VO_ICC08_LichKing_Male_Human_MageSpellReflect_02	太扯了！這遊戲有好好做過測試嗎？	
VO_ICC08_LichKing_Male_Human_Mograine_01	莫格萊尼，我都搞不清楚你是好人還是壞人了。	
VO_ICC08_LichKing_Male_Human_MutedResponse_01	閉嘴！	
VO_ICC08_LichKing_Male_Human_MutedResponse_02	噓！	
VO_ICC08_LichKing_Male_Human_MutedResponse_03	噓！	
VO_ICC08_LichKing_Male_Human_MutedResponse_04	住口。	
VO_ICC08_LichKing_Male_Human_MutedResponse_05	好啦，閉嘴。	
VO_ICC08_LichKing_Male_Human_MutedResponse_06	閉嘴～	
VO_ICC08_LichKing_Male_Human_Paladin_01	聖光在這裡沒辦法保護你，聖騎士。沒有東西能保護你…	
VO_ICC08_LichKing_Male_Human_Phase03_01	面對你的可悲下場吧。	
VO_ICC08_LichKing_Male_Human_PhaseTransition_02	我的武器被人削弱了？	
VO_ICC08_LichKing_Male_Human_PowerReplace_01	我的力量可沒這麼容易消失。	
VO_ICC08_LichKing_Male_Human_Priest_01	沉默吧，牧師！聖光不會聽見你的哀嚎。	
VO_ICC08_LichKing_Male_Human_Putricide_01	我早就覺得你很討厭了。	
VO_ICC08_LichKing_Male_Human_Rogue_01	出來吧，盜賊。別躲了。你就只會這些小花招嗎？	
VO_ICC08_LichKing_Male_Human_Shaman_01	薩滿，你的手下都害怕我的力量！	
VO_ICC08_LichKing_Male_Human_Sindragosa_01	我都用她來收頭！還給我！	
VO_ICC08_LichKing_Male_Human_Sylvanas_01	你給我帶來了這麼多的麻煩，我最不願給你的就是死亡的寧靜	
VO_ICC08_LichKing_Male_Human_Tirion_01	我會讓你活著見證到最後，弗丁。	
VO_ICC08_LichKing_Male_Human_TransformDK_01	很好…享用全新的力量…這代表我已經獲勝了…	
VO_ICC08_LichKing_Male_Human_Turn6_01	你剛剛那回合打得爛透了…其實你之前也打得不怎麼樣。	
VO_ICC08_LichKing_Male_Human_Turn6_03	你打牌的方式就像我父親的領導風格一樣優柔寡斷！	
VO_ICC08_LichKing_Male_Human_Turn6_04	帶這些牌上場，你都不覺得可恥嗎？	
VO_ICC08_LichKing_Male_Human_Turn6_05	你每打一張牌，就離死亡更近一步。	
VO_ICC08_LichKing_Male_Human_Turn6_06	你的死亡無可避免，而且沒有語音可以表達你有多丟臉。	
VO_ICC08_LichKing_Male_Human_Turn6_07	這誰幫你組的牌啊？	
VO_ICC08_LichKing_Male_Human_Turn6_08	他們以為你還在跟霍格打嗎？	
VO_ICC08_LichKing_Male_Human_Warlock_01	術士，舉起你可悲的雙手投降吧。你所駕馭的恐懼之力很快就會歸我所有。	
VO_ICC08_LichKing_Male_Human_Warrior_01	戰士，你屈服以後會是很厲害的死亡騎士。	
VO_ICC08_LichKing_Male_Human_Wounded_01	希望破滅…	
VO_ICC08_LichKing_Male_Human_Wounded_02	不可能…不可能！	
VO_ICC08_LichKing_Male_Human_YoungArthas_01	這是在演哪一齣？面對我自己內心的衝突矛盾嗎？	
VO_ICC08_Malfurion_Male_NightElf_WinA_01	世上永遠都需要一個…	
VO_ICC08_Malfurion_Male_NightElf_WinB_01	巫妖王！	
VO_ICC08_Rexxar_Male_Orc_WinA_01	世上永遠都需要一個…	
VO_ICC08_Rexxar_Male_Orc_WinB_01	巫妖王！	
VO_ICC08_Thrall_Male_Orc_WinA_01	世上永遠都需要一個…	
VO_ICC08_Thrall_Male_Orc_WinB_01	巫妖王！	
VO_ICC08_Tirion_Male_Human_Win_01	你辦到了，勇士！	
VO_ICC08_Tirion_Male_Human_Win_02	但天譴軍團失去首領以後，無法安息的亡者只會對這個世界造成更大的威脅。	
VO_ICC08_Uther_Male_Human_WinA_01	世上永遠都需要一個…	
VO_ICC08_Uther_Male_Human_WinB_01	巫妖王！	
VO_ICC08_Valeera_Female_Human_WinA_01	世上永遠都需要一個…	
VO_ICC08_Valeera_Female_Human_WinB_01	巫妖王！	
VO_ICC09_LichKing_Male_Human_LichKing_02	別擔心，我不能打你。	
VO_ICC09_LichKing_Male_Human_Lose_01	下次帶把強一點的武器吧。	
VO_ICC09_LichKing_Male_Human_Win_01	他可是我最愛的傳說手下！但看來我得分解他，去合成其他更強的東西了。	
VO_ICC09_Saurfang_Male_Orc_AttackedByPlayer_01	儘管來吧！	
VO_ICC09_Saurfang_Male_Orc_AttacksPlayer_01	面對天譴軍團的力量吧！	
VO_ICC09_Saurfang_Male_Orc_AttacksPlayer_02	我就是死亡！	
VO_ICC09_Saurfang_Male_Orc_AttacksPlayer_03	巫妖王會奪走一切。	
VO_ICC09_Saurfang_Male_Orc_AttacksPlayer_04	戰鬥！死亡！你的命運已經註定了。	
VO_ICC09_Saurfang_Male_Orc_BloodBeast_01	吃吧，我的爪牙們!	
VO_ICC09_Saurfang_Male_Orc_BloodBeast_02	吃掉他們…	
VO_ICC09_Saurfang_Male_Orc_BloodBeast_03	我的力量只會更強。	
VO_ICC09_Saurfang_Male_Orc_BloodBeast_04	見識我的憤怒！	
VO_ICC09_Saurfang_Male_Orc_BloodBeastStolen_01	你的衣服會沾滿血的味道。	
VO_ICC09_Saurfang_Male_Orc_CursedBlade_01	這個鬼東西是誰的主意？	
VO_ICC09_Saurfang_Male_Orc_Death_01	我…終於…解脫了…	
VO_ICC09_Saurfang_Male_Orc_DKTransform_01	終於有值得一戰的對手了！	
VO_ICC09_Saurfang_Male_Orc_Doomerang_01	嗯…我也想要…	
VO_ICC09_Saurfang_Male_Orc_EmoteResponse_01	哭哭啼啼的膽小鬼。	
VO_ICC09_Saurfang_Male_Orc_EquipWeapon_01	以巫妖王之力！	
VO_ICC09_Saurfang_Male_Orc_EquipWeapon_02	還不錯嘛。	
VO_ICC09_Saurfang_Male_Orc_Intro_01	面對天譴軍團的力量吧！	
VO_ICC09_Saurfang_Male_Orc_LichKing_01	你為什麼在這裡？	
VO_ICC09_Saurfang_Male_Orc_WeaponDestroyed_01	啊啊啊！	
VO_ICC10_Deathwhisper_Female_Lich_DamageByValithria_01	啊…	
VO_ICC10_Deathwhisper_Female_Lich_Death_01	怎麼可能…！	
VO_ICC10_Deathwhisper_Female_Lich_DKTransform_01	啊，你也體驗過主人的力量了嗎…	
VO_ICC10_Deathwhisper_Female_Lich_EmoteResponse_01	哦，那是在威脅我嗎？	
VO_ICC10_Deathwhisper_Female_Lich_Equality_01	你好像打錯算盤了。	
VO_ICC10_Deathwhisper_Female_Lich_HeroPower_01	活人太弱了…	
VO_ICC10_Deathwhisper_Female_Lich_HeroPower_02	你的血肉是詛咒…	
VO_ICC10_Deathwhisper_Female_Lich_HeroPower_03	你瞭解自己的行為毫無意義嗎？	
VO_ICC10_Deathwhisper_Female_Lich_HeroPower_04	黑暗擁抱你…	
VO_ICC10_Deathwhisper_Female_Lich_HeroPowerInitial_01	死亡在呼喚你…	
VO_ICC10_Deathwhisper_Female_Lich_Intro_01	這騷動是怎麼回事？我的工作還沒完成。	
VO_ICC10_Deathwhisper_Female_Lich_LichKing_01	主人！請息怒！我…我會盡快解決他們！	
VO_ICC10_Deathwhisper_Female_Lich_PlayerPlaysEnrage_01	你的手下是被虐狂啊！	
VO_ICC10_Deathwhisper_Female_Lich_StoneskinGargoyle_01	什麼？我不知道這裡可以用開放卡牌！	
VO_ICC10_Deathwhisper_Female_Lich_ValithriaBlessedChampion_01	聖騎士，別插手！	
VO_ICC10_Deathwhisper_Female_Lich_ValithriaDivineShield_01	別再去幫那條龍了！	
VO_ICC10_Deathwhisper_Female_Lich_ValithriaResurrect_01	這遊戲開始不好玩了	
VO_ICC10_Deathwhisper_Female_Lich_ValithriaTaunt_01	你是怕我還不夠討厭那條龍嗎？	
VO_ICC10_Deathwhisper_Female_Lich_ValithriaWindfury_01	噁心。	
VO_ICC10_LichKing_Male_Human_DamageByValithria_02	那條龍會害我們的心血全都白費！亡語女士，消滅她！	
VO_ICC10_LichKing_Male_Human_Lose_01	帶些治療卡牌再來挑戰吧。	
VO_ICC10_LichKing_Male_Human_Turn2_01	亡語女士，我不是叫你解決那條龍嗎！	
VO_ICC10_LichKing_Male_Human_Turn2_02	身為詛咒神教的教主，你可真會利用時間啊。	
VO_ICC10_LichKing_Male_Human_Win_01	你的套牌讓我太失望了，亡語女士。但至少你輸得乾淨俐落。	
VO_ICC10_LichKing_Male_Human_Wounded_01	不要再玩了，亡語女士。趕快收拾他們。	
VO_ICC10_LichKing_Male_Human_Wounded_02	你的套牌裡為什麼沒有魔爆術？	
VO_ICCA08_033_Male_HumanGhost_Flavor_01	…幫我…	
VO_ICCA08_033_Male_HumanGhost_Flavor_02	…救救我們…	
VO_ICCA08_033_Male_HumanGhost_Flavor_03	…逃不掉…	
VO_ICCA08_033_Male_HumanGhost_Flavor_04	…有辦法逃嗎…	
VO_ICCA08_033_Male_HumanGhost_Flavor_05	…噓！	
VO_ICCA10_001_Female_GreenDragon_Healed_01	我…重生了！	
VO_ICCA10_001_Female_GreenDragon_Start_01	幫幫我，勇士！我絕不能…屈服…	
VO_Illhoof_Male_Demon_IlhoofKilrek_01	來吧，基瑞克。我們來完成召喚儀式！	
VO_Illhoof_Male_Demon_IllhoofDeath_02	不！就快好了！薩格…	
VO_Illhoof_Male_Demon_IllhoofEmoteResponse_01	儀式需要你的精華！	
VO_Illhoof_Male_Demon_IllhoofOpen_01	啊，來得正是時候！	
VO_Illhoof_Male_Demon_IllhoofSummonImps_01	來吧，黑暗中的生物！聽我號令！	
VO_Illhoof_Male_Demon_IllhoofSummoningPortal_01	不需要儀式就有傳送門？真是太方便了…	
VO_Illhoof_Male_Demon_IllhoofTurn1_01	召喚儀式開始啦！	
VO_Illhoof_Male_Demon_IllhoofWounded_01	寵物們，集合！一定要讓儀式完成！	
VO_INNKEEPER_Male_Dwarf_HSNewYearBrawl_02	烏鴉年的氣氛會有一點點…可怕。	
VO_INNKEEPER_Male_Dwarf_HSNewYearBrawl_03	你看，好像有烏鴉年的使者來了。	
VO_INNKEEPER_Male_Dwarf_HSNewYearBrawl_05	烏鴉年會有一些陰森的感覺…	
VO_INNKEEPER_Male_Dwarf_HSNewYearBrawl_08	躲藏的野獸會變得大膽…	
VO_INNKEEPER_Male_Dwarf_HSNewYearBrawl_09	黑暗的生物會到處搗亂…	
VO_INNKEEPER_Male_Dwarf_HSNewYearBrawl_10	沼澤的怪物會逐漸逼近…	
VO_Jaraxxus_Male_Demon_FinalMalchezaarJaraxxus_01	你太蠢啦，誰叫你不多練練卡拉OK！	
VO_Jaraxxus_Male_Demon_FinalMalchezaarJaraxxus_02	探險者…來這裡…探險者協會歡迎你…啊～	
VO_Julianne_Female_Human_JulianneDeath_01	羅慕歐，我來了！	
VO_Julianne_Female_Human_JulianneEmoteResponse_01	你在咬大拇指嗎？	
VO_Julianne_Female_Human_JulianneFeignDeath_03	然後從甜美的睡夢中甦醒…	
VO_Julianne_Female_Human_JulianneHeroPower_01	啊，溫和的夜晚，把我的羅慕歐還給我！	
VO_Julianne_Female_Human_JulianneOpen_01	你是什麼樣的惡魔？	
VO_KAR03_MOROES_MALE_HUMAN_CHESS_TURN_1	啊，我想起來了。棋子會在你的回合結束時自動攻擊。	
VO_KAR03_MOROES_MALE_HUMAN_CHESS_TURN_3	如果棋子在前方兩個敵人中間，就會同時攻擊他們！	
VO_KAR03_MOROES_MALE_HUMAN_CHESS_TURN_5	下好位置是致勝的關鍵。利用雙重攻擊！	
VO_KARA_04_01_Female_Human_CroneHuffer_01	噢，胡佛。我覺得這裡不是西部荒野…	
VO_KARA_04_01_Female_Human_CroneLionTigerBear_02	啊！有獅子有龍還有熊！天啊！	
VO_KARA_04_01_Female_Human_CroneTurn1_01	噢，不，別讓她傷害我！	
VO_KARA_04_01_Female_Human_CroneTurn3_01	來吧，只要手搭著手！我們就是最強的！	
VO_KARA_06_01_Male_Human_JulianneDeadlyPoison_02	啊，一劑毒藥！	
VO_KARA_06_01_Male_Human_JulianneTurn1_01	你想挑釁我嗎？那就來吧！	
VO_KT_ANTI_CHEESE1_65	這裡是英雄模式的納克薩瑪斯。我不會忍受這樣廉價的戰術。	
VO_KT_ANTI_CHEESE2_66	末日預言者？你以為你很聰明對吧。	
VO_KT_ANTI_CHEESE3_67	一視同仁？想都別想…	
VO_KT_ANUB2_43	不！我是說，無所謂。你無法擊敗大寡婦的。	
VO_KT_BARON2_64	軍事區太令我失望了。這個年頭要找靠得住的手下還真不容易。	
VO_KT_FAERLINA2_45	費琳娜不算什麼。蜘蛛之后會輕鬆解決你。	
VO_KT_GLUTH2_73	我問殭屍想不想吃你的腦子，他們說「我不吃垃圾食物」。	
VO_KT_GLUTH2_ALT_74	輸給古魯斯會拿到成就。我敢保證。	
VO_KT_GLUTH3_75	哈哈哈，其實輸給古魯斯沒有成就可以拿！	
VO_KT_GLUTH4_76	不！以後多餘的殭屍要給誰吃？	
VO_KT_GLUTH5_77	消滅敵人是我最愛的活動。等一下，把你的血液結凍才是我最愛的活動。	
VO_KT_GLUTH6_78	乖狗狗！這才是乖狗狗！	
VO_KT_GOTHIK2_62	為什麼高希沒有變成亡靈版的高希？搞什麼！	
VO_KT_GROBBULUS2_71	看來又得從頭設計了…	
VO_KT_HEIGAN2_55	我怒火中燒。燒很大。	
VO_KT_LOATHEB2_57	你一直在殺我的手下。停手，給我停手！	
VO_KT_MAEXXNA2_47	她的劇毒會讓你的死亡「幾乎」感覺不到痛苦。	
VO_KT_MAEXXNA3_48	海巨人？梅克絲娜，那張牌沒有在我的批准清單裡面！	
VO_KT_MAEXXNA4_49	不可能！我們還沒完，卑微的凡人！	
VO_KT_MAEXXNA6_51	手下被網住的玩家會怎樣？死定啦！	
VO_KT_NOTH2_53	可憐的諾斯。看來他有點恍神了。	
VO_KT_PATCHWERK2_69	我的戰鬥機器！我當初應該用更好的玩家把他拼起來的…	
VO_KT_RAZUVIOUS2_59	現在還有誰能幫我訓練死亡騎士？我沒空自己訓練，我超忙的。	
VO_KT_SAPPHIRON2_84	看看那個小地精。他以前也像你一樣是個闖入者。	
VO_KT_SAPPHIRON3_85	不要再躲在那個冰柱後面了！	
VO_KT_SAPPHIRON4_ALT_87	薩菲隆，執行「冰凍血液」的計畫！	
VO_KT_SAPPHIRON5_88	我的龍！我討厭你！	
VO_KT_THADDIUS2_81	闖入者！我不會再忍耐下去了！	
VO_LichKing_Male_Human_Brawl_01	必須淨化整座旅店…	
VO_LichKing_Male_Human_Brawl_03	想找幾個蠢蛋來打都可以，反正我一定會贏。	
VO_LichKing_Male_Human_Brawl_05	絕望吧，看看我的生命值有多高…	
VO_LichKing_Male_Human_ExpansionIntro_02	冰冠城塞！許多人為了追求強大的力量而來，但最後獲得的只有死亡。	
VO_LichKing_Male_Human_FinaleFirstVictory_01	不可能…不可能…我們說好了九戰五勝的，對吧？	
VO_LichKing_Male_Human_FinaleLock_01	你不可能打敗我…至少要等這一區開放了以後再說。	
VO_LichKing_Male_Human_FinaleUnlock_03	我是否該把霜之哀傷放下，祈求你的寬恕呢？先爆個雷：我不會。	
VO_LichKing_Male_Human_LowerCitadelUnlock_01	冰冠城塞！裡面有我最可怕的手下，因為他們不是用魔塵合出來的，是用怨念！	
VO_LichKing_Male_Human_PrologueBossCoin_01	來吧，勇士！我會消滅你，再把你分解成魔塵！	
VO_LichKing_Male_Human_PrologueBossCoin_02	這個可怕的骸骨怪物，是我用滿滿的恨意，和多出來的牌做的！	
VO_LichKing_Male_Human_PrologueBossCoin_03	死亡使者薩魯法爾是我的第一個傳說手下，我幫他量身打造了這個冒險篇章。	
VO_LichKing_Male_Human_PrologueBossCoin_04	這是亡語女士，而且是被削弱之前的亡語女士！	
VO_LichKing_Male_Human_PrologueBossCoin_05	普崔希德教授是我抽牌的手段，但是他每次都抽到一堆「毒氣」…我真的很討厭他。	
VO_LichKing_Male_Human_PrologueBossCoin_07	菈娜薩爾！你又咬壞我的牌了！我說過這些可是決鬥盤要用的！	
VO_LichKing_Male_Human_PrologueBossCoin_08	我都用辛德拉苟莎收頭！別想搶，她是我的！	
VO_LichKing_Male_Human_PrologueBossCoin_09	你會乞求我給你一個痛快。你會立刻按下「投降」。但我還是不會放過你。	
VO_LichKing_Male_Human_PrologueBossCoin_11	看看你自己，看看你變成什麼樣子。你和我，又有什麼不同呢？	
VO_LichKing_Male_Human_PrologueBossCoin_12	面對我的力量，他們根本是以卵擊石，但卻毫不畏懼。	
VO_LichKing_Male_Human_ResponseAnubaArak_01	聽我命令，阿努巴拉克！	
VO_LichKing_Male_Human_ResponseMalganis_01	瑪爾加尼斯，我要打敗你幾次，你才甘願？	
VO_LichKing_Male_Human_UpperReachesLock_01	你想用我的牌來對付我嗎？等我抄好牌，你就知道整個世界被黑暗籠罩是什麼滋味了。	
VO_LichKing_Male_Human_UpperReachesUnlock_01	你想用我的牌來對付我嗎？你知道我打上傳說幾次了嗎？	
VO_LOE_01_DEATH_2	奧爾希斯！為我復仇！	
VO_LOE_01_RESPONSE	在太陽的憤怒前顫抖吧！	
VO_LOE_01_STAFF	哈哈！是我的了！	
VO_LOE_01_STAFF_2	燃燒吧！	
VO_LOE_01_STAFF_2_RENO	保護好節杖。這東西很值錢啊。	
VO_LOE_01_START	我是無敵的！	
VO_LOE_01_WIN	哈哈！我拿到節杖啦！真希望哈里遜能看到我現在的樣子！	
VO_LOE_01_WIN_2	快把節杖搶過來！	
VO_LOE_01_WIN_2_ALT_2	呃…這麼晃是正常的嗎？	
VO_LOE_01_WOUNDED	哈哈，他快不行了！你來…呃…解決他。	
VO_LOE_02_DEATH	要回神燈裡啦，不～～	
VO_LOE_02_INTRO	太陽節杖，是我的！	
VO_LOE_02_MORE_WISHES	哇喔，這居然行得通。	
VO_LOE_02_PHAERIX_STAFF_RECOVER	你無法駕馭節杖的力量！	
VO_LOE_02_RESPONSE	奇蹟一般的宇宙神力！	
VO_LOE_02_START	終於自由啦！我就賞你個痛快！	
VO_LOE_02_START2	嗨，冒險者！我是里諾‧傑克森。世界知名的考古學家，探險家，和尋寶獵人。	
VO_LOE_02_START3	但是自制力奇差無比。	
VO_LOE_02_TURN_10	冒險者，這可是太陽節杖啊！想想看它有多值錢！	
VO_LOE_02_TURN_6	我有和你提過，當初我偽裝成巨魔，混進厄運之槌的故事嗎？	
VO_LOE_02_TURN_6_2	嗯…那我有說過，我溜進黑石講學廳去偷拿…	
VO_LOE_02_WIN	走吧！節杖就在前面！	
VO_LOE_02_WISH	真體貼啊。想殺我們，居然還可以許願！	
VO_LOE_03_RESPONSE	快點！	
VO_LOE_03_TURN_1	天花板要塌了！怪物要來了！快點！	
VO_LOE_03_TURN_10	快到了！我看到陽光了！	
VO_LOE_03_TURN_2	嘿嘿！有個發光的水池耶！	
VO_LOE_03_TURN_2_2	沒時間了啦！	
VO_LOE_03_TURN_3	嗯…左邊…還是右邊？	
VO_LOE_03_TURN_3_BOULDER	好大的石頭！快點閃開！	
VO_LOE_03_TURN_3_WARNING	喔，越來越晃了。我看下個回合天花板就要塌了！	
VO_LOE_03_TURN_4	嘿嘿，是尖刺陷阱！	
VO_LOE_03_TURN_4_BAD	噢呵呵呵！看起來有點不妙。	
VO_LOE_03_TURN_4_GOOD	嘿，不錯喔！幾乎跟我一樣厲害。	
VO_LOE_03_TURN_4_NEITHER	唉，怎麼跟烏龜一樣慢？動作快啊！	
VO_LOE_03_TURN_5	嘿！那個雕像不錯喔…還有顆閃亮的紅寶石…	
VO_LOE_03_TURN_5_4	糟糕，他生氣了。看來他想拿回紅寶石。	
VO_LOE_03_TURN_6	小心，天花板垮了！	
VO_LOE_03_TURN_6_2	喔！好險！還好我有拉到你。不必謝啦！	
VO_LOE_03_TURN_7	嗯…好黑喔。可是我覺得走這邊離出口比較近。走吧！	
VO_LOE_03_TURN_7_2	我的地圖上只寫著「不要進去」。	
VO_LOE_03_TURN_8	呼！越來越熱了，我們得快點！	
VO_LOE_03_TURN_9	噁。為什麼每次都會有蟲？	
VO_LOE_03_WIN	哈，成功啦！沒想過看到沙漠還會這麼開心！呼，口好渴啊。	
VO_LOE_04_RESPONSE	穴居怪，打笨蛋！	
VO_LOE_04_SCARVASH_TURN_2	穴居怪不笨！我讓你笨笨！	
VO_LOE_04_START	奧達曼是穴居怪的！	
VO_LOE_04_WIN	怎麼這麼多啊！走這邊，英雄！跳進礦車！	
VO_LOE_07_RESPONSE	你還有時間這樣玩嗎？	
VO_LOE_07_START	小心，有東西在追我們！	
VO_LOE_07_WIN	哈哈！搭礦車丟炸彈！這才帶勁！	
VO_LOE_08_ANIMATE_STONE	石塊與泥土，醒來吧！	
VO_LOE_08_LANDSLIDE	我要活埋你！	
VO_LOE_08_RESPONSE	你會化為塵土！	
VO_LOE_08_START	誰敢冒犯造物之神！	
VO_LOE_08_WIN	拿到杖頂了！還差一個組件！	
VO_LOE_092_Attack_02	看啊！	
VO_LOE_10_NYAH	呣嚕咕嚕咕嚕！	
VO_LOE_10_RESPONSE	呣咕嚕咕嚕咕嚕！	
VO_LOE_10_RESPONSE_ALT_read	中鰭，你在這裡做什麼？	
VO_LOE_10_START	呣咕嚕咕嚕咕嚕！	
VO_LOE_10_START_2	是嗎？這麼說真是太失禮了。	
VO_LOE_10_TURN_2_GIANTFIN	咕嚕嚕！呣嚕咕嚕咕嚕！	
VO_LOE_10_TURN1	呣嚕嚕！呣嚕咕嚕咕嚕！	
VO_LOE_10_WIN	可惜啊，要是多讀點書的話，他應該會變得斯文點。	
VO_LOE_12_NAZJAR_PEARL	了不起。浪潮珍珠比我想像的還厲害。	
VO_LOE_12_NAZJAR_TURN_1	我是艾薩拉之刃，無名小卒竟然敢挑戰我？	
VO_LOE_12_NAZJAR_TURN_1_FINLEY	我是芬利‧莫戈頓爵士，很榮幸見到你。	
VO_LOE_12_NAZJAR_TURN_3_FINLEY	伊莉絲，其他人的進展呢？	
VO_LOE_12_NAZJAR_TURN_5	深淵大軍啊，化身為死亡浪潮吞噬敵人吧！	
VO_LOE_12_NAZJAR_TURN_5_FINLEY	這手段太過激烈了吧。	
VO_LOE_12_NAZJAR_TURN_7_FINLEY	呣嚕嚕！呣嚕咕嚕咕嚕！	
VO_LOE_12_NAZJAR_TURN_7_FINLEY_2	抱…抱歉，探險者。有時候我會有點…失態。	
VO_LOE_12_RESPONSE	我擁有珍珠的力量！	
VO_LOE_12_START	浪潮之力會吞噬你！	
VO_LOE_12_WIN	太棒了！珍珠到手了！我們一起回探險者大廳，把法杖組裝起來！	
VO_LOE_13_RESPONSE	吼！	
VO_LOE_13_START_2	吼！	
VO_LOE_13_TURN_1	法杖有詛咒！它召喚了這個以太族穿越我們的結界！這傢伙想偷光我們的收藏品！	
VO_LOE_13_TURN_1_2	不對～我只要最好的。	
VO_LOE_13_TURN_5	喔～這真的是阿薩斯的璽戒嗎？而且還像新的一樣？	
VO_LOE_13_TURN_5_2	里諾、布萊恩，快把東西藏好！  	
VO_LOE_13_TURN_9	他復活了一支軍隊！伊莉絲，阻止他！	
VO_LOE_13_TURN_9_2	*咒語* 法杖的力量太強了，但我可以拖延他的時間！	
VO_LOE_13_WIN	我們會保護展覽品。探險者，去對付拉法姆！	
VO_LOE_14_RESPONSE	鏘！	
VO_LOE_14_START	洛薩的鎧甲！我在黑石山花了好幾個月才從龍的大便堆裡挖出來。	
VO_LOE_14_TURN_13	布萊恩！他讓藏書都活過來了！我去應付羅德隆展覽廳那些飛來飛去的錘子。	
VO_LOE_14_TURN_5	我解決東邊大廳那些活過來的劍了。伊莉絲，我該去幫誰？	
VO_LOE_14_TURN_5_2	去大儲藏室幫里諾！他被爆爆機器人困住了！	
VO_LOE_14_TURN_9	你們好像都很忙。這個漂亮的胸針我就自己拿了。	
VO_LOE_14_WIN	我們守住博物館了。探險者，去找拉法姆算帳吧！	
VO_LOE_15_RESPONSE	多麼棒的牌啊！	
VO_LOE_15_SPARE	探險者！我們還有套備用的牌，就用它吧！	
VO_LOE_16_BOOM_BOT	喔，還有好多個可以用。解決他！	
VO_LOE_16_CROWN	瘋法師的魔法就是有辦法。	
VO_LOE_16_EYE	真奇怪，這東西怎麼還在口袋裡？就借你用吧。	
VO_LOE_16_FIRST_ITEM	我們正在博物館找可以派上用場的東西。需要的話就喊一聲！	
VO_LOE_16_GOBLET	我討厭蛇。	
VO_LOE_16_GREAVE	洛薩的盔甲還有一個地方沒壞。	
VO_LOE_16_LOCKET	卡拉贊的冤魂還在這個墜盒裡作祟。	
VO_LOE_16_PIPE	接好！別跟布萊恩說，他很喜歡這支菸斗！	
VO_LOE_16_RAFAAM_DEATH2	不！我不可能會輸！	
VO_LOE_16_SHARD	這是從寫著…「請勿開啟」的箱子拿出來的。所以…呃…祝你好運！	
VO_LOE_16_SPLINTER	這是我在熔火之心找到的，埃克索圖斯會用它來剔牙。	
VO_LOE_16_START_2	法杖正在充能，小心！	
VO_LOE_16_TEAR	這是我們夜精靈的聖物，快喝下去！	
VO_LOE_16_TURN_2	法杖快要到達極限了，準備！	
VO_LOE_16_TURN_2_2	哈哈哈！無與倫比的力量！	
VO_LOE_16_TURN_2_3	法杖超載了！就是現在！	
VO_LOE_16_TURN_3	我是無敵的！你們別想擊敗我！	
VO_LOE_16_TURN_3_2	法杖又開始充能了，等等還有另一次機會。	
VO_LOE_16_TURN_4	法杖快要充能完成了，做好準備！	
VO_LOE_16_TURN_5	哈哈哈！無與倫比的力量！	
VO_LOE_16_TURN_5_2	他的護盾沒了，上吧！	
VO_LOE_16_TURN_6	護盾又出現了，小心！	
VO_LOE_16_VIAL	上面寫著「請喝我」。但這東西是在納克薩瑪斯找到的，所以沒人想試。	
VO_LOE_ARCHAEDAS_TURN_1_CARTOGRAPHER	如果他沒有忙著把你們埋在石堆裡的話。	
VO_LOE_GIANTFIN_TIDEHUNTER_2	不，芬利！你跟他們完全不同。	
VO_LOE_NAZJAR_TURN_3_CARTOGRAPHER	里諾帶回太陽節杖了，然後布萊恩正在回來的路上。	
VO_LOE_SCARVASH_TURN_6_CARTOGRAPHER	專心點，布萊恩！	
VO_LOE_ZINAAR_TURN_10_CARTOGRAPHER_2	我們沒有要賣。	
VO_LOE_ZINAAR_TURN_6_CARTOGRAPHER_2	說過了。	
VO_LOE_ZINAAR_TURN_6_CARTOGRAPHER_2_ALT	說過了。	
VO_LOE10_DEAD_MURLOCS	死了這麼多人，真是遺憾。	
VO_LOE10_NYAH_FINLEY	哦，我的天啊。別這麼幼稚。	
VO_LOE10_TIDEHUNTER	遇見伊莉絲之前，我是個獵潮者。難道這就是我原本的命運嗎？	
VO_LOE10_TURN_2_FINLEY	各位兄弟！我們非得一決生死嗎？	
VO_LOE10_TURN_2_FINLEY_2	看來是免不了了。	
VO_LOEA04_BRANN_TURN_1	以前斯卡瓦還是個小小穴居怪。現在他變大、變笨，也變醜了。	
VO_LOEA04_BRANN_TURN_6	真有趣，這些符文寫著守護者的密文，歷史可追溯到泰坦時代！	
VO_LOEA07_MINE_ALMOST_DONE	快到了！這個按鈕是幹嘛的…	
VO_LOEA07_MINE_ARCHAEDAS	麥格尼的鬍子啊！這是阿札達斯嗎？	
VO_LOEA07_MINE_BARREL_FORWARD	全速前進！	
VO_LOEA07_MINE_BOOM	彈跳爆彈！給他們來點教訓！	
VO_LOEA07_MINE_BOOMZOOKA	轟！等我一下，準備再來一發！	
VO_LOEA07_MINE_DETONATE	你要炸掉整個礦坑嗎？你瘋了嗎？	
VO_LOEA07_MINE_DYNAMITE	小心點！你炸壞了一段軌道！	
VO_LOEA07_MINE_HUNKER_DOWN	趴下！	
VO_LOEA07_MINE_PARROT	飛吧！	
VO_LOEA07_MINE_RAMMING	哈哈！不要擋路！	
VO_LOEA07_MINE_REPAIRS	用砂囊口香糖黏一下就跟新的一樣了！	
VO_LOEA07_MINE_SPIKED_DECOY	嘿！笨穴居怪！來抓我啊！	
VO_LOEA08_TURN_1_BRANN	古代泰坦的僕人…他可以告訴我們好多故事啊。	
VO_LOEA09_1_RESPONSE	晚餐有著落了！	
VO_LOEA09_1_TURN1	你膽敢入侵古城遺跡？	
VO_LOEA09_FINLEY_DEATH	我等等就會復原了。探險者，解決掉那個納迦！	
VO_LOEA09_HERO_POWER	開飯啦！今晚喝魚人湯！	
VO_LOEA09_HERO_POWER1	你好，冒險者。我似乎碰到了點小麻煩，請問你可以幫我個忙嗎？	
VO_LOEA09_HERO_POWER2	我說啊！這裡還真是黑呀。	
VO_LOEA09_HERO_POWER3	噢糟糕，是不是越來越熱了？	
VO_LOEA09_HERO_POWER4	我說啊，這真是不太好受。	
VO_LOEA09_HERO_POWER5	呃…真的越來越熱了。	
VO_LOEA09_HERO_POWER6	能幫點忙的話，我會非常感激的。	
VO_LOEA09_QUOTE1	多謝啦，朋友！真是千鈞一髮呀！	
VO_LOEA09_UNSTABLE	滾回鍋裡！	
VO_LOEA09_WIN	萬分感謝，冒險者。我帶你去找最後的組件吧？	
VO_LOEA10_1_MIDDLEFIN	中鰭，你在這裡做什麼？	
VO_LOEA15_1_LOSS_11	你的牌太廢了，我要用我自己的！	
VO_LOEA15_1_LOW_HEALTH_10	看來我犯的最大錯誤，就是用了你的牌。	
VO_LOEA15_1_MAGMA_RAGER_09	熔岩狂怒者？你怎麼會放這張牌？	
VO_LOEA15_1_START_07	我喜歡你這副牌。我要拿來用。	
VO_LOEA15_1_TURN1_08	太棒啦！真是一手好牌！	
VO_LOEA15_1_WIN_12	你的牌真好啊！哈哈哈！	
VO_LOEA15_GOLDEN	全都是金卡？你的收藏比我還厲害！	
VO_LOEA16_1_CARD_04	我從無數世界收集來的寶物！	
VO_LOEA16_1_RESPONSE_03	好！很好！	
VO_LOEA16_1_START_01	見識法杖真正的力量吧！	
VO_LOEA16_1_TURN1_02	我是無敵的！我擁有泰坦的力量！	
VO_LOOT_329_Male_Elemental_Attack_01	枯萎。	
VO_LOOT_329_Male_Elemental_Death_01	<Death>	
VO_LOOT_329_Male_Elemental_Play_01	生命會腐爛…腐爛有生命…	
VO_LOOT_541_Male_Kobold_BOSS_AFKay_01	打她！趁這個詹莉暫離的時候，用力打她！	
VO_LOOT_541_Male_Kobold_BOSS_Blackseed_01	黑種子挖很深、很深，回來就有觸手了。	
VO_LOOT_541_Male_Kobold_BOSS_Brimstone_01	噓！雕像有眼睛，亮亮的眼睛。不要吵醒它們！	
VO_LOOT_541_Male_Kobold_BOSS_Candlebeard_01	蠟燭鬍子以為找到寶藏，就可以讓狗頭人變海盜了。	
VO_LOOT_541_Male_Kobold_BOSS_Chronomancer_01	時間巫師！我們又第一次見面了！	
VO_LOOT_541_Male_Kobold_BOSS_Everrot_01	不要碰孢子！讓手下去碰！	
VO_LOOT_541_Male_Kobold_BOSS_Flurgl_01	狗頭人不懂魚人。他們一直說一直說，可是有說沒有懂。	
VO_LOOT_541_Male_Kobold_BOSS_GeorgeKarl_01	這兩個是叢林迷路過來的。	
VO_LOOT_541_Male_Kobold_BOSS_Gnosh_01	隧道不是隧道！是大嘴巴！牙齒尖尖的嘴巴！	
VO_LOOT_541_Male_Kobold_BOSS_Graves_01	這個補血的很囉嗦。聖光啊！聖光啊！有夠吵，殺掉！	
VO_LOOT_541_Male_Kobold_BOSS_Gutmook_01	哼，穴居怪！最好閉上嘴巴，讓手下來打。	
VO_LOOT_541_Male_Kobold_BOSS_Hamm_01	哈姆很會挖洞！「挖」是客氣的說法。	
VO_LOOT_541_Male_Kobold_BOSS_Jeeru_01	喔不要不要，不要摸油燈！是討厭的陷阱。	
VO_LOOT_541_Male_Kobold_BOSS_Lyris_01	瘋狂的精靈！你要小心她鬼鬼祟祟的火蛇人。	
VO_LOOT_541_Male_Kobold_BOSS_MagmaRager_01	狗頭人堵住了熔岩管，可是它會一直打開。   	
VO_LOOT_541_Male_Kobold_BOSS_Mothergloop_01	小心黏媽媽，所有黏黏的東西都是從這個黏黏東西的媽媽來的。	
VO_LOOT_541_Male_Kobold_BOSS_Mushhuckster_01	蘑菇販子麥克斯是地城貧民區跑來的。	
VO_LOOT_541_Male_Kobold_BOSS_Russell_01	這個詩人唱的歌讓大家都想打頭。	
VO_LOOT_541_Male_Kobold_BOSS_Seriona_01	笨蛋暮光龍害狗頭人變弱！呃… 變更弱！	
VO_LOOT_541_Male_Kobold_BOSS_Sturmi_01	史嘟咪會做小蠟人！喔，狗頭人派對有她就很好玩。	
VO_LOOT_541_Male_Kobold_BOSS_TrappedRoom_01	噓… 不要… 亂碰… 東西… 	
VO_LOOT_541_Male_Kobold_BOSS_TreasureVault_01	寶藏！寶藏在這裡！快點打破！快點拿！	
VO_LOOT_541_Male_Kobold_BOSS_Troll_01	均衡的地城飲食不能少了食人妖頭目。	
VO_LOOT_541_Male_Kobold_BOSS_Whopwhisker_01	轟鬍子是最會生氣的狗頭人。	
VO_LOOT_541_Male_Kobold_DefeatPlayer_01	好多好多寶藏！嘿嘿！我的、我的、我的、我的、我的…！	
VO_LOOT_541_Male_Kobold_EmoteResponse_01	嘴巴不要一直說啦！	
VO_LOOT_541_Male_Kobold_LOOT_Backpacks_01	背包！不一定要背在背上。	
VO_LOOT_541_Male_Kobold_LOOT_Boombox_01	爆爆箱！最爆爆的炸彈！最爆爆的爆爆箱！	
VO_LOOT_541_Male_Kobold_LOOT_Candle1_01	不能拿走蠟燭！	
VO_LOOT_541_Male_Kobold_LOOT_Candle2_01	我告訴你！我告訴你你不能拿，你還是拿！	
VO_LOOT_541_Male_Kobold_LOOT_CapturedFlag_01	聯盟和部落都是愛搶旗子的瘋子。	
VO_LOOT_541_Male_Kobold_LOOT_Cube_01	喔，瘋狂的方盒子！在打贏已經不可能的時候用！	
VO_LOOT_541_Male_Kobold_LOOT_Invisibility_01	隱形斗篷！我一直搞丟！因為是隱形的。	
VO_LOOT_541_Male_Kobold_LOOT_QuelDelar_01	奎爾德拉！傳說寶劍變一半。不是我弄的喔。	
VO_LOOT_541_Male_Kobold_LOOT_QuelDelarForged_01	好漂亮！好閃亮！好…好劍啊！	
VO_LOOT_541_Male_Kobold_LOOT_Wand_01	狗頭人尊敬「烤肉節杖」，這是一張需要技巧的牌。	
VO_LOOT_541_Male_Kobold_LOOT_WaxRager_01	蠟燭狂怒者是很厲害的朋友。不要問蠟是哪裡來的。是耳朵。	
VO_LOOT_541_Male_Kobold_TUT_AdventureSelect_01	什麼味道？有皮？有鐵？還有火把…是冒險者。可惡！是冒險者！	
VO_LOOT_541_Male_Kobold_TUT_BossHeroPower_01	怪物會做的事不一樣。但是都很壞。點點看看就知道！	
VO_LOOT_541_Male_Kobold_TUT_BountyBoard_01	住手！回去！一大堆寶物都是我的，不是你的！	
VO_LOOT_541_Male_Kobold_TUT_CharacterSelect_01	誰敢搶狗頭人寶藏？是拿劍的？還是手上有火花的？	
VO_LOOT_541_Male_Kobold_TUT_Final_Boss_Azari_01	吞噬者跑出來了！快逃啊！	
VO_LOOT_541_Male_Kobold_TUT_Final_Boss_Darkness_01	小心黑暗！你一定要！這就是為什麼，狗頭人都要有蠟燭。	
VO_LOOT_541_Male_Kobold_TUT_Final_Boss_KoboldKing_01	換我了，哈哈！你不拿的寶物我都拿走了！	
VO_LOOT_541_Male_Kobold_TUT_Final_Boss_Vustrasz_01	你要拿走龍的寶藏？喔，他會好生氣、好生氣… 	
VO_LOOT_541_Male_Kobold_TUT_Final_Boss_Xol_01	不要看莎爾的眼睛！她的大臉上面都是眼睛。	
VO_LOOT_541_Male_Kobold_TUT_Game1Begin1_01	剛開始的怪物小小弱弱的。但是你也一樣！	
VO_LOOT_541_Male_Kobold_TUT_Game1Begin2_01	打死他們，搶走東西，你變厲害！	
VO_LOOT_541_Male_Kobold_TUT_Game1Defeat_01	沒關係。早點死比老不死好。	
VO_LOOT_541_Male_Kobold_TUT_Game1Victory_01	你贏了！寶藏是你的啦！嘿嘿，真是個厲害的冒險者。	
VO_LOOT_541_Male_Kobold_TUT_Game2Begin1_01	你變得越強，怪物也變得越強。	
VO_LOOT_541_Male_Kobold_TUT_Game2Begin2_01	彈性貨幣政策是狗頭人帝國混合市場經濟體系的重要部分。	
VO_LOOT_541_Male_Kobold_TUT_GeneralDefeat1_01	不好了，你不好了。冒險者死掉，狗頭人國王拿走全部寶物！	
VO_LOOT_541_Male_Kobold_TUT_GeneralDefeat2_01	派更多冒險者來！哈哈！更多寶物給我，寶物，寶物… 更多寶物…	
VO_LOOT_541_Male_Kobold_TUT_MainBoss1_01	狗頭人帝國有很多怪物。打架會讓你變強壯！…或者死掉。	
VO_LOOT_541_Male_Kobold_TUT_MainBoss3_01	打一次地城，要打八隻怪物！一隻一根手指頭！	
VO_LOOT_541_Male_Kobold_TUT_TreasureSelect1_01	喔！喔～大寶藏！你選一個，只能選一個。好好選。	
VO_LOOT_541_Male_Kobold_TUT_TreasureSelect2_01	現在選的是卡牌。要放到地城套牌的卡牌。	
VO_LOOT_541_Male_Kobold_TUT_TreasureSelect3_01	組一個打怪物的牌。要用到你死掉的牌！	
VO_LOOT_541_Male_Kobold_TUT_TreasureSelect4_01	打贏更多架，拿更多寶物！狗頭人就是這樣！	
VO_LOOT_541_Male_Kobold_TUT_Victory1_01	什麼?!沒有人可以拿走狗頭人寶藏！	
VO_LOOT_541_Male_Kobold_TUT_Victory2_01	不可以讓你九次都贏！	
VO_LOOT_541_Male_Kobold_TUT_VictoryComplete_01	你成功了！你像地下城主一樣變成地下的城主了！	
VO_LOOT_541_Male_Kobold_TUT_VictoryComplete_02	你成功了！你是地下城的老大了！	
VO_LOOTA_829_Male_Human_Event_01	這是我突然，但是又必然的背叛！	
VO_LOOTA_BOSS_04h_Female_Kobold_Death_01	*慘叫*	
VO_LOOTA_BOSS_04h_Female_Kobold_DefeatPlayer_01	不要掙扎！讓蠟冷卻…你真漂亮、漂亮、漂亮…	
VO_LOOTA_BOSS_04h_Female_Kobold_EmoteResponse_01	我是蠟術師…不是打蠟的。	
VO_LOOTA_BOSS_04h_Female_Kobold_EventWaxOff_01	左手上蠟…	
VO_LOOTA_BOSS_04h_Female_Kobold_EventWaxOn_01	右手上蠟…	
VO_LOOTA_BOSS_04h_Female_Kobold_EventWaxRagerPlay_01	喔…漂亮！	
VO_LOOTA_BOSS_04h_Female_Kobold_EventWaxRagerRespawn_01	喔…他會一直出現！	
VO_LOOTA_BOSS_04h_Female_Kobold_Intro1_01	喔～蠟，有眼睛…	
VO_LOOTA_BOSS_04h_Female_Kobold_Intro2_01	我會做漂亮的蠟像，好漂亮的蠟像。	
VO_LOOTA_BOSS_05h_Male_Kobold_Death_01	*慘叫*	
VO_LOOTA_BOSS_05h_Male_Kobold_DefeatPlayer_01	爆爆！哈姆爆爆！	
VO_LOOTA_BOSS_05h_Male_Kobold_EmoteResponse_01	不要爆爆。	
VO_LOOTA_BOSS_05h_Male_Kobold_EventBoomBots_01	好－好－好好好！	
VO_LOOTA_BOSS_05h_Male_Kobold_EventMadBomberDeath_01	啊～不要這樣…	
VO_LOOTA_BOSS_05h_Male_Kobold_HeroPower1_01	爆吧！寶貝！哈哈！爆炸！	
VO_LOOTA_BOSS_05h_Male_Kobold_HeroPower2_01	啊哈哈哈哈！	
VO_LOOTA_BOSS_05h_Male_Kobold_HeroPower3_01	啊哈哈哈哈啊哈哈！	
VO_LOOTA_BOSS_05h_Male_Kobold_Intro_01	嘻嘻嘻！要爆啦！	
VO_LOOTA_BOSS_06h_Male_Furbolg_Death_01	還有一個…在底下很深的地方…	
VO_LOOTA_BOSS_06h_Male_Furbolg_DefeatPlayer_01	是我…是我殺的嗎？我做了什麼…？	
VO_LOOTA_BOSS_06h_Male_Furbolg_EmoteResponse_01	你只是另一個…聲音…	
VO_LOOTA_BOSS_06h_Male_Furbolg_EventPlayerEvolves_01	你被黑暗感染了。	
VO_LOOTA_BOSS_06h_Male_Furbolg_HeroPower1_01	它在呼喚…	
VO_LOOTA_BOSS_06h_Male_Furbolg_HeroPower2_01	這個洞穴很深。	
VO_LOOTA_BOSS_06h_Male_Furbolg_HeroPower3_01	事情和你想的不一樣…	
VO_LOOTA_BOSS_06h_Male_Furbolg_HeroPower4_01	誰才是這裡的怪物？	
VO_LOOTA_BOSS_06h_Male_Furbolg_HeroPower5_01	你沒看見暗影…但是他們看見你。	
VO_LOOTA_BOSS_06h_Male_Furbolg_Intro_01	這底下有邪惡的東西…	
VO_LOOTA_BOSS_09h_Female_Furbolg_Death_01	*慘叫*	
VO_LOOTA_BOSS_09h_Female_Furbolg_DefeatPlayer_01	這就是我們冬泉谷的風格。	
VO_LOOTA_BOSS_09h_Female_Furbolg_EmoteResponse_01	真是冷淡。	
VO_LOOTA_BOSS_09h_Female_Furbolg_EventFrostMagic1_01	你也要擁抱冰冷。	
VO_LOOTA_BOSS_09h_Female_Furbolg_EventFrostMagic2_01	*發抖*	
VO_LOOTA_BOSS_09h_Female_Furbolg_EventFrostMagic3_01	冰冷！	
VO_LOOTA_BOSS_09h_Female_Furbolg_HeroPower1_01	待著別動。	
VO_LOOTA_BOSS_09h_Female_Furbolg_HeroPower2_01	喔，不行。別想攻擊。	
VO_LOOTA_BOSS_09h_Female_Furbolg_HeroPower3_01	乖乖待著。	
VO_LOOTA_BOSS_09h_Female_Furbolg_Intro_01	狗頭人，我不是說…喔，這是哪位啊？	
VO_LOOTA_BOSS_10h_Male_Human_Death_01	這是註定的…	
VO_LOOTA_BOSS_10h_Male_Human_DefeatPlayer_02	我要拿走寶藏。為了聖光！…也為了我。	
VO_LOOTA_BOSS_10h_Male_Human_EmoteResponse_01	跪地求饒也救不了你。	
VO_LOOTA_BOSS_10h_Male_Human_EventOverdraw_01	噢！北郡教士用過頭了！	
VO_LOOTA_BOSS_10h_Male_Human_HeroPower1_01	信念！	
VO_LOOTA_BOSS_10h_Male_Human_HeroPower2_01	你獲得治療了！	
VO_LOOTA_BOSS_10h_Male_Human_HeroPower3_01	棄暗投明！	
VO_LOOTA_BOSS_10h_Male_Human_HeroPower4_01	慈愛的聖光啊！	
VO_LOOTA_BOSS_10h_Male_Human_HeroPower5_01	榮耀聖光！	
VO_LOOTA_BOSS_10h_Male_Human_Intro_01	站住！以聖光之名，把寶藏交給我！	
VO_LOOTA_BOSS_11h_Male_Trogg_Death_01	*慘叫*	
VO_LOOTA_BOSS_11h_Male_Trogg_DefeatPlayer_01	好老闆會教手下、帶手下，還有打手下。	
VO_LOOTA_BOSS_11h_Male_Trogg_EmoteResponse_01	不准說話！只准挨鞭子！	
VO_LOOTA_BOSS_11h_Male_Trogg_EventEquality_01	這些手下居然挨過鞭子了！	
VO_LOOTA_BOSS_11h_Male_Trogg_HeroPower1_01	動起來！	
VO_LOOTA_BOSS_11h_Male_Trogg_HeroPower2_01	快一點！	
VO_LOOTA_BOSS_11h_Male_Trogg_HeroPower3_01	動作快！	
VO_LOOTA_BOSS_11h_Male_Trogg_HeroPower4_01	不要偷懶！	
VO_LOOTA_BOSS_11h_Male_Trogg_HeroPower5_01	鞭打！	
VO_LOOTA_BOSS_11h_Male_Trogg_Intro_01	吃我一鞭！	
VO_LOOTA_BOSS_12h_Male_Kobold_CandleAttack1_01	你讓蠟燭很生氣！	
VO_LOOTA_BOSS_12h_Male_Kobold_CandleAttack2_01	不要嘲諷蠟燭！	
VO_LOOTA_BOSS_12h_Male_Kobold_CandleAttack3_01	拉卡尼休！	
VO_LOOTA_BOSS_12h_Male_Kobold_CandleAttack4_01	蠟燭！蠟燭！	
VO_LOOTA_BOSS_12h_Male_Kobold_CandleAttack5_01	你不能對付蠟燭！	
VO_LOOTA_BOSS_12h_Male_Kobold_Death_01	不要…拿走…	
VO_LOOTA_BOSS_12h_Male_Kobold_Death1_01	要溺水啦！	
VO_LOOTA_BOSS_12h_Male_Kobold_Death2_01	呦…呵…	
VO_LOOTA_BOSS_12h_Male_Kobold_Death3_01	啊！沉下去了…	
VO_LOOTA_BOSS_12h_Male_Kobold_DefeatPlayer_01	哈哈啊！這是你自找的！	
VO_LOOTA_BOSS_12h_Male_Kobold_DefeatPlayer_02	好多寶藏！哈哈哈…可以拿去給拉法姆看了…	
VO_LOOTA_BOSS_12h_Male_Kobold_EmoteResponse_01	啊！閉嘴，你這個地面來的！	
VO_LOOTA_BOSS_12h_Male_Kobold_EventCandleStolen_01	什麼!?拿走蠟燭的規定已經說很清楚了！	
VO_LOOTA_BOSS_12h_Male_Kobold_EventChargeBigMinion_01	喔…呵…呵！哈哈哈！	
VO_LOOTA_BOSS_12h_Male_Kobold_EventFindCandle_01	喔，寶貝蠟燭！噓，別怕…我拿了…我拿了…	
VO_LOOTA_BOSS_12h_Male_Kobold_EventPlayCandle_01	我說過了，你不能拿！	
VO_LOOTA_BOSS_12h_Male_Kobold_EventPlayerPlaysCrab_01	把它趕走！呃啊！	
VO_LOOTA_BOSS_12h_Male_Kobold_EventPlayerPlaysPatches_01	不對，我還沒叫你衝！	
VO_LOOTA_BOSS_12h_Male_Kobold_EventPlayKoboldKing_01	喔！我才是國王！	
VO_LOOTA_BOSS_12h_Male_Kobold_GetTreasure1_01	我也有寶藏！	
VO_LOOTA_BOSS_12h_Male_Kobold_GetTreasure2_01	亮亮的東西給狗頭人王… 	
VO_LOOTA_BOSS_12h_Male_Kobold_GetTreasure3_01	我拿到什麼？喔！好棒！	
VO_LOOTA_BOSS_12h_Male_Kobold_GetTreasure4_01	嗯… 寶藏！	
VO_LOOTA_BOSS_12h_Male_Kobold_GetTreasure5_01	我的地城！我的寶藏！	
VO_LOOTA_BOSS_12h_Male_Kobold_Intro_01	你放下寶藏！快快！我拿走！我的！	
VO_LOOTA_BOSS_12h_Male_Kobold_Intro1_01	喔！嘻嘻我的蠟燭芯！	
VO_LOOTA_BOSS_12h_Male_Kobold_Intro2_01	呼呼我的鬍子！	
VO_LOOTA_BOSS_12h_Male_Kobold_Intro3_01	喔啊～敲敲我的十字鎬！	
VO_LOOTA_BOSS_13h_Female_Undead_Death_01	*慘叫*	
VO_LOOTA_BOSS_13h_Female_Undead_DefeatPlayer_01	來看看你帶了什麼…拜託，你真的選了這些牌？ 	
VO_LOOTA_BOSS_13h_Female_Undead_EmoteResponse_01	你是新來的嗎？我們都不打招呼的。	
VO_LOOTA_BOSS_13h_Female_Undead_EventBagOfCoins_01	喔～是個有錢的冒險者…	
VO_LOOTA_BOSS_13h_Female_Undead_EventStealQuest_01	住手！小偷！	
VO_LOOTA_BOSS_13h_Female_Undead_HeroPower_01	到我背後！	
VO_LOOTA_BOSS_13h_Female_Undead_HeroPower1_01	退後。	
VO_LOOTA_BOSS_13h_Female_Undead_HeroPower2_01	動作快。	
VO_LOOTA_BOSS_13h_Female_Undead_HeroPower3_01	自由來去陰影…	
VO_LOOTA_BOSS_13h_Female_Undead_HeroPower4_01	別讓敵人有攻擊目標。	
VO_LOOTA_BOSS_13h_Female_Undead_Intro_01	把寶藏交出來，我就給你個痛快。	
VO_LOOTA_BOSS_15h_Male_Human_Death_01	*慘叫*	
VO_LOOTA_BOSS_15h_Male_Human_DefeatPlayer_01	好了。要是我們走這條路的話，說不定就能找到回安戈洛的路。	
VO_LOOTA_BOSS_15h_Male_Human_EmoteResponse_01	我是不是在安戈洛見過你？	
VO_LOOTA_BOSS_15h_Male_Human_Intro_01	聖光啊，卡爾！我們跑到什麼地方了！	
VO_LOOTA_BOSS_15h_Male_Human_PartnerDeath_01	聖光啊，你殺了卡爾！	
VO_LOOTA_BOSS_15h_Male_Human_TaggedIn1_01	讓開，交給我來處理。	
VO_LOOTA_BOSS_15h_Male_Human_TaggedIn2_01	太誇張了。把牌給我。	
VO_LOOTA_BOSS_15h_Male_Human_TaggedIn3_01	退後！換我來。	
VO_LOOTA_BOSS_16h_Male_Troll_Death_01	我要…跟我自己…講話了！	
VO_LOOTA_BOSS_16h_Male_Troll_DefeatPlayer_01	嘿～小小死人不要擔心。阿祖恩會陪你。	
VO_LOOTA_BOSS_16h_Male_Troll_EmoteResponse_01	我講給死人聽。你講給我的手聽。	
VO_LOOTA_BOSS_16h_Male_Troll_EventPlayerDeathrattle1_01	嘿嘿，那一個還不錯。	
VO_LOOTA_BOSS_16h_Male_Troll_EventPlayerDeathrattle2_01	這裡沒有人可以安息。	
VO_LOOTA_BOSS_16h_Male_Troll_EventPlayerDeathrattle3_01	我來幫那個一下下。	
VO_LOOTA_BOSS_16h_Male_Troll_EventPlayerDeathrattle4_01	那個東西最好趕快…死掉。	
VO_LOOTA_BOSS_16h_Male_Troll_EventPlayerDeathrattle5_01	你只能死…兩次。	
VO_LOOTA_BOSS_16h_Male_Troll_Intro_01	我會跟死人講話！對不對？對～！	
VO_LOOTA_BOSS_17h_Male_Troll_Death_01	*慘叫*	
VO_LOOTA_BOSS_17h_Male_Troll_DefeatPlayer_01	你來打金佐，金佐就讓你很痛。	
VO_LOOTA_BOSS_17h_Male_Troll_EmoteResponse_01	不要用講的，要用吼～的！	
VO_LOOTA_BOSS_17h_Male_Troll_EventPlayerBattlecry1_01	喔…我喜歡這種態度。	
VO_LOOTA_BOSS_17h_Male_Troll_EventPlayerBattlecry2_01	金佐覺得可以！	
VO_LOOTA_BOSS_17h_Male_Troll_EventPlayerBattlecry3_01	很好！這個有金佐Style！	
VO_LOOTA_BOSS_17h_Male_Troll_EventPlayerBrann_01	小小矮人以為他吼得跟金佐一樣大聲？錯了！	
VO_LOOTA_BOSS_17h_Male_Troll_Intro_01	金佐會好好處理你！	
VO_LOOTA_BOSS_19h_Male_Trogg_Death_01	*慘叫*	
VO_LOOTA_BOSS_19h_Male_Trogg_DefeatPlayer_01	你用怪招，就把你打扁。	
VO_LOOTA_BOSS_19h_Male_Trogg_EmoteResponse_01	你喜歡穴居怪？我有好多穴居怪。	
VO_LOOTA_BOSS_19h_Male_Trogg_EventHandFull_01	安靜！我…呃，太多了！	
VO_LOOTA_BOSS_19h_Male_Trogg_HeroPower1_01	穴居怪，過來！	
VO_LOOTA_BOSS_19h_Male_Trogg_HeroPower2_01	再放啊。我還有穴居怪。	
VO_LOOTA_BOSS_19h_Male_Trogg_HeroPower3_01	他們可以聞到魔法。	
VO_LOOTA_BOSS_19h_Male_Trogg_HeroPowerHard1_01	好多力量。	
VO_LOOTA_BOSS_19h_Male_Trogg_HeroPowerHard2_01	再放啊。	
VO_LOOTA_BOSS_19h_Male_Trogg_HeroPowerHard3_01	啊…魔法…	
VO_LOOTA_BOSS_19h_Male_Trogg_Intro_01	對穴居怪跪下！	
VO_LOOTA_BOSS_20h_Male_Earthen_Death_01	沉睡…	
VO_LOOTA_BOSS_20h_Male_Earthen_DefeatPlayer_01	這裡安全了。	
VO_LOOTA_BOSS_20h_Male_Earthen_EmoteResponse_01	你無法阻止我。	
VO_LOOTA_BOSS_20h_Male_Earthen_EventPlayerSilence_01	好吧…謝謝你。	
VO_LOOTA_BOSS_20h_Male_Earthen_EventStatueDestroyed1_01	你只是在拖延時間。	
VO_LOOTA_BOSS_20h_Male_Earthen_EventStatueDestroyed2_01	只是時間早晚的問題。	
VO_LOOTA_BOSS_20h_Male_Earthen_EventStatueDestroyed3_01	你褻瀆了這個地方。	
VO_LOOTA_BOSS_20h_Male_Earthen_EventStatueDestroyed4_01	我…必須保護…聖地…	
VO_LOOTA_BOSS_20h_Male_Earthen_EventStatueDestroyed5_01	我的意志堅若磐石…	
VO_LOOTA_BOSS_20h_Male_Earthen_HeroPower_01	醒來吧！	
VO_LOOTA_BOSS_20h_Male_Earthen_HeroPowerNoStatues_01	醒來吧！…喔…	
VO_LOOTA_BOSS_20h_Male_Earthen_Intro_01	走開。這裡沒有東西可以給你。	
VO_LOOTA_BOSS_22h_Male_Murloc_Death_01	*慘叫*	
VO_LOOTA_BOSS_22h_Male_Murloc_DeathSpecial_01	…！	
VO_LOOTA_BOSS_22h_Male_Murloc_DefeatPlayer_01	…！…？	
VO_LOOTA_BOSS_22h_Male_Murloc_EmoteResponse_01	…?!	
VO_LOOTA_BOSS_22h_Male_Murloc_EventFishUpChest_01	…	
VO_LOOTA_BOSS_22h_Male_Murloc_EventSummonCrab_01	…！！	
VO_LOOTA_BOSS_22h_Male_Murloc_FishLarge_02	…！	
VO_LOOTA_BOSS_22h_Male_Murloc_FishMedium_01	…？	
VO_LOOTA_BOSS_22h_Male_Murloc_FishSmall_01	…	
VO_LOOTA_BOSS_22h_Male_Murloc_Intro_01	…！	
VO_LOOTA_BOSS_23h_Male_Furbolg_Death_01	*慘叫*	
VO_LOOTA_BOSS_23h_Male_Furbolg_DefeatPlayer_01	你的骨頭，可以警告其他人。	
VO_LOOTA_BOSS_23h_Male_Furbolg_EmoteResponse_01	繼續說話，我的野獸就能找到你…	
VO_LOOTA_BOSS_23h_Male_Furbolg_EventPlayBigMinion1_01	狩獵…結束了！	
VO_LOOTA_BOSS_23h_Male_Furbolg_EventPlayBigMinion2_01	你無處可逃！	
VO_LOOTA_BOSS_23h_Male_Furbolg_EventPlayBigMinion3_01	他們聞到了你的恐懼！	
VO_LOOTA_BOSS_23h_Male_Furbolg_HeroPower1_01	你的死期快到了…	
VO_LOOTA_BOSS_23h_Male_Furbolg_HeroPower2_01	我的力量越來越強。	
VO_LOOTA_BOSS_23h_Male_Furbolg_HeroPower3_01	我的野獸一定會找到你。	
VO_LOOTA_BOSS_23h_Male_Furbolg_HeroPower4_01	我很了解洞窟，你就不一樣了。	
VO_LOOTA_BOSS_23h_Male_Furbolg_HeroPower5_01	這裡是我的主場。	
VO_LOOTA_BOSS_23h_Male_Furbolg_Intro_01	在這裡…你才是獵物！	
VO_LOOTA_BOSS_25h_Male_Dragon_Death_01	*慘叫*	
VO_LOOTA_BOSS_25h_Male_Dragon_DefeatPlayer_01	這些寶藏…古老而珍貴的寶藏…會留在這裡。	
VO_LOOTA_BOSS_25h_Male_Dragon_EmoteResponse_01	我會好好考慮你說的話。	
VO_LOOTA_BOSS_25h_Male_Dragon_EventMarinTheFox_01	老狐狸馬林…你膽敢回來這個地方？	
VO_LOOTA_BOSS_25h_Male_Dragon_HeroPower1_01	燒吧，闖入者。	
VO_LOOTA_BOSS_25h_Male_Dragon_HeroPower2_01	可惡的傢伙！	
VO_LOOTA_BOSS_25h_Male_Dragon_HeroPower3_01	受死吧！	
VO_LOOTA_BOSS_25h_Male_Dragon_HeroPower4_01	消失吧！	
VO_LOOTA_BOSS_25h_Male_Dragon_HeroPower5_01	你沒地方躲了。	
VO_LOOTA_BOSS_25h_Male_Dragon_Intro_01	現身吧，卑劣的小偷。	
VO_LOOTA_BOSS_25h_Male_Dragon_TreasureDestroy1_01	這不是你的！	
VO_LOOTA_BOSS_25h_Male_Dragon_TreasureDestroy2_01	小偷！	
VO_LOOTA_BOSS_25h_Male_Dragon_TreasureDestroy3_01	還給我！	
VO_LOOTA_BOSS_25h_Male_Dragon_TreasureDestroy4_02	貪心的小鬼！	
VO_LOOTA_BOSS_25h_Male_Dragon_TreasureDestroy5_01	你要為你的貪婪付出代價。	
VO_LOOTA_BOSS_26h_Female_Demon_Death_01	*慘叫*	
VO_LOOTA_BOSS_26h_Female_Demon_DefeatPlayer_01	發傻的冒險者，我什麼…都能看見。	
VO_LOOTA_BOSS_26h_Female_Demon_EmoteResponse_01	我的眼中…只有你。	
VO_LOOTA_BOSS_26h_Female_Demon_EyeStalkConfuse_01	發昏。	
VO_LOOTA_BOSS_26h_Female_Demon_EyeStalkDeath_01	發作。	
VO_LOOTA_BOSS_26h_Female_Demon_EyeStalkDevitalize_01	發累。	
VO_LOOTA_BOSS_26h_Female_Demon_EyeStalkFear_01	發驚。	
VO_LOOTA_BOSS_26h_Female_Demon_EyeStalkFire_01	發火。	
VO_LOOTA_BOSS_26h_Female_Demon_EyeStalkFrost_01	發冷。	
VO_LOOTA_BOSS_26h_Female_Demon_Intro_01	真沒想到你可以到這裡來呢…接下來…先讓我看看你…	
VO_LOOTA_BOSS_32h_Male_Human_Death_01	*慘叫*	
VO_LOOTA_BOSS_32h_Male_Human_EmoteResponse_01	我不跟陌生人說話。	
VO_LOOTA_BOSS_32h_Male_Human_PartnerDeath_01	噢！不要！別死啊！喬治！	
VO_LOOTA_BOSS_32h_Male_Human_TaggedIn1_01	讓我試看看！	
VO_LOOTA_BOSS_32h_Male_Human_TaggedIn2_01	我來幫你，喬治！	
VO_LOOTA_BOSS_32h_Male_Human_TaggedIn3_01	換我好不好，喬治？啊？可以嗎？	
VO_LOOTA_BOSS_34h_Male_Demon_Death_01	*慘叫*	
VO_LOOTA_BOSS_34h_Male_Demon_DefeatPlayer_01	我還要更多…我還要！	
VO_LOOTA_BOSS_34h_Male_Demon_EmoteResponse_01	我會暢飲你的恐懼，吞食你的懊悔。	
VO_LOOTA_BOSS_34h_Male_Demon_HeroPower1_01	吞噬！	
VO_LOOTA_BOSS_34h_Male_Demon_HeroPower2_01	更多…	
VO_LOOTA_BOSS_34h_Male_Demon_HeroPower3_01	給我更多…	
VO_LOOTA_BOSS_34h_Male_Demon_HeroPower4_01	我要吞噬這個世界。	
VO_LOOTA_BOSS_34h_Male_Demon_HeroPower5_01	這是你的末日。	
VO_LOOTA_BOSS_34h_Male_Demon_Intro_01	飢餓…	
VO_LOOTA_BOSS_35h_Male_Furbolg_Death_01	回去吧…底下只有毀滅在等著你！	
VO_LOOTA_BOSS_35h_Male_Furbolg_DefeatPlayer_01	雖然軀殼留在這裡，但是你的靈魂終於解脫了。	
VO_LOOTA_BOSS_35h_Male_Furbolg_EmoteResponse_01	你不想起爭議的話，就放下寶藏離開吧。	
VO_LOOTA_BOSS_35h_Male_Furbolg_Intro_01	走開！你的魔法在這裡沒有用！	
VO_LOOTA_BOSS_35h_Male_Furbolg_SpellCountered1_01	你的魔法沒有作用。	
VO_LOOTA_BOSS_35h_Male_Furbolg_SpellCountered2_01	沉默！	
VO_LOOTA_BOSS_35h_Male_Furbolg_SpellCountered3_01	你的力量衰退了…	
VO_LOOTA_BOSS_35h_Male_Furbolg_SpellCountered4_01	我的魔法比你的強…	
VO_LOOTA_BOSS_35h_Male_Furbolg_SpellCountered5_01	老方法永遠都管用。	
VO_LOOTA_BOSS_37h_Female_BloodElf_Death_01	我燒起來了！	
VO_LOOTA_BOSS_37h_Female_BloodElf_DefeatPlayer_01	來我的地城跳舞，就要體驗火焰的熱情…	
VO_LOOTA_BOSS_37h_Female_BloodElf_EmoteResponse_01	你火氣很大！哈哈…懂了嗎？	
VO_LOOTA_BOSS_37h_Female_BloodElf_EventFireball_01	火焰…火焰！	
VO_LOOTA_BOSS_37h_Female_BloodElf_EventPyroblast_01	火熱！火熱！太火熱了！	
VO_LOOTA_BOSS_37h_Female_BloodElf_EventRagnaros_01	啊！這才是我期待的戰鬥！	
VO_LOOTA_BOSS_37h_Female_BloodElf_EventTheCandle_01	所以…拿走蠟燭的是你？	
VO_LOOTA_BOSS_37h_Female_BloodElf_Flamewakers_01	準備欣賞煙火了嗎？	
VO_LOOTA_BOSS_37h_Female_BloodElf_HeroPower1_01	需要更多力量…	
VO_LOOTA_BOSS_37h_Female_BloodElf_HeroPower2_01	還要…還要…	
VO_LOOTA_BOSS_37h_Female_BloodElf_HeroPower3_01	法術好好玩，太好玩了！	
VO_LOOTA_BOSS_37h_Female_BloodElf_Intro_01	火焰，會讓你跳起熱舞！	
VO_LOOTA_BOSS_38h_Male_Kobold_Death_01	我詛咒你！	
VO_LOOTA_BOSS_38h_Male_Kobold_DefeatPlayer_01	我就知道，我的巫毒最厲害！	
VO_LOOTA_BOSS_38h_Male_Kobold_EmoteResponse_01	你中妖術了！	
VO_LOOTA_BOSS_38h_Male_Kobold_EventBrann_01	矮人巫毒是怪怪的巫毒。	
VO_LOOTA_BOSS_38h_Male_Kobold_EventPlayerBattlecries1_01	那個吼得好大聲。	
VO_LOOTA_BOSS_38h_Male_Kobold_EventPlayerBattlecries2_01	他一直在叫。	
VO_LOOTA_BOSS_38h_Male_Kobold_EventPlayerBattlecries3_01	大家都叫得好大聲。	
VO_LOOTA_BOSS_38h_Male_Kobold_EventPlayerDeathrattles1_01	那個死掉聲音好大。	
VO_LOOTA_BOSS_38h_Male_Kobold_EventPlayerDeathrattles3_01	它有死掉的巫毒。	
VO_LOOTA_BOSS_38h_Male_Kobold_EventRivendare_01	死掉的巫毒是壞壞的巫毒。	
VO_LOOTA_BOSS_38h_Male_Kobold_Intro_01	我也會巫毒。	
VO_LOOTA_BOSS_39h_Male_Golem_Death_01	我…壞掉了	
VO_LOOTA_BOSS_39h_Male_Golem_DefeatPlayer_01	寶藏…安全了。	
VO_LOOTA_BOSS_39h_Male_Golem_EmoteResponse_01	你…不是主人。	
VO_LOOTA_BOSS_39h_Male_Golem_HeroPower1_01	踩…扁。	
VO_LOOTA_BOSS_39h_Male_Golem_HeroPower2_01	踐…踏。	
VO_LOOTA_BOSS_39h_Male_Golem_HeroPower3_01	不能…通過。	
VO_LOOTA_BOSS_39h_Male_Golem_HeroPower4_01	多麼…渺小…	
VO_LOOTA_BOSS_39h_Male_Golem_HeroPower5_01	消…失吧！	
VO_LOOTA_BOSS_39h_Male_Golem_Intro_01	守護… 寶藏… 	
VO_LOOTA_BOSS_40h_Female_Dragon_Death_01	*慘叫*	
VO_LOOTA_BOSS_40h_Female_Dragon_DefeatPlayer_01	暮光龍族會再度興起！	
VO_LOOTA_BOSS_40h_Female_Dragon_EmoteResponse_01	嗯…我尊重你的意見。	
VO_LOOTA_BOSS_40h_Female_Dragon_EventPlayTwilightDrake_01	小兄弟，不要背叛我們。	
VO_LOOTA_BOSS_40h_Female_Dragon_EventPlayTwilightWhelp_01	小傢伙，回歸龍群吧！	
VO_LOOTA_BOSS_40h_Female_Dragon_HeroPower1_01	給我力量…！	
VO_LOOTA_BOSS_40h_Female_Dragon_HeroPower2_01	你的力量滋養我。	
VO_LOOTA_BOSS_40h_Female_Dragon_HeroPower3_01	暮光龍會活下去！	
VO_LOOTA_BOSS_40h_Female_Dragon_HeroPower4_01	擁抱暮光。	
VO_LOOTA_BOSS_40h_Female_Dragon_Intro_01	我感應到強大的力量…靠近一點…	
VO_LOOTA_BOSS_41h_Male_Kobold_Death_01	*慘叫*	
VO_LOOTA_BOSS_41h_Male_Kobold_DefeatPlayer_01	我拿走蠟燭。你什麼都沒有。	
VO_LOOTA_BOSS_41h_Male_Kobold_EmoteResponse_01	堵住說話的洞！快打架！	
VO_LOOTA_BOSS_41h_Male_Kobold_EventHornOfCenarius_01	啊！什麼？你作弊！	
VO_LOOTA_BOSS_41h_Male_Kobold_HeroPower1_01	大家都進來－－打！	
VO_LOOTA_BOSS_41h_Male_Kobold_HeroPower2_01	來打架！	
VO_LOOTA_BOSS_41h_Male_Kobold_HeroPower3_01	疊上去！	
VO_LOOTA_BOSS_41h_Male_Kobold_Intro_01	把蠟燭還來！	
VO_LOOTA_BOSS_42h_Female_Furbolg_Armor10_01	感謝所有的先人。	
VO_LOOTA_BOSS_42h_Female_Furbolg_Armor15_01	強大的祖靈啊！	
VO_LOOTA_BOSS_42h_Female_Furbolg_Armor20_01	把寶藏交出來，你沒機會贏！	
VO_LOOTA_BOSS_42h_Female_Furbolg_Armor5_01	我毫無畏懼。	
VO_LOOTA_BOSS_42h_Female_Furbolg_Death_01	祖靈啊…我來了…	
VO_LOOTA_BOSS_42h_Female_Furbolg_DefeatPlayer_01	讚美祖靈！感謝祖靈保佑。	
VO_LOOTA_BOSS_42h_Female_Furbolg_EmoteResponse_01	祖靈他們…真的不太喜歡你。	
VO_LOOTA_BOSS_42h_Female_Furbolg_Intro_01	祖靈啊！保護我吧。	
VO_LOOTA_BOSS_43h_Female_Djinn_Death_01	*慘叫*	
VO_LOOTA_BOSS_43h_Female_Djinn_DefeatPlayer_01	這不就是你要的嗎…？	
VO_LOOTA_BOSS_43h_Female_Djinn_EmoteResponse_01	你要這樣浪費願望嗎？	
VO_LOOTA_BOSS_43h_Female_Djinn_HeroAbility1_01	你的願望是什麼？	
VO_LOOTA_BOSS_43h_Female_Djinn_HeroAbility2_01	一… 二… 三…	
VO_LOOTA_BOSS_43h_Female_Djinn_HeroAbility3_01	願望實現！	
VO_LOOTA_BOSS_43h_Female_Djinn_HeroAbilityHandFull1_01	*笑*	
VO_LOOTA_BOSS_43h_Female_Djinn_HeroAbilityHandFull2_01	承受不了嗎？	
VO_LOOTA_BOSS_43h_Female_Djinn_HeroAbilityHandFull3_01	當心你許的願望。	
VO_LOOTA_BOSS_43h_Female_Djinn_Intro_01	你吩咐，我照辦…只是要一點代價…	
VO_LOOTA_BOSS_44h_Female_Dragon_Death_01	*哭泣*	
VO_LOOTA_BOSS_44h_Female_Dragon_DefeatPlayer_01	沒得玩了！掰掰！	
VO_LOOTA_BOSS_44h_Female_Dragon_EmoteResponse_01	你不是媽媽！	
VO_LOOTA_BOSS_44h_Female_Dragon_Intro_01	喔！吃飯了嗎？	
VO_LOOTA_BOSS_45h_Male_Gnome_Death_01	*慘叫*	
VO_LOOTA_BOSS_45h_Male_Gnome_DefeatPlayer_01	難免有贏有輸啦！只要贏的是我就好。	
VO_LOOTA_BOSS_45h_Male_Gnome_EmoteResponse_01	這個地方簡直是迷宮…而且每條路都長得一樣！	
VO_LOOTA_BOSS_45h_Male_Gnome_HeroPower1_01	啊，亮晶晶的錢幣。	
VO_LOOTA_BOSS_45h_Male_Gnome_HeroPower2_01	嘿嘿嘿嘿…	
VO_LOOTA_BOSS_45h_Male_Gnome_HeroPower3_01	正面！我贏了！	
VO_LOOTA_BOSS_45h_Male_Gnome_HeroPower4_01	反面！你輸了！	
VO_LOOTA_BOSS_45h_Male_Gnome_Intro_01	你的口袋看起來很滿喔！	
VO_LOOTA_BOSS_46h_Male_Murloc_Death_01	*慘叫*	
VO_LOOTA_BOSS_46h_Male_Murloc_DefeatPlayer_01	… …？…！ 	
VO_LOOTA_BOSS_46h_Male_Murloc_EmoteResponse_01	*嘔吐聲*	
VO_LOOTA_BOSS_46h_Male_Murloc_HeroPower1_01	…	
VO_LOOTA_BOSS_46h_Male_Murloc_HeroPower2_01	…？	
VO_LOOTA_BOSS_46h_Male_Murloc_HeroPower3_01	…	
VO_LOOTA_BOSS_46h_Male_Murloc_Intro_01	…！	
VO_LOOTA_BOSS_49h_Male_Elemental_Death_01	*慘叫*	
VO_LOOTA_BOSS_49h_Male_Elemental_DefeatPlayer_01	哈哈哈哈哈…	
VO_LOOTA_BOSS_49h_Male_Elemental_EmoteResponse_01	我要拿走蠟燭。這就是我。	
VO_LOOTA_BOSS_49h_Male_Elemental_HeroPower1_01	黑暗…	
VO_LOOTA_BOSS_49h_Male_Elemental_HeroPower2_01	快滾…	
VO_LOOTA_BOSS_49h_Male_Elemental_HeroPower3_01	哈哈哈哈哈…	
VO_LOOTA_BOSS_49h_Male_Elemental_Intro_01	你的光就快熄滅了，冒險者…	
VO_LOOTA_BOSS_50h_Male_Kobold_Death_01	*慘叫*	
VO_LOOTA_BOSS_50h_Male_Kobold_DefeatPlayer_01	喔，嘻嘻嘻，這個東西真夠力！	
VO_LOOTA_BOSS_50h_Male_Kobold_EmoteResponse_01	不行！不准退貨。	
VO_LOOTA_BOSS_50h_Male_Kobold_EventKazakus_01	卡札克斯！你又要買什麼啊？	
VO_LOOTA_BOSS_50h_Male_Kobold_EventMakePotion1_01	喔，這個…啊呸…這個不好。	
VO_LOOTA_BOSS_50h_Male_Kobold_EventMakePotion2_01	耶，這個很壞，真的很壞。	
VO_LOOTA_BOSS_50h_Male_Kobold_EventMakePotion3_01	耶，嘿，你也要嗎？啊，不給你。	
VO_LOOTA_BOSS_50h_Male_Kobold_EventUsePotion1_01	喔，這個好壞。你聞聞看！	
VO_LOOTA_BOSS_50h_Male_Kobold_EventUsePotion2_01	*笑聲*	
VO_LOOTA_BOSS_50h_Male_Kobold_EventUsePotion3_01	這味道壞壞，不過壞得好。	
VO_LOOTA_BOSS_50h_Male_Kobold_Intro_01	嘿…嘿…要不要來點蘑菇啊？	
VO_LOOTA_BOSS_51h_Male_Dwarf_Death_01	艾澤拉斯，晚安！	
VO_LOOTA_BOSS_51h_Male_Dwarf_DefeatPlayer_02	謝謝你的手下，朋友！	
VO_LOOTA_BOSS_51h_Male_Dwarf_EmoteResponse_01	喔喝，來亂的是吧？	
VO_LOOTA_BOSS_51h_Male_Dwarf_EventBoombox_01	嘿！把那個東西弄掉！	
VO_LOOTA_BOSS_51h_Male_Dwarf_Intro_01	請留步，聽我說個故事！	
VO_LOOTA_BOSS_51h_Male_Dwarf_KillingBlowReady_01	狗頭人與地下城！	
VO_LOOTA_BOSS_51h_Male_Dwarf_Song1A_01	高手在此處，開始出任務…	
VO_LOOTA_BOSS_51h_Male_Dwarf_Song1B_01	...前進地下的大洞窟！	
VO_LOOTA_BOSS_51h_Male_Dwarf_Song1C_01	有許多寶物，和危險旅途 …	
VO_LOOTA_BOSS_51h_Male_Dwarf_Song1D_01	...地下通道它也不太牢固！	
VO_LOOTA_BOSS_51h_Male_Dwarf_Song2A_01	要是你偷蠟燭，最好加快腳步…	
VO_LOOTA_BOSS_51h_Male_Dwarf_Song2B_01	躲開那沿途機關密佈。	
VO_LOOTA_BOSS_51h_Male_Dwarf_Song2C_01	那瘋狂的追逐，和怪物獵捕	
VO_LOOTA_BOSS_51h_Male_Dwarf_Song2D_01	想要逃命，還要看著地圖	
VO_LOOTA_BOSS_51h_Male_Dwarf_Song3A_01	前方沒出路，後面是怪物…	
VO_LOOTA_BOSS_51h_Male_Dwarf_Song3B_01	這輩子，恐怕你都無法逃出。	
VO_LOOTA_BOSS_51h_Male_Dwarf_Song3C_01	你追求財富，卻要葬送此生…	
VO_LOOTA_BOSS_51h_Male_Dwarf_Song3D_01	狗頭人與地下城！	
VO_LOOTA_BOSS_51h_Male_Dwarf_Steal_01	過來這裡！	
VO_LOOTA_BOSS_51h_Male_Dwarf_Steal_02	過來～	
VO_LOOTA_BOSS_51h_Male_Dwarf_Steal_03	來開派對囉！	
VO_LOOTA_BOSS_51h_Male_Dwarf_StealDoomsayer_01	史上‧最爛的‧隊友！	
VO_LOOTA_BOSS_51h_Male_Dwarf_StealMinstrel_01	啊！可以來二重唱了！	
VO_LOOTA_BOSS_53h2_Female_Undead_Death_01	時間…矛盾了…	
VO_LOOTA_BOSS_53h2_Female_Undead_DefeatPlayer_01	我見過未來，我知道我會贏。	
VO_LOOTA_BOSS_53h2_Female_Undead_EmoteResponse_01	我連青銅龍都騙過了。你別想威脅我。	
VO_LOOTA_BOSS_53h2_Female_Undead_EventManaDestroyed_01	你只是在拖延時間！	
VO_LOOTA_BOSS_53h2_Female_Undead_EventPlayerTimeWalk_01	你也去過永恆之島？	
VO_LOOTA_BOSS_53h2_Female_Undead_Intro_01	時光可以重來，你可以重新投胎。	
VO_LOOTA_BOSS_53h2_Female_Undead_RitualPrep1_01	你的時間快到了…	
VO_LOOTA_BOSS_53h2_Female_Undead_RitualPrep2_01	我的力量正在凝聚。	
VO_LOOTA_BOSS_53h2_Female_Undead_RitualPrep3_01	滴答滴答…	
VO_LOOTA_BOSS_53h2_Female_Undead_TimeRewindPlayCard1_01	每次我都會變強。	
VO_LOOTA_BOSS_53h2_Female_Undead_TimeRewindPlayCard2_01	之前我們就做過了	
VO_LOOTA_BOSS_53h2_Female_Undead_TimeRewindPlayCard3_01	時間是我的盟友。	
VO_LOOTA_BOSS_53h2_Female_Undead_TimeRewindPlayCard4_01	掌握時間的人，就掌握了無限！	
VO_LOOTA_BOSS_53h2_Female_Undead_TimeRewindPlayCard5_01	結束的時候到了！	
VO_LOOTA_BOSS_53h2_Female_Undead_TimeRewindStart1_01	看看我的發現！	
VO_LOOTA_BOSS_53h2_Female_Undead_TimeRewindStart2_01	時間到了！	
VO_LOOTA_BOSS_53h2_Female_Undead_TimeRewindStart3_01	再一次！我們再來一次！	
VO_LOOTA_BOSS_53h2_Female_Undead_TimeRewindStart4_01	我的時刻到了！	
VO_LOOTA_BOSS_54h_Female_Human_Death_01	我還沒… 準備好！	
VO_LOOTA_BOSS_54h_Female_Human_DefeatPlayer_01	沒問題！我準備好了！	
VO_LOOTA_BOSS_54h_Female_Human_EmoteResponse_01	馬上好…開打的時候跟我說一下！	
VO_LOOTA_BOSS_54h_Female_Human_Intro_01	*心不在焉地唱歌*	
VO_LOOTA_BOSS_54h_Female_Human_Intro_02	*心不在焉地唱歌*	
VO_LOOTA_BOSS_54h_Female_Human_Intro_03	*心不在焉地唱歌*	
VO_LOOTA_BOSS_54h_Female_Human_Intro_04	*心不在焉地吹口哨*	
VO_LOOTA_BOSS_54h_Female_Human_Intro_07	*心不在焉地唱歌*	
VO_LOOTA_BOSS_54h_Female_Human_WakeUp_01	蛤？開打了嗎？	
VO_Maiden_Female_Titan_FinalMaidenEmoteResponse_01	你的行為無法容忍。	
VO_Maiden_Female_Titan_FinalMaidenEyeForAnEye_01	伸張正義。	
VO_Maiden_Female_Titan_FinalMaidenHeroPower_01	捨棄你墮落的思想。	
VO_Maiden_Female_Titan_FinalMaidenHumility_01	跪下！我可以寬恕你！	
VO_Maiden_Female_Titan_FinalMaidenOpen_01	你召喚了泰坦的使者？	
VO_Maiden_Female_Titan_FinalMaidenTurn5_01	我們是不朽的，你不夠資格！	
VO_Malchezaar_Male_Demon_Brawl_06	你該不會以為，自己真的能贏吧？	
VO_Malchezaar_Male_Demon_EmoteParty_01	莫克札也喜歡派對！	
VO_Malchezaar_Male_Demon_FinalAltOpening_01	愚蠢的笨蛋！	
VO_Malchezaar_Male_Demon_FinalMalchezaarDeath_01	不！不！不要～！	
VO_Malchezaar_Male_Demon_FinalMalchezaarEmoteResponse_01	我會消滅你！	
VO_Malchezaar_Male_Demon_FinalMalchezaarHeroPower_01	你挑戰的不只是莫克札，而是我所率領的整個軍隊！	
VO_Malchezaar_Male_Demon_FinalMalchezaarJaraxxus_01	就是你！本來應該要邀請我的！	
VO_Malchezaar_Male_Demon_FinalMalchezaarMedivhSkin_01	你變裝過來的？嗯…我也想要…	
VO_Malchezaar_Male_Demon_FInalMalchezaarSacrificialPact_03	哈哈哈！那對真正的埃雷達爾領主沒用！	
VO_Malchezaar_Male_Demon_FinalMalchezaarTurn1_01	大法師確實很強。但是你有什麼本事對抗如此強大的力量？	
VO_Malchezaar_Male_Demon_FinalMalchezaarTurn7_01	我聽到音樂了！是麥迪娃！有派對，我要狂歡！	
VO_Malchezaar_Male_Demon_FinalThirdSequence_01	我回到卡拉贊了？剛好趕上派對！	
VO_Malchezaar_Male_Demon_FinalThirdSequence_04	蠢貨，別擋我的路！	
VO_Malchezaar_Male_Demon_PrologueEmoteResponse_01	愚蠢的笨蛋！	
VO_Malchezaar_Male_Demon_PrologueHeroPower_01	我可以自由來去所有世界，所有次元！	
VO_Malchezaar_Male_Demon_PrologueOpen_01	我的邀請函呢？	
VO_Malchezaar_Male_Demon_PrologueTurn1_04	你居然沒邀請我？我可是埃雷達爾的王子！	
VO_Malchezaar_Male_Demon_PrologueTurn11_02	你邀請了賈拉克瑟斯這個魯蛇？	
VO_Malchezaar_Male_Demon_PrologueWin_01	我要帶你一起走！	
VO_Mediva_01_Female_Blood Elf_AranSpell_04	噢，好冷。	
VO_Mediva_01_Female_Blood Elf_ChessEmoteOops_06	呃喔。	
VO_Mediva_01_Female_Blood Elf_PrologueTurn5_06	麥-迪娃！	
VO_Mediva_02_Female_Draenei_JulianneDeadlyPoison_02	真正是悲劇。	
VO_Mediva_02_Female_Draenei_PrologueTurn5_05	嗯？	
VO_Mediva_03_Male_Night Elf_AranHeroPower_01	燃燒吧，燃燒吧，寶貝！	
VO_Mediva_03_Male_Night Elf_CuratorBeasts_04	哈啾，寶貝。	
VO_Mediva_03_Male_Night Elf_PrologueTurn5_01	你叫我？	
VO_Medivas_Multiple_Multiple_CroneLionTigerBear_01	天啊！	
VO_Medivas_Multiple_Multiple_IllhoofWounded_01	嗯，我驚驚。	
VO_Medivas_Multiple_Multiple_NetherspiteTurn1_01	光線！	
VO_Medivh_Male_Human_EmoteGreetings_01	你在這裡做什麼？	
VO_Medivh_Male_Human_EmoteOops_01	那就是你的計劃嗎？	
VO_Medivh_Male_Human_EmoteSorry_01	唉，打得不好啊…	
VO_Medivh_Male_Human_EmoteThanks_01	你人真好。	
VO_Medivh_Male_Human_EmoteThreaten_01	你毫無勝算！	
VO_Medivh_Male_Human_EmoteWellPlayed_01	這招不錯，惡魔。	
VO_Medivh_Male_Human_EmoteWow_01	哈哈！厲害！	
VO_Medivh_Male_Human_FinalMalchezaarTurn5_01	做得好，摩洛斯。派對準備得很好！	
VO_Medivh_Male_Human_FinalMalchezaarWin_01	太好了！來吧，派對開始了！	
VO_Medivh_Male_Human_FinalMedivhMedivhSkin_01	噢，等等！你就是我，未來的我？告訴我…這派對怎麼樣？一定很有趣對吧？	
VO_Medivh_Male_Human_FinalThirdSequence_01	啊，有客人！麻煩幫我搞定這個惡魔。我還得去主持派對！	
VO_Medivh_Male_Human_FinalThirdSequence_02	你的牌全沒了？那傳送門就隨你使用吧。	
VO_Medivh_Male_Human_FinalThirdSequence_03	我把法杖借你，可以用來控制傳送門。小心別弄壞了。	
VO_Medivh_Male_Human_PrologueDeath_02	什麼？不可能…	
VO_Medivh_Male_Human_PrologueHeroPower_01	但這場派對除外！	
VO_Medivh_Male_Human_PrologueOpen_01	唉，又是你…	
VO_Medivh_Male_Human_PrologueTurn1_02	拜託！上次被你弄壞的屋頂到現在都還沒修好！	
VO_Medivh_Male_Human_PrologueTurn11_01	你聽過他唱歌嗎？人家上過爐石好聲音啊！	
VO_Medivh_Male_Human_PrologueTurn3_02	摩洛斯，去看一下西洋棋。真正的客人馬上就要到了。	
VO_Medivh_Male_Human_PrologueTurn9_01	啊！氣球！摩洛斯，我們忘記氣球了！	
VO_Medivh_Male_Human_PrologueWin_01	滾回老家吧，惡魔！	
VO_Medivh_Male_Human_Wing0Intro_01	餐具，準備好了。歌劇，排演好了。展覽廳，佈置好了。今晚，絕對是最難忘的一夜！	
VO_Medivh_Male_Human_Wing4Win_01	冒險者，來吧！享受派對吧！	
VO_Mirror_Male_Mirror_MirrorDeath_01	嘿！你作弊！我要重來！	
VO_Mirror_Male_Mirror_MirrorEmoteResponse_01	你才是！	
VO_Mirror_Male_Mirror_MirrorFirstCard_01	喔喔，你竟然有那張啊？	
VO_Mirror_Male_Mirror_MirrorMedivhSkin_01	噢！麥迪文先生！您今天超帥的…嘿！不對！你不是麥迪文！	
VO_Mirror_Male_Mirror_MirrorMirrorImage_01	嘿，那是我最喜歡的牌！你呢？該不會是熔岩狂怒者吧？	
VO_Mirror_Male_Mirror_MirrorOpen_02	哈囉！	
VO_Mirror_Male_Mirror_MirrorTurn1_01	哇，你們醜爆了！	
VO_Mirror_Male_Mirror_MirrorTurn3_01	魔鏡啊魔鏡，誰是世界上最美的人？	
VO_Mirror_Male_Mirror_MirrorTurn3_03	不是你，老爹！	
VO_Mirror_Male_Mirror_MirrorTurn5_02	奈法利斯？是奈肥利斯才對吧！呼呼呼！	
VO_Mirror_Male_Mirror_MirrorWellPlayedResponse_01	真希望我也能這樣說！哈！	
VO_Moroes_Male_Human_AranTurn1_01	唉…這是埃蘭，他是個壞脾氣的鬼魂。	
VO_Moroes_Male_Human_AranTurn9_04	龍把大餐都吃光了，而且還虎視眈眈的盯著魚人！	
VO_Moroes_Male_Human_AranWin_01	傳送門就在隔壁房間！我們趕上了！	
VO_Moroes_Male_Human_ChessForfeit_02	棋子用光了。你輸了。	
VO_Moroes_Male_Human_ChessTurn1_03	在這裡，棋子會在你的回合結束時自動攻擊。	
VO_Moroes_Male_Human_ChessTurn3_01	如果棋子在前方兩個敵人中間，就會同時攻擊他們！	
VO_Moroes_Male_Human_ChessTurn5_01	下好位置是致勝的關鍵。利用雙重攻擊！	
VO_Moroes_Male_Human_ChessTurn7_01	客人開始在外面排隊了！動作快，我們離歌劇院不遠了！	
VO_Moroes_Male_Human_ChessTurn7_02	你的棋子不多了。要是棋子用完的話，你就輸了。	
VO_Moroes_Male_Human_ChessTurn7_03	先生，你的棋子不多了。要是棋子用完的話，你就輸了。	
VO_Moroes_Male_Human_ChessWin_01	太好了！前往歌劇院！	
VO_Moroes_Male_Human_CroneTurn5_02	管理者埃克索圖斯到了。我要下樓去和他說，「太早了！你太早來了」嗎？	
VO_Moroes_Male_Human_CroneWin_01	終於啊！我們可以去救巫師了！	
VO_Moroes_Male_Human_CuratorTurn3_01	館長失控了！趕緊阻止它，免得它把所有東西都放出來！	
VO_Moroes_Male_Human_CuratorWin_01	好的…這邊稍微調整一下…就像新的一樣！	
VO_Moroes_Male_Human_EndWing1_01	太好了！歌劇院就在樓上！巴奈斯應該會讓我們快速通過！	
VO_Moroes_Male_Human_FinalAltTurn5_01	呃…好多傳送門…這個裡面不曉得是什麼…	
VO_Moroes_Male_Human_FinalMaidenTurn1_01	抱歉，應付一下這個。我下一次不會弄錯了。	
VO_Moroes_Male_Human_FinalMaidenTurn7_03	噢，都是觸手。這絕對不是我們要的。	
VO_Moroes_Male_Human_FinalNazraTurn7_02	把那個獸人趕走，我們才能打開另一個傳送門。	
VO_Moroes_Male_Human_FinalSecondSequence_01	太好了。嗯…我來試試這個…	
VO_Moroes_Male_Human_FInalStartSequence_01	嗯…我看看。呃，好像是這一個？	
VO_Moroes_Male_Human_FinalThirdSequence_01	就是這個！	
VO_Moroes_Male_Human_FinalTurn1_02	糟糕！弄錯了。擊敗這個獸人，我才能再試一次。	
VO_Moroes_Male_Human_IllhoofKilrekResponse_01	他們在召喚什麼？	
VO_Moroes_Male_Human_JulianneTurn5_01	巴奈斯，讓我們過去！我們要在派對失控之前救出麥迪文！	
VO_Moroes_Male_Human_JulianneTurn9_02	伊利丹到了！我們…還沒準備好！	
VO_Moroes_Male_Human_MedivhSkinResponse_01	麥迪文cosplay？喔…扮得還真像啊	
VO_Moroes_Male_Human_MirrorTurn3_01	哼嗯…	
VO_Moroes_Male_Human_MirrorTurn5_01	奈法利斯領主快到了，我不敢想像他會說什麼。	
VO_Moroes_Male_Human_MirrorWin_02	太好了！往歌劇院的樓梯就在前面！	
VO_Moroes_Male_Human_NetherspiteTurn1_01	光線會強化那隻龍。用手下擋住光線！	
VO_Moroes_Male_Human_NetherspiteTurn5_01	快點告訴我們，麥迪文在哪個門！	
VO_Moroes_Male_Human_NetherspiteTurn7_01	我們需要那些傳送門，客人開始在亂丟書本了！	
VO_Moroes_Male_Human_NetherspiteWin_01	做得好！嗯…看看我還記不記得怎麼操作…	
VO_Moroes_Male_Human_NightbaneTurn3_01	館長，我們得去救麥迪文！	
VO_Moroes_Male_Human_NightbaneTurn7_01	探險者協會來了。里諾，放下那個銀器！	
VO_Moroes_Male_Human_PrologueTurn11_01	而且他沒有燒掉圖書館…	
VO_Moroes_Male_Human_PrologueTurn5_03	先生，麥迪娃合唱團準備好了。巴奈斯正在和他們排練。	
VO_Moroes_Male_Human_PrologueTurn7_01	先生，你看到外面的狀況了嗎？一堆團隊首領搶著想拿到我們的邀請。	
VO_Moroes_Male_Human_PrologueTurn9_02	先生，氣球會嚇到魚人。還記得上禮拜的事嗎？	
VO_Moroes_Male_Human_PrologueWin_02	糟糕了。這下糟糕了。	
VO_Moroes_Male_Human_SilverwareResponse_01	呃，那可是古董啊。	
VO_Moroes_Male_Human_SilverwareTurn3_02	銀器團結起來了！我們被包圍了！	
VO_Moroes_Male_Human_SilverwareWin_01	唉，真是一團糟啊。	
VO_Moroes_Male_Human_Wing1Intro_02	我是摩洛斯，卡拉贊的管家。我需要你的幫忙，因為麥迪文不見了！我們得去塔頂的傳送門找他回來，才能挽救這場派對！	
VO_Moroes_Male_Human_Wing1Win_01	很好！照這個速度來看，我們可以及時趕到塔頂，拯救這場派對！	
VO_Moroes_Male_Human_Wing2Win_01	前進！樓上是館長看守的展覽廳，希望它沒有失控…	
VO_Moroes_Male_Human_Wing3Open_02	館長看守著展覽廳，裡面展示著許多艾澤拉斯最奇特的生物。過了展覽廳就是主人的房間和傳送門！	
VO_Moroes_Male_Human_Wing3Win_02	快到塔頂了！我們得趕緊救回麥迪文，免得派對變成格鬥大會！	
VO_Moroes_Male_Human_Wing4Intro_01	終於！塔頂到了！找到正確的傳送門，把麥迪文帶回來！	
VO_Moroes_Male_Human_Wing4Win_01	你辦到了。真不敢相信，派對竟然能準時開始。你下禮拜有空嗎？麥迪文的生日到了…呃，我需要…幫手。	
VO_Moroes_Male_Human_WolfClaws_03	別相信他的話…	
VO_NAX1_01_CARD_02	一些小點心！	
VO_NAX1_01_DEATH_05	為什麼，為什麼？！	
VO_NAX1_01_EMOTE_04	會說話呢！	
VO_NAX1_01_HP_03	哦，小點心終於來了。	
VO_NAX1_01_START_01	歡迎來到我的大廳。	
VO_NAX10_01_DEATH_LINE_03	怎麼…搞的…	
VO_NAX10_01_EMOTE1_04	一起玩嗎？	
VO_NAX10_01_EMOTE2_05	好！一起玩！一起玩！	
VO_NAX10_01_HP_02	不玩了？	
VO_NAX10_01_START_01	縫補者要跟你玩！	
VO_NAX11_01_CARD_03	軟泥。	
VO_NAX11_01_DEATH_05	*死亡的悲鳴*	
VO_NAX11_01_EMOTE_04	不想說話。	
VO_NAX11_01_HP_02	好臭。	
VO_NAX11_01_START_01	肉肉。	
VO_NAX12_01_CARD_01	*吼叫*	
VO_NAX12_01_DEATH_01	*悲鳴聲*	
VO_NAX12_01_EMOTE_01	*嘟噥*	
VO_NAX12_01_EMOTE_02	*低吼*	
VO_NAX12_01_EMOTE_03	*低吼*	
VO_NAX12_01_HP_01	*低吼*	
VO_NAX12_01_START_01	*低吼*	
VO_NAX13_01_DEATH_LINE_03	謝謝你…	
VO_NAX13_01_EMOTE_04	殺！	
VO_NAX13_01_HP_02	你…死吧！	
VO_NAX13_01_START_01	我…必須…服從！	
VO_NAX14_01_CARD_01	*吼叫聲*	
VO_NAX14_01_DEATH_01	*吼叫聲*	
VO_NAX14_01_EMOTE_01	*吼叫聲*	
VO_NAX14_01_EMOTE_02	*吼叫聲*	
VO_NAX14_01_EMOTE_03	*吼叫聲*	
VO_NAX14_01_HP_01	*吼叫聲*	
VO_NAX14_01_START_01	*吼叫聲*	
VO_NAX15_01_BIGGLES_32	不！我詛咒你，闖入者！	
VO_NAX15_01_DEATH_LINE_08	這還沒結束！……還有英雄模式呢！	
VO_NAX15_01_DEATH_LINE2_09	不………！！！	
VO_NAX15_01_EMOTE_HELLO_26	你經常向想殺死你的人打招呼嗎？	
VO_NAX15_01_EMOTE_OOPS_29	的確。	
VO_NAX15_01_EMOTE_SORRY_28	沒關係，闖入者，每個人都會犯錯。	
VO_NAX15_01_EMOTE_THANKS_27	呃…不客氣？	
VO_NAX15_01_EMOTE_THREATEN_30	噢，我好怕喔！	
VO_NAX15_01_EMOTE_WP_25	切，那還用說。我可是科爾蘇加德！	
VO_NAX15_01_HP_07	我要凍結你的每一滴血！	
VO_NAX15_01_HP2_05	你的靈魂現在屬於我了！	
VO_NAX15_01_HP3_06	你無路可逃了！	
VO_NAX15_01_HURRY_31	我的耐心有限。	
VO_NAX15_01_PHASE2_10	笨蛋！你已經開始顧此失彼了！	
VO_NAX15_01_PHASE2_ALT_11	不！你的回合結束了。現在是「我的」回合。	
VO_NAX15_01_RESPOND_ANDUIN_24	太天真了！記得烏瑟的下場嗎？	
VO_NAX15_01_RESPOND_GARROSH_15	是嗎？那你就去死吧。	
VO_NAX15_01_RESPOND_GARROSH_ALT_16	那就是我勝利，你死亡！	
VO_NAX15_01_RESPOND_GULDAN_22	我的靈魂應該是我自己的吧。	
VO_NAX15_01_RESPOND_JAINA_23	不是吧。是你入侵我的地盤耶！	
VO_NAX15_01_RESPOND_MALFURION_ALT_21	大自然？那你來納克薩瑪斯幹嘛？	
VO_NAX15_01_RESPOND_REXXAR_19	那我就不客氣嘍？	
VO_NAX15_01_RESPOND_THRALL_17	你要為了一把錘子出生入死？好吧。	
VO_NAX15_01_RESPOND_UTHER_14	…我會以巨大的手下跟毀滅性的法術作戰。祝你好運！	
VO_NAX15_01_RESPOND_VALEERA_18	我會很小心。	
VO_NAX15_01_START_13	我們終於見面了。	
VO_NAX15_01_SUMMON_ADDS_12	上吧，我的手下！	
VO_NAX2_01_CARD_02	以主人之名，殺了他們！	
VO_NAX2_01_CUSTOM_03	你失敗了！	
VO_NAX2_01_DEATH_LINE_05	主人會為我復仇雪恥的！	
VO_NAX2_01_EMOTE_06	哈哈哈哈哈！	
VO_NAX2_01_HP_04	跪下求饒吧，懦夫！	
VO_NAX2_01_START_01	我的侍僧會無條件服從我！	
VO_NAX3_01_CARD_01	*嘶嘶聲*	
VO_NAX3_01_DEATH_01	*發出嘶嘶聲*	
VO_NAX3_01_EMOTE_01	*發出嘶嘶聲*	
VO_NAX3_01_EMOTE_02	*發出嘶嘶聲*	
VO_NAX3_01_EMOTE_03	*發出嘶嘶聲*	
VO_NAX3_01_EMOTE_04	*發出嘶嘶聲*	
VO_NAX3_01_EMOTE_05	*發出嘶嘶聲*	
VO_NAX3_01_HP_01	*發出嘶嘶聲*	
VO_NAX3_01_START_01	*爬動聲*	
VO_NAX4_01_CARD_03	停止呼吸吧！	
VO_NAX4_01_DEATH_LINE_04	我要侍奉主人…到最後一刻。	
VO_NAX4_01_EMOTE_06	死吧，入侵者！	
VO_NAX4_01_HP_02	起來吧，我的戰士們！起來，再為主人盡忠一次！	
VO_NAX4_01_START_01	又有靈魂可以收藏了。	
VO_NAX5_01_CARD_03	我會摧毀你的心靈！	
VO_NAX5_01_DEATH_LINE_04	我該洗澡的。	
VO_NAX5_01_EMOTE_05	我沒空理你。	
VO_NAX5_01_HP_02	跳舞吧，笨蛋！	
VO_NAX5_01_START_01	你以為在這裡很安全嗎？	
VO_NAX6_01_CARD_03	你的生命正走向終結。	
VO_NAX6_01_DEATH_LINE_04	*吼叫聲*	
VO_NAX6_01_EMOTE_05	別浪費唇舌了。	
VO_NAX6_01_HP_02	你現在是我的了。	
VO_NAX6_01_START_01	我看到你了。	
VO_NAX7_01_CARD_03	你該在家裡待著。	
VO_NAX7_01_DEATH_LINE_04	呃…光榮的戰死。	
VO_NAX7_01_EMOTE_05	哈哈！我正好剛剛完成熱身！	
VO_NAX7_01_HP_02	唉呀！	
VO_NAX7_01_START_01	不！不！我的學生！把學生還給我！	
VO_NAX8_01_CARD_02	殺死我的手下…他們的靈魂會來找你。	
VO_NAX8_01_CUSTOM_03	哈哈哈！笨蛋！我可是靈魂的收割者！	
VO_NAX8_01_CUSTOM2_04	死者復生！	
VO_NAX8_01_DEATH_LINE_05	我…被…收割了。	
VO_NAX8_01_EMOTE1_06	你們這些蠢貨已經主動步入了陷阱。	
VO_NAX8_01_EMOTE2_07	你們正在挑戰一個無比強大的存在。	
VO_NAX8_01_EMOTE3_08	雖然你們經歷了千難萬險才來到收割者的領域，來到我的面前。	
VO_NAX8_01_EMOTE4_09	但是現在，活下來的唯一途徑…	
VO_NAX8_01_EMOTE5_10	…就是打開選單並按下「投降」。	
VO_NAX8_01_START_01	我的手下不會真的死去。	
VO_NAX9_01_CUSTOM_02	別多說廢話了。讓他們來吧。	
VO_NAX9_01_DEATH_LINE_03	不！我需要更多時間！	
VO_NAX9_01_EMOTE_04	你找死嗎？	
VO_NAX9_01_START_01	我們會把你連骨頭一起碾成灰的。	
VO_NAX9_02_CUSTOM_01	入侵者！趁你們還活著，馬上離開這裡！	
VO_NAX9_03_CUSTOM_01	嘿，札里克，等我們玩夠了再說！	
VO_NAX9_04_CUSTOM_01	來呀，放馬過來呀！	
VO_Nazra_Female_Orc_FinalNazraChogall_02	這裡有暮光之錘的傢伙？	
VO_Nazra_Female_Orc_FinalNazraDeath_01	呃啊，為了部落…	
VO_Nazra_Female_Orc_FinalNazraEmoteResponse_01	娜茲拉要打爆你！	
VO_Nazra_Female_Orc_FinalNazraGrom_01	葛羅瑪許？好久不見了！	
VO_Nazra_Female_Orc_FinalNazraHeroPower_01	娜茲拉會統治這個弱小的世界！	
VO_Nazra_Female_Orc_FinalStartSequence_01	向部落屈服吧！	
VO_NEFARIAN_ATRAMEDES_DEATH_76	你殺死了一隻失明的龍。你應該感到羞恥。	
VO_NEFARIAN_BARON_GEDDON_DEAD_40	我們快到了。很好，很好！	
VO_NEFARIAN_CHROMAGGUS_DEAD_63	事實上，克洛瑪古斯是我最弱的手下。你有沒有覺得自己很厲害？	
VO_NEFARIAN_CHROMAGGUS1_59	我給了牠兩顆頭，因為…這樣就能一口氣咬兩下！	
VO_NEFARIAN_CHROMAGGUS2_60	我賦予牠所有巨龍軍團的能力！牠是完美的！	
VO_NEFARIAN_CHROMAGGUS3_61	做得好，克洛瑪古斯。好孩子。	
VO_NEFARIAN_CHROMAGGUS4_62	牌有點卡手了嗎？哇哈哈哈！好狗狗。	
VO_NEFARIAN_COREN_DEAD_28	黑鐵酒吧。笑死人了。	
VO_NEFARIAN_DRAKKISATH_DEAD_50	我已經開始不高興了。	
VO_NEFARIAN_DRAKKISATH_RESPOND_48	是的，達基薩斯。冒險者，你真的走錯邊了。	
VO_NEFARIAN_DRAKKISATH1_49	快去玩排名模式吧。這個冒險篇章不適合你玩。	
VO_NEFARIAN_GARR_DEAD1_38	你應該從加爾身上弄塊小石頭，從拉格納羅斯的岩漿池上打水漂。他一定會很開心。	
VO_NEFARIAN_GARR2_35	小心那些小石頭，好嗎？	
VO_NEFARIAN_GARR3_36	你可別死啊。還有一個元素領主等著你去放逐呢。	
VO_NEFARIAN_GARR4_37	你知道嗎，我很喜歡看你工作的樣子。	
VO_NEFARIAN_GRIMSTONE_DEAD1_30	繼續下去，拉格納羅斯就會從這座山脈被驅除！	
VO_NEFARIAN_HEROIC_BLOCK_77	在英雄模式裡可行不通！	
VO_NEFARIAN_MALORIAK_DEATH_PT1_72	恭喜你！真是令人讚嘆的成就！	
VO_NEFARIAN_MALORIAK_DEATH_PT2_73	我替你想了一個新名字，來紀念這一刻。	
VO_NEFARIAN_MALORIAK_DEATH_PT3_74	「專殺白痴無能手下的殺手」。嗯，這聽起來很適合。	
VO_NEFARIAN_MALORIAK_TURN2_71	瑪洛里亞克，別輸給這個凡人。	
VO_NEFARIAN_NEF_MISSION_66	這是作弊！我不會容忍這樣的行為！	
VO_NEFARIAN_NEF2_65	不，不！我會摧毀你！	
VO_NEFARIAN_OMNOTRON_DEAD_69	你讓我省了龐大的維修費用。謝謝你。	
VO_NEFARIAN_OMOKK_DEAD_46	這完全不合邏輯。	
VO_NEFARIAN_OMOKK1_44	你為什麼跑來這裡？拉格納羅斯已經死了。你應該要去找你的朋友慶祝一番才對。	
VO_NEFARIAN_OMOKK2_45	我不明白。這上面沒有拉格納羅斯。你的任務已經完成了。回家去吧。	
VO_NEFARIAN_RAZORGORE_DEAD_55	那些蛋是用來做偉大的實驗用的！	
VO_NEFARIAN_REND_DEAD_53	好吧，凡人。你不該把黑龍惹毛的。	
VO_NEFARIAN_REND1_52	連這個獸人都知道你做了錯誤的決定。	
VO_NEFARIAN_THAURISSAN_DEAD_32	你應該殺死另外那個矮人！不留活口！	
VO_NEFARIAN_THAURISSAN_DEAD2_33	你把兩個矮人都殺了？不錯嘛，冒險者。	
VO_NEFARIAN_VAEL_DEAD_57	哈！你殺死了好人那一邊的！有沒有很傷心啊？	
VO_Netherspite_Male_Dragon_NetherspiteAngryChicken_01	又是你！你怎麼老是在我的傳送門裡面！	
VO_Netherspite_Male_Dragon_NetherspiteDeath_01	我的研究…	
VO_Netherspite_Male_Dragon_NetherspiteEmoteResponse_01	你居然敢在我的實驗室裡挑戰我？	
VO_Netherspite_Male_Dragon_NetherspiteEmpowerment_01	太多世界，太多要學的了！	
VO_Netherspite_Male_Dragon_NetherspiteOpen_01	是誰在干擾我的研究？	
VO_Netherspite_Male_Dragon_NetherspiteShadowBreath_01	走開！	
VO_Netherspite_Male_Dragon_NetherspiteTurn12_01	嗯…如果有12隻魚人從4點鐘方向的紅色傳送門離開，然後克蘇恩從5點鐘方向過來…嗯…我要好好想想…	
VO_Netherspite_Male_Dragon_NetherspiteTurn3_02	我的實驗！別碰它們！	
VO_Netherspite_Male_Dragon_NetherspiteTurn5_01	不要亂碰傳送門！能量波動已經校對好了！	
VO_Netherspite_Male_Dragon_NetherspiteTurn7_01	派對好像很好玩。快點去玩吧，不要干擾我的傳送門！	
VO_Netherspite_Male_Dragon_NetherspiteUnstablePortal_01	真有趣。共振的變化顯示了本質上的不穩定性。	
VO_Netherspite_Male_Dragon_NetherspiteUnstablePortal_02	真有趣。本質上的不穩定性。	
VO_Nightbane_Roar	*吼叫*	
VO_PrinceKeleseth_Male_Vampire_ResponseLanaThel_01	女王陛下！	
VO_PrinceTaldaram_Male_Vampire_ResponseLanaThel_01	女王…我好飢渴。	
VO_PrinceValanar_Male_Vampire_ResponseLanaThel_01	菈娜薩爾女王	
VO_RAGNAROS_GRIMSTONE_DEAD2_66	我會淨化你，你這隻該死的爬蟲！	
VO_RAGNAROS_Male_Elemental_AhuneResponses_01	艾胡恩？拜託你走開好嘛。	
VO_RAGNAROS_Male_Elemental_AhuneResponses_02	我們才不是什麼兄弟！	
VO_RAGNAROS_Male_Elemental_AhuneResponses_05	*不滿*	
VO_Ragnaros_Male_Elemental_Brawl_01	讓開，蠢貨！	
VO_Ragnaros_Male_Elemental_Brawl_02	到底是誰告訴你我有亂鬥？	
VO_Ragnaros_Male_Elemental_Brawl_05	這就是為什麼我都自己來…	
VO_Ragnaros_Male_Elemental_Brawl_07	不對，是我辦到的。你快點滾啦！	
VO_RAGNAROS_NEF1_71	冒險者。看來你需要一些幫助。	
VO_RAGNAROS_NEF3_72	我會報仇的！讓火焰淨化一切！	
VO_RAGNAROS_NEF4_73	我會派我的手下消滅你，黑翼。	
VO_RAGNAROS_NEF5_74	把這隻驕傲的龍燒成灰燼！	
VO_RAGNAROS_NEF6_75	這是來自火源之界的禮物！	
VO_RAGNAROS_NEF7_76	你無法熄滅炎魔的火焰！	
VO_RAGNAROS_NEF8_77	我會報仇的，黑龍！	
VO_Rakanishu_Male_Elemental_CastSpell1_01	不要…拿走…我！	
VO_Rakanishu_Male_Elemental_CastSpell2_01	讓火焰淨化一切！	
VO_Rakanishu_Male_Elemental_CastSpell3_01	死吧，冒險者！	
VO_Rakanishu_Male_Elemental_CastSpell4_01	為了拉法姆！	
VO_Rakanishu_Male_Elemental_CastSpell5_01	燒光一切！	
VO_Rakanishu_Male_Elemental_EventRagnaros_02	我的偶像！	
VO_Rakanishu_Male_Elemental_Intro_01	消滅！搶走寶藏！	
VO_SilverwareGolem_Male_SilverwareGolem_SilverwareDeath_02	上菜…結束…	
VO_SilverwareGolem_Male_SilverwareGolem_SilverwareEmoteResponse_01	擦得亮晶晶！	
VO_SilverwareGolem_Male_SilverwareGolem_SilverwareForkedLightning_01	喜歡叉狀的東西？我有很多叉子！	
VO_SilverwareGolem_Male_SilverwareGolem_SilverwareHeroPower_01	佈置餐桌！整理場地！	
VO_SilverwareGolem_Male_SilverwareGolem_SilverwareKnifeJuggler_01	喔，是飛刀！	
VO_SilverwareGolem_Male_SilverwareGolem_SilverwareOpen_01	跳舞真有趣！	
VO_SilverwareGolem_Male_SilverwareGolem_SilverwarePlateTossing_01	你有盤子！他有盤子！大家都有盤子！	
VO_TB_MEDIVA1_001	燒吧…	
VO_TB_MEDIVA1_002	小心！	
VO_TB_MEDIVA1_003	噢，多多！	
VO_TB_MEDIVA1_004	保重…	
VO_TB_MEDIVA1_005	有野獸！	
VO_TB_MEDIVA1_006	可愛的小東西。	
VO_TB_MEDIVA1_007	不！不要用毒。	
VO_TB_MEDIVA1_008	閃亮亮！	
VO_TB_MEDIVA1_009	找我嗎？	
VO_TB_MEDIVA2_001	好熱！	
VO_TB_MEDIVA2_002	真恐怖！	
VO_TB_MEDIVA2_003	喔，好冷。	
VO_TB_MEDIVA2_004	糟糕，中計了！	
VO_TB_MEDIVA2_005	不！我不敢看！	
VO_TB_MEDIVA2_006	真可愛！	
VO_TB_MEDIVA2_007	我愛小鬼。	
VO_TB_MEDIVA2_008	閃亮亮！	
VO_TB_MEDIVA2_009	哈啾！	
VO_TB_MEDIVA2_010	你找我嗎？	
VO_TB_MEDIVA3_001	好熱！	
VO_TB_MEDIVA3_002	凍成雪人了！	
VO_TB_MEDIVA3_003	可怕的黑暗！	
VO_TB_MEDIVA3_004	是假的！	
VO_TB_MEDIVA3_005	有野獸！	
VO_TB_MEDIVA3_006	他有寵物！	
VO_TB_MEDIVA3_007	噢，不妙。	
VO_TB_MEDIVA3_008	真的好毒啊。	
VO_TB_MEDIVA3_009	麥迪娃來了！	
VO_TB_MEDIVA3_010	我在這！	
VO_Terenas_Male_Human_ICCDruidVictory_01	Once, he nurtured life by tending the wilds of Azeroth. Now Malfurion the Pestilent ensures the balance of nature by tending a garden of death.	
VO_Terenas_Male_Human_ICCHunterVictory_01	Rexxar released the souls once trapped by the Lich King. He drew a black arrow from his quicker. “Come Misha!” he said. “The hunt begins…”	
VO_Terenas_Male_Human_ICCMageVictory_01	The newly-crowned frost lich surveyed her domain. Legions of undead added their power to her own. She didn’t even notice her blood freezing.	
VO_Terenas_Male_Human_ICCPaladinVictory_01	The once-noble Paladin embraced his new destiny. Those who lived a worthy life would had nothing to fear. But in death, the wicked would face his judgement... 	
VO_Terenas_Male_Human_ICCPriestVictory_01	The young Prince’s body dissolved into shadow. “I see it all now,” he said, his eyes burning with blue flame. “I have been so naive…”	
VO_Terenas_Male_Human_ICCRogueVictory_01	Valeera the Hollow disappeared into the night. Her shades and shadows see all, and none are safe from her icy blade…	
VO_Terenas_Male_Human_ICCShamanVictory_01	The shaman’s mind was overwhelmed with voices, a cacophony of the dead. The Deathseer closed his eyes and uttered a single word: “Sleep…”	
VO_Terenas_Male_Human_ICCWarlockVictory_01	At last Gul’dan sat upon the Frozen Throne. The Dark Portal yawned open once more, and worlds uncounted trembled before him.	
VO_Terenas_Male_Human_ICCWarriorVictory_01	The one-time Warchief of the Horde embraced his newfound power. The frozen victims of his army would rise up to serve, until he was master of all he surveyed.	
VO_TIRION_INTRO_03	今天有哪位英勇的騎士可以取得勇士的名號呢？	
VO_TRLA_200h_Male_Troll_Concede_01	我的表演，就到這邊…	
VO_TRLA_200h_Male_Troll_Emote_Respond_Greetings_01	噢，你是我的粉絲吧！	
VO_TRLA_200h_Male_Troll_Emote_Respond_Oops_01	真的很糟糕啊。	
VO_TRLA_200h_Male_Troll_Emote_Respond_Sorry_01	犯錯難免的。	
VO_TRLA_200h_Male_Troll_Emote_Respond_Thanks_01	感謝大家支持！	
VO_TRLA_200h_Male_Troll_Emote_Respond_Threaten_01	我會把你當成鼓來打。	
VO_TRLA_200h_Male_Troll_Emote_Respond_Well_Played_01	小犀牛喜歡那句話。	
VO_TRLA_200h_Male_Troll_Emote_Respond_Wow_01	打完才可以要簽名！	
VO_TRLA_200h_Male_Troll_EVENT_Armor_01	我準備好搖滾了！	
VO_TRLA_200h_Male_Troll_EVENT_Armor_02	你打不破的！	
VO_TRLA_200h_Male_Troll_EVENT_Armor_03	打我啊！	
VO_TRLA_200h_Male_Troll_EVENT_Dragon_01	憤怒的翅膀啊！	
VO_TRLA_200h_Male_Troll_EVENT_Dragon_02	龍的火焰！	
VO_TRLA_200h_Male_Troll_EVENT_Dragon_03	龍在哪裡？哈～在這裡！	
VO_TRLA_200h_Male_Troll_EVENT_Weapon_01	這一把不錯。	
VO_TRLA_200h_Male_Troll_EVENT_Weapon_02	準備開扁！	
VO_TRLA_200h_Male_Troll_EVENT_Weapon_03	這是我的主打歌！	
VO_TRLA_200h_Male_Troll_Greetings_01	古拉巴什的朋友，大家好！	
VO_TRLA_200h_Male_Troll_Kill_Shrine_Generic_01	這個獻給現場的各位小犀牛！	
VO_TRLA_200h_Male_Troll_Kill_Shrine_Generic_02	你沒有戲可以唱了！	
VO_TRLA_200h_Male_Troll_Kill_Shrine_Generic_03	搶走你的麥克風！	
VO_TRLA_200h_Male_Troll_Kill_Shrine_Generic_04	阿卡利狂熱大暴走！	
VO_TRLA_200h_Male_Troll_Oops_01	觀眾不喜歡那樣。	
VO_TRLA_200h_Male_Troll_Play_Akali_01	阿卡利會要你付出代價！	
VO_TRLA_200h_Male_Troll_Play_Hakkar_01	我才不管什麼後果。	
VO_TRLA_200h_Male_Troll_Play_Janalai_01	那種東西也能叫龍？	
VO_TRLA_200h_Male_Troll_Play_Ragewing_01	這傢伙很懂搖滾嘛。	
VO_TRLA_200h_Male_Troll_Play_SpiritOfTheRhino_01	準備衝撞！	
VO_TRLA_200h_Male_Troll_Player_Defeated_01	我會在你的墓碑上簽名。你也會出名！	
VO_TRLA_200h_Male_Troll_Shrine_Killed_01	表演有點小狀況！	
VO_TRLA_200h_Male_Troll_Shrine_Killed_02	嘿，這東西還可以用嗎？	
VO_TRLA_200h_Male_Troll_Shrine_Killed_03	儘管放馬過來！	
VO_TRLA_200h_Male_Troll_ShrineComesBack_01	表演繼續！	
VO_TRLA_200h_Male_Troll_ShrineComesBack_02	安可時間！	
VO_TRLA_200h_Male_Troll_ShrineComesBack_03	我會把你當成鼓來打。	
VO_TRLA_200h_Male_Troll_ShrineDoesThing_01	這個獻給在家收看的小犀牛！	
VO_TRLA_200h_Male_Troll_Sorry_01	嘿，抱歉啦。	
VO_TRLA_200h_Male_Troll_Start_01	我就是搖滾區！	
VO_TRLA_200h_Male_Troll_Thanks_01	謝謝，非常感謝。	
VO_TRLA_200h_Male_Troll_Threaten_01	我要聽到你的尖叫聲！	
VO_TRLA_200h_Male_Troll_Well_Played_01	演出很精彩。	
VO_TRLA_200h_Male_Troll_WOW_01	厲害。	
VO_TRLA_201h_Male_Troll_Concede_01	輸了…*呱*	
VO_TRLA_201h_Male_Troll_Emote_Respond_Greetings_02	嗯…	
VO_TRLA_201h_Male_Troll_Emote_Respond_Oops_01	哈...哈…	
VO_TRLA_201h_Male_Troll_Emote_Respond_Sorry_01	對…噗…起	
VO_TRLA_201h_Male_Troll_Emote_Respond_Thanks_01	我也會舔我的眼珠。	
VO_TRLA_201h_Male_Troll_Emote_Respond_Threaten_01	你…要打敗我？	
VO_TRLA_201h_Male_Troll_Emote_Respond_Well_Played_02	耶！	
VO_TRLA_201h_Male_Troll_Emote_Respond_Wow_01	好...喔。	
VO_TRLA_201h_Male_Troll_EVENT_BigSpell_01	我有大巫毒…	
VO_TRLA_201h_Male_Troll_EVENT_BigSpell_02	魔精的力量…	
VO_TRLA_201h_Male_Troll_EVENT_BigSpell_03	啊…哈哈哈哈…	
VO_TRLA_201h_Male_Troll_EVENT_Card_Draw_01	還要…我還要。	
VO_TRLA_201h_Male_Troll_EVENT_Card_Draw_02	給我！	
VO_TRLA_201h_Male_Troll_EVENT_Card_Draw_03	有了。	
VO_TRLA_201h_Male_Troll_EVENT_Damage_All_01	蛙蛙。	
VO_TRLA_201h_Male_Troll_EVENT_HauntingVisions_01	嗯？哼哼哼…	
VO_TRLA_201h_Male_Troll_EVENT_Kragwa_01	我...等很久了…	
VO_TRLA_201h_Male_Troll_EVENT_Likkem_01	找到我的棍棍了。	
VO_TRLA_201h_Male_Troll_EVENT_NagaSummon_01	海裡來的老兄。	
VO_TRLA_201h_Male_Troll_EVENT_RainOfToads_01	奎格瓦！	
VO_TRLA_201h_Male_Troll_Greetings_02	你？嘿嘿嘿嘿...哈囉。	
VO_TRLA_201h_Male_Troll_Kill_Shrine_Generic_01	玩具不見了！	
VO_TRLA_201h_Male_Troll_Kill_Shrine_Generic_03	沒得玩了。	
VO_TRLA_201h_Male_Troll_Kill_Shrine_Generic_04	壞掉了。	
VO_TRLA_201h_Male_Troll_Kill_Shrine_Mage_01	火熄掉了。	
VO_TRLA_201h_Male_Troll_Kill_Shrine_Paladin_01	抓到貓尾巴了。	
VO_TRLA_201h_Male_Troll_Kill_Shrine_Priest_02	埋起來了。	
VO_TRLA_201h_Male_Troll_Kill_Shrine_Rogue_01	沉下去了。	
VO_TRLA_201h_Male_Troll_Kill_Shrine_Warlock_01	壞壞魂能。	
VO_TRLA_201h_Male_Troll_Kill_Shrine_Warrior_01	閉嘴。	
VO_TRLA_201h_Male_Troll_LowCards_01	卡牌？需要卡牌。	
VO_TRLA_201h_Male_Troll_Oops_01	糟糕。	
VO_TRLA_201h_Male_Troll_Player_Defeated_01	耐心點。飛蟲總會…飛下來。	
VO_TRLA_201h_Male_Troll_Shrine_Event_Battlecry_02	吼！吼！吼！	
VO_TRLA_201h_Male_Troll_Shrine_Event_General_01	*呱呱*  *呱呱*  好。	
VO_TRLA_201h_Male_Troll_Shrine_Event_General_02	*呱呱*  ！	
VO_TRLA_201h_Male_Troll_Shrine_Killed_01	真討厭。	
VO_TRLA_201h_Male_Troll_Shrine_Killed_02	報仇！	
VO_TRLA_201h_Male_Troll_Shrine_Killed_03	啊。	
VO_TRLA_201h_Male_Troll_Shrine_Returns_01	回來了。	
VO_TRLA_201h_Male_Troll_Shrine_Returns_02	又好了。	
VO_TRLA_201h_Male_Troll_Shrine_Returns_04	準備好了。	
VO_TRLA_201h_Male_Troll_Sorry_02	抱歉。	
VO_TRLA_201h_Male_Troll_Start_03	來，小蝌蚪。	
VO_TRLA_201h_Male_Troll_Thanks_03	謝謝你。	
VO_TRLA_201h_Male_Troll_Threaten_02	好吃…	
VO_TRLA_201h_Male_Troll_Well_Played_01	真聰明！	
VO_TRLA_201h_Male_Troll_WOW_01	*呱呱*	
VO_TRLA_202h_Female_Troll_Concede_01	我沒有輸，只是選擇不要贏！	
VO_TRLA_202h_Female_Troll_Death_Long_04	跟著船一起沉了…	
VO_TRLA_202h_Female_Troll_Emote_Respond_Greetings_01	看來我們的關係應該會…一帆風順。	
VO_TRLA_202h_Female_Troll_Emote_Respond_Oops_01	大家都會犯錯，只是有些人錯得比較離譜。	
VO_TRLA_202h_Female_Troll_Emote_Respond_Sorry_01	不需要道歉的。	
VO_TRLA_202h_Female_Troll_Emote_Respond_Thanks_01	不客氣，讓我們把愛傳出去。	
VO_TRLA_202h_Female_Troll_Emote_Respond_Threaten_01	哈哈哈！喔…你是認真的。	
VO_TRLA_202h_Female_Troll_Emote_Respond_Well_Played_01	欸，觀眾也都覺得不錯。	
VO_TRLA_202h_Female_Troll_Emote_Respond_Wow_01	那個真的厲害。	
VO_TRLA_202h_Female_Troll_Greetings_01	呦呵！	
VO_TRLA_202h_Female_Troll_Kill_Shrine_Generic_01	嘿嘿，這是一定要的。	
VO_TRLA_202h_Female_Troll_Kill_Shrine_Generic_02	彎腰撿碎片的時候，要小心背後喔…	
VO_TRLA_202h_Female_Troll_Kill_Shrine_Generic_03	管你什麼聖壇，照樣砸了！	
VO_TRLA_202h_Female_Troll_Kill_Shrine_Mage_01	水對上火，你的運氣真差。	
VO_TRLA_202h_Female_Troll_Oops_01	噢喔！	
VO_TRLA_202h_Female_Troll_Play _Gral_02	水裡有血，你最好游快一點。	
VO_TRLA_202h_Female_Troll_Play_Burgle_01	那是我的了。	
VO_TRLA_202h_Female_Troll_Play_Burgle_02	來看看有什麼好東西。	
VO_TRLA_202h_Female_Troll_Play_Burgle_03	你用這些牌？你認真的嗎？	
VO_TRLA_202h_Female_Troll_Play_Burgle_04	我的規則我說了算。	
VO_TRLA_202h_Female_Troll_Play_CannonBarrage_02	記得提醒我多偷點砲彈…	
VO_TRLA_202h_Female_Troll_Play_CannonBarrage_03	給他們下一場砲彈雨！	
VO_TRLA_202h_Female_Troll_Play_CannonBarrage_04	弄沉他們！…呃，我打個比方啦！	
VO_TRLA_202h_Female_Troll_Play_CannonBarrage_06	大砲準備！全部開火！	
VO_TRLA_202h_Female_Troll_Play_OneEyedCheat_01	這招我超愛！	
VO_TRLA_202h_Female_Troll_Play_Patches_01	衝不起來了吧！	
VO_TRLA_202h_Female_Troll_Play_Pirate_01	又一個吃裡扒外的。	
VO_TRLA_202h_Female_Troll_Play_Pirate_03	啊，各位船員！小心那個傢伙啊。	
VO_TRLA_202h_Female_Troll_Play_Pirate_04	我們會處得不錯。	
VO_TRLA_202h_Female_Troll_Play_RaidingParty_01	自己的薪水自己搶！	
VO_TRLA_202h_Female_Troll_Play_ShadyDealer_01	他的東西是最划算的！	
VO_TRLA_202h_Female_Troll_Play_Spirit_01	見識大海的憤怒！	
VO_TRLA_202h_Female_Troll_Play_WalkThePlank_01	去跳海吧！	
VO_TRLA_202h_Female_Troll_Player_Defeated_01	你的勝算本來就很低...我動過手腳了。	
VO_TRLA_202h_Female_Troll_Shrine_Killed_01	反正也沒有那麼重要。	
VO_TRLA_202h_Female_Troll_Shrine_Killed_02	你以為那樣真的有用嗎？	
VO_TRLA_202h_Female_Troll_Shrine_Killed_03	啊…拜託！	
VO_TRLA_202h_Female_Troll_Shrine_Mana_02	喔～那我就不客氣啦！	
VO_TRLA_202h_Female_Troll_Shrine_Mana_04	其他食人妖不要的，都是我的寶物。	
VO_TRLA_202h_Female_Troll_Shrine_Return_02	回來啦！祝你好運。	
VO_TRLA_202h_Female_Troll_Shrine_Return_03	該回來的，就會回來。	
VO_TRLA_202h_Female_Troll_Shrine_Return_04	啊，我們又可以放膽的打了。	
VO_TRLA_202h_Female_Troll_Shrine_Spell_01	看清楚了嗎？有兩個！	
VO_TRLA_202h_Female_Troll_Shrine_Spell_02	免費再多送你一個…	
VO_TRLA_202h_Female_Troll_Shrine_Spell_03	買一送一！	
VO_TRLA_202h_Female_Troll_Shrine_Stealth_01	我們被盯上了！	
VO_TRLA_202h_Female_Troll_Shrine_Stealth_02	我們被拆穿了！	
VO_TRLA_202h_Female_Troll_Shrine_Stealth_03	該發動突擊了！	
VO_TRLA_202h_Female_Troll_Sorry_01	我好像太超過了。	
VO_TRLA_202h_Female_Troll_Start_03	我絕不作弊...這一次...我保證。	
VO_TRLA_202h_Female_Troll_Thanks_01	噢～你不用這麼客氣。	
VO_TRLA_202h_Female_Troll_Threaten_01	鯊魚會把你吃得乾乾淨淨。	
VO_TRLA_202h_Female_Troll_Well_Played_02	以旱鴨子來說...還不算太差。	
VO_TRLA_202h_Female_Troll_WOW_01	哇，真是不錯！	
VO_TRLA_203h_Male_Troll_Concede_02	呿，我會再來找你挑戰的！	
VO_TRLA_203h_Male_Troll_Death_Long_03	爪子…折斷了…	
VO_TRLA_203h_Male_Troll_Emote_Respond_Greetings_01	我不是來跟你套交情的。	
VO_TRLA_203h_Male_Troll_Emote_Respond_Oops_01	正常啦，因為你不是我。	
VO_TRLA_203h_Male_Troll_Emote_Respond_Thanks_01	不客氣。	
VO_TRLA_203h_Male_Troll_Emote_Respond_Threaten_01	你過來再說一遍。	
VO_TRLA_203h_Male_Troll_Emote_Respond_Well_Played_01	所以冠軍是我，哼！	
VO_TRLA_203h_Male_Troll_Emote_Respond_Wow_01	我知道、我知道。我就是那麼厲害。	
VO_TRLA_203h_Male_Troll_Greetings_01	你好啊，恭喜你輸了！	
VO_TRLA_203h_Male_Troll_Kill_Shrine_Druid_01	你的「心中的野獸」根本還沒發育完全。	
VO_TRLA_203h_Male_Troll_Kill_Shrine_Generic_01	先打你的祭壇，再來就打你。	
VO_TRLA_203h_Male_Troll_Kill_Shrine_Generic_02	關鍵的一擊！	
VO_TRLA_203h_Male_Troll_Kill_Shrine_Generic_03	K.O.！	
VO_TRLA_203h_Male_Troll_Kill_Shrine_Hunter_01	你的聖壇就像你的帝國一樣，毀滅啦。	
VO_TRLA_203h_Male_Troll_Kill_Shrine_Mage_01	沒有燃料，看你怎麼燒？	
VO_TRLA_203h_Male_Troll_Kill_Shrine_Priest_01	我的這一下，連魂靈都感覺得到！	
VO_TRLA_203h_Male_Troll_Kill_Shrine_Rogue_02	海盜的鉤子不算什麼，我的鉤拳更厲害。	
VO_TRLA_203h_Male_Troll_Kill_Shrine_Shaman_01	打到你呱呱叫，青蛙老兄！	
VO_TRLA_203h_Male_Troll_Kill_Shrine_Warlock_01	啊啊…有翅膀的不准進來！	
VO_TRLA_203h_Male_Troll_Kill_Shrine_Warrior_01	讓你搖不起來。	
VO_TRLA_203h_Male_Troll_Oops_01	喔…那樣不對。	
VO_TRLA_203h_Male_Troll_Play_ANewChallenger_01	新的挑戰者，出現了！	
VO_TRLA_203h_Male_Troll_Play_ANewChallenger_02	終於有厲害的挑戰者啦！	
VO_TRLA_203h_Male_Troll_Play_ANewChallenger_03	是誰？居然敢踏進競技場？	
VO_TRLA_203h_Male_Troll_Play_FlashOfLight_01	放個閃！	
VO_TRLA_203h_Male_Troll_Play_Healing_01	不痛不癢！	
VO_TRLA_203h_Male_Troll_Play_Rush_01	老虎的速度。	
VO_TRLA_203h_Male_Troll_Play_Rush_02	衝啊！	
VO_TRLA_203h_Male_Troll_Play_Shirvallah_01	兄弟們，上啊！老虎發威！	
VO_TRLA_203h_Male_Troll_Play_Spirit_01	老虎來囉。	
VO_TRLA_203h_Male_Troll_Play_TimeOut_01	快來打我啊。	
VO_TRLA_203h_Male_Troll_Play_TimeOut_02	你抓不到我。	
VO_TRLA_203h_Male_Troll_Player_Defeated_02	這一戰不公平，因為你的對手是我。	
VO_TRLA_203h_Male_Troll_Shrine_Buff_01	團結力量大！	
VO_TRLA_203h_Male_Troll_Shrine_Buff_02	閃耀吧，希爾瓦拉！	
VO_TRLA_203h_Male_Troll_Shrine_Buff_03	喔，希爾瓦拉的光芒！	
VO_TRLA_203h_Male_Troll_Shrine_Damage_01	出拳！	
VO_TRLA_203h_Male_Troll_Shrine_Damage_02	打回去！	
VO_TRLA_203h_Male_Troll_Shrine_Damage_03	報仇！	
VO_TRLA_203h_Male_Troll_Shrine_Damage_04	反擊！	
VO_TRLA_203h_Male_Troll_Shrine_DivineShield_01	希爾瓦拉保護我們！	
VO_TRLA_203h_Male_Troll_Shrine_DivineShield_02	堅持下去！	
VO_TRLA_203h_Male_Troll_Shrine_DivineShield_03	我們是打不倒的！	
VO_TRLA_203h_Male_Troll_Shrine_Killed_01	那樣犯規…	
VO_TRLA_203h_Male_Troll_Shrine_Killed_02	只是先喘口氣。	
VO_TRLA_203h_Male_Troll_Shrine_Killed_03	我還沒有要丟毛巾。	
VO_TRLA_203h_Male_Troll_Shrine_Return_01	力氣恢復了！	
VO_TRLA_203h_Male_Troll_Shrine_Return_02	我回來啦，而且比之前更厲害！	
VO_TRLA_203h_Male_Troll_Shrine_Return_03	準備繼續開扁。	
VO_TRLA_203h_Male_Troll_Sorry_01	呃…對不起？	
VO_TRLA_203h_Male_Troll_Start_01	在你面前的，是競技場之王！	
VO_TRLA_203h_Male_Troll_Thanks_01	觀眾喜歡那樣。	
VO_TRLA_203h_Male_Troll_Threaten_02	你要有新的疤了。	
VO_TRLA_203h_Male_Troll_Well_Played_01	這招厲害。	
VO_TRLA_203h_Male_Troll_WOW_01	不錯喔！不錯喔。	
VO_TRLA_204h_Male_Troll_Death_Long_03	我…還…沒有…死…	
VO_TRLA_204h_Male_Troll_Emote_Respond_Greetings_01	歡迎，來到叢林！	
VO_TRLA_204h_Male_Troll_Emote_Respond_Oops_01	哈哈哈哈…	
VO_TRLA_204h_Male_Troll_Emote_Respond_Sorry_01	最好是啦。	
VO_TRLA_204h_Male_Troll_Emote_Respond_Thanks_01	你繼續廢話，我繼續砍人。	
VO_TRLA_204h_Male_Troll_Emote_Respond_Threaten_01	遺言講成這樣，很弱捏，真的。	
VO_TRLA_204h_Male_Troll_Emote_Respond_Well_Played_01	要給粉絲一點特別的！	
VO_TRLA_204h_Male_Troll_Emote_Respond_Wow_01	耶，老兄！	
VO_TRLA_204h_Male_Troll_Event_Harbinger_01	不管怎樣，他都會把你解決掉的！	
VO_TRLA_204h_Male_Troll_Event_Hatchet_02	還是斧頭最順手。	
VO_TRLA_204h_Male_Troll_Event_Lynx_01	這是我的好兄弟，阿牙和阿爪。	
VO_TRLA_204h_Male_Troll_Event_Panther_01	他們會逮到你的。	
VO_TRLA_204h_Male_Troll_Event_RandomSpell_01	我的魔精發威了。	
VO_TRLA_204h_Male_Troll_Event_Reducecost_01	要開始讓你痛到底了！	
VO_TRLA_204h_Male_Troll_Kill_Shrine_Generic_01	為了哈拉齊！	
VO_TRLA_204h_Male_Troll_Kill_Shrine_Shaman_01	現在不能躲在青蛙後面了吧。	
VO_TRLA_204h_Male_Troll_Player_Defeated_01	為了阿曼尼！為了哈拉齊！	
VO_TRLA_204h_Male_Troll_Shrine_BeastComesBack_	我的寵物，不要放棄！	
VO_TRLA_204h_Male_Troll_Shrine_BigDamage_02	這裡是殘酷的叢林！	
VO_TRLA_204h_Male_Troll_Shrine_BigDamage_03	喔…哈哈哈！他們聞到了血的味道！	
VO_TRLA_204h_Male_Troll_Shrine_BigDamage_04	全部一起上啦！	
VO_TRLA_204h_Male_Troll_Shrine_DrawCards_02	阿曼尼絕對不會停手。	
VO_TRLA_204h_Male_Troll_Shrine_DrawCards_03	出手幫我一下，哈哈哈！	
VO_TRLA_204h_Male_Troll_Shrine_Killed_01	阿曼尼不會原諒！	
VO_TRLA_204h_Male_Troll_Shrine_Killed_02	哈拉齊有仇必報！	
VO_TRLA_204h_Male_Troll_Shrine_Killed_03	你要付出代價！你們全部都要付出代價！	
VO_TRLA_204h_Male_Troll_Start_01	我會送你上路！	
VO_TRLA_205h_Female_Troll_Concede_01	這場我輸了，但是大自然是不朽的。	
VO_TRLA_205h_Female_Troll_Death_Long_02	我的魂靈可以自由奔跑了…	
VO_TRLA_205h_Female_Troll_Emote_Respond_Greetings_01	我們早就聞到你的味道了。	
VO_TRLA_205h_Female_Troll_Emote_Respond_Oops_01	錯誤的判斷。	
VO_TRLA_205h_Female_Troll_Emote_Respond_Sorry_01	你是應該道歉。	
VO_TRLA_205h_Female_Troll_Emote_Respond_Thanks_01	心裡的野獸讓我們展現出最好的一面。	
VO_TRLA_205h_Female_Troll_Emote_Respond_Threaten_01	那就來做個了斷吧。我的獸群餓了。	
VO_TRLA_205h_Female_Troll_Emote_Respond_Well_Played_01	那當然。	
VO_TRLA_205h_Female_Troll_Emote_Respond_Wow_01	只不過是我的本能。	
VO_TRLA_205h_Female_Troll_Greetings_01	獸群歡迎你。	
VO_TRLA_205h_Female_Troll_Kill_Shrine_Generic_01	不堪一擊，就跟你的人。	
VO_TRLA_205h_Female_Troll_Kill_Shrine_Mage_01	都是花招，沒有真材實料。	
VO_TRLA_205h_Female_Troll_Kill_Shrine_Paladin_01	你的聖壇不過就是個貓抓板。	
VO_TRLA_205h_Female_Troll_Kill_Shrine_Priest_01	原始直覺是不朽的。	
VO_TRLA_205h_Female_Troll_Kill_Shrine_Rogue_01	看來你在陸地上反而站不穩啊。	
VO_TRLA_205h_Female_Troll_Kill_Shrine_Shaman_01	你專殺飛蟲，我專殺你這種蠢貨。	
VO_TRLA_205h_Female_Troll_LowCards_01	我的選擇不多了…	
VO_TRLA_205h_Female_Troll_Oops_01	出錯了！	
VO_TRLA_205h_Female_Troll_Play_Gonk_01	在剛克的面前顫抖吧！	
VO_TRLA_205h_Female_Troll_Play_Hakkar_01	拉帕塔利，原諒我…	
VO_TRLA_205h_Female_Troll_Play_MarkOfTheLoa_01	怎麼選都是對的。	
VO_TRLA_205h_Female_Troll_Play_SpiritOfTheRaptor_01	迅猛龍！來幫助我！	
VO_TRLA_205h_Female_Troll_Player_Defeated_02	這世界上沒人可以馴服我。	
VO_TRLA_205h_Female_Troll_Shrine_Killed_01	我不會放過你的。	
VO_TRLA_205h_Female_Troll_Shrine_Killed_02	你只是在痛恨你不了解的事情。	
VO_TRLA_205h_Female_Troll_Shrine_Killed_03	生命不斷循環…	
VO_TRLA_205h_Female_Troll_ShrineComesBack_01	我的靈魂永不毀滅。	
VO_TRLA_205h_Female_Troll_ShrineComesBack_02	大自然會找到出路的。	
VO_TRLA_205h_Female_Troll_ShrineEvent_Mana_01	能活下來的，只有最強的、還有最快的。	
VO_TRLA_205h_Female_Troll_ShrineEvent_Mana_02	剛克給我力量！	
VO_TRLA_205h_Female_Troll_ShrineEvent_Mana_03	我不會停下來的！	
VO_TRLA_205h_Female_Troll_ShrineEvent_MinionBuff_04	剛克會摧毀你！	
VO_TRLA_205h_Female_Troll_ShrineEvent_PlusAttack_01	我們是大自然的力量！	
VO_TRLA_205h_Female_Troll_ShrineEvent_PlusAttack_02	為了剛克的榮耀！	
VO_TRLA_205h_Female_Troll_ShrineEvent_PlusAttack_03	剛克的力量會不斷變強的。	
VO_TRLA_205h_Female_Troll_Sorry_02	對不起。	
VO_TRLA_205h_Female_Troll_Start_01	狂野而活，凋零而死。	
VO_TRLA_205h_Female_Troll_Thanks_01	感謝你。	
VO_TRLA_205h_Female_Troll_Threaten_01	我會讓你絕種！	
VO_TRLA_205h_Female_Troll_Well_Played_01	表現不錯。	
VO_TRLA_205h_Female_Troll_WOW_01	真是太驚人了。	
VO_TRLA_206h_Female_Troll_Concede_01	我會，再回來的…	
VO_TRLA_206h_Female_Troll_Emote_Respond_Greetings_01	希爾雷克啊！我們的獵物在說話。	
VO_TRLA_206h_Female_Troll_Emote_Respond_Oops_01	別煩惱啦。	
VO_TRLA_206h_Female_Troll_Emote_Respond_Sorry_01	希爾雷克從不原諒。	
VO_TRLA_206h_Female_Troll_Emote_Respond_Thanks_01	不要把我的仁慈當成示弱。	
VO_TRLA_206h_Female_Troll_Emote_Respond_Threaten_01	威脅我？那我要配合你說「我怕怕」嗎？	
VO_TRLA_206h_Female_Troll_Emote_Respond_Well_Played_01	所以你還是分得出好壞的。	
VO_TRLA_206h_Female_Troll_Emote_Respond_Wow_01	真有趣。	
VO_TRLA_206h_Female_Troll_Greetings_01	歡迎啊，蝙蝠飼料。	
VO_TRLA_206h_Female_Troll_HakkarReponse_01	哈卡！這次希爾雷克會吞食你！	
VO_TRLA_206h_Female_Troll_Kill_Shrine_Generic_01	你的羅亞好弱。	
VO_TRLA_206h_Female_Troll_Kill_Shrine_Hunter_01	回去玩貓砂吧你。	
VO_TRLA_206h_Female_Troll_Kill_Shrine_Priest_01	黑夜籠罩一切。	
VO_TRLA_206h_Female_Troll_Kill_Shrine_Rogue_01	滾回海上抓魚吧。	
VO_TRLA_206h_Female_Troll_Kill_Shrine_Shaman_01	還有遺言嗎？除了呱呱叫以外？	
VO_TRLA_206h_Female_Troll_Kill_Shrine_Warrior_01	給你個教訓！	
VO_TRLA_206h_Female_Troll_Oops_01	那樣行不通的。	
VO_TRLA_206h_Female_Troll_Play_Hireek_01	蝙蝠甦醒了！	
VO_TRLA_206h_Female_Troll_Play_Lanathel_01	你的品味不錯。	
VO_TRLA_206h_Female_Troll_Play_SpiritofBat_01	天空是我們的！	
VO_TRLA_206h_Female_Troll_Player_Defeated_01	你這樣也敢來參賽？實在是…太可笑了。	
VO_TRLA_206h_Female_Troll_Shrine_BounceDamage_01	痛苦歸你，收穫歸我。	
VO_TRLA_206h_Female_Troll_Shrine_BounceDamage_02	一定要有人犧牲，但不會是我。	
VO_TRLA_206h_Female_Troll_Shrine_BounceDamage_03	血債，血還。	
VO_TRLA_206h_Female_Troll_Shrine_CheapSpell_01	像蝙蝠一樣迅速。	
VO_TRLA_206h_Female_Troll_Shrine_CheapSpell_02	我的力量來自另一個世界。	
VO_TRLA_206h_Female_Troll_Shrine_General_01	希爾雷克是永恆的！	
VO_TRLA_206h_Female_Troll_Shrine_Killed_01	你要付出血的代價！	
VO_TRLA_206h_Female_Troll_Shrine_Killed_02	午夜的天空會再次來臨。	
VO_TRLA_206h_Female_Troll_Shrine_Killed_03	我可沒這麼容易就放棄。	
VO_TRLA_206h_Female_Troll_Sorry_01	太讓人失望了。	
VO_TRLA_206h_Female_Troll_Start_01	今晚，希爾雷克要喝你的血。	
VO_TRLA_206h_Female_Troll_Thanks_01	你還真好心啊…	
VO_TRLA_206h_Female_Troll_Threaten_03	哪個比較鹹？你的淚水，還是血水？	
VO_TRLA_206h_Female_Troll_Well_Played_01	希爾雷克也會認同。	
VO_TRLA_206h_Female_Troll_WOW_01	厲害。	
VO_TRLA_207h_Male_Troll_Concede_01	就算輸，我也要輸得夠勁爆！	
VO_TRLA_207h_Male_Troll_Emote_Respond_Greetings_01	你說什麼？我聽不見！	
VO_TRLA_207h_Male_Troll_Emote_Respond_Oops_01	那就從頭開始吧。	
VO_TRLA_207h_Male_Troll_Emote_Respond_Sorry_01	啊，就這樣吧。	
VO_TRLA_207h_Male_Troll_Emote_Respond_Thanks_01	都是為了觀眾的！	
VO_TRLA_207h_Male_Troll_Emote_Respond_Threaten_02	觀眾需要一點戲劇張力。	
VO_TRLA_207h_Male_Troll_Emote_Respond_Well_Played_01	很高興你喜歡我的表演！	
VO_TRLA_207h_Male_Troll_Emote_Respond_Wow_01	對，我知道我超厲害的。	
VO_TRLA_207h_Male_Troll_Greetings_01	精彩的表演開始了！	
VO_TRLA_207h_Male_Troll_Kill_Opponent_01	精彩大結局來啦！	
VO_TRLA_207h_Male_Troll_Kill_Shrine_Generic_01	會燒起來喔。	
VO_TRLA_207h_Male_Troll_Kill_Shrine_Generic_02	唷，你的聖壇是可燃的。	
VO_TRLA_207h_Male_Troll_Kill_Shrine_Generic_06	這裡沒有防火裝置，老兄。	
VO_TRLA_207h_Male_Troll_Kill_Shrine_Paladin_01	有東西…起火了嗎？	
VO_TRLA_207h_Male_Troll_Kill_Shrine_Shaman_01	聽說蟾蜍最怕火燒。	
VO_TRLA_207h_Male_Troll_Oops_01	噢，走火了。	
VO_TRLA_207h_Male_Troll_Play_Antonidas_01	這傢伙很懂火。	
VO_TRLA_207h_Male_Troll_Play_Blast_Wave_01	衝起來！	
VO_TRLA_207h_Male_Troll_Play_Fan_of_Flames_01	太壯觀了！	
VO_TRLA_207h_Male_Troll_Play_Fireball_01	瘋狂火球！	
VO_TRLA_207h_Male_Troll_Play_FirePlume_01	你有看到我的吉祥物嗎？	
VO_TRLA_207h_Male_Troll_Play_Flamestrike_01	通通燒起來吧！	
VO_TRLA_207h_Male_Troll_Play_Janalai_01	賈納雷，讓場子熱起來！	
VO_TRLA_207h_Male_Troll_Play_Magma_Rager_01	至少，他很努力的。	
VO_TRLA_207h_Male_Troll_Play_Pyroblast_01	炎殺大爆彈！	
VO_TRLA_207h_Male_Troll_Play_Pyromaniac_01	終於，有鐵粉來了！	
VO_TRLA_207h_Male_Troll_Player_Defeated_01	你應該多抽動幾下的，觀眾會比較喜歡看。	
VO_TRLA_207h_Male_Troll_Shrine_ACTIVATE_01	燒起來！	
VO_TRLA_207h_Male_Troll_Shrine_ACTIVATE_02	火熱登場！	
VO_TRLA_207h_Male_Troll_Shrine_EVENT_01	我們再來一次。	
VO_TRLA_207h_Male_Troll_Shrine_EVENT_02	好的，再試一次。	
VO_TRLA_207h_Male_Troll_Shrine_EVENT_03	準備開拍第二場了嗎？	
VO_TRLA_207h_Male_Troll_Shrine_Killed_02	太緊張了！	
VO_TRLA_207h_Male_Troll_Shrine_Killed_03	我們的英雄會怎麼做？	
VO_TRLA_207h_Male_Troll_Shrine_Killed_04	啊，戲劇性的一幕！	
VO_TRLA_207h_Male_Troll_Sorry_01	喔，真不好意思。	
VO_TRLA_207h_Male_Troll_Start_01	你準備要被火燒燒燒燒燒了嗎？	
VO_TRLA_207h_Male_Troll_Thanks_01	感謝你！	
VO_TRLA_207h_Male_Troll_Threaten_02	為了觀眾，我要打垮你。	
VO_TRLA_207h_Male_Troll_Trigger_Cinderstorm_01	燒成灰燼！	
VO_TRLA_207h_Male_Troll_Trigger_Frostfire_01	冰冷的火焰！	
VO_TRLA_207h_Male_Troll_Trigger_Meteor_01	隕石來了！	
VO_TRLA_207h_Male_Troll_Well_Played_01	表演太精彩了！	
VO_TRLA_207h_Male_Troll_WOW_01	太華麗了！	
VO_TRLA_208h_Female_Troll_Concede_01	我的命運已定。伯昂撒姆第，幫我復仇！	
VO_TRLA_208h_Female_Troll_Death_Long_03	贊達拉...	
VO_TRLA_208h_Female_Troll_Emote_Respond_Greetings_01	可惜我們是在這樣的地方見面。	
VO_TRLA_208h_Female_Troll_Emote_Respond_Oops_01	你使出全力了嗎？	
VO_TRLA_208h_Female_Troll_Emote_Respond_Sorry_01	我也是。	
VO_TRLA_208h_Female_Troll_Emote_Respond_Thanks_01	在這裡沒必要客氣。	
VO_TRLA_208h_Female_Troll_Emote_Respond_Threaten_01	我經歷過太多事情，這不算什麼。	
VO_TRLA_208h_Female_Troll_Emote_Respond_Well_Played_01	這就是贊達拉的風格。	
VO_TRLA_208h_Female_Troll_Emote_Respond_Wow_01	我，也非常驚訝。	
VO_TRLA_208h_Female_Troll_EventCopies_01	我的力量更強了…	
VO_TRLA_208h_Female_Troll_EventMedic_01	黑暗的力量…流動...我全身…	
VO_TRLA_208h_Female_Troll_EventMender_01	這就是贊達拉的力量！	
VO_TRLA_208h_Female_Troll_EventSoulbreaker_01	伯昂薩姆第知道你在想什麼…	
VO_TRLA_208h_Female_Troll_Greetings_01	我在此歡迎你。	
VO_TRLA_208h_Female_Troll_Kill_Shrine_Generic_01	你的力量到哪裡去啦？	
VO_TRLA_208h_Female_Troll_Kill_Shrine_Rogue_01	絕不寬恕。	
VO_TRLA_208h_Female_Troll_Kill_Shrine_Warrior_01	沒有智慧，再大的力量也沒有用的。	
VO_TRLA_208h_Female_Troll_LowCards_01	我快沒有選擇了。	
VO_TRLA_208h_Female_Troll_Oops_01	伯昂撒姆第會懲罰錯誤。	
VO_TRLA_208h_Female_Troll_Play_AuchenaiPhantasm_01	從生，到死。	
VO_TRLA_208h_Female_Troll_Play_Seance_01	死者對我說話。	
VO_TRLA_208h_Female_Troll_Play_Seance_02	你聽到魂靈的呼喚了嗎？	
VO_TRLA_208h_Female_Troll_Play_Surrender_01	伯昂撒姆第的力量在我的血液中流動。	
VO_TRLA_208h_Female_Troll_Player_Defeated_01	我的家族付出了代價，才得到這股力量。	
VO_TRLA_208h_Female_Troll_Shrine_BigDamage_01	為死者復仇！	
VO_TRLA_208h_Female_Troll_Shrine_BigDamage_02	來自黑暗力量的大禮。	
VO_TRLA_208h_Female_Troll_Shrine_BigDamage_03	感受伯昂撒姆第的力量…	
VO_TRLA_208h_Female_Troll_Shrine_BigRez_01	讚美伯昂薩姆第！	
VO_TRLA_208h_Female_Troll_Shrine_BigRez_02	死者來討回他們應得的東西。	
VO_TRLA_208h_Female_Troll_Shrine_BigRez_03	死亡，只是新的起點。	
VO_TRLA_208h_Female_Troll_Shrine_BigSummon_01	我的話語擁有力量。	
VO_TRLA_208h_Female_Troll_Shrine_BigSummon_02	魂靈聽我呼喚！	
VO_TRLA_208h_Female_Troll_Shrine_BigSummon_03	贊達拉屹立不搖。	
VO_TRLA_208h_Female_Troll_Shrine_Killed_01	伯昂撒姆第！	
VO_TRLA_208h_Female_Troll_Shrine_Killed_02	不能就這樣結束…	
VO_TRLA_208h_Female_Troll_Shrine_Killed_03	死者不滅，終將再起。	
VO_TRLA_208h_Female_Troll_Sorry_01	我很抱歉。	
VO_TRLA_208h_Female_Troll_Start_01	我會奮戰到底，我會贏得勝利。	
VO_TRLA_208h_Female_Troll_Thanks_01	我向你道謝。	
VO_TRLA_208h_Female_Troll_Threaten_02	墓穴在呼喚你！	
VO_TRLA_208h_Female_Troll_Well_Played_01	看得出來，你很有本事。	
VO_TRLA_208h_Female_Troll_WOW_01	真是太精彩了！	
VO_TRLA_209h_Male_Troll_Concede_01	我的比賽結束了…	
VO_TRLA_209h_Male_Troll_ERROR_FULL_MINIONS_01	不能再叫更多手下了。	
VO_TRLA_209h_Male_Troll_ERROR_GENERIC_01	我覺得不能那樣啦。	
VO_TRLA_209h_Male_Troll_ERROR_HAND_FULL_01	我不能再拿牌了。	
VO_TRLA_209h_Male_Troll_ERROR_I_ATTACKED_01	我已經攻擊過了。	
VO_TRLA_209h_Male_Troll_ERROR_MINION_ATTACKED_01	那個手下攻擊過了。	
VO_TRLA_209h_Male_Troll_ERROR_NEED_MANA_01	我需要法力。	
VO_TRLA_209h_Male_Troll_ERROR_NEED_WEAPON_01	我需要武器。	
VO_TRLA_209h_Male_Troll_ERROR_PLAY_01	那個我不能打！	
VO_TRLA_209h_Male_Troll_ERROR_STEALTH_01	哇，躲起來的！	
VO_TRLA_209h_Male_Troll_ERROR_SUMMON_SICKNESS_01	那個手下還不能打人的。	
VO_TRLA_209h_Male_Troll_ERROR_TARGET_01	沒辦法攻擊那個。	
VO_TRLA_209h_Male_Troll_ERROR_TAUNT_01	我要先打敗那個嘲諷的手下。	
VO_TRLA_209h_Male_Troll_GG_01	玩得不錯！	
VO_TRLA_209h_Male_Troll_Greetings_01	我向你致敬。	
VO_TRLA_209h_Male_Troll_HAPPY_EVENT_01	開心過節！	
VO_TRLA_209h_Male_Troll_Kill_Shrine_Druid_01	畜生，給我規矩一點！	
VO_TRLA_209h_Male_Troll_Kill_Shrine_Generic_01	這場我會贏的！	
VO_TRLA_209h_Male_Troll_Kill_Shrine_Hunter_01	你已經老了，祖爾金！	
VO_TRLA_209h_Male_Troll_Kill_Shrine_Mage_01	表演結束了，瑪拉克雷斯！	
VO_TRLA_209h_Male_Troll_Kill_Shrine_Paladin_01	塞卡爾，我會破解你的每一招！	
VO_TRLA_209h_Male_Troll_Kill_Shrine_Priest_01	…死了就不要再起來了！	
VO_TRLA_209h_Male_Troll_Kill_Shrine_Rogue_01	鉤牙，我看你要沈船了！	
VO_TRLA_209h_Male_Troll_Kill_Shrine_Shaman_01	你的聖壇…噁，黏黏的！	
VO_TRLA_209h_Male_Troll_Kill_Shrine_Warlock_01	耶克里克，看我怎麼教訓你。	
VO_TRLA_209h_Male_Troll_Kill_Shrine_Warrior_01	你真的很強…但是我比你更強！	
VO_TRLA_209h_Male_Troll_LowCards_01	我快要沒有牌了！	
VO_TRLA_209h_Male_Troll_Mirror_Greetings_	我也向你致敬。	
VO_TRLA_209h_Male_Troll_MIRROR_START_01	冠軍只能有一個…	
VO_TRLA_209h_Male_Troll_NoCards_01	我沒有牌了！	
VO_TRLA_209h_Male_Troll_Oops_01	犯錯了…	
VO_TRLA_209h_Male_Troll_Picked_01	冠軍一定是我！	
VO_TRLA_209h_Male_Troll_Shrine_Flavor_Druid_01	我的身上流著剛克的力量…	
VO_TRLA_209h_Male_Troll_Shrine_Flavor_Hunter_01	哈拉齊，把你的力量借給我！	
VO_TRLA_209h_Male_Troll_Shrine_Flavor_Mage_01	賈納雷，在敵人身上降下火雨！	
VO_TRLA_209h_Male_Troll_Shrine_Flavor_Paladin_01	偉大的希爾瓦拉，保護我！	
VO_TRLA_209h_Male_Troll_Shrine_Flavor_Priest_01	死者的代言人，伯昂撒姆第…	
VO_TRLA_209h_Male_Troll_Shrine_Flavor_Rogue_01	鯊魚會聞到鮮血的氣味！	
VO_TRLA_209h_Male_Troll_Shrine_Flavor_Shaman_01	奎格瓦，我呼喚你…	
VO_TRLA_209h_Male_Troll_Shrine_Flavor_Warlock_01	希爾雷克，我把身軀和靈魂都獻給你！	
VO_TRLA_209h_Male_Troll_Shrine_Flavor_Warrior_01	阿卡利，請賜我力量！	
VO_TRLA_209h_Male_Troll_Shrine_Killed_01	喔，要小心一點了…	
VO_TRLA_209h_Male_Troll_Shrine_Killed_02	真是糟糕。	
VO_TRLA_209h_Male_Troll_Shrine_Killed_03	我的聖壇！	
VO_TRLA_209h_Male_Troll_Shrine_Killed_04	最好打保守一點…	
VO_TRLA_209h_Male_Troll_Shrine_Returns_01	可以再打了！	
VO_TRLA_209h_Male_Troll_Shrine_Returns_02	我恢復力量了。	
VO_TRLA_209h_Male_Troll_Shrine_Returns_03	準備反擊！	
VO_TRLA_209h_Male_Troll_Shrine_Returns_04	繼續戰鬥！	
VO_TRLA_209h_Male_Troll_Shrine_Returns_05	我的聖壇恢復了！	
VO_TRLA_209h_Male_Troll_Sorry_01	喔…抱歉。	
VO_TRLA_209h_Male_Troll_Start_01	我不是來被淘汰的！	
VO_TRLA_209h_Male_Troll_Start_02	大家會記住我的名字。	
VO_TRLA_209h_Male_Troll_Start_03	我辦得到的！	
VO_TRLA_209h_Male_Troll_Start_04	為了暗矛部族!	
VO_TRLA_209h_Male_Troll_Start_05	我一定辦得到！	
VO_TRLA_209h_Male_Troll_Start_06	來吧，放馬過來吧！	
VO_TRLA_209h_Male_Troll_Start_07	我會一路贏到底！	
VO_TRLA_209h_Male_Troll_Start_08	我就是冠軍！	
VO_TRLA_209h_Male_Troll_Thanks_01	謝謝你。	
VO_TRLA_209h_Male_Troll_Thinking_01	嗯…	
VO_TRLA_209h_Male_Troll_Thinking_05	想想平時的訓練…	
VO_TRLA_209h_Male_Troll_Thinking_06	我一定可以贏的…	
VO_TRLA_209h_Male_Troll_Threaten_01	你沒有料到這個吧！	
VO_TRLA_209h_Male_Troll_Time_01	時間快要不夠了！	
VO_TRLA_209h_Male_Troll_Trigger_Nearing_Loss_01	我還沒有…放棄…	
VO_TRLA_209h_Male_Troll_Trigger_Nearing_Loss_02	暗矛部族永遠不死…	
VO_TRLA_209h_Male_Troll_Trigger_Nearing_Loss_03	我還不能放棄…	
VO_TRLA_209h_Male_Troll_Trigger_Nearing_Loss_04	這個痛…我要忍住…	
VO_TRLA_209h_Male_Troll_Trigger_Nearing_Loss_05	還沒有…結束…	
VO_TRLA_209h_Male_Troll_Trigger_Nearing_Win_01	我就是來贏的！	
VO_TRLA_209h_Male_Troll_Trigger_Nearing_Win_02	這是為了暗矛部族！	
VO_TRLA_209h_Male_Troll_Trigger_Nearing_Win_03	這就是我的真本事！	
VO_TRLA_209h_Male_Troll_Trigger_Nearing_Win_04	辛苦的訓練，總算有回報了！	
VO_TRLA_209h_Male_Troll_Trigger_Nearing_Win_05	大聲喊我的名字！大聲喊！	
VO_TRLA_209h_Male_Troll_WELCOME_01	歡迎！	
VO_TRLA_209h_Male_Troll_Well_Played_01	真厲害！	
VO_TRLA_209h_Male_Troll_WOW_01	了不起！	
VO_WhiteKing_Male_ChessPiece_ChessDeath_01	將軍…	
VO_WhiteKing_Male_ChessPiece_ChessEmoteGreetings_01	要下一盤棋嗎？	
VO_WhiteKing_Male_ChessPiece_ChessEmoteOops_01	噢，走錯了。	
VO_WhiteKing_Male_ChessPiece_ChessEmoteSorry_01	你的情勢不妙啊。	
VO_WhiteKing_Male_ChessPiece_ChessEmoteThanks_01	你人真好。	
VO_WhiteKing_Male_ChessPiece_ChessEmoteThinking_01	嗯，城堡走到A3…	
VO_WhiteKing_Male_ChessPiece_ChessEmoteThinking_02	騎士到F6…	
VO_WhiteKing_Male_ChessPiece_ChessEmoteThinking_03	皇后到E5…不對不對不對…	
VO_WhiteKing_Male_ChessPiece_ChessEmoteThreaten_01	再4手就將軍了。	
VO_WhiteKing_Male_ChessPiece_ChessEmoteWellPlayed_01	將軍。	
VO_WhiteKing_Male_ChessPiece_ChessEmoteWow_01	啊，這一手真是妙啊！	
VO_WhiteKing_Male_ChessPiece_ChessOpen_02	接招吧！	
VOX_Nightbane_Start_01	*吼叫*	
