TAG	TEXT	COMMENT
GLOBAL_AADC_BUTTON_PRIVACY	Конфиденциальность	
GLOBAL_AADC_BUTTON_PRIVACYSETTINGS	Настройки конфиденциальности	
GLOBAL_AADC_CHATSETTINGS_DISABLEDESCRIPTION	Отключение чата лишит вас возможности обмениваться сообщениями с друзьями.	
GLOBAL_AADC_CHATSETTINGS_DISABLEHEADER	Отключить сообщения чата	
GLOBAL_AADC_CHATSETTINGS_ENABLEDESCRIPTION	Если вы включите чат, то сможете обмениваться сообщениями с друзьями. Старайтесь вести себя осмотрительно и не делиться личной информацией.	
GLOBAL_AADC_CHATSETTINGS_ENABLEHEADER	Включить сообщения чата	
GLOBAL_AADC_CHATSETTINGS_SETTINGSUPDATED	Настройки чата изменены	
GLOBAL_AADC_CHATSETTINGS_TITLE	Настройки чата	
GLOBAL_AADC_CHATSETTINGS_UPDATINGSETTINGS	Изменение настроек чата	
GLOBAL_AADC_CHATWARNING	Старайтесь вести себя осмотрительно и не упоминать личную информацию в сообщениях.	
GLOBAL_AADC_FRIENDSETTINGS_DISABLEDESCRIPTION	При отключении отслеживания друзей поблизости находящиеся неподалеку игроки не смогут наблюдать за вашими действиями в списке друзей.	
GLOBAL_AADC_FRIENDSETTINGS_DISABLEHEADER	Не отслеживать друзей поблизости	
GLOBAL_AADC_FRIENDSETTINGS_ENABLEDESCRIPTION	При включении отслеживания друзей поблизости находящиеся неподалеку игроки смогут наблюдать за вашими действиями в списке друзей.	
GLOBAL_AADC_FRIENDSETTINGS_ENABLEHEADER	Отслеживать друзей поблизости	
GLOBAL_AADC_FRIENDSETTINGS_SETTINGSUPDATED	Изменение отслеживания друзей поблизости	
GLOBAL_AADC_FRIENDSETTINGS_TITLE	Параметры друзей	
GLOBAL_AADC_FRIENDSETTINGS_UPDATINGSETTINGS	Изменение параметров друзей	
GLOBAL_AADC_LOCATIONSERVICES_DISABLEDESCRIPTION	Отключение службы геоданных лишит вас возможности устраивать мероприятия Fireside Gathering и участвовать в них.	
GLOBAL_AADC_LOCATIONSERVICES_DISABLEHEADER	Отключить геоданные	
GLOBAL_AADC_LOCATIONSERVICES_ENABLEDESCRIPTION	Включив службы геоданных, вы сможете облегчить поиск игроков поблизости и сможете участвовать в мероприятиях Fireside Gathering.	
GLOBAL_AADC_LOCATIONSERVICES_ENABLEHEADER	Включить геоданные	
GLOBAL_AADC_LOCATIONSERVICES_SETTINGSUPDATED	Настройки геоданных изменены	
GLOBAL_AADC_LOCATIONSERVICES_TITLE	Геоданные	
GLOBAL_AADC_LOCATIONSERVICES_UPDATINGSETTINGS	Изменение настроек геоданных	
GLOBAL_AADC_PARENTALLOCK_DESCRIPTION	Прежде чем вы сможете изменить настройки, ваш родитель или опекун должен изменить ваши настройки конфиденциальности в Battle.net.	
GLOBAL_AADC_PRIVACYSETTINGSMENU_PRIVACYRIGHTS	Права доступа	
GLOBAL_AADC_PRIVACYSETTINGSPOPUP_DEVICE_LOCATIONSETTINGS	Включение настройки геоданных	
GLOBAL_AADC_PRIVACYSETTINGSPOPUP_DEVICE_PUSHNOTIFICATIONS	Включение Push-уведомлений	
GLOBAL_AADC_PRIVACYSETTINGSPOPUP_SECTIONHEADER_DEVICE	Настройки устройства	
GLOBAL_AADC_PRIVACYSETTINGSPOPUP_SECTIONHEADER_SOCIAL	Настройки социальных возможностей	
GLOBAL_AADC_PRIVACYSETTINGSPOPUP_SOCIAL_CHATMESSAGES	Включение сообщений чата	
GLOBAL_AADC_PRIVACYSETTINGSPOPUP_SOCIAL_NEARBYFRIENDS	Отслеживать друзей поблизости	
GLOBAL_AADC_PRIVACYSETTINGSPOPUP_SOCIAL_SPECIALOFFERS	Включить индивидуальные предложения в магазине	
GLOBAL_AADC_PUSHNOTIFICATIONS_DISABLEDESCRIPTION	Отключив Push-уведомления, вы не будете получать уведомления Hearthstone на вашем устройстве.	
GLOBAL_AADC_PUSHNOTIFICATIONS_DISABLEHEADER	Отключить Push-уведомления	
GLOBAL_AADC_PUSHNOTIFICATIONS_ENABLEDESCRIPTION	Включив Push-уведомления, вы будете получать уведомления Hearthstone на вашем устройстве.	
GLOBAL_AADC_PUSHNOTIFICATIONS_ENABLEHEADER	Включить Push-уведомления	
GLOBAL_AADC_PUSHNOTIFICATIONS_SETTINGSUPDATED	Настройки уведомлений изменены	
GLOBAL_AADC_PUSHNOTIFICATIONS_TITLE	Настройки уведомлений	
GLOBAL_AADC_PUSHNOTIFICATIONS_UPDATINGSETTINGS	Изменение настроек уведомлений	
GLOBAL_AADC_SHOPSETTINGS_DISABLEDESCRIPTION	В случае отключения индивидуальных предложений в магазине вам больше не будут предлагаться товары, специально подобранные с учетом ваших действий в игре.	
GLOBAL_AADC_SHOPSETTINGS_DISABLEHEADER	Отключить индивидуальные предложения	
GLOBAL_AADC_SHOPSETTINGS_ENABLEDESCRIPTION	Если включить индивидуальные предложения в магазине, вам будут предлагаться товары, специально подобранные с учетом ваших действий в игре.	
GLOBAL_AADC_SHOPSETTINGS_ENABLEHEADER	Включить индивидуальные предложения	
GLOBAL_AADC_SHOPSETTINGS_SETTINGSUPDATED	Настройки магазина изменены	
GLOBAL_AADC_SHOPSETTINGS_TITLE	Настройки магазина	
GLOBAL_AADC_SHOPSETTINGS_UPDATINGSETTINGS	Изменение настроек магазина	
GLOBAL_AADC_UPDATESETTINGSPOPUP_DESCRIPTION	Вам доступна возможность изменения всех настроек устройства, включая настройки чата, магазина и индивидуальных предложений.	
GLOBAL_AADC_UPDATESETTINGSPOPUP_TITLE	Настройки изменены	
GLOBAL_ACCOUNT	Учетная запись	
GLOBAL_ADDFRIEND_BUTTON	Добавить друга	
GLOBAL_ADDFRIEND_ERROR_ALREADY_FRIEND	Этот игрок уже находится в вашем списке друзей.	
GLOBAL_ADDFRIEND_ERROR_MALFORMED	Введите электронный адрес или Battle Tag.	
GLOBAL_ADDFRIEND_HEADER	Добавить друга	
GLOBAL_ADDFRIEND_INSTRUCTION	Укажите BattleTag или адрес электронной почты.	
GLOBAL_ADDFRIEND_SENT_CONFIRMATION	Запрос на добавление в друзья отправлен.	
GLOBAL_ADVENTURE_CHOOSE_BUTTON_TEXT	Выбрать	
GLOBAL_ADVENTURE_DESC_HEADER	Приключения	
GLOBAL_ADVENTURE_TRAY_HEADER	Выберите приключение	
GLOBAL_APPROXIMATE_DATETIME	~{0}	0=time string
GLOBAL_APPROXIMATE_DATETIME_RANGE	~{0} – {1}	0=min seconds 1=max seconds string
GLOBAL_ARENA_MEDAL_0	Ключ новичка	
GLOBAL_ARENA_MEDAL_1	Ключ ученика	
GLOBAL_ARENA_MEDAL_10	Ледяной ключ	
GLOBAL_ARENA_MEDAL_11	Пылающий ключ	
GLOBAL_ARENA_MEDAL_12	Ключ из светостали	
GLOBAL_ARENA_MEDAL_2	Ключ подмастерья	
GLOBAL_ARENA_MEDAL_3	Медный ключ	
GLOBAL_ARENA_MEDAL_4	Серебряный ключ	
GLOBAL_ARENA_MEDAL_5	Золотой ключ	
GLOBAL_ARENA_MEDAL_6	Платиновый ключ	
GLOBAL_ARENA_MEDAL_7	Алмазный ключ	
GLOBAL_ARENA_MEDAL_8	Ключ чемпиона	
GLOBAL_ARENA_MEDAL_9	Рубиновый ключ	
GLOBAL_ARENA_SEASON_ERROR_NOT_ACTIVE	Данный режим Арены более недоступен. Пожалуйста, повторите попытку через несколько минут.	
GLOBAL_ASSET_DOWNLOAD	Загрузка данных	
GLOBAL_ASSET_DOWNLOAD_ALERT	Загрузка данных во время игры отключена.	
GLOBAL_ASSET_DOWNLOAD_AWAITING_FETCH	Идет поиск обновлений...	
GLOBAL_ASSET_DOWNLOAD_AWAITING_OTHER_DOWNLOAD	Ожидание	
GLOBAL_ASSET_DOWNLOAD_AWAITING_WIFI	Требуется Wi-Fi	
GLOBAL_ASSET_DOWNLOAD_BYTE_SYMBOL	Б	
GLOBAL_ASSET_DOWNLOAD_CELLULAR_DATA_BODY	Загружать данные по мобильной связи.	
GLOBAL_ASSET_DOWNLOAD_CELLULAR_DATA_HEADER	Мобильная связь	
GLOBAL_ASSET_DOWNLOAD_CELLULAR_POPUP_ADDITIONAL_BODY	Подключение по Wi-Fi недоступно. Использовать мобильное подключение для загрузки дополнительных данных ({0})?	
GLOBAL_ASSET_DOWNLOAD_CELLULAR_POPUP_HEADER	Мобильная связь	
GLOBAL_ASSET_DOWNLOAD_CELLULAR_POPUP_INITIAL_BODY	Подключение по Wi-Fi недоступно. Использовать мобильное подключение для загрузки дополнительных данных ({0})?	
GLOBAL_ASSET_DOWNLOAD_COMPLETE	Готово	
GLOBAL_ASSET_DOWNLOAD_DETAILS_AUDIO	Звук	
GLOBAL_ASSET_DOWNLOAD_DETAILS_HIGHRES	Улучшенные текстуры	
GLOBAL_ASSET_DOWNLOAD_DISABLED	Откл.	
GLOBAL_ASSET_DOWNLOAD_ENABLE_DOWNLOAD_BODY	Разрешить загрузку данных Hearthstone.	
GLOBAL_ASSET_DOWNLOAD_ENABLE_DOWNLOAD_HEADER	Разрешить загрузку	
GLOBAL_ASSET_DOWNLOAD_ENABLED	Вкл.	
GLOBAL_ASSET_DOWNLOAD_ERROR_AGENT_IMPEDED	Медленное подключение	
GLOBAL_ASSET_DOWNLOAD_ERROR_CELLULAR_DISABLED	Загрузка данных по мобильной связи отключена	
GLOBAL_ASSET_DOWNLOAD_ERROR_DOWNLOAD_DISABLED	Загрузка отключена	
GLOBAL_ASSET_DOWNLOAD_ERROR_OUT_OF_STORAGE	Недостаточно места	
GLOBAL_ASSET_DOWNLOAD_GIGABYTE_SYMBOL	ГБ	
GLOBAL_ASSET_DOWNLOAD_INTENTION_PAUSED	{0} (пауза)	
GLOBAL_ASSET_DOWNLOAD_IOS_REQ_POPUP_BODY	Доступно обновление. Загрузить оставшиеся данные ({0})?	
GLOBAL_ASSET_DOWNLOAD_IOS_REQ_POPUP_HEADER	Загрузка данных	
GLOBAL_ASSET_DOWNLOAD_KILOBYTE_SYMBOL	КБ	
GLOBAL_ASSET_DOWNLOAD_MEGABYTE_SYMBOL	МБ	
GLOBAL_ASSET_DOWNLOAD_PAUSED	Приостановлено	
GLOBAL_ASSET_DOWNLOAD_SETTINGS	Настройки	
GLOBAL_ASSET_DOWNLOAD_STATUS	Осталось {0} (скорость: {1}/сек.)	
GLOBAL_ASSET_DOWNLOAD_STATUS_DECIMAL_FORMAT	{0},{1} {2}	
GLOBAL_ASSET_DOWNLOAD_STATUS_SHORT	{0} (скорость: {1}/сек.)	
GLOBAL_ASSET_INTENTION_DONE	Готово	
GLOBAL_ASSET_INTENTION_DOWNLOADING_EXPANSION_MUSIC	Доп. звуки (2/3)	
GLOBAL_ASSET_INTENTION_DOWNLOADING_FONTS	Шрифты	
GLOBAL_ASSET_INTENTION_DOWNLOADING_HERO_MUSIC	Геройская музыка	
GLOBAL_ASSET_INTENTION_DOWNLOADING_HIGH_RES_PORTRAITS	Карты в HD	
GLOBAL_ASSET_INTENTION_DOWNLOADING_LEGEND_STINGERS	Доп. звуки (1/3)	
GLOBAL_ASSET_INTENTION_DOWNLOADING_MINION_PLAY_SOUNDS	Звуковые эффекты существ	
GLOBAL_ASSET_INTENTION_DOWNLOADING_MISSION_SOUNDS	Звуки приключения	
GLOBAL_ASSET_INTENTION_DOWNLOADING_OTHER_MINION_SOUNDS	Доп. звуки (3/3)	
GLOBAL_ASSET_INTENTION_DOWNLOADING_PREMIUM_ANIMATIONS	Золотые анимации	
GLOBAL_ASSET_INTENTION_DOWNLOADING_SPELL_SOUNDS	Звуки заклинаний	
GLOBAL_ASSET_INTENTION_UNINITIALIZED	Подготовка	
GLOBAL_ATTACK	Атака	
GLOBAL_BACK	Назад	
GLOBAL_BASIC_DECK_NAME	{0}	0=class name
GLOBAL_BATTLEGROUNDS	Поля сражений	
GLOBAL_BETA_REIMBURSEMENT_DETAILS	Это золото выдано в качестве компенсации за предыдущие покупки. Спасибо!	
GLOBAL_BETA_REIMBURSEMENT_HEADLINE	Компенсация	
GLOBAL_BRAWLISEUM	Потасовочный цех	
GLOBAL_BUTTON_AWESOME	Ура!	
GLOBAL_BUTTON_BUY	КУПИТЬ	
GLOBAL_BUTTON_CLOSE	Закрыть	
GLOBAL_BUTTON_CONVERT	Преобразовать	
GLOBAL_BUTTON_GO	Вперед!	
GLOBAL_BUTTON_GOT_IT	Понятно!	
GLOBAL_BUTTON_INFO_LETTER	i	
GLOBAL_BUTTON_LATER	Пока!	
GLOBAL_BUTTON_MORE_INFO	Подробнее	
GLOBAL_BUTTON_NEXT	Далее	
GLOBAL_BUTTON_NO	Нет	
GLOBAL_BUTTON_NOT_NOW	Позже	
GLOBAL_BUTTON_OK	ОК	
GLOBAL_BUTTON_OR	ИЛИ	
GLOBAL_BUTTON_OWNED	В коллекции	
GLOBAL_BUTTON_YES	Да	
GLOBAL_CANCEL	Отмена	
GLOBAL_CARD_SET_AV	Разделенные Альтераком	
GLOBAL_CARD_SET_AV_SEARCHABLE_SHORTHAND_NAMES	А РА	This is a space-separated list indicating all of the allowable search keywords that can be used in Collection Manager screen's text-search feature to narrow down the cards to this specific Card Set via shorthand names (note: the full name above is also used for this feature). Also note: letter case is ignored.
GLOBAL_CARD_SET_AV_SHORT	Альтеракская долина	
GLOBAL_CARD_SET_BAR	Закаленные Степями	
GLOBAL_CARD_SET_BAR_SEARCHABLE_SHORTHAND_NAMES	bar зс зак степ	This is a space-separated list indicating all of the allowable search keywords that can be used in Collection Manager screen's text-search feature to narrow down the cards to this specific Card Set via shorthand names (note: the full name above is also used for this feature). Also note: letter case is ignored.
GLOBAL_CARD_SET_BAR_SHORT	Степи	
GLOBAL_CARD_SET_BASIC	Базовый набор	
GLOBAL_CARD_SET_BOOMSDAY	Проект Бумного дня	
GLOBAL_CARD_SET_BOOMSDAY_SEARCHABLE_SHORTHAND_NAMES	bd tbp bdp tbdp bp бд пбд	This is a space-separated list indicating all of the allowable search keywords that can be used in Collection Manager screen's text-search feature to narrow down the cards to this specific Card Set via shorthand names (note: the full name above is also used for this feature). Also note: letter case is ignored.
GLOBAL_CARD_SET_BOOMSDAY_SHORT	Бумный день	
GLOBAL_CARD_SET_BRM	Черная гора	
GLOBAL_CARD_SET_BRM_SEARCHABLE_SHORTHAND_NAMES	ЧГ	This is a space-separated list indicating all of the allowable search keywords that can be used in Collection Manager screen's text-search feature to narrow down the cards to this specific Card Set via shorthand names (note: the full name above is also used for this feature). Also note: letter case is ignored.
GLOBAL_CARD_SET_BT	Руины Запределья	
GLOBAL_CARD_SET_BT_SEARCHABLE_SHORTHAND_NAMES	рз руины	This is a space-separated list indicating all of the allowable search keywords that can be used in Collection Manager screen's text-search feature to narrow down the cards to this specific Card Set via shorthand names (note: the full name above is also used for this feature). Also note: letter case is ignored.
GLOBAL_CARD_SET_BT_SHORT	Запределье	
GLOBAL_CARD_SET_CORE	Основной набор	
GLOBAL_CARD_SET_CORE_SEARCHABLE_SHORTHAND_NAMES	основной	This is a space-separated list indicating all of the allowable search keywords that can be used in Collection Manager screen's text-search feature to narrow down the cards to this specific Card Set via shorthand names (note: the full name above is also used for this feature). Also note: letter case is ignored.
GLOBAL_CARD_SET_CORE_SHORT	Основной	
GLOBAL_CARD_SET_DALARAN	Возмездие теней	
GLOBAL_CARD_SET_DALARAN_SEARCHABLE_SHORTHAND_NAMES	вт	This is a space-separated list indicating all of the allowable search keywords that can be used in Collection Manager screen's text-search feature to narrow down the cards to this specific Card Set via shorthand names (note: the full name above is also used for this feature). Also note: letter case is ignored.
GLOBAL_CARD_SET_DALARAN_SHORT	Возмездие теней	
GLOBAL_CARD_SET_DEBUG	Жижа	
GLOBAL_CARD_SET_DHI	Иллидари-посвященный	
GLOBAL_CARD_SET_DHI_SEARCHABLE_SHORTHAND_NAMES	од онд дх	This is a space-separated list indicating all of the allowable search keywords that can be used in Collection Manager screen's text-search feature to narrow down the cards to this specific Card Set via shorthand names (note: the full name above is also used for this feature). Also note: letter case is ignored.
GLOBAL_CARD_SET_DHI_SHORT	Посвященный	
GLOBAL_CARD_SET_DMF	Ярмарка безумия	
GLOBAL_CARD_SET_DMF_SEARCHABLE_SHORTHAND_NAMES	яб dmf ярмарка новолуния	This is a space-separated list indicating all of the allowable search keywords that can be used in Collection Manager screen's text-search feature to narrow down the cards to this specific Card Set via shorthand names (note: the full name above is also used for this feature). Also note: letter case is ignored.
GLOBAL_CARD_SET_DMF_SHORT	Ярмарка	
GLOBAL_CARD_SET_DRG	Натиск драконов	
GLOBAL_CARD_SET_DRG_SEARCHABLE_SHORTHAND_NAMES	dod dd нд	This is a space-separated list indicating all of the allowable search keywords that can be used in Collection Manager screen's text-search feature to narrow down the cards to this specific Card Set via shorthand names (note: the full name above is also used for this feature). Also note: letter case is ignored.
GLOBAL_CARD_SET_DRG_SHORT	Драконы	
GLOBAL_CARD_SET_EXPERT1	Классический набор	
GLOBAL_CARD_SET_GANGS	Злачный город Прибамбасск	
GLOBAL_CARD_SET_GANGS_RESERVE	В банде	
GLOBAL_CARD_SET_GANGS_SEARCHABLE_SHORTHAND_NAMES	прибамбасск гаджетзан гаджезан мсг мсог	This is a space-separated list indicating all of the allowable search keywords that can be used in Collection Manager screen's text-search feature to narrow down the cards to this specific Card Set via shorthand names (note: the full name above is also used for this feature). Also note: letter case is ignored.
GLOBAL_CARD_SET_GANGS_SHORT	Прибамбасск	
GLOBAL_CARD_SET_GILNEAS	Ведьмин лес	
GLOBAL_CARD_SET_GILNEAS_SEARCHABLE_SHORTHAND_NAMES	вл	This is a space-separated list indicating all of the allowable search keywords that can be used in Collection Manager screen's text-search feature to narrow down the cards to this specific Card Set via shorthand names (note: the full name above is also used for this feature). Also note: letter case is ignored.
GLOBAL_CARD_SET_GILNEAS_SHORT	Ведьмин лес	
GLOBAL_CARD_SET_GVG	Гоблины и гномы	
GLOBAL_CARD_SET_GVG_SEARCHABLE_SHORTHAND_NAMES	ГиГ	This is a space-separated list indicating all of the allowable search keywords that can be used in Collection Manager screen's text-search feature to narrow down the cards to this specific Card Set via shorthand names (note: the full name above is also used for this feature). Also note: letter case is ignored.
GLOBAL_CARD_SET_HOF	Зал славы	
GLOBAL_CARD_SET_ICECROWN	Рыцари Ледяного Трона	
GLOBAL_CARD_SET_ICECROWN_SHORT	Ледяной Трон	
GLOBAL_CARD_SET_KARA	Вечеринка в Каражане	
GLOBAL_CARD_SET_KARA_RESERVE	Запасник Каражана	
GLOBAL_CARD_SET_KARA_SHORT	Каражан	
GLOBAL_CARD_SET_LEGACY	Старые карты	
GLOBAL_CARD_SET_LEGACY_SEARCHABLE_SHORTHAND_NAMES	старые	This is a space-separated list indicating all of the allowable search keywords that can be used in Collection Manager screen's text-search feature to narrow down the cards to this specific Card Set via shorthand names (note: the full name above is also used for this feature). Also note: letter case is ignored.
GLOBAL_CARD_SET_LEGACY_SHORT	Старые карты	
GLOBAL_CARD_SET_LETL		Lettuce
GLOBAL_CARD_SET_LETL_SEARCHABLE_SHORTHAND_NAMES	сал	This is a space-separated list indicating all of the allowable search keywords that can be used in Collection Manager screen's text-search feature to narrow down the cards to this specific Card Set via shorthand names (note: the full name above is also used for this feature). Also note: letter case is ignored.
GLOBAL_CARD_SET_LETL_SHORT	Салат	
GLOBAL_CARD_SET_LOE	Лига исследователей	
GLOBAL_CARD_SET_LOE_SEARCHABLE_SHORTHAND_NAMES	ЛИ лига исследователи loe	This is a space-separated list indicating all of the allowable search keywords that can be used in Collection Manager screen's text-search feature to narrow down the cards to this specific Card Set via shorthand names (note: the full name above is also used for this feature). Also note: letter case is ignored.
GLOBAL_CARD_SET_LOE_SHORT	Лига исследователей	
GLOBAL_CARD_SET_LOOTAPALOOZA	Кобольды и катакомбы	
GLOBAL_CARD_SET_LOOTAPALOOZA_SEARCHABLE_SHORTHAND_NAMES	kc kac knc кик кк	This is a space-separated list indicating all of the allowable search keywords that can be used in Collection Manager screen's text-search feature to narrow down the cards to this specific Card Set via shorthand names (note: the full name above is also used for this feature). Also note: letter case is ignored.
GLOBAL_CARD_SET_LOOTAPALOOZA_SHORT	Кобольды	
GLOBAL_CARD_SET_NAXX	Наксрамас	
GLOBAL_CARD_SET_NAXX_SEARCHABLE_SHORTHAND_NAMES	Накс	This is a space-separated list indicating all of the allowable search keywords that can be used in Collection Manager screen's text-search feature to narrow down the cards to this specific Card Set via shorthand names (note: the full name above is also used for this feature). Also note: letter case is ignored.
GLOBAL_CARD_SET_OG	Пробуждение древних богов	
GLOBAL_CARD_SET_OG_RESERVE	Old Gods Reserve	
GLOBAL_CARD_SET_OG_SEARCHABLE_SHORTHAND_NAMES	tog пдб дб	This is a space-separated list indicating all of the allowable search keywords that can be used in Collection Manager screen's text-search feature to narrow down the cards to this specific Card Set via shorthand names (note: the full name above is also used for this feature). Also note: letter case is ignored.  For Whispers of the Old Gods, 'tog' should be available in all locales; wotog and wog are additional English shorthands, which should be replaced by locale specific variants.
GLOBAL_CARD_SET_OG_SHORT	Древние боги	
GLOBAL_CARD_SET_PROMO	Промо-карты	
GLOBAL_CARD_SET_SCH	Некроситет	
GLOBAL_CARD_SET_SCH_SEARCHABLE_SHORTHAND_NAMES	некро	This is a space-separated list indicating all of the allowable search keywords that can be used in Collection Manager screen's text-search feature to narrow down the cards to this specific Card Set via shorthand names (note: the full name above is also used for this feature). Also note: letter case is ignored.
GLOBAL_CARD_SET_SCH_SHORT	Некроситет	
GLOBAL_CARD_SET_SW	Сплоченные Штормградом	
GLOBAL_CARD_SET_SW_SEARCHABLE_SHORTHAND_NAMES	шг	uis
GLOBAL_CARD_SET_SW_SHORT	Штормград	
GLOBAL_CARD_SET_TGT	Большой турнир	
GLOBAL_CARD_SET_TGT_SEARCHABLE_SHORTHAND_NAMES	tgt тгт турнир	This is a space-separated list indicating all of the allowable search keywords that can be used in Collection Manager screen's text-search feature to narrow down the cards to this specific Card Set via shorthand names (note: the full name above is also used for this feature). Also note: letter case is ignored.
GLOBAL_CARD_SET_TGT_SHORT	Большой турнир	
GLOBAL_CARD_SET_TROLL	Растахановы игрища	
GLOBAL_CARD_SET_TROLL_SEARCHABLE_SHORTHAND_NAMES	rr	This is a space-separated list indicating all of the allowable search keywords that can be used in Collection Manager screen's text-search feature to narrow down the cards to this specific Card Set via shorthand names (note: the full name above is also used for this feature). Also note: letter case is ignored.
GLOBAL_CARD_SET_TROLL_SHORT	Игрища	
GLOBAL_CARD_SET_ULDUM	Спасители Ульдума	
GLOBAL_CARD_SET_ULDUM_SEARCHABLE_SHORTHAND_NAMES	sou su су ульдум спа	This is a space-separated list indicating all of the allowable search keywords that can be used in Collection Manager screen's text-search feature to narrow down the cards to this specific Card Set via shorthand names (note: the full name above is also used for this feature). Also note: letter case is ignored.
GLOBAL_CARD_SET_ULDUM_SHORT	Ульдум	
GLOBAL_CARD_SET_UNGORO	Экспедиция в Ун'Горо	
GLOBAL_CARD_SET_UNGORO_SHORT	Ун'Горо	
GLOBAL_CARD_SET_VANILLA	Классический набор	
GLOBAL_CARD_SET_VANILLA_FORMAT_SEARCHABLE_SHORTHAND_NAMES	классика	This is a space-separated list indicating all of the allowable search keywords that can be used in Collection Manager screen's text-search feature to narrow down the cards to this specific Card Set via shorthand names (note: the full name above is also used for this feature). Also note: letter case is ignored.
GLOBAL_CARD_SET_VANILLA_FORMAT_SHORT	Классический	
GLOBAL_CARD_SET_WILD_EVENT	Событие в вольном формате	
GLOBAL_CARD_SET_WILD_EVENT_SHORT	Событие в вольном формате	
GLOBAL_CARD_SET_YOD	Пробуждение Галакронда	
GLOBAL_CARD_SET_YOD_SHORT	Пробуждение Галакронда	
GLOBAL_CARDTYPE_ENCHANTMENT	Чары	
GLOBAL_CARDTYPE_HERO	Герой	
GLOBAL_CARDTYPE_HEROPOWER	Сила героя	
GLOBAL_CARDTYPE_ITEM	Предмет	
GLOBAL_CARDTYPE_MINION	Существо	
GLOBAL_CARDTYPE_SPELL	Заклинание	
GLOBAL_CARDTYPE_TOKEN	Жетон	
GLOBAL_CARDTYPE_WEAPON	Оружие	
GLOBAL_CHAT_BUBBLE_RECEIVER_NAME	Для: {0}	0=player name
GLOBAL_CHAT_CHALLENGE	Вызов	
GLOBAL_CHAT_NO_FRIENDS_ONLINE	В данный момент никто из ваших друзей не находится в сети.	
GLOBAL_CHAT_NO_RECENT_CONVERSATIONS	Откройте список друзей, чтобы начать разговор с другом.	
GLOBAL_CHAT_RECEIVER_OFFLINE	{0} сейчас не в сети.	0=player name
GLOBAL_CHAT_RECEIVER_ONLINE	{0} входит в сеть.	0=player name
GLOBAL_CHAT_SENDER_APPEAR_OFFLINE	Вы не можете отправлять сообщения в чат, пока ваш статус отображается как «Не в сети».	
GLOBAL_CHAT_SENDER_OFFLINE	Ваш статус отображается как «Не в сети».	
GLOBAL_CHOOSE_PAYMENT	Выбрать метод оплаты	
GLOBAL_CLASS_DEATHKNIGHT	Рыцарь смерти	
GLOBAL_CLASS_DEMONHUNTER	Охотник на демонов	
GLOBAL_CLASS_DRUID	Друид	
GLOBAL_CLASS_HUNTER	Охотник	
GLOBAL_CLASS_MAGE	Маг	
GLOBAL_CLASS_NEUTRAL	Общие	
GLOBAL_CLASS_PALADIN	Паладин	
GLOBAL_CLASS_PRIEST	Жрец	
GLOBAL_CLASS_ROGUE	Разбойник	
GLOBAL_CLASS_SHAMAN	Шаман	
GLOBAL_CLASS_WARLOCK	Чернокнижник	
GLOBAL_CLASS_WARRIOR	Воин	
GLOBAL_CLASSIC	Классика	
GLOBAL_CLICK_TO_CONTINUE	Щелкните, чтобы продолжить.	
GLOBAL_CLICK_TO_CONTINUE_TOUCH	Нажмите, чтобы продолжить.	
GLOBAL_COLLECTION_DIAMOND	Алмаз	
GLOBAL_COLLECTION_GOLDEN	Золотая карта	
GLOBAL_COMMA_SEPARATOR	,	
GLOBAL_CONCEDE	Сдаться	
GLOBAL_CONFIRM	ОК	
GLOBAL_CONTINUE	Продолжить	
GLOBAL_COST	Стоимость	
GLOBAL_CREATE	Создать	
GLOBAL_CURRENT_DATE	{0:dd.MM.yyyy}	see http://msdn.microsoft.com/en-us/library/8kb3ddd4.aspx
GLOBAL_CURRENT_TIME	{0:HH:mm}	see http://msdn.microsoft.com/en-us/library/8kb3ddd4.aspx
GLOBAL_CURRENT_TIME_AM	утра	
GLOBAL_CURRENT_TIME_AND_DATE_DEV	{0} ({1} - {2})	
GLOBAL_CURRENT_TIME_PM	вечера	
GLOBAL_DATETIME_AFK_DAY	Отсутствует больше дня	
GLOBAL_DATETIME_AFK_DAYS	Отсутствует {0} дн.	
GLOBAL_DATETIME_AFK_HOURS	Отсутствует {0} ч.	
GLOBAL_DATETIME_AFK_MINUTES	Отсутствует {0} мин.	
GLOBAL_DATETIME_AFK_MONTH	Отсутствует более месяца	
GLOBAL_DATETIME_AFK_SECONDS	Отсутствует менее минуты	
GLOBAL_DATETIME_AFK_WEEKS	Отсутствует {0} нед.	
GLOBAL_DATETIME_COMING_SOON	Скоро	
GLOBAL_DATETIME_COMING_SOON_DAYS	Откроется через: \{0} |4(день,дня,дней)	
GLOBAL_DATETIME_COMING_SOON_HOURS	Откроется через: \{0} |4(час,часа,часов)	
GLOBAL_DATETIME_COMING_SOON_MINUTES	До открытия\n<1 часа	
GLOBAL_DATETIME_COMING_SOON_WEEKS	Откроется через\n{0} |4(неделю,недели,недель).	
GLOBAL_DATETIME_FRIENDREQUEST_DAY	вчера	
GLOBAL_DATETIME_FRIENDREQUEST_DAYS	{0} дн. назад	
GLOBAL_DATETIME_FRIENDREQUEST_HOURS	{0} ч. назад	
GLOBAL_DATETIME_FRIENDREQUEST_MINUTES	{0} мин. назад	
GLOBAL_DATETIME_FRIENDREQUEST_MONTH	> мес. назад	
GLOBAL_DATETIME_FRIENDREQUEST_SECONDS	< 1 мин. назад	
GLOBAL_DATETIME_FRIENDREQUEST_WEEKS	{0} нед. назад	
GLOBAL_DATETIME_GREATER_THAN_X_MINUTES	> {0} мин.	
GLOBAL_DATETIME_LASTONLINE_DAY	Последний раз в сети: вчера	
GLOBAL_DATETIME_LASTONLINE_DAYS	Последний раз в сети: {0} дн. назад	
GLOBAL_DATETIME_LASTONLINE_HOURS	Последний раз в сети: {0} ч. назад	
GLOBAL_DATETIME_LASTONLINE_MINUTES	Последний раз в сети: {0} мин. назад	
GLOBAL_DATETIME_LASTONLINE_MONTH	Последний раз в сети: > мес. назад	
GLOBAL_DATETIME_LASTONLINE_SECONDS	Последний раз в сети: < 1 мин. назад	
GLOBAL_DATETIME_LASTONLINE_WEEKS	Последний раз в сети: {0} нед. назад	
GLOBAL_DATETIME_SPINNER_DAY	> 1 дня	
GLOBAL_DATETIME_SPINNER_DAYS	{0} дн.	
GLOBAL_DATETIME_SPINNER_HOURS	{0} ч.	
GLOBAL_DATETIME_SPINNER_MINUTES	{0} мин.	
GLOBAL_DATETIME_SPINNER_MONTH	> 1 мес.	
GLOBAL_DATETIME_SPINNER_SECONDS	{0} сек.	
GLOBAL_DATETIME_SPINNER_WEEKS	{0} нед.	
GLOBAL_DATETIME_SPLASHSCREEN_DAY	> 1 дня	
GLOBAL_DATETIME_SPLASHSCREEN_DAYS	{0} дн.	
GLOBAL_DATETIME_SPLASHSCREEN_HOURS	{0} ч.	
GLOBAL_DATETIME_SPLASHSCREEN_MINUTES	{0} мин.	
GLOBAL_DATETIME_SPLASHSCREEN_MONTH	> 1 мес.	
GLOBAL_DATETIME_SPLASHSCREEN_SECONDS	< 1 мин.	
GLOBAL_DATETIME_SPLASHSCREEN_WEEKS	{0} нед.	
GLOBAL_DATETIME_UNLOCKS_SOON_WEEKS	Станет доступным через {0} |4(неделю,недели,недель)	
GLOBAL_DECK_SHARE_ACCEPT_REQUEST	Поделиться	
GLOBAL_DECK_SHARE_DECLINE_REQUEST	Ни за что!	
GLOBAL_DECK_SHARE_ERROR	Произошла ошибка при попытке поделиться колодами.	
GLOBAL_DECK_SHARE_HEADER	Поделиться колодами?	
GLOBAL_DECK_SHARE_REQUEST_CANCELED	{0} больше не просит вас поделиться колодами.	0=friend name
GLOBAL_DECK_SHARE_REQUEST_DECLINED	{0} не хочет делиться с вами колодами.	0=friend name
GLOBAL_DECK_SHARE_REQUEST_WAITING_RESPONSE	Ждем, пока {0} ответит на ваш запрос поделиться колодами.	
GLOBAL_DECK_SHARE_REQUESTED	{0} хочет скопировать одну из ваших колод.	0=friend name
GLOBAL_DEFAULT_ALERT_HEADER	Внимание!	
GLOBAL_DEMO_COMPLETE_BODY	Спасибо за использование демо-версии Hearthstone!	
GLOBAL_DEMO_COMPLETE_HEADER	Поздравляем!	
GLOBAL_DEMO_DISCLAIMER	Эта версия игры Hearthstone предназначена исключительно для ознакомления.	
GLOBAL_DEMO_LEARN_MORE	Подробнее	
GLOBAL_DISABLE	Отключить	
GLOBAL_DONE	Готово	
GLOBAL_ENABLE	Включить	
GLOBAL_END_GAME	Конец игры	
GLOBAL_ENTER	Войти	
GLOBAL_ERROR	Ошибка	
GLOBAL_ERROR_ACCOUNT_LICENSES	Примите наши извинения. Мы не смогли определить список ваших приобретений, поэтому чего-то может не хватать. При вашем следующем входе в игру мы постараемся все исправить.	
GLOBAL_ERROR_ASSET_CREATE_PERSISTENT_DATA_PATH	Не удалось создать папку для сохранения данных: {0}.	0=folder path
GLOBAL_ERROR_ASSET_DOWNLOAD_FAILED	Не удалось загрузить ресурс {0}.	0=asset name
GLOBAL_ERROR_ASSET_INCORRECT_DATA	Ресурс {0} содержит неверные данные.	0=asset name
GLOBAL_ERROR_ASSET_LOAD_FAILED	Ошибка загрузки данных {0}.	0=asset name
GLOBAL_ERROR_ASSET_MANIFEST	Не удалось загрузить манифест ресурса	
GLOBAL_ERROR_ASSET_NO_FILE_PATH	Неверный путь к файлу ресурса {0}.	0=asset name
GLOBAL_ERROR_CURRENCY_INVALID	Клиент игры использует неверную валюту для совершения покупки.	
GLOBAL_ERROR_FIND_GAME_SCENARIO_INCORRECT_NUM_PLAYERS	При запуске матча произошла ошибка. Неверное количество игроков для сценария.	
GLOBAL_ERROR_FIND_GAME_SCENARIO_MISCONFIGURED	При запуске матча произошла ошибка. Неверные данные сценария.	
GLOBAL_ERROR_FIND_GAME_SCENARIO_NO_DECK_SPECIFIED	При запуске матча произошла ошибка. Один или оба игрока не выбрали колоду.	
GLOBAL_ERROR_GAME_DENIED	При запуске матча произошла ошибка. Повторите попытку через несколько минут.	
GLOBAL_ERROR_GAME_OPPONENT_TIMEOUT	Игра не может быть начата, поскольку ваш противник не смог подключиться. Пожалуйста, попробуйте еще раз.	
GLOBAL_ERROR_GENERIC_HEADER	Ошибка	
GLOBAL_ERROR_INACTIVITY_KICK	Вы давно не совершали никаких действий в игре, поэтому ваше соединение с сервером было разорвано. Пожалуйста, перезапустите игру!	
GLOBAL_ERROR_NETWORK_ACCOUNT_BANNED	Ваша учетная запись заблокирована.	
GLOBAL_ERROR_NETWORK_ACCOUNT_CURFEW_REACHED	[Борьба с зависимостями] Согласно действующему местному законодательству и нормам, несовершеннолетние игроки не могут заходить в игру с 22:00 до 8:00 следующего дня.	
GLOBAL_ERROR_NETWORK_ACCOUNT_INVALID_NID	Вы не сможете продолжить, пока не пройдете проверку по настоящему имени. Подробности: https://www.battlenet.com.cn/support/zh/article/210633	
GLOBAL_ERROR_NETWORK_ACCOUNT_PLAYTIME_EXCEEDED	[Борьба с зависимостями] Согласно действующему местному законодательству и нормам, общее ежедневное время игры несовершеннолетних игроков не может превышать 1,5 часа. Вы исчерпали лимит отведенного суточного времени. Играйте ответственно.	
GLOBAL_ERROR_NETWORK_ACCOUNT_SUSPENDED	Действие вашей учетной записи приостановлено.	
GLOBAL_ERROR_NETWORK_ADMIN_KICKED	Соединение со службой Blizzard было потеряно. Пожалуйста, перезапустите Hearthstone.	
GLOBAL_ERROR_NETWORK_ADVENTURE_RECONNECT_TIMEOUT	Ваша игра сохранена. Снова войдя в Hearthstone, вы сможете продолжить ее.	
GLOBAL_ERROR_NETWORK_CONNECTION_TIMEOUT	Превышено время ожидания подключения. Пожалуйста, проверьте подключение к Интернету.	
GLOBAL_ERROR_NETWORK_DISCONNECT	Потеряно соединение со службой Blizzard. Пожалуйста, перезапустите Hearthstone.	
GLOBAL_ERROR_NETWORK_DISCONNECT_GAME_SERVER	Связь с игровой службой Hearthstone прервана.	
GLOBAL_ERROR_NETWORK_DISCONNECT_GENERIC	Соединение было разорвано.	
GLOBAL_ERROR_NETWORK_DUPLICATE_LOGIN	Ваша учетная запись Blizzard была использована для входа в Hearthstone с другого устройства. \n\nКлиент игры был отключен от сети, так как поддерживается только одно подключение единовременно.	
GLOBAL_ERROR_NETWORK_GENERIC	Внутренняя ошибка сети.	
GLOBAL_ERROR_NETWORK_INCORRECT_REGION	Эта учетная запись Blizzard в настоящий момент не может принимать участие в бета-тестировании Hearthstone. Как только бета-тестирование откроется в вашем регионе, пожалуйста, попробуйте еще раз.	
GLOBAL_ERROR_NETWORK_LOGIN_FAILURE	Невозможно зайти в игру через службу Blizzard. Пожалуйста, попробуйте подключиться позднее.	
GLOBAL_ERROR_NETWORK_LOST_GAME_CONNECTION	Ваша игра была отключена от игровой службы Blizzard. Попробуйте восстановить соединение, начав новую игру.	
GLOBAL_ERROR_NETWORK_NO_CONNECTION	Не удалось подключиться. Пожалуйста, проверьте подключение к Интернету.	
GLOBAL_ERROR_NETWORK_NO_GAME_SERVER	Ой! У нас не получилось начать для вас новую игру. Пожалуйста, попробуйте еще раз.	
GLOBAL_ERROR_NETWORK_PARENTAL_CONTROLS	Доступ к данной учетной записи ограничен на правах родительского контроля.	
GLOBAL_ERROR_NETWORK_PHONE_LOCK	Обратитесь по номеру телефона Blizzard Phone Lock, чтобы получить доступ к своей учетной записи.\nНа Тайване: 0800-303-585\nВ Гонконге: 396-54666	
GLOBAL_ERROR_NETWORK_RISK_ACCOUNT_LOCKED	Мы заблокировали вашу учетную запись. Перейдите по ссылке https://eu.battle.net/support/ru/ и найдите статью 7537, чтобы узнать, что произошло.	
GLOBAL_ERROR_NETWORK_SPAM	Ввиду большого количества одновременных запросов с вашей стороны вы были отключены от службы Blizzard. Пожалуйста, перезапустите Hearthstone.	
GLOBAL_ERROR_NETWORK_TITLE	ОШИБКА СЕТИ	
GLOBAL_ERROR_NETWORK_UNAVAILABLE_NEW_VERSION	Для вашей учетной записи используется более новая версия игры. Подождите, пока будут установлены обновления для данного устройства.	
GLOBAL_ERROR_NETWORK_UNAVAILABLE_OFFLINE	Игра Hearthstone не подключена к сети. Пожалуйста, подождите несколько минут и повторите попытку.	
GLOBAL_ERROR_NETWORK_UNAVAILABLE_UNKNOWN	Ой! Похоже, шаловливые бесы мешают вашему клиенту Hearthstone подключиться к нашим серверам. Подождите несколько минут, пока мы попытаемся их изгнать, и попробуйте еще раз.	
GLOBAL_ERROR_NETWORK_UNAVAILABLE_UPGRADE	Для Hearthstone вышло обновление! Пожалуйста, загрузите последнюю версию игры.	
GLOBAL_ERROR_NETWORK_UTIL_TIMEOUT	Превышено время ожидания при запросе данных сервисной службы Hearthstone. Для продолжения игры перезапустите Hearthstone.	
GLOBAL_ERROR_NO_MAGE_PRECON	У нас возникли некоторые сетевые неполадки при загрузке карт вашей коллекции. Пожалуйста, перезапустите Hearthstone, чтобы получить доступ к коллекции и продолжить играть.	
GLOBAL_ERROR_STREAMING_ASSET_TIMEOUT	Превышено время ожидания системы потоковой загрузки при попытке загрузки ресурса {0}.	0=asset name
GLOBAL_ERROR_UNKNOWN_ERROR	Ой! Похоже, шаловливые бесы мешают вашему клиенту Hearthstone подключиться к службе Blizzard. Подождите несколько минут, пока мы попытаемся их изгнать, после чего вам надо будет перезапустить игру.	
GLOBAL_EXIT	Выход	
GLOBAL_FEATURE_DISABLED_MESSAGE_BATTLEGROUNDS	К сожалению, сейчас поля сражений недоступны.	
GLOBAL_FEATURE_DISABLED_MESSAGE_COLLECTION	К сожалению, коллекция в данный момент недоступна.	
GLOBAL_FEATURE_DISABLED_MESSAGE_FORGE	К сожалению, Арена в данный момент недоступна.	
GLOBAL_FEATURE_DISABLED_MESSAGE_PLAY	К сожалению, традиционный режим игры в данный момент недоступен.	
GLOBAL_FEATURE_DISABLED_MESSAGE_PRACTICE	К сожалению, режим тренировки в данный момент недоступен.	
GLOBAL_FEATURE_DISABLED_TITLE	Неактивно	
GLOBAL_FINISH	Завершить	
GLOBAL_FIRESIDE_BRAWL	Fireside-потасовка	
GLOBAL_FIRESIDE_GATHERING	Fireside Gathering	
GLOBAL_FIRESIDE_GATHERING_CHOOSE_HEADER	Выберите вариант	
GLOBAL_FIRESIDE_GATHERING_DEFAULT_TAVERN_NAME	Fireside Gathering	
GLOBAL_FIRESIDE_GATHERING_FIRST_TIME_TAVERN_NAME	Хозяин таверны: {0}	0=innkeeper battle tag
GLOBAL_FIRESIDE_GATHERING_PATRON_LIST_FOOTER_TEXT_LARGE_SCALE	Игроков на Fireside: {0}+	This is shown on the Friends List button whenever player is checked into a large scale Fireside Gathering (one that doesn't show the full patron list). the design decision was to show 99+ regardless of how many people are actually checked in.
GLOBAL_FIRESIDE_GATHERING_PATRON_LIST_FOOTER_TEXT_SOFT_LIMIT	Игроков на Fireside: {0}	0=The number of patrons up to 99.
GLOBAL_FIRESIDE_GATHERING_REUNPACK	Обновить настройки	
GLOBAL_FIRESIDE_GATHERING_SOCIAL_BUTTON_LARGE_SCALE_LABEL	<size=32>99<size=26>+</size></size>	This is shown on the Friends List button whenever player is checked into a large scale Fireside Gathering (one that doesn't show the full patron list). the design decision was to show 99+ regardless of how many people are actually checked in. NOTE: the size tag was used in enUS to shrink the + sign, to make sure 99+ fit into the small button.
GLOBAL_FORGE_END_DONE	Готово	
GLOBAL_FORGE_END_JOKE_0	Это было здорово!	
GLOBAL_FORGE_END_JOKE_1	Слов нет!	
GLOBAL_FORGE_END_JOKE_2	Невероятно!	
GLOBAL_FORGE_END_JOKE_3	У тебя талант!	
GLOBAL_FORGE_END_JOKE_4	Такой отличный результат будет нелегко повторить!	
GLOBAL_FORGE_END_JOKE_5	Просто потрясающе!	
GLOBAL_FORGE_END_JOKE_6	Невероятная игра!	
GLOBAL_FORGE_END_JOKE_7	ТРЕПЕЩИТЕ!	
GLOBAL_FORGE_END_JOKE_8	Это еще не конец! Хотя...	
GLOBAL_FORGE_END_TITLE	Сражение на Арене завершено	
GLOBAL_FRIEND_CHALLENGE_ACCEPT	Принять	
GLOBAL_FRIEND_CHALLENGE_BODY_BACON	Вас пригласили на поля сражений!\nИгрок:	
GLOBAL_FRIEND_CHALLENGE_BODY1	Вам бросает вызов:	
GLOBAL_FRIEND_CHALLENGE_BODY1_STANDARD	Вам бросает вызов на матч стандартного формата игрок	
GLOBAL_FRIEND_CHALLENGE_BODY1_WILD	Вам бросает вызов на матч\nвольного формата игрок	
GLOBAL_FRIEND_CHALLENGE_BODY2	Вы принимаете вызов?	
GLOBAL_FRIEND_CHALLENGE_DECLINE	Отклонить	
GLOBAL_FRIEND_CHALLENGE_FIRESIDE_BRAWL_BODY1	Вы получили вызов на Fireside-потасовку от	
GLOBAL_FRIEND_CHALLENGE_HEADER	Вызов	
GLOBAL_FRIEND_CHALLENGE_NEARBY_PLAYER_NOTE	В списке друзей можно отключить приглашения от находящихся рядом игроков.	
GLOBAL_FRIEND_CHALLENGE_OPPONENT_CANCELED	{0} отменяет вызов.	0=friend name
GLOBAL_FRIEND_CHALLENGE_OPPONENT_DECLINED	{0} отклоняет ваш вызов.	0=friend name
GLOBAL_FRIEND_CHALLENGE_OPPONENT_FRIEND_REMOVED	Вызов отменен, поскольку {0} больше не находится в вашем списке друзей.	0=friend name
GLOBAL_FRIEND_CHALLENGE_OPPONENT_WAITING_DECK	Вы ждете, пока {0} выбирает колоду.	0=friend name
GLOBAL_FRIEND_CHALLENGE_OPPONENT_WAITING_RESPONSE	Вы ждете, пока {0} ответит на ваш вызов.	0=friend name
GLOBAL_FRIEND_CHALLENGE_OPPONENT_WAITING_TEAM	Вы ждете, пока ваш оппонент не выберет команду.	
GLOBAL_FRIEND_CHALLENGE_QUEUE_CANCELED	Вызов отменен.	
GLOBAL_FRIEND_CHALLENGE_TAVERN_BRAWL_BODY1	Вас приглашает поучаствовать в «Потасовке» игрок:	
GLOBAL_FRIEND_CHALLENGE_TAVERN_BRAWL_HEADER	Вызов на «Потасовку»	
GLOBAL_FRIEND_CHALLENGE_TAVERN_BRAWL_OPPONENT_WAITING_READY	Вы ждете, когда игрок {0} присоединится к потасовке.	0=friend name
GLOBAL_FRIEND_CHALLENGE_TAVERN_BRAWL_RECIPIENT_NO_VALID_DECK_RECIPIENT	Вас приглашает поучаствовать в «Потасовке» игрок {0}. Перед тем как принять вызов, соберите колоду в режиме «Потасовки».	
GLOBAL_FRIEND_CHALLENGE_TAVERN_BRAWL_RECIPIENT_NO_VALID_DECK_SENDER	Ваш друг еще не собрал колоду, соответствующую правилам «Потасовки». Вы можете повторить вызов позже!	
GLOBAL_FRIEND_CHALLENGE_TAVERN_BRAWL_RECIPIENT_NOT_UNLOCKED_SENDER	Вашему другу пока недоступен режим «Потасовки». Повторите вызов позже!	
GLOBAL_FRIEND_CHALLENGE_TITLE	Вызов	
GLOBAL_FRIENDLIST_ADD_FRIEND_BUTTON	Добавить	
GLOBAL_FRIENDLIST_BATTLEGROUNDS_TOOLTIP_INVITE_BODY	Пригласить игрока {0}, чтобы вместе играть на полях сражений!	0=player name
GLOBAL_FRIENDLIST_BATTLEGROUNDS_TOOLTIP_INVITE_HEADER	Пригласить	
GLOBAL_FRIENDLIST_BATTLEGROUNDS_TOOLTIP_KICK_BODY	Исключить игрока {0} из вашей группы для полей сражений.	0=player name
GLOBAL_FRIENDLIST_BATTLEGROUNDS_TOOLTIP_KICK_HEADER	Исключить	
GLOBAL_FRIENDLIST_BUSYSTATUS	Занят	
GLOBAL_FRIENDLIST_CHALLENGE_BUTTON_AVAILABLE	Игрок {0} свободен. Бросьте ему вызов!	0=player name
GLOBAL_FRIENDLIST_CHALLENGE_BUTTON_BATTLEGROUNDS_LOCKED	Завершите обучение в режиме «Поля сражений», чтобы открыть.	
GLOBAL_FRIENDLIST_CHALLENGE_BUTTON_BATTLEGROUNDS_PARTY_MEMBER	Вы не можете послать другу вызов, находясь в группе для полей сражений.	
GLOBAL_FRIENDLIST_CHALLENGE_BUTTON_EARLY_ACCESS	Этот режим находится в раннем доступе.	
GLOBAL_FRIENDLIST_CHALLENGE_BUTTON_HEADER	Дружеская дуэль	
GLOBAL_FRIENDLIST_CHALLENGE_BUTTON_IM_APPEARING_OFFLINE	Игрок {0} сейчас не может получить ваш вызов. Ваш статус отображается как «Не в сети».	0=player name
GLOBAL_FRIENDLIST_CHALLENGE_BUTTON_IM_UNAVAILABLE	Игрок {0} сейчас не может получить ваш вызов. Вернитесь в главное меню.	0=player name
GLOBAL_FRIENDLIST_CHALLENGE_BUTTON_MODE_UNAVAILABLE	В настоящее время бросить вызов другу в этом режиме невозможно.	
GLOBAL_FRIENDLIST_CHALLENGE_BUTTON_TAVERN_BRAWL_LOCKED	Пройдите обучение в традиционном режиме Hearthstone и получите 20-й уровень за один из классов, чтобы открыть.	
GLOBAL_FRIENDLIST_CHALLENGE_BUTTON_THEYRE_UNAVAILABLE	Игрок {0} сейчас не может получить ваш вызов. Дождитесь, когда он вернется в главное меню.	0=player name
GLOBAL_FRIENDLIST_CHALLENGE_BUTTON_TRADITIONAL_LOCKED	Пройдите обучение в традиционном режиме Hearthstone, чтобы открыть.	
GLOBAL_FRIENDLIST_CHALLENGE_CHALLENGEE_NO_BATTLEGROUNDS_EARLY_ACCESS	У этого игрока нет раннего доступа к «Полям сражений».	
GLOBAL_FRIENDLIST_CHALLENGE_CHALLENGEE_NO_CLASSIC_DECK	У этого игрока нет классических колод.	
GLOBAL_FRIENDLIST_CHALLENGE_CHALLENGEE_NO_DECK	У этого игрока нет колод.	
GLOBAL_FRIENDLIST_CHALLENGE_CHALLENGEE_NO_STANDARD_DECK	У этого игрока нет стандартных колод.	
GLOBAL_FRIENDLIST_CHALLENGE_CHALLENGEE_NO_TAVERN_BRAWL_DECK	Этот игрок еще не создал колоду для «Потасовки».	
GLOBAL_FRIENDLIST_CHALLENGE_CHALLENGEE_NOT_SEEN_WILD	Этот игрок еще не открыл вольный формат.	
GLOBAL_FRIENDLIST_CHALLENGE_CHALLENGEE_TAVERN_BRAWL_LOCKED	Этот игрок еще не получил доступ к «Потасовке».	
GLOBAL_FRIENDLIST_CHALLENGE_CHALLENGEE_USER_IS_BUSY	Этот игрок пока занят.	
GLOBAL_FRIENDLIST_CHALLENGE_CHALLENGER_NO_CLASSIC_DECK	У вас нет классических колод.	
GLOBAL_FRIENDLIST_CHALLENGE_CHALLENGER_NO_DECK	Сперва нужно создать колоду.	
GLOBAL_FRIENDLIST_CHALLENGE_CHALLENGER_NO_STANDARD_DECK	У вас пока нет стандартных колод.	
GLOBAL_FRIENDLIST_CHALLENGE_CHALLENGER_NO_TAVERN_BRAWL_DECK	Для участия в «Потасовке» на этой неделе необходимо создать колоду.	
GLOBAL_FRIENDLIST_CHALLENGE_CHALLENGER_TAVERN_BRAWL_LOCKED	Вы получите доступ к «Потасовке», когда достигнете 20-го уровня любым классом.	
GLOBAL_FRIENDLIST_CHALLENGE_MENU_CLASSIC_DUEL_BUTTON	Классика	
GLOBAL_FRIENDLIST_CHALLENGE_MENU_DUEL_BUTTON	Дуэль	
GLOBAL_FRIENDLIST_CHALLENGE_MENU_STANDARD_DUEL_BUTTON	Стандартный	
GLOBAL_FRIENDLIST_CHALLENGE_MENU_WILD_DUEL_BUTTON	Вольный	
GLOBAL_FRIENDLIST_CHALLENGE_TOOLTIP_NO_TAVERN_BRAWL	«Потасовка» сейчас недоступна. Попробуйте позже!	
GLOBAL_FRIENDLIST_CHALLENGE_TOOLTIP_TAVERN_BRAWL_NOT_CHALLENGEABLE	Дружеская дуэль недоступна для этой потасовки.	
GLOBAL_FRIENDLIST_CURRENT_GAMES_HEADER	ТЕКУЩИЕ ИГРЫ – {0}	0=number of friends you have unfinished games with
GLOBAL_FRIENDLIST_FRIENDS_HEADER	ДРУЗЬЯ – {0}/{1} в сети	0=number of online friends 1=number of offline friends
GLOBAL_FRIENDLIST_FRIENDS_HEADER_ALL_ONLINE	ДРУЗЬЯ – {0} в сети	
GLOBAL_FRIENDLIST_LASTPLAYED	Последний противник:	
GLOBAL_FRIENDLIST_MYSTATUS	В СЕТИ	
GLOBAL_FRIENDLIST_NEARBY_PLAYERS_DISABLED_HEADER	РЯДОМ С ВАМИ (отключено)	
GLOBAL_FRIENDLIST_NEARBY_PLAYERS_HEADER	РЯДОМ С ВАМИ – {0}	0=number of players
GLOBAL_FRIENDLIST_REMOVE_FRIEND_ALERT_MESSAGE	Вы действительно хотите удалить игрока {0}?	0=friend name
GLOBAL_FRIENDLIST_REMOVE_FRIEND_BUTTON	Удалить	
GLOBAL_FRIENDLIST_REQUEST_SENT_TIME	Получен: {0}	0=one of the GLOBAL_DATETIME_ELAPSED_ strings
GLOBAL_FRIENDLIST_REQUESTS_HEADER	Запросы на дружбу – {0}	0=number of received friend requests
GLOBAL_FRIENDLIST_SPECTATE_MENU_DESCRIPTION	В игре: {0}	0=player name
GLOBAL_FRIENDLIST_SPECTATE_TOOLTIP_AVAILABLE_HEADER	Присоединиться в качестве зрителя	
GLOBAL_FRIENDLIST_SPECTATE_TOOLTIP_AVAILABLE_TEXT	Щелкните здесь, чтобы присоединиться к матчу этого игрока в качестве зрителя.	
GLOBAL_FRIENDLIST_SPECTATE_TOOLTIP_AVAILABLE_TEXT_TOUCH	Нажмите здесь, чтобы присоединиться к матчу этого игрока в качестве зрителя.	
GLOBAL_FRIENDLIST_SPECTATE_TOOLTIP_INVITE_HEADER	Пригласить в качестве зрителя	
GLOBAL_FRIENDLIST_SPECTATE_TOOLTIP_INVITE_OTHER_SIDE_HEADER	Смотрит игру противника	
GLOBAL_FRIENDLIST_SPECTATE_TOOLTIP_INVITE_OTHER_SIDE_TEXT	Щелкните, чтобы показать ваши карты игроку {0}.	0=player name
GLOBAL_FRIENDLIST_SPECTATE_TOOLTIP_INVITE_OTHER_SIDE_TEXT_TOUCH	Нажмите, чтобы показать ваши карты игроку {0}.	0=player name
GLOBAL_FRIENDLIST_SPECTATE_TOOLTIP_INVITE_TEXT	Пригласить игрока {0} в качестве зрителя.	0=player name
GLOBAL_FRIENDLIST_SPECTATE_TOOLTIP_INVITED_HEADER	Приглашение в качестве зрителя	
GLOBAL_FRIENDLIST_SPECTATE_TOOLTIP_INVITED_TEXT	Вы пригласили игрока {0} посмотреть матч.	0=player name
GLOBAL_FRIENDLIST_SPECTATE_TOOLTIP_KICK_HEADER	Исключить	
GLOBAL_FRIENDLIST_SPECTATE_TOOLTIP_KICK_TEXT	{0} наблюдает за вашим матчем. Щелкните, чтобы удалить этого зрителя.	
GLOBAL_FRIENDLIST_SPECTATE_TOOLTIP_KICK_TEXT_TOUCH	{0} наблюдает за вашим матчем. Нажмите, чтобы удалить этого зрителя.	
GLOBAL_FRIENDLIST_SPECTATE_TOOLTIP_PREVIOUSLY_KICKED_HEADER	Невозможно посмотреть матч	
GLOBAL_FRIENDLIST_SPECTATE_TOOLTIP_PREVIOUSLY_KICKED_TEXT	Данный игрок ранее удалил вас из числа зрителей. Вы больше не можете смотреть его матчи.	
GLOBAL_FRIENDLIST_SPECTATE_TOOLTIP_RECEIVED_INVITE_TEXT	Вы получили приглашение от игрока {0} посмотреть матч. Щелкните, чтобы присоединиться к игре.	
GLOBAL_FRIENDLIST_SPECTATE_TOOLTIP_RECEIVED_INVITE_TEXT_TOUCH	Вы получили приглашение от игрока {0} посмотреть матч. Нажмите, чтобы присоединиться к игре.	
GLOBAL_FRIENDLIST_SPECTATE_TOOLTIP_SPECTATING_HEADER	Режим зрителя	
GLOBAL_FRIENDLIST_SPECTATE_TOOLTIP_SPECTATING_TEXT	Вы присутствуете на матче этого игрока в качестве зрителя.	
GLOBAL_FRIENDLYCHALLENGE_QUEST_REWARD_AT_LIMIT	Исчерпан дневной лимит для наград в заданиях «Вызов другу».	
GLOBAL_FRIENDLYCHALLENGE_REWARD_CONCEDED_YOUR_OPPONENT	Ваш противник покинул игру слишком рано, из-за чего вы не можете получить награду.	
GLOBAL_FRIENDLYCHALLENGE_REWARD_CONCEDED_YOURSELF	Вы покинули игру слишком рано и не можете получить награду.	
GLOBAL_GAME_MENU	Меню	
GLOBAL_GAME_QUEUE_TIME_IN_QUEUE	Время в очереди	
GLOBAL_GAME_QUEUE_WAIT_TIME	Время ожидания	
GLOBAL_GOLD_REWARD_ALREADY_CAPPED	Вы уже получили сегодня {0} золота.	
GLOBAL_GOLD_REWARD_BAD_RATING	Ваш рейтинг или рейтинг вашего противника не соответствует требованиям для получения золота за победу.	
GLOBAL_GOLD_REWARD_OVER_CAIS	Дальнейшее получение золота невозможно из-за системы контроля.	
GLOBAL_GOLD_REWARD_SHORT_GAME_BY_TIME	Ваша игра длилась недостаточно долго для получения золота за победу.	
GLOBAL_HEALTH	Здоровье	
GLOBAL_HEALTHY_GAMING_CHINA_CAIS_ACTIVE	Контроль времени игры включен.	
GLOBAL_HEALTHY_GAMING_CHINA_LESS_THAN_THREE_HOURS	您累计在线时间已满{0}小时。	
GLOBAL_HEALTHY_GAMING_CHINA_MORE_THAN_FIVE_HOURS	您已进入不健康游戏时间，为了您的健康，请您立即下线休息。如不下线，您的身体将受到损害，您的收益已降为零，直到您的累计下线时间满5小时后，才能恢复正常。	
GLOBAL_HEALTHY_GAMING_CHINA_MORE_THAN_FIVE_HOURS_PHONE	您已进入不健康游戏时间，为了您的健康，请您立即下线休息。如不下线，您的身体将受到损害，\n您的收益已降为零，直到您的累计下线时间满5小时后，才能恢复正常。	
GLOBAL_HEALTHY_GAMING_CHINA_STARTUP_MESSAGE	抵制不良游戏，拒绝盗版游戏。\n注意自我保护，谨防上当受骗。\n适度游戏益脑，沉迷游戏伤身。\n合理安排时间，享受健康生活。	
GLOBAL_HEALTHY_GAMING_CHINA_STARTUP_SUBTEXT	ISBN：978-7-900262-36-3 版署批号：新出审字[2013]1510号 沪网文[2017]9633-727号 文网进字[2013]029号 著作权：暴雪娱乐有限公司 出版单位：金报电子音像出版中心	
GLOBAL_HEALTHY_GAMING_CHINA_THREE_HOURS	您累计在线时间已满{0}小时，请您下线休息，做适当身体活动。	
GLOBAL_HEALTHY_GAMING_CHINA_THREE_TO_FIVE_HOURS	您已经进入疲劳游戏时间，您的游戏收益将降为正常值的0%，为了您的健康，请尽快下线休息，做适当身体活动，合理安排学习生活。	
GLOBAL_HEALTHY_GAMING_CHINA_THREE_TO_FIVE_HOURS_PHONE	您已经进入疲劳游戏时间，您的游戏收益将降为正常值的0%，为了您的健康，\n请尽快下线休息，做适当身体活动，合理安排学习生活。	
GLOBAL_HEALTHY_GAMING_KOREA_STARTUP_MESSAGE	본 게임물은 만 12세 이용가 게임으로서 해당 연령 미만의 청소년이 이용하기에 부적절합니다. 반드시 보호자의 지도 감독이 필요합니다.	
GLOBAL_HEALTHY_GAMING_TOAST	게임을 플레이한지 {0}시간 지났습니다. 과도한 게임이용은 정상적인 일상생활에 지장을 줄 수 있습니다	
GLOBAL_HEALTHY_GAMING_TOAST_OVER_THRESHOLD	Вы играете уже {0} |4(час,часа,часов). Это очень, очень долго!	0=hours
GLOBAL_HELP	Помощь	
GLOBAL_HERO_LEVEL_NEXT_REWARD_TITLE	Награда за {0}-й уровень	0=level
GLOBAL_HERO_LEVEL_REWARD_ARCANE_DUST	Чародейная пыль: {0}	0=amount
GLOBAL_HERO_LEVEL_REWARD_BOOSTER	{0} |4(комплект,комплекта,комплектов) карт	0=booster type
GLOBAL_HERO_LEVEL_REWARD_GOLD	Золото: {0}	0=amount
GLOBAL_HERO_LEVEL_REWARD_GOLDEN_CARD	{0} «{1}»	0=flair 1=card name
GLOBAL_HERO_WINS	Побед: {0}/{1}	0=number of games this class has won 1=number of wins to get golden
GLOBAL_HERO_WINS_PAST_MAX	Побед: {0}	0=number of games this class has won
GLOBAL_HERO_WINS_PAST_MAX_PHONE	Побед\n{0}	0=number of games this class has won
GLOBAL_HERO_WINS_PHONE	Побед: {0}/{1}	0=number of games this class has won 1=number of wins to get golden
GLOBAL_HEROIC_BRAWL	Героическая потасовка	
GLOBAL_HIDE	Скрыть	
GLOBAL_IN_PROGRESS_REWARD_CHEST_INSTRUCTIONS	Выиграйте еще {0} |4(матч,матча,матчей), чтобы получить сезонный сундук!\n(станет доступно в следующем месяце)	
GLOBAL_JOIN	Присоединиться	
GLOBAL_KEYWORD_ADAPT	Адаптация	
GLOBAL_KEYWORD_ADAPT_TEXT	Выберите один из 3 бонусов.	
GLOBAL_KEYWORD_ALLIANCE	Альянс	
GLOBAL_KEYWORD_ALLIANCE_TEXT	Расы Альянса: дренеи, дворфы, гномы, люди, ночные эльфы и воргены	
GLOBAL_KEYWORD_ATTACK_MERC	Атака	
GLOBAL_KEYWORD_ATTACK_REF_TEXT_MERC	Атакует цель и получает ответный урон.	
GLOBAL_KEYWORD_ATTACK_TEXT_MERC	Атакует цель и получает ответный урон.	
GLOBAL_KEYWORD_AUTOATTACK	Автоатака	
GLOBAL_KEYWORD_AUTOATTACK_TEXT	Не может атаковать, но действует [x]в_конце вашего хода.	
GLOBAL_KEYWORD_AUTOCAST	Автоматическое применение	
GLOBAL_KEYWORD_AUTOCAST_TEXT	Эта сила героя БУДЕТ использоваться на каждом ходу.	
GLOBAL_KEYWORD_AVENGE	Месть: (X)	
GLOBAL_KEYWORD_AVENGE_TEXT	Когда погибает X ваших существ, срабатывает некий эффект.	
GLOBAL_KEYWORD_BATTLECRY	Боевой клич	
GLOBAL_KEYWORD_BATTLECRY_TEXT	Бонусный эффект при разыгрывании из руки.	
GLOBAL_KEYWORD_BATTLECRY_TEXT_MERC	Эффект, срабатывающий при розыгрыше с руки или когда это существо призывает наемник.	
GLOBAL_KEYWORD_BLEED	Кровотечение	
GLOBAL_KEYWORD_BLEED_TEXT	Кровотечение наносит урон в конце каждого хода. Восстановление здоровья снимает этот эффект.	
GLOBAL_KEYWORD_BLOOD_GEM	Кровавый самоцвет	
GLOBAL_KEYWORD_BLOOD_GEM_TEXT	Заклинание, дающее вашему существу +1/+1.	
GLOBAL_KEYWORD_BOSS	Босс	
GLOBAL_KEYWORD_BOSS_TEXT	Игроки сражаются вместе, чтобы победить босса.	
GLOBAL_KEYWORD_CASTS_WHEN_DRAWN	При взятии	
GLOBAL_KEYWORD_CASTS_WHEN_DRAWN_TEXT	Разыгрывается при взятии из колоды. Затем вы берете еще одну карту.	
GLOBAL_KEYWORD_CHARGE	Рывок	
GLOBAL_KEYWORD_CHARGE_TEXT	Может немедленно атаковать.	
GLOBAL_KEYWORD_COMBO	Серия приемов	
GLOBAL_KEYWORD_COMBO_MERC	Серия приемов	
GLOBAL_KEYWORD_COMBO_TEXT	Бонус, срабатывающий, если вы уже разыграли карту на этом ходу.	
GLOBAL_KEYWORD_COMBO_TEXT_MERC	Дополнительный эффект, срабатывающий, если ваш отряд уже применял способность на этом ходу.	
GLOBAL_KEYWORD_CORRUPT	Порча	
GLOBAL_KEYWORD_CORRUPT_TEXT	Улучшается в руке после того, как вы разыграете карту с большей стоимостью.	
GLOBAL_KEYWORD_CORRUPTEDCARD	Под порчей	
GLOBAL_KEYWORD_CORRUPTEDCARD_TEXT	Карта улучшилась, когда вы разыграли карту с большей стоимостью.	
GLOBAL_KEYWORD_COUNTER	Отмена	
GLOBAL_KEYWORD_COUNTER_TEXT	Отмененная карта не производит никакого действия.	
GLOBAL_KEYWORD_CRITICAL_DAMAGE	Критический урон	
GLOBAL_KEYWORD_CRITICAL_DAMAGE_TEXT	Получает удвоенный урон.	
GLOBAL_KEYWORD_CTHUN	К'Тун	
GLOBAL_KEYWORD_CTHUN_TEXT	К'Тун получает усиления вне зависимости от того, где находится. Пусть даже в колоде!	
GLOBAL_KEYWORD_DEATHBLOW	Добивание	
GLOBAL_KEYWORD_DEATHBLOW_TEXT	Дополнительный эффект, срабатывающий при убийстве.	
GLOBAL_KEYWORD_DEATHRATTLE	Предсмертный хрип	
GLOBAL_KEYWORD_DEATHRATTLE_TEXT	Срабатывает в момент гибели.	
GLOBAL_KEYWORD_DISCOVER	Раскопка	
GLOBAL_KEYWORD_DISCOVER_TEXT	Выберите одну из трех карт и положите в руку.	
GLOBAL_KEYWORD_DIVINE_SHIELD	Божественный щит	
GLOBAL_KEYWORD_DIVINE_SHIELD_REF_TEXT	Когда защищенное существо первый раз получает урон, он не засчитывается.	
GLOBAL_KEYWORD_DIVINE_SHIELD_TEXT	Когда существо первый раз получает урон, он не засчитывается.	
GLOBAL_KEYWORD_DORMANT	Спячка	
GLOBAL_KEYWORD_DORMANT_TEXT	Существо недостижимо для обоих игроков.	
GLOBAL_KEYWORD_ECHO	Эхо	
GLOBAL_KEYWORD_ECHO_TEXT	Можно разыграть несколько раз за ход. Копии не могут стоить меньше (1).	
GLOBAL_KEYWORD_ELVES_MERC	Эльфы	
GLOBAL_KEYWORD_ELVES_MERC_TEXT	В число эльфов входят: эльфы крови и ночные эльфы	
GLOBAL_KEYWORD_EMPOWER	Воззвание	
GLOBAL_KEYWORD_EMPOWER_PRIEST	Воззвание: жрец	
GLOBAL_KEYWORD_EMPOWER_PRIEST_TEXT	Сила Галакронда: <i>вы кладете в руку случайное существо жреца.</i>	
GLOBAL_KEYWORD_EMPOWER_ROGUE	Воззвание: разбойник	
GLOBAL_KEYWORD_EMPOWER_ROGUE_COLLECTION_TEXT	Сила Галакронда: <i>вы кладете в руку прихвостня.</i>	
GLOBAL_KEYWORD_EMPOWER_ROGUE_TEXT	Сила Галакронда: <i>вы кладете в руку <b>прихвостня</b>.</i>	
GLOBAL_KEYWORD_EMPOWER_SHAMAN	Воззвание: шаман	
GLOBAL_KEYWORD_EMPOWER_SHAMAN_COLLECTION_TEXT	Сила Галакронда: <i>призывает элементаля 2/1 с «Натиском».</i>	
GLOBAL_KEYWORD_EMPOWER_SHAMAN_TEXT	Сила Галакронда: <i>призывает элементаля 2/1 с <b>«Натиском»</b>.</i>	
GLOBAL_KEYWORD_EMPOWER_TEXT	Применяет силу Галакронда.	
GLOBAL_KEYWORD_EMPOWER_WARLOCK	Воззвание: чернокнижник	
GLOBAL_KEYWORD_EMPOWER_WARLOCK_TEXT	Сила Галакронда: <i>призывает двух бесов 1/1.</i>	
GLOBAL_KEYWORD_EMPOWER_WARRIOR	Воззвание: воин	
GLOBAL_KEYWORD_EMPOWER_WARRIOR_TEXT	Сила Галакронда: <i>ваш герой получает +3 к атаке до конца хода.</i>	
GLOBAL_KEYWORD_ENRAGED_TOOLTIP	Исступление	
GLOBAL_KEYWORD_ENRAGED_TOOLTIP_TEXT	Пока у этого существа неполное здоровье, оно получает новую способность.	
GLOBAL_KEYWORD_EVILZUG	Прихвостень	
GLOBAL_KEYWORD_EVILZUG_TEXT	Существо за (1) с «Боевым кличем».	
GLOBAL_KEYWORD_FATIGUE	Усталость	
GLOBAL_KEYWORD_FATIGUE_TEXT	Урон, получаемый при попытке взять карту из пустой колоды.	
GLOBAL_KEYWORD_FLOOPY	Ухлюпистый Хлюп	
GLOBAL_KEYWORD_FLOOPY_TEXT	Превращается, когда вы разыгрываете существо.	
GLOBAL_KEYWORD_FREEZE	Заморозка	
GLOBAL_KEYWORD_FREEZE_TEXT	Замороженные персонажи пропускают следующую атаку.	
GLOBAL_KEYWORD_FREEZE_TEXT_MERC	Замороженные противники теряют следующее действие на этом ходу.	
GLOBAL_KEYWORD_FRENZY	Бешенство	
GLOBAL_KEYWORD_FRENZY_TEXT	Срабатывает один раз, когда существо получает урон и выживает.	
GLOBAL_KEYWORD_FROZEN	Под действием заморозки	
GLOBAL_KEYWORD_FROZEN_TEXT	Не может атаковать в следующий ход.	
GLOBAL_KEYWORD_FROZEN_TEXT_MERC	Не применяет следующую способность.	
GLOBAL_KEYWORD_GALAKROND	Галакронд	
GLOBAL_KEYWORD_GALAKROND_COLLECTION_TEXT	Эту карту можно использовать в колоде жреца, разбойника, шамана, чернокнижника или воина.	
GLOBAL_KEYWORD_GRIMY_GOONS	«Ржавые Бугаи»	
GLOBAL_KEYWORD_GRIMY_GOONS_COLLECTION_TEXT	Эту карту можно использовать в колоде охотника, паладина или воина.	
GLOBAL_KEYWORD_HONORABLEKILL	Почетная победа	
GLOBAL_KEYWORD_HONORABLEKILL_TEXT	Дает бонус, если в точности нанести смертельный урон.	
GLOBAL_KEYWORD_HORDE	Орда	
GLOBAL_KEYWORD_HORDE_TEXT	Расы Орды: эльфы крови, гоблины, полуорки, огры, орки, таурены, тролли и нежить	
GLOBAL_KEYWORD_IMMUNE	Неуязвимость	
GLOBAL_KEYWORD_IMMUNE_REF_TEXT	Персонажу с неуязвимостью нельзя нанести урон.	
GLOBAL_KEYWORD_IMMUNE_TEXT	Не получает урон.	
GLOBAL_KEYWORD_INSPIRE	Воодушевление	
GLOBAL_KEYWORD_INSPIRE_TEXT	Срабатывает после применения вашей силы героя.	
GLOBAL_KEYWORD_JADE_GOLEM	Нефритовый голем	
GLOBAL_KEYWORD_JADE_GOLEM_COLLECTION_TEXT	Ваш первый нефритовый голем – 1/1. Каждый следующий получает +1/+1.	
GLOBAL_KEYWORD_JADE_GOLEM_TEXT	Каждый новый нефритовый голем на +1/+1 сильнее предыдущего.	
GLOBAL_KEYWORD_JADE_LOTUS	Нефритовый лотос	
GLOBAL_KEYWORD_JADE_LOTUS_COLLECTION_TEXT	Эту карту можно использовать в колоде друида, разбойника или шамана.	
GLOBAL_KEYWORD_KABAL	Кабал	
GLOBAL_KEYWORD_KABAL_COLLECTION_TEXT	Эту карту можно использовать в колоде жреца, мага или чернокнижника.	
GLOBAL_KEYWORD_LIFESTEAL	Похищение жизни	
GLOBAL_KEYWORD_LIFESTEAL_TEXT	Нанося урон, также исцеляет вашего героя.	
GLOBAL_KEYWORD_MEGAWINDFURY	Меганеистовство ветра	
GLOBAL_KEYWORD_MEGAWINDFURY_TEXT	Атакует четырежды за ход.	
GLOBAL_KEYWORD_MINION_TYPE_REFERENCE	Тип существа	
GLOBAL_KEYWORD_MINION_TYPE_REFERENCE_TEXT	Зверь, демон, дракон, механизм, мурлок, пират и тотем.	
GLOBAL_KEYWORD_MODULAR	Магнетизм	
GLOBAL_KEYWORD_MODULAR_TEXT	Разыграйте это существо слева от механизма, чтобы объединить их.	
GLOBAL_KEYWORD_OFFHAND	Левая рука	
GLOBAL_KEYWORD_OFFHAND_TEXT	Невозможно уничтожить или зачаровать.	
GLOBAL_KEYWORD_OUTCAST	Изгой	
GLOBAL_KEYWORD_OUTCAST_TEXT	Дополнительное свойство при разыгрывании из крайней левой или крайней правой позиции в руке.	
GLOBAL_KEYWORD_OVERKILL	Сверхурон	
GLOBAL_KEYWORD_OVERKILL_TEXT	Получает бонус при нанесении избыточного урона на вашем ходу.	
GLOBAL_KEYWORD_OVERLOAD	Перегрузка: Х	
GLOBAL_KEYWORD_OVERLOAD_REF_TEXT	Карты с «Перегрузкой» ограничивают ваш запас маны на следующем ходу.	
GLOBAL_KEYWORD_OVERLOAD_TEXT	На следующем ходу у вас будет на X ед. меньше маны.	
GLOBAL_KEYWORD_PASSIVE	Пассивный эффект	
GLOBAL_KEYWORD_PASSIVE_TEXT	Постоянный эффект на время текущего похода.	
GLOBAL_KEYWORD_POISONOUS	Яд	
GLOBAL_KEYWORD_POISONOUS_TEXT	Уничтожает существо, которому наносит урон.	
GLOBAL_KEYWORD_QUEST	Задача	
GLOBAL_KEYWORD_QUEST_TEXT	Находится в руке в начале матча. Выполните задачу, чтобы получить награду.	
GLOBAL_KEYWORD_QUESTLINE	Задание	
GLOBAL_KEYWORD_QUESTLINE_TEXT	Будет в стартовой руке. Выполните, чтобы получить награду — до 3 раз!	
GLOBAL_KEYWORD_REBORN	Перерождение	
GLOBAL_KEYWORD_REBORN_TEXT	После первой смерти воскресает с 1 ед. здоровья.	
GLOBAL_KEYWORD_RECRUIT	Вербовка	
GLOBAL_KEYWORD_RECRUIT_TEXT	Призывает существо из вашей колоды.	
GLOBAL_KEYWORD_REFRESH	Обновление	
GLOBAL_KEYWORD_REFRESH_MERC	Обновление	
GLOBAL_KEYWORD_REFRESH_MERC_TEXT	Завершает восстановление способности.	
GLOBAL_KEYWORD_REFRESH_TEXT	Заполняет таверну Боба новыми существами.	
GLOBAL_KEYWORD_ROOT	Обездвиживание	
GLOBAL_KEYWORD_ROOT_TEXT	Обездвиженные существа и наемники не могут атаковать.	
GLOBAL_KEYWORD_RUSH	Натиск	
GLOBAL_KEYWORD_RUSH_TEXT	Может атаковать существ сразу после разыгрывания.	
GLOBAL_KEYWORD_RUSH_TEXT_MERC	Атакует сразу после призыва.	
GLOBAL_KEYWORD_SECRET	Секрет	
GLOBAL_KEYWORD_SECRET_TEXT	Скрытый эффект. Срабатывает, когда на ходу противника выполняется определенное действие.	
GLOBAL_KEYWORD_SHIFTING_MINION_TEXT	В начале вашего хода превращается в другое существо.	
GLOBAL_KEYWORD_SHIFTING_SPELL_TEXT	В начале вашего хода превращается в другое заклинание.	
GLOBAL_KEYWORD_SHIFTING_TEXT	В начале вашего хода превращается в другую карту.	
GLOBAL_KEYWORD_SHIFTING_WEAPON_TEXT	В начале вашего хода превращается в другое оружие.	
GLOBAL_KEYWORD_SHRINE	Идол	
GLOBAL_KEYWORD_SHRINE_TEXT	Возрождается через 3 хода после разрушения.	
GLOBAL_KEYWORD_SIDEQUEST	Побочная задача	
GLOBAL_KEYWORD_SIDEQUEST_TEXT	Выполните, чтобы получить награду.	
GLOBAL_KEYWORD_SILENCE	Немота	
GLOBAL_KEYWORD_SILENCE_TEXT	Отменяет все чары и эффекты карты.	
GLOBAL_KEYWORD_SPAREPART	Запасные части	
GLOBAL_KEYWORD_SPAREPART_TEXT	Заклинания за (1) с незначительным эффектом.	
GLOBAL_KEYWORD_SPELLBURST	Резонанс	
GLOBAL_KEYWORD_SPELLBURST_TEXT	Эффект, срабатывающий один раз после того, как вы применяете заклинание.	
GLOBAL_KEYWORD_SPELLCOMBO_MERC	Серия заклинаний	
GLOBAL_KEYWORD_SPELLCOMBO_REF_TEXT_MERC	Получает бонус, если другой ваш наемник разыгрывал заклинание той же школы на этом ходу. 	
GLOBAL_KEYWORD_SPELLCOMBO_TEXT_MERC	Получает бонус, если другой ваш наемник разыгрывал заклинание той же школы на этом ходу. 	
GLOBAL_KEYWORD_SPELLPOWER	Урон от заклинаний	
GLOBAL_KEYWORD_SPELLPOWER_ARCANE	Урон от заклинаний тайной магии	
GLOBAL_KEYWORD_SPELLPOWER_ARCANE_MERC	Урон от тайной магии	
GLOBAL_KEYWORD_SPELLPOWER_ARCANE_REF_TEXT	Ваши заклинания тайной магии наносят больше урона.	
GLOBAL_KEYWORD_SPELLPOWER_ARCANE_REF_TEXT_MERC	Ваши эффекты тайной магии\nнаносят дополнительный урон.	
GLOBAL_KEYWORD_SPELLPOWER_ARCANE_TEXT	Ваши заклинания тайной магии наносят на {0} ед. больше урона.	0=amount of spell damage
GLOBAL_KEYWORD_SPELLPOWER_ARCANE_TEXT_MERC	Ваши эффекты тайной магии\nнаносят дополнительный урон.	
GLOBAL_KEYWORD_SPELLPOWER_FEL	Урон от заклинаний Скверны	
GLOBAL_KEYWORD_SPELLPOWER_FEL_MERC	Урон от Скверны.	
GLOBAL_KEYWORD_SPELLPOWER_FEL_REF_TEXT	Ваши заклинания Скверны наносят больше урона.	
GLOBAL_KEYWORD_SPELLPOWER_FEL_REF_TEXT_MERC	Ваши эффекты Скверны\nнаносят дополнительный урон.	
GLOBAL_KEYWORD_SPELLPOWER_FEL_TEXT	Ваши заклинания Скверны наносят на {0} ед. больше урона.	0=amount of spell damage
GLOBAL_KEYWORD_SPELLPOWER_FEL_TEXT_MERC	Ваши эффекты Скверны\nнаносят дополнительный урон.	
GLOBAL_KEYWORD_SPELLPOWER_FIRE	Урон от заклинаний огня	
GLOBAL_KEYWORD_SPELLPOWER_FIRE_MERC	Урон от огня	
GLOBAL_KEYWORD_SPELLPOWER_FIRE_REF_TEXT	Ваши заклинания огня наносят больше урона.	
GLOBAL_KEYWORD_SPELLPOWER_FIRE_REF_TEXT_MERC	Ваши эффекты огня\nнаносят дополнительный урон.	
GLOBAL_KEYWORD_SPELLPOWER_FIRE_TEXT	Ваши заклинания огня наносят на {0} ед. больше урона.	0=amount of spell damage
GLOBAL_KEYWORD_SPELLPOWER_FIRE_TEXT_MERC	Ваши эффекты огня\nнаносят дополнительный урон.	
GLOBAL_KEYWORD_SPELLPOWER_FROST	Урон от заклинаний льда	
GLOBAL_KEYWORD_SPELLPOWER_FROST_MERC	Урон от магии льда 	
GLOBAL_KEYWORD_SPELLPOWER_FROST_REF_TEXT	Ваши заклинания льда наносят больше урона.	
GLOBAL_KEYWORD_SPELLPOWER_FROST_REF_TEXT_MERC	Ваши эффекты льда\nнаносят дополнительный урон.	
GLOBAL_KEYWORD_SPELLPOWER_FROST_TEXT	Ваши заклинания льда наносят на {0} ед. больше урона.	0=amount of spell damage
GLOBAL_KEYWORD_SPELLPOWER_FROST_TEXT_MERC	Ваши эффекты льда\nнаносят дополнительный урон.	
GLOBAL_KEYWORD_SPELLPOWER_HOLY	Урон от заклинаний Света	
GLOBAL_KEYWORD_SPELLPOWER_HOLY_MERC	Урон от магии Света	
GLOBAL_KEYWORD_SPELLPOWER_HOLY_REF_TEXT	Ваши заклинания Света наносят больше урона.	
GLOBAL_KEYWORD_SPELLPOWER_HOLY_REF_TEXT_MERC	Ваши эффекты Света\nнаносят дополнительный урон. 	
GLOBAL_KEYWORD_SPELLPOWER_HOLY_TEXT	Ваши заклинания Света наносят на {0} ед. больше урона.	0=amount of spell damage
GLOBAL_KEYWORD_SPELLPOWER_HOLY_TEXT_MERC	Ваши эффекты Света\nнаносят дополнительный урон. 	
GLOBAL_KEYWORD_SPELLPOWER_NATURE	Урон от заклинаний природы	
GLOBAL_KEYWORD_SPELLPOWER_NATURE_MERC	Урон от сил природы	
GLOBAL_KEYWORD_SPELLPOWER_NATURE_REF_TEXT	Ваши заклинания природы наносят больше урона.	
GLOBAL_KEYWORD_SPELLPOWER_NATURE_REF_TEXT_MERC	Ваши эффекты природы\nнаносят дополнительный урон.	
GLOBAL_KEYWORD_SPELLPOWER_NATURE_TEXT	Ваши заклинания природы наносят на {0} ед. больше урона.	0=amount of spell damage
GLOBAL_KEYWORD_SPELLPOWER_NATURE_TEXT_MERC	Ваши эффекты природы\nнаносят дополнительный урон.	
GLOBAL_KEYWORD_SPELLPOWER_PHYSICAL	Урон от заклинаний силы	
GLOBAL_KEYWORD_SPELLPOWER_PHYSICAL_REF_TEXT	Ваши заклинания силы наносят больше урона.	
GLOBAL_KEYWORD_SPELLPOWER_PHYSICAL_TEXT	Ваши заклинания силы наносят на {0} ед. больше урона.	0=amount of spell damage
GLOBAL_KEYWORD_SPELLPOWER_REF_TEXT	Ваши заклинания наносят больше урона.	
GLOBAL_KEYWORD_SPELLPOWER_SHADOW	Урон от заклинаний Тьмы	
GLOBAL_KEYWORD_SPELLPOWER_SHADOW_MERC	Урон он темной магии	
GLOBAL_KEYWORD_SPELLPOWER_SHADOW_REF_TEXT	Ваши заклинания Тьмы наносят больше урона.	
GLOBAL_KEYWORD_SPELLPOWER_SHADOW_REF_TEXT_MERC	Ваши эффекты Тьмы\nнаносят дополнительный урон.	
GLOBAL_KEYWORD_SPELLPOWER_SHADOW_TEXT	Ваши заклинания Тьмы наносят на {0} ед. больше урона.	0=amount of spell damage
GLOBAL_KEYWORD_SPELLPOWER_SHADOW_TEXT_MERC	Ваши эффекты Тьмы\nнаносят дополнительный урон.	
GLOBAL_KEYWORD_SPELLPOWER_TEXT	Ваши заклинания наносят на {0} ед. больше урона.	0=amount of spell damage
GLOBAL_KEYWORD_SPELLRESISTANCE_ARCANE	Сопротивление тайной магии	
GLOBAL_KEYWORD_SPELLRESISTANCE_ARCANE_REF_TEXT	Получает уменьшенный урон от эффектов тайной магии.	
GLOBAL_KEYWORD_SPELLRESISTANCE_ARCANE_TEXT	Получает на {0} ед. меньше урона от эффектов тайной магии.	0=amount of spell damage
GLOBAL_KEYWORD_SPELLRESISTANCE_FEL	Сопротивление Скверне	
GLOBAL_KEYWORD_SPELLRESISTANCE_FEL_REF_TEXT	Получает уменьшенный урон от эффектов Скверны.	
GLOBAL_KEYWORD_SPELLRESISTANCE_FEL_TEXT	Получает на {0} ед. меньше урона от эффектов Скверны.	0=amount of spell damage
GLOBAL_KEYWORD_SPELLRESISTANCE_FIRE	Сопротивление огню	
GLOBAL_KEYWORD_SPELLRESISTANCE_FIRE_REF_TEXT	Получает уменьшенный урон от эффектов огня.	
GLOBAL_KEYWORD_SPELLRESISTANCE_FIRE_TEXT	Получает на {0} меньше урона от эффектов огня.	0=amount of spell damage
GLOBAL_KEYWORD_SPELLRESISTANCE_FROST	Сопротивление магии льда	
GLOBAL_KEYWORD_SPELLRESISTANCE_FROST_REF_TEXT	Получает уменьшенный урон от эффектов магии льда.	
GLOBAL_KEYWORD_SPELLRESISTANCE_FROST_TEXT	Получает на {0} ед. меньше урона от эффектов магии льда.	0=amount of spell damage
GLOBAL_KEYWORD_SPELLRESISTANCE_HOLY	Сопротивление Свету	
GLOBAL_KEYWORD_SPELLRESISTANCE_HOLY_REF_TEXT	Получает уменьшенный урон от эффектов Света.	
GLOBAL_KEYWORD_SPELLRESISTANCE_HOLY_TEXT	Получает на {0} ед. меньше урона от эффектов Света.	0=amount of spell damage
GLOBAL_KEYWORD_SPELLRESISTANCE_NATURE	Сопротивление силам природы	
GLOBAL_KEYWORD_SPELLRESISTANCE_NATURE_REF_TEXT	Получает уменьшенный урон от эффектов природы.	
GLOBAL_KEYWORD_SPELLRESISTANCE_NATURE_TEXT	Получает на {0} ед. меньше урона от эффектов природы.	0=amount of spell damage
GLOBAL_KEYWORD_SPELLRESISTANCE_SHADOW	Сопротивление магии Тьмы	
GLOBAL_KEYWORD_SPELLRESISTANCE_SHADOW_REF_TEXT	Получает уменьшенный урон от эффектов Тьмы.	
GLOBAL_KEYWORD_SPELLRESISTANCE_SHADOW_TEXT	Получает на {0} ед. меньше урона от эффектов Тьмы.	0=amount of spell damage
GLOBAL_KEYWORD_SPELLWEAKNESS_ARCANE	Чародейская уязвимость	
GLOBAL_KEYWORD_SPELLWEAKNESS_ARCANE_REF_TEXT	Получает увеличенный урон от эффектов тайной магии.	
GLOBAL_KEYWORD_SPELLWEAKNESS_ARCANE_TEXT	Получает на {0} ед. больше урона от эффектов тайной магии.	0=amount of spell damage
GLOBAL_KEYWORD_SPELLWEAKNESS_FEL	Уязвимость к Скверне	
GLOBAL_KEYWORD_SPELLWEAKNESS_FEL_REF_TEXT	Получает увеличенный урон от эффектов Скверны.	
GLOBAL_KEYWORD_SPELLWEAKNESS_FEL_TEXT	Получает на {0} ед. больше урона от эффектов Скверны.	0=amount of spell damage
GLOBAL_KEYWORD_SPELLWEAKNESS_FIRE	Уязвимость к огню	
GLOBAL_KEYWORD_SPELLWEAKNESS_FIRE_REF_TEXT	Получает увеличенный урон от эффектов огня.	
GLOBAL_KEYWORD_SPELLWEAKNESS_FIRE_TEXT	Получает на {0} ед. больше урона от эффектов огня.	0=amount of spell damage
GLOBAL_KEYWORD_SPELLWEAKNESS_FROST	Уязвимость ко льду	
GLOBAL_KEYWORD_SPELLWEAKNESS_FROST_REF_TEXT	Получает увеличенный урон от эффектов магии льда.	
GLOBAL_KEYWORD_SPELLWEAKNESS_FROST_TEXT	Получает на {0} ед. больше урона от эффектов магии льда.	0=amount of spell damage
GLOBAL_KEYWORD_SPELLWEAKNESS_HOLY	Уязвимость к Свету	
GLOBAL_KEYWORD_SPELLWEAKNESS_HOLY_REF_TEXT	Получает увеличенный урон от эффектов Света.	
GLOBAL_KEYWORD_SPELLWEAKNESS_HOLY_TEXT	Получает на {0} ед. больше урона от эффектов Света.	0=amount of spell damage
GLOBAL_KEYWORD_SPELLWEAKNESS_NATURE	Уязвимость к силам природы	
GLOBAL_KEYWORD_SPELLWEAKNESS_NATURE_REF_TEXT	Получает увеличенный урон от эффектов природы.	
GLOBAL_KEYWORD_SPELLWEAKNESS_NATURE_TEXT	Получает на {0} ед. больше урона от эффектов природы.	0=amount of spell damage
GLOBAL_KEYWORD_SPELLWEAKNESS_SHADOW	Уязвимость к магии Тьмы	
GLOBAL_KEYWORD_SPELLWEAKNESS_SHADOW_REF_TEXT	Получает увеличенный урон от эффектов Тьмы.	
GLOBAL_KEYWORD_SPELLWEAKNESS_SHADOW_TEXT	Получает на {0} ед. больше урона от эффектов Тьмы.	0=amount of spell damage
GLOBAL_KEYWORD_START_OF_COMBAT	Начало боя	
GLOBAL_KEYWORD_START_OF_COMBAT_TEXT	Бонусный эффект в начале фазы боя.	
GLOBAL_KEYWORD_START_OF_GAME	Начало матча	
GLOBAL_KEYWORD_START_OF_GAME_TEXT	Делает что-то до первого хода.	
GLOBAL_KEYWORD_STEALTH	Маскировка	
GLOBAL_KEYWORD_STEALTH_REF_TEXT	Это существо нельзя атаковать или выбрать целью, пока оно не атакует.	
GLOBAL_KEYWORD_STEALTH_REF_TEXT_MERC	Это существо нельзя атаковать или выбрать целью, пока оно не применит способность.	
GLOBAL_KEYWORD_STEALTH_TEXT	Это существо нельзя атаковать или выбрать целью, пока оно не атакует.	
GLOBAL_KEYWORD_STEALTH_TEXT_MERC	Это существо нельзя атаковать или выбрать целью, пока оно не применит способность.	
GLOBAL_KEYWORD_TAUNT	Провокация	
GLOBAL_KEYWORD_TAUNT_REF_TEXT	Вынуждает противников атаковать существо с «Провокацией».	
GLOBAL_KEYWORD_TAUNT_REF_TEXT_Merc	Вынуждает противников атаковать существо со способностью «Провокация».	
GLOBAL_KEYWORD_TAUNT_TEXT	Противники вынуждены атаковать это существо.	
GLOBAL_KEYWORD_TOOL	Инструмент	
GLOBAL_KEYWORD_TOOL_TEXT	Предмет с активируемой способностью.	
GLOBAL_KEYWORD_TRADE	Можно обменять	
GLOBAL_KEYWORD_TRADE_TEXT	Перетащите эту карту в свою колоду, чтобы потратить 1 ед. маны и взять новую карту.	
GLOBAL_KEYWORD_TWINSPELL	Дуплет	
GLOBAL_KEYWORD_TWINSPELL_TEXT	Можно разыграть дважды.	
GLOBAL_KEYWORD_WILD	Вольный	
GLOBAL_KEYWORD_WILD_TEXT	Карты из прошлых дополнений Hearthstone, которые нельзя использовать в стандартном формате.	
GLOBAL_KEYWORD_WINDFURY	Неистовство ветра	
GLOBAL_KEYWORD_WINDFURY_TEXT	Атакует дважды за ход.	
GLOBAL_KEYWORD_WINDFURY_TEXT_MERC	Всегда атакует дважды.	
GLOBAL_LANGUAGE_CHANGE_CONFIRM_MESSAGE	Текущее действие будет прервано. Вы уверены, что хотите продолжить?	
GLOBAL_LANGUAGE_CHANGE_CONFIRM_TITLE	Изменить язык?	
GLOBAL_LANGUAGE_CHANGE_OUT_OF_SPACE_MESSAGE	Освободите {0} в хранилище на вашем устройстве, чтобы продолжить.	
GLOBAL_LANGUAGE_CHANGE_OUT_OF_SPACE_TITLE	Недостаточно места в хранилище!	
GLOBAL_LANGUAGE_DOWNLOAD_VOICE_PACK	Файлы озвучки загружены	
GLOBAL_LANGUAGE_DROPDOWN	Язык	
GLOBAL_LANGUAGE_NATIVE_DEDE	Deutsch	The name of the language IN THAT LANGUAGE.
GLOBAL_LANGUAGE_NATIVE_ENGB	English (UK)	The name of the language IN THAT LANGUAGE.
GLOBAL_LANGUAGE_NATIVE_ENUS	English	The name of the language IN THAT LANGUAGE.
GLOBAL_LANGUAGE_NATIVE_ESES	Español (España)	The name of the language IN THAT LANGUAGE.
GLOBAL_LANGUAGE_NATIVE_ESMX	Español (Latinoamérica)	The name of the language IN THAT LANGUAGE.
GLOBAL_LANGUAGE_NATIVE_FRFR	Français	The name of the language IN THAT LANGUAGE.
GLOBAL_LANGUAGE_NATIVE_ITIT	Italiano	The name of the language IN THAT LANGUAGE.
GLOBAL_LANGUAGE_NATIVE_JAJP	日本語	The name of the language IN THAT LANGUAGE.
GLOBAL_LANGUAGE_NATIVE_KOKR	한국어	The name of the language IN THAT LANGUAGE.
GLOBAL_LANGUAGE_NATIVE_PLPL	Polski	The name of the language IN THAT LANGUAGE.
GLOBAL_LANGUAGE_NATIVE_PTBR	Português (Brasil)	The name of the language IN THAT LANGUAGE.
GLOBAL_LANGUAGE_NATIVE_RURU	Русский	The name of the language IN THAT LANGUAGE.
GLOBAL_LANGUAGE_NATIVE_THTH	ภาษาไทย	The name of the laugnage IN THAT LANGUAGE.
GLOBAL_LANGUAGE_NATIVE_ZHCN	中文（简体）	The name of the language IN THAT LANGUAGE.
GLOBAL_LANGUAGE_NATIVE_ZHTW	繁體中文(台灣)	The name of the language IN THAT LANGUAGE.
GLOBAL_LEAVE	Покинуть	
GLOBAL_LEAVE_SPECTATOR_MODE	Покинуть	
GLOBAL_LETTUCE_LOBBY_TITLE	Выберите стиль игры	
GLOBAL_LETTUCE_REWARD_BANNER_TEXT	Награда наемников	
GLOBAL_LOCATIONS	Подробнее	
GLOBAL_LOGIN	Войти	
GLOBAL_LOGIN_CONFIRM_MESSAGE	Текущий прогресс будет потерян. Вы уверены, что хотите продолжить?	
GLOBAL_LOGIN_CONFIRM_TITLE	Войти в игру?	
GLOBAL_LOGO_COPYRIGHT	炉石传说 - 魔兽英雄传 ©2016 暴雪娱乐股份有限公司版权所有 由上海网之易网络科技发展有限公司运营	
GLOBAL_LOGOUT	Выйти	
GLOBAL_LOGOUT_CONFIRM_MESSAGE	Вы уверены, что хотите выйти?	
GLOBAL_LOGOUT_CONFIRM_TITLE	Выйти из игры?	
GLOBAL_LOSSES	Поражения	
GLOBAL_MEDAL_0	Легенда	
GLOBAL_MEDAL_1	Хозяин таверны	
GLOBAL_MEDAL_10	Огр-маг	
GLOBAL_MEDAL_11	Опытный охотник	
GLOBAL_MEDAL_12	Командир Песни Войны	
GLOBAL_MEDAL_13	Жуткий корсар	
GLOBAL_MEDAL_14	Лидер рейда	
GLOBAL_MEDAL_15	Страж Луносвета	
GLOBAL_MEDAL_16	Авантюрист	
GLOBAL_MEDAL_17	Таурен-воин	
GLOBAL_MEDAL_18	Ученица чародея	
GLOBAL_MEDAL_19	Инженер-новичок	
GLOBAL_MEDAL_2	Черный рыцарь	
GLOBAL_MEDAL_20	Щитоносец	
GLOBAL_MEDAL_21	Матрос Южных Морей	
GLOBAL_MEDAL_22	Мурлок-налетчик	
GLOBAL_MEDAL_23	Сквайр Авангарда	
GLOBAL_MEDAL_24	Лепрогном	
GLOBAL_MEDAL_25	Злая курица	
GLOBAL_MEDAL_3	Огненный великан	
GLOBAL_MEDAL_4	Горный великан	
GLOBAL_MEDAL_5	Морской великан	
GLOBAL_MEDAL_6	Древо войны	
GLOBAL_MEDAL_7	Служительница солнца	
GLOBAL_MEDAL_8	Вождь Северного Волка	
GLOBAL_MEDAL_9	Рыцарь Длани	
GLOBAL_MEDAL_ARENA_TOOLTIP_BODY	Это ваш лучший ключ на Арене.\nКоличество побед: {0}	0=num wins
GLOBAL_MEDAL_REWARD_CONGRATULATIONS	Поздравляем!	
GLOBAL_MEDAL_REWARD_DESCRIPTION	Медаль за прошлую неделю	
GLOBAL_MEDAL_TOOLTIP_BEST_RANK_CLASSIC	Ранг в классическом формате: {0}	
GLOBAL_MEDAL_TOOLTIP_BEST_RANK_STANDARD	Ранг в стандартном формате: {0}	
GLOBAL_MEDAL_TOOLTIP_BEST_RANK_WILD	Ранг в вольном формате: {0}	
GLOBAL_MEDAL_TOOLTIP_BODY_ARENA_GRAND_MASTER	Вы – чемпион Арены!	
GLOBAL_MEDAL_TOOLTIP_BODY_CLASSIC	Побеждайте в классическом формате, чтобы перейти на следующий ранг!	
GLOBAL_MEDAL_TOOLTIP_BODY_LEGEND	Вы – легенда! С каждой игрой ваша позиция в рейтинге этого ранга будет меняться.	
GLOBAL_MEDAL_TOOLTIP_BODY_STANDARD	Побеждайте в стандартном формате, чтобы перейти на следующий ранг!	
GLOBAL_MEDAL_TOOLTIP_BODY_WILD	Побеждайте в вольном формате, чтобы перейти на следующий ранг!	
GLOBAL_MEDAL_TOOLTIP_HEADER	{0}	0=medal name
GLOBAL_MEDAL_TOURNAMENT_TOOLTIP_BODY	Вы – один из {0}% лучших игроков этого сезона	0=rank percentile
GLOBAL_MERCENARIES	Наемники	
GLOBAL_MERCENARIES_COOP	Наемники, совместный режим	
GLOBAL_MINI_SET_BAR	Пещеры Стенаний	
GLOBAL_MINI_SET_DMF	Гонки Новолуния	
GLOBAL_MINI_SET_SW	Мертвые копи	
GLOBAL_MOBILE_ERROR_ANDROID_PHONE_DETECTED	К сожалению, на данный момент Hearthstone поддерживается только планшетами под управлением Android с размером экрана от 6".	
GLOBAL_MOBILE_ERROR_BREAKING_NEWS	Срочные новости:\n\n{0}	
GLOBAL_MOBILE_ERROR_GAMESERVER_CONNECT	Мы заметили, что вы не смогли начать игру по мобильной связи. Эта статья службы поддержки может вам помочь.	
GLOBAL_MOBILE_ERROR_LOGON_WEB_TIMEOUT	Вы давно не совершали никаких действий в Hearthstone, и ваше соединение с сервером было разорвано.	
GLOBAL_MOBILE_ERROR_NETWORK_DISCONNECT	Соединение было разорвано.	
GLOBAL_MOBILE_ERROR_NETWORK_SPAM	Ввиду большого количества одновременных запросов с вашей стороны соединение было прервано.	
GLOBAL_MOBILE_ERROR_NETWORK_UTIL_TIMEOUT	Превышено время ожидания подключения при запросе данных с серверов Hearthstone.	
GLOBAL_MOBILE_ERROR_UNSUPPORTED_IOS_PHONE_DETECTED	Для игры в Hearthstone требуется iPhone 6s, iPod Touch 7 или устройство более поздней версии.	
GLOBAL_MOBILE_ERROR_UNSUPPORTED_IOS_TABLET_DETECTED	Для игры в Hearthstone требуется iPad 5, iPad Air 2, iPad mini 4 или устройство более поздней версии.	
GLOBAL_MOBILE_LOG_IN_TOOLTIP	Войдите в игру, если у вас уже есть учетная запись.	
GLOBAL_MOBILE_LOGIN_POINTER	Вход здесь	
GLOBAL_MOBILE_RESTART_APPLICATION	Перезапустите приложение	
GLOBAL_MOBILE_TAP_TO_RECONNECT	Нажмите, чтобы подключиться повторно.	
GLOBAL_MOBILE_TAP_TO_UPDATE	Нажмите, чтобы обновить игру.	
GLOBAL_MOBILECHAT_NOTIFICATION_MULLIGAIN	Игра началась!	
GLOBAL_MOBILECHAT_NOTIFICATION_TURN_COUNTDOWN	Время заканчивается!	
GLOBAL_MOBILECHAT_NOTIFICATION_YOUR_TURN	Ваш ход!	
GLOBAL_MOBILECHAT_RETURN_TO_GAME	Закрыть	
GLOBAL_MOBILECHAT_RETURN_TO_MENU	Вернуться в меню	
GLOBAL_MORE	Дополнительно	
GLOBAL_MY_NUM_WINS	{0}	0=number of games this player has won
GLOBAL_NOT_AVAILABLE	Недоступно	
GLOBAL_OFF	Откл.	
GLOBAL_OFFLINE	Не в сети	
GLOBAL_OKAY	ОК	
GLOBAL_ON	Вкл.	
GLOBAL_OPTIONS	Настройки	
GLOBAL_OPTIONS_CARDBACK_LABEL	Доступные рубашки	
GLOBAL_OPTIONS_CHOOSE_CARD_BACK	Выберите рубашку	
GLOBAL_OPTIONS_CINEMATIC	Ролик	
GLOBAL_OPTIONS_CREDITS	Создатели	
GLOBAL_OPTIONS_GRAPHICS_FULLSCREEN_LABEL	Полный экран	
GLOBAL_OPTIONS_GRAPHICS_LABEL	Графика	
GLOBAL_OPTIONS_GRAPHICS_QUALITY_HIGH	Максимальное	
GLOBAL_OPTIONS_GRAPHICS_QUALITY_LABEL	Качество	
GLOBAL_OPTIONS_GRAPHICS_QUALITY_LOW	Минимальное	
GLOBAL_OPTIONS_GRAPHICS_QUALITY_MEDIUM	Среднее	
GLOBAL_OPTIONS_GRAPHICS_RESOLUTION_CUSTOM	По выбору	
GLOBAL_OPTIONS_GRAPHICS_RESOLUTION_LABEL	Разрешение	
GLOBAL_OPTIONS_MISCELLANEOUS_LABEL	Разное	
GLOBAL_OPTIONS_NEARBY_PLAYERS	Возможность бросать вызов игрокам рядом с вами – список друзей	
GLOBAL_OPTIONS_OTHER_LABEL	Другое	
GLOBAL_OPTIONS_PREFERENCES_LABEL	Параметры	
GLOBAL_OPTIONS_PRIVACY_POLICY	Конфиденциальность	
GLOBAL_OPTIONS_PUBLIC_CHAT_ENABLED	Общий чат	
GLOBAL_OPTIONS_RESTORE_PURCHASES	Восстановить покупки	
GLOBAL_OPTIONS_RESTORE_PURCHASES_POPUP_TEXT	Не находите своих покупок? Убедитесь, что ввели данные верной учетной записи.	
GLOBAL_OPTIONS_SCREEN_SHAKE	Включить эффект дрожащего экрана	
GLOBAL_OPTIONS_SKIP_NPR	Пропустить курс новичка	
GLOBAL_OPTIONS_SKIP_TO_RANK_25	К 25-му рангу	
GLOBAL_OPTIONS_SOUND_IN_BACKGROUND	Фоновый режим	
GLOBAL_OPTIONS_SOUND_LABEL	Звук	
GLOBAL_OPTIONS_SOUND_MASTER_VOLUME_LABEL	Общая громкость	
GLOBAL_OPTIONS_SOUND_MUSIC_VOLUME_LABEL	Громкость музыки	
GLOBAL_OPTIONS_SPECTATOR_OPEN_JOIN	Друзья могут наблюдать за моими матчами	
GLOBAL_PLAY	Играть	
GLOBAL_PLAY_RANKED	Играть	
GLOBAL_PLAY_STANDARD	Стандартная игра	
GLOBAL_PLAY_WAITING	Ожидание	
GLOBAL_PLAY_WILD	Вольная игра	
GLOBAL_PLAYER_MIGRATION_RESTART_BODY	Требуется обновить учетную запись.\nПожалуйста, перезапустите игру.	
GLOBAL_PLAYER_MIGRATION_RESTART_HEADER	Обновите учетную запись	
GLOBAL_PLAYER_PLAYER	Игрок	this is the word for generic "Player" - this will be used when there a player's name is unknown at the time.
GLOBAL_PRACTICE_MAX_LEVEL_REACHED	Макс. уровень тренировки	
GLOBAL_PROGRAMNAME_BLACKOPS4	Black Ops 4	
GLOBAL_PROGRAMNAME_BLACKOPSCOLDWAR	Black Ops Cold War	
GLOBAL_PROGRAMNAME_CODVANGUARD	Call of Duty: Vanguard	
GLOBAL_PROGRAMNAME_CRASHBANDICOOT4	Crash Bandicoot 4	
GLOBAL_PROGRAMNAME_DESTINY2	Destiny 2	
GLOBAL_PROGRAMNAME_DIABLO2R	Diablo II: Resurrected	
GLOBAL_PROGRAMNAME_DIABLO3	Diablo III	
GLOBAL_PROGRAMNAME_HEARTHSTONE	Hearthstone	
GLOBAL_PROGRAMNAME_HEROES	Heroes of the Storm	
GLOBAL_PROGRAMNAME_MODERNWARFARE	Modern Warfare	
GLOBAL_PROGRAMNAME_MODERNWARFARE2_REMASTER	MW2CR	
GLOBAL_PROGRAMNAME_OVERWATCH	Overwatch	
GLOBAL_PROGRAMNAME_PHOENIX	В сети	
GLOBAL_PROGRAMNAME_STARCRAFT	StarCraft	
GLOBAL_PROGRAMNAME_STARCRAFT2	StarCraft II	
GLOBAL_PROGRAMNAME_WARCRAFT3	Warcraft III: Reforged	
GLOBAL_PROGRAMNAME_WOW	World of Warcraft	
GLOBAL_PROGRESSION_ACHIEVEMENT_COMPLETION	Получено: {0}	
GLOBAL_PROGRESSION_ACHIEVEMENT_COMPLETION_DATE	{0:dd/MM/yyyy}	see http://msdn.microsoft.com/en-us/library/8kb3ddd4.aspx
GLOBAL_PROGRESSION_ACHIEVEMENT_COMPLETION_PERCENTAGE	{0}%	
GLOBAL_PROGRESSION_ACHIEVEMENT_SUBCATEGORY_NAME	{0} — {1}	
GLOBAL_PROGRESSION_DAILY_QUESTS_POPUP_TITLE	Задания	
GLOBAL_PROGRESSION_POINTS	Очки достижений: {0}	
GLOBAL_PROGRESSION_PROFILE_ARENA_STAT_TOOLTIP	Наибольшее число побед на Арене.	
GLOBAL_PROGRESSION_PROFILE_ARENA_STAT_TOOLTIP_TITLE	Арена	
GLOBAL_PROGRESSION_PROFILE_ARENA_WINS	{0} |4(победа,победы,побед)	
GLOBAL_PROGRESSION_PROFILE_BATTLEGROUNDS_STAT_TOOLTIP	Побеждайте, чтобы повысить рейтинг. Задания учитывают завершение игры в четверке лучших как победу!	
GLOBAL_PROGRESSION_PROFILE_BATTLEGROUNDS_STAT_TOOLTIP_TITLE	Поля сражений	
GLOBAL_PROGRESSION_PROFILE_BATTLEGROUNDS_TOP4	{0} |4(матч, матча, матчей) в четверке лучших	
GLOBAL_PROGRESSION_PROFILE_GAME_MODES	Режимы	
GLOBAL_PROGRESSION_PROFILE_MERCENARIES_STAT_TOOLTIP	Показывает количество побед в PvP и поручений, выполненных в режиме «Наемники».	
GLOBAL_PROGRESSION_PROFILE_MERCENARIES_STAT_TOOLTIP_TITLE	Наемники	
GLOBAL_PROGRESSION_PROFILE_MERCENARIES_TOTAL_BOUNTIES	{0} |4(поручение,поручения,поручений)	
GLOBAL_PROGRESSION_PROFILE_PLAY_MODE	Традиционный режим	
GLOBAL_PROGRESSION_PROFILE_PVPDR_CASUAL_STAT_TITLE	Обычные дуэли	
GLOBAL_PROGRESSION_PROFILE_PVPDR_CASUAL_STAT_TOOLTIP	Показывает наивысший рейтинг в обычных и героических дуэлях.	
GLOBAL_PROGRESSION_PROFILE_PVPDR_CASUAL_STAT_TOOLTIP_TITLE	Рейтинг в обычных дуэлях	
GLOBAL_PROGRESSION_PROFILE_PVPDR_HEROIC_STAT_TITLE	Героические дуэли	
GLOBAL_PROGRESSION_PROFILE_PVPDR_HEROIC_STAT_TOOLTIP	Показывает наивысший рейтинг в обычных и героических дуэлях.	
GLOBAL_PROGRESSION_PROFILE_PVPDR_HEROIC_STAT_TOOLTIP_TITLE	Рейтинг в героических дуэлях	
GLOBAL_PROGRESSION_PROFILE_RANKED_STAT_TOOLTIP	Общее число побед в рейтинговых играх.	
GLOBAL_PROGRESSION_PROFILE_TOTAL_WINS	{0} |4(победа,победы,побед) в сумме	
GLOBAL_PROGRESSION_PROGRESS_MESSAGE	{0} / {1}	
GLOBAL_PROGRESSION_QUEST_TIME_UNTIL_NEXT	Новое задание через\n{0}	
GLOBAL_PROGRESSION_RANKED_REWARDS_TOOLTIP	Получайте награды в каждом сезоне за лучший ранг в вольном, стандартном или классическом формате.	
GLOBAL_PROGRESSION_RANKED_REWARDS_TOOLTIP_TITLE	Награды за ранг	
GLOBAL_PROGRESSION_REWARD_SUMMARY	{0}\n{1}	
GLOBAL_PROGRESSION_REWARD_TRACK_XP	{0} ед. опыта	
GLOBAL_PROGRESSION_TIER_MESSAGE	{0}/{1}	
GLOBAL_PROGRESSION_TOOLTIP_CLASS_DEFAULT_DESC	{0}-й уровень	
GLOBAL_PROGRESSION_TOOLTIP_GOLDEN_WINS_DESC	Одержите {0} |4(победу,победы,побед) в рейтинговых матчах, на Арене или в дуэлях, выбрав класс «{1}», чтобы получить золотого классического героя этого класса!	{0}=win count {1}=class name
GLOBAL_PROGRESSION_TOOLTIP_PREMIUM_WINS_DESC	Одержите {0} |4(победу,победы,побед) в рейтинговых матчах, на Арене или в дуэлях, выбрав класс «{1}», чтобы получить награду ({2})!	{0}=win count {1}=class name {2}=hero card name
GLOBAL_PROGRESSION_TOOLTIP_PREMIUM_WINS_DONE_DESC	Вы одержали {0} |4(победу,победы,побед) за класс «{1}» в рейтинговых матчах, на Арене или в дуэлях и получаете награду ({2})!	{0}=win count {1}=class name {2}=hero card name
GLOBAL_PROGRESSION_TOOLTIP_TOTAL_CLASS_WINS	Всего побед ({0})	{0}=class name
GLOBAL_PROGRESSION_WEEKLY_QUESTS_POPUP_TITLE	Еженедельные задания	
GLOBAL_PVPDR_SEASON_ERROR_NOT_ACTIVE	Данный сезон дуэлей более недоступен. Пожалуйста, повторите попытку позже.	
GLOBAL_QUEST_PROGRESS_COUNT	{0}/{1}	0=progress,1=max progress
GLOBAL_QUIT	Выход	
GLOBAL_RACE_ALL	Все	
GLOBAL_RACE_ALL_BATTLEGROUNDS	Слияния	This should be the plural of DAL_087t
GLOBAL_RACE_BLOODELF	Эльф крови	
GLOBAL_RACE_BLOODELF_BATTLEGROUNDS	Эльфы крови	
GLOBAL_RACE_CENTAUR	Кентавр	
GLOBAL_RACE_DEMON	Демон	
GLOBAL_RACE_DEMON_BATTLEGROUNDS	Демоны	
GLOBAL_RACE_DRAENEI	Дреней	
GLOBAL_RACE_DRAENEI_BATTLEGROUNDS	Дренеи	
GLOBAL_RACE_DRAGON	Дракон	
GLOBAL_RACE_DRAGON_BATTLEGROUNDS	Драконы	
GLOBAL_RACE_DWARF	Дворф	
GLOBAL_RACE_DWARF_BATTLEGROUNDS	Дворфы	
GLOBAL_RACE_EGG	Яйцо	
GLOBAL_RACE_EGG_BATTLEGROUNDS	Яйца	
GLOBAL_RACE_ELEMENTAL	Элементаль	
GLOBAL_RACE_ELEMENTAL_BATTLEGROUNDS	Элементали	
GLOBAL_RACE_FURBOLG	Фурболг	
GLOBAL_RACE_GNOME	Гном	
GLOBAL_RACE_GNOME_BATTLEGROUNDS	Гномы	
GLOBAL_RACE_GOBLIN	Гоблин	
GLOBAL_RACE_GOBLIN_BATTLEGROUNDS	Гоблины	
GLOBAL_RACE_HALFORC	Полуорк	
GLOBAL_RACE_HIGHELF	Высший эльф	
GLOBAL_RACE_HUMAN	Человек	
GLOBAL_RACE_HUMAN_BATTLEGROUNDS	Люди	
GLOBAL_RACE_LOCK	Недоступно	
GLOBAL_RACE_MECHANICAL	Механизм	
GLOBAL_RACE_MECHANICAL_BATTLEGROUNDS	Механизмы	
GLOBAL_RACE_MIXED_BATTLEGROUNDS	Смешанные существа	
GLOBAL_RACE_MURLOC	Мурлок	
GLOBAL_RACE_MURLOC_BATTLEGROUNDS	Мурлоки	
GLOBAL_RACE_NERUBIAN	Неруб	
GLOBAL_RACE_NERUBIAN_BATTLEGROUNDS	Нерубы	
GLOBAL_RACE_NIGHTELF	Ночной эльф	
GLOBAL_RACE_NIGHTELF_BATTLEGROUNDS	Ночные эльфы	
GLOBAL_RACE_OGRE	Огр	
GLOBAL_RACE_OGRE_BATTLEGROUNDS	Огры	
GLOBAL_RACE_ORC	Орк	
GLOBAL_RACE_ORC_BATTLEGROUNDS	Орки	
GLOBAL_RACE_OWLKIN	Совух	
GLOBAL_RACE_PET	Зверь	
GLOBAL_RACE_PET_BATTLEGROUNDS	Звери	
GLOBAL_RACE_PIRATE	Пират	
GLOBAL_RACE_PIRATE_BATTLEGROUNDS	Пираты	
GLOBAL_RACE_QUILBOAR	Свинобраз	
GLOBAL_RACE_QUILBOARS_BATTLEGROUNDS	Свинобразы	
GLOBAL_RACE_SCOURGE	Плеть	
GLOBAL_RACE_SCOURGE_BATTLEGROUNDS	Плеть	
GLOBAL_RACE_TAUREN	Таурен	
GLOBAL_RACE_TAUREN_BATTLEGROUNDS	Таурены	
GLOBAL_RACE_TOTEM	Тотем	
GLOBAL_RACE_TOTEM_BATTLEGROUNDS	Тотемы	
GLOBAL_RACE_TREANT	Древень	
GLOBAL_RACE_TROLL	Тролль	
GLOBAL_RACE_TROLL_BATTLEGROUNDS	Тролли	
GLOBAL_RACE_UNDEAD	Нежить	
GLOBAL_RACE_UNDEAD_BATTLEGROUNDS	Нежить	
GLOBAL_RACE_WORGEN	Ворген	
GLOBAL_RACE_WORGEN_BATTLEGROUNDS	Воргены	
GLOBAL_RANK_CANT_LOSE_LEVEL	Вы не можете потерять этот ранг.	
GLOBAL_RANK_PROMOTION_DESC	Вы получили 25-й ранг!	
GLOBAL_RANK_SCRUB_RANK_DESC	На этом ранге вы не теряете звезды.	
GLOBAL_RANK_STAR_MULT	Бонус к звездам! x{0}	
GLOBAL_RANK_STAR_MULT_STREAK	Бонус за победную серию! x2	
GLOBAL_RANK_WIN_STREAK	Дополнительная звезда за победную серию!	
GLOBAL_RANKED	Рейтинг	
GLOBAL_RARITY_COMMON	Обычная	
GLOBAL_RARITY_EPIC	Эпическая	
GLOBAL_RARITY_FREE	Бесплатно	
GLOBAL_RARITY_LEGENDARY	Легендарная	
GLOBAL_RARITY_RARE	Редкая	
GLOBAL_RECONNECT_EXIT_BUTTON	Выход	
GLOBAL_RECONNECT_RECONNECTED	Повторное подключение к игре прошло успешно. Продолжение игры...	
GLOBAL_RECONNECT_RECONNECTED_HEADER	Переподключение	
GLOBAL_RECONNECT_RECONNECTED_LOGIN	Повторное подключение к вашей последней игре прошло успешно. Продолжение игры...	
GLOBAL_RECONNECT_RECONNECTING	В игре произошел разрыв соединения. Идет подключение...	
GLOBAL_RECONNECT_RECONNECTING_HEADER	Подключение	
GLOBAL_RECONNECT_RECONNECTING_LOGIN	В вашей последней игре произошел разрыв соединения. Идет подключение...	
GLOBAL_RECONNECT_TIMEOUT	Невозможно повторно подключиться к игре.	
GLOBAL_RECONNECT_TIMEOUT_HEADER	Ошибка	
GLOBAL_REFRESH	Обновить	
GLOBAL_REGION_AMERICAS	С. и Ю. Америка и Ю.-В. Азия	
GLOBAL_REGION_ASIA	Азия	
GLOBAL_REGION_CHINA	Китай	
GLOBAL_REGION_EUROPE	Европа	
GLOBAL_RELAUNCH_APPLICATION_AFTER_INSTALLAPK	Идет попытка установки нового клиента. Пожалуйста, перезапустите Hearthstone, если клиент не был установлен.	
GLOBAL_REMAINING_DATETIME	Осталось {0}	0=time string
GLOBAL_REMINDER_CARDBACK_SEASON_END_DIALOG	Выиграйте {0} |4(матч,матча,матчей) и получите рубашку этого сезона.	
GLOBAL_REMINDER_CHEST_QUESTION_MARK	?	Label for unearned chest, assuming "?" universally means unknown, it doesn't need to be localized
GLOBAL_REMINDER_CHEST_SEASON_END_DIALOG	Выиграйте 5 матчей и получите сезонный сундук!	
GLOBAL_RESTART	Переиграть	
GLOBAL_RESUME_GAME	Вернуться	
GLOBAL_RETRY	Повторить попытку	
GLOBAL_RETURNING_PLAYER_GENERATED_DECK	Колода хозяина таверны	
GLOBAL_REWARD_ARCANE_DUST_HEADLINE	Чародейная пыль!	
GLOBAL_REWARD_ARCANE_ORBS_HEADLINE	Получены чародейские сферы!	
GLOBAL_REWARD_ARENA_TICKET_ADMIT	ПРОПУСК	the word 'admit' in capital letters - displayed like "Admit 1" and looks like a movie/fair ticket. this is the Arena Ticket reward visual.
GLOBAL_REWARD_ARENA_TICKET_AUTHORIZED_BY	Выдан	a label that shows up in the Arena Ticket under the Player's name indicating this ticket reward was granted by some guy.
GLOBAL_REWARD_ARENA_TICKET_ENTRANT	Участник	a label that shows up in the Arena Ticket under the Player's name to say this person is allowed entrance into the Arena.
GLOBAL_REWARD_ARENA_TICKET_HEADLINE	Бесплатный пропуск!	
GLOBAL_REWARD_ARENA_TICKET_LABEL	Арена	
GLOBAL_REWARD_ARENA_TICKET_STORE_COUNT_1	1	
GLOBAL_REWARD_ARENA_TICKET_TITLE	Таверна	
GLOBAL_REWARD_BATTLEGROUNDS_GUIDE_HEADLINE	Открыт бармен полей сражений	
GLOBAL_REWARD_BATTLEGROUNDS_HERO_HEADLINE	Открыт герой полей сражений	
GLOBAL_REWARD_BONUS_CHALLENGE_HEADLINE	Открыто последнее испытание	
GLOBAL_REWARD_BOOSTER_DETAILS_OUT_OF_BAND	Вы получили {0} |4(комплект,комплекта,комплектов) карт.	0=count
GLOBAL_REWARD_BOOSTER_DETAILS_PRESALE_OUT_OF_BAND	Вы сможете воспользоваться вашей электронной покупкой в виде {0} |4(комплекта,комплектов,комплектов) через некоторое время!	0=count
GLOBAL_REWARD_BOOSTER_HEADLINE_GENERIC	Награда: комплект карт!	
GLOBAL_REWARD_BOOSTER_HEADLINE_MULTIPLE	Вы получили {0} |4(комплект,комплекта,комплектов)!	
GLOBAL_REWARD_BOOSTER_HEADLINE_OUT_OF_BAND	Получен комплект карт!	
GLOBAL_REWARD_BOOSTER_HEADLINE_OUT_OF_BAND_MULTI	Получены комплекты карт!	
GLOBAL_REWARD_CARD_BACK_HEADLINE	Новая рубашка!	
GLOBAL_REWARD_CARD_COUNT_MULTIPLIER	x	
GLOBAL_REWARD_CARD_DETAILS_TUTORIAL01	О да!	
GLOBAL_REWARD_CARD_DETAILS_TUTORIAL02	Это впечатляет.	
GLOBAL_REWARD_CARD_DETAILS_TUTORIAL03	Вы сегодня в ударе!	
GLOBAL_REWARD_CARD_DETAILS_TUTORIAL04	Это было невероятно.	
GLOBAL_REWARD_CARD_DETAILS_TUTORIAL05	Восхитительно!	
GLOBAL_REWARD_CARD_DETAILS_TUTORIAL06	Отлично!	
GLOBAL_REWARD_CARD_HEADLINE	Награда!	
GLOBAL_REWARD_CARD_LEVEL_UP	Открыто в награду за достижение {0}-го уровня классом «{1}»	0=# level, 1=class
GLOBAL_REWARD_CHEST_HEADER	Вы получили рейтинговые награды!	
GLOBAL_REWARD_CHEST_INSTRUCTIONS	Вы сможете открыть сундук в конце сезона.\nПовышайте ранг, чтобы получить больше сокровищ!	
GLOBAL_REWARD_CHEST_TIER1	Сокровище морского великана	
GLOBAL_REWARD_CHEST_TIER1_EARNED	Вы получили сокровище морского великана!	
GLOBAL_REWARD_CHEST_TIER2	Заначка огра-мага	
GLOBAL_REWARD_CHEST_TIER2_EARNED	Вы получили заначку огра-мага!	
GLOBAL_REWARD_CHEST_TIER3	Сундук стража	
GLOBAL_REWARD_CHEST_TIER3_EARNED	Вы получили сундук стража!	
GLOBAL_REWARD_CHEST_TIER4	Сундучок щитоносца	
GLOBAL_REWARD_CHEST_TIER4_EARNED	Вы получили сундучок щитоносца!	
GLOBAL_REWARD_CHEST_TIER5	Ящик злой курицы	
GLOBAL_REWARD_CHEST_TIER5_EARNED	Вы получили ящик злой курицы!	
GLOBAL_REWARD_CHEST_TIER6	Посылка завсегдатая	
GLOBAL_REWARD_CHEST_TIER6_EARNED	Вы получили посылку завсегдатая!	
GLOBAL_REWARD_CLASS_CHALLENGE_DETAIL	{0}	0=first class
GLOBAL_REWARD_CLASS_CHALLENGE_DETAIL_DOUBLE	{0} и {1}	0=first class, 1=second class
GLOBAL_REWARD_CLASS_CHALLENGE_HEADLINE	Доступно: |4(новое классовоe испытание,новые классовые испытания,новые классовые испытания)	
GLOBAL_REWARD_CORE_CARD_DETAILS	Открыто карт класса «{2}»: {0}/{1}	0=# cards unlocked, 1=# cards possible to unlock, 2=class
GLOBAL_REWARD_FORGE_DETAILS_OUT_OF_BAND	Добавлено доступов на арену из-за пределов игры: {0}	0=count
GLOBAL_REWARD_FORGE_HEADLINE	Получен доступ к арене	
GLOBAL_REWARD_FORGE_UNLOCKED_HEADLINE	Вам стала доступна Арена!	
GLOBAL_REWARD_FORGE_UNLOCKED_SOURCE	Награда за вход на Арену.	
GLOBAL_REWARD_GOLD_HEADLINE	Вы получили золото!	
GLOBAL_REWARD_GOLD_SOURCE_IGR	Награда за подключение к игре из интернет-кафе (IGR).	
GLOBAL_REWARD_GOLD_SOURCE_IGR_DATED	Награда за подключение к игре из интернет-кафе (IGR) {0}.	0=GLOBAL_CURRENT_DATE
GLOBAL_REWARD_GOLD_SOURCE_TOURNEY	Награда за {0} |4(выигранный матч,выигранных матча,выигранных матчей) в «Потасовке», на полях сражений или в режиме игры.	
GLOBAL_REWARD_GOLDEN_HERO_HEADLINE	Открыт золотой герой	
GLOBAL_REWARD_HEARTHSTEED_HEADLINE	Скакун Азарт	
GLOBAL_REWARD_HERO_DETAILS	Открыто героев: {0}/{1}	
GLOBAL_REWARD_HERO_HEADLINE	Открыто: {0}	
GLOBAL_REWARD_HEROES_CARD_MOUNT_HEADLINE	Транспорт: карта Hearthstone	
GLOBAL_REWARD_PROGRESS	Побед: {0}/{1}	0=current wins,1=required wins
GLOBAL_REWARD_SARGE_TALE_HEADLINE	Болтливый Серж	
GLOBAL_ROLE_CASTER	Заклинатель	
GLOBAL_ROLE_FIGHTER	Боец	
GLOBAL_ROLE_TANK	Защитник	
GLOBAL_SCAN	Поиск	
GLOBAL_SCREENSHOT_COMPLETE	Снимок экрана сохранен на рабочий стол.	
GLOBAL_SCREENSHOT_COMPLETE_SPECIFIC_DIRECTORY	Скриншот сохранен в {0}.	0=The directory that the file was saved to
GLOBAL_SEASON_CHEST_BANNER	Сезонный сундук	Default label for the banner in the end game screen that is placed above the in progress chest
GLOBAL_SEASON_END_BEST_EVER_ABOVE_MAX	В зависимости от прошлых достижений вы стартуете на {0}-м или более высоком ранге.	0=rank
GLOBAL_SEASON_END_BONUS_STAR_BOOST	Бонус к звездам увеличивает ваш ранг до:	
GLOBAL_SEASON_END_BONUS_STAR_TITLE	Награда за ранг предыдущего сезона:	
GLOBAL_SEASON_END_BONUS_STARS_LABEL	|4(дополнительная звезда,дополнительные звезды,дополнительных звезд)	
GLOBAL_SEASON_END_CHEST_INSTRUCTIONS	Щелкните, чтобы открыть.	
GLOBAL_SEASON_END_CHEST_INSTRUCTIONS_TOUCH	Нажмите, чтобы открыть.	
GLOBAL_SEASON_END_NEW_CARD_BACK	Вы получили новую рубашку.	
GLOBAL_SEASON_END_NEW_CARDBACK_TITLE	Новая сезонная рубашка!	
GLOBAL_SEASON_END_NEW_CARDBACK_TITLE_PHONE	Новая сезонная\nрубашка!	
GLOBAL_SEASON_END_NEW_SEASON	{0} начался!	0=season name
GLOBAL_SEASON_END_PERCENTILE_LABEL	Вы попали в {0}% лучших рейтинговых игроков!	0=rank percentile
GLOBAL_SEASON_END_RANK_LABEL	Достигнутый вами ранг:	
GLOBAL_SEASON_END_STAR_MULTIPLIER_LABEL	Бонус к звездам	
GLOBAL_SEASON_END_STAR_MULTIPLIER_TITLE	Награда за рейтинговые матчи прошлого сезона:	
GLOBAL_SEASON_END_WELCOME	Добро пожаловать!	
GLOBAL_SET_BASIC	Базовый набор	
GLOBAL_SET_EXPERT1	Классический набор	
GLOBAL_SET_ROTATION_ROLLOVER_BODY_DESKTOP	В Hearthstone наступил новый год!\nПерезапустите игру, чтобы присоединиться к празднику!	
GLOBAL_SET_ROTATION_ROLLOVER_BODY_MOBILE	В Hearthstone наступил новый год!\nПерезапускаем игру, чтобы вы могли присоединиться к празднику.	
GLOBAL_SET_ROTATION_ROLLOVER_HEADER	С Новым годом!	
GLOBAL_SHOW	Показать	
GLOBAL_SHUTDOWN_TOAST	<color=#{0}>Служба Blizzard будет отключена через {1} мин.</color>	0=color, 1=minutes
GLOBAL_SKIP	Пропустить	
GLOBAL_SKIP_TUTORIAL	Пропустить обучение	
GLOBAL_SOCIAL_TOAST_FRIEND_ACHIEVEMENT	<color=#{0}>{1}</color> получает <color=#FFD451>{2}</color>	0=name color,1=player name,2=achievement name
GLOBAL_SOCIAL_TOAST_FRIEND_ACHIEVEMENT_TIER	<color=#{0}>{1}</color> получает <color=#FFD451>{2} (уровень {3})</color>	0=name color,1=player name,2=achievement name,3=tier
GLOBAL_SOCIAL_TOAST_FRIEND_ARENA_COMPLETE	<color=#{0}>{1}</color> заканчивает выступление на Арене со счетом ({2}-{3}).	0=name color,1=player name,2=Arena Wins,3=Arena Losses
GLOBAL_SOCIAL_TOAST_FRIEND_ARENA_START	<color=#{0}>{1}</color> начинает выступление на Арене.	0=name color,1=player name
GLOBAL_SOCIAL_TOAST_FRIEND_ARENA_START_WITH_MANY_WINS	<color=#{0}>{1}</color> начинает сражение на арене, имея за плечами уже {2} |4(победу,победы,побед)!	0=name color,1=player name,2=Arena Wins
GLOBAL_SOCIAL_TOAST_FRIEND_BRAWLISEUM_COMPLETE	<color=#{0}>{1}</color> заканчивает «Потасовочный цех» со счетом {2}-{3}.	0=name color,1=player name,2=Brawl Wins,3=Brawl Losses
GLOBAL_SOCIAL_TOAST_FRIEND_BRAWLISEUM_START	<color=#{0}>{1}</color> заходит в «Потасовочный цех».	0=name color,1=player name
GLOBAL_SOCIAL_TOAST_FRIEND_BRAWLISEUM_START_WITH_MANY_WINS	<color=#{0}>{1}</color> заходит в «Потасовочный цех», имея за плечами {2} |4(победу,победы,побед)!	0=name color,1=player name,2=Brawl Wins
GLOBAL_SOCIAL_TOAST_FRIEND_DRUID_LEVEL	<color=#{0}>{1}</color> получает {2} уровень друидом.	0=name color,1=player name,2=level
GLOBAL_SOCIAL_TOAST_FRIEND_DUEL_START	<color=#{0}>{1}</color> начинает серию дуэлей.	0=name color,1=player name
GLOBAL_SOCIAL_TOAST_FRIEND_GOLDEN_LEGENDARY	<color=#{0}>{1}</color> получает <color=#{3}>золотую карту «{2}»</color>!	0=name color,1=player name,2=card name,3=Golden Color
GLOBAL_SOCIAL_TOAST_FRIEND_HEROIC_BRAWL_COMPLETE	<color=#{0}>{1}</color> завершает героическую потасовку. (В: {2}; П: {3})	0=name color,1=player name,2=Heroic brawl Wins,3=Heroic brawl Losses
GLOBAL_SOCIAL_TOAST_FRIEND_HEROIC_BRAWL_START	<color=#{0}>{1}</color> начинает новую героическую потасовку.	0=name color,1=player name
GLOBAL_SOCIAL_TOAST_FRIEND_HEROIC_BRAWL_START_WITH_MANY_WINS	<color=#{0}>{1}</color> начинает сражение в героической потасовке, имея за плечами уже {2} |4(победу,победы,побед)!	0=name color,1=player name,2=Heroic brawl Wins
GLOBAL_SOCIAL_TOAST_FRIEND_HUNTER_LEVEL	<color=#{0}>{1}</color> получает {2} уровень охотником.	0=name color,1=player name,2=level
GLOBAL_SOCIAL_TOAST_FRIEND_ILLIDAN_COMPLETE	<color=#{0}>{1}</color> одерживает победу над Иллиданом!	0=name color,1=player name
GLOBAL_SOCIAL_TOAST_FRIEND_LEGENDARY	<color=#{0}>{1}</color> получает <color=#{3}> карту «{2}»</color>!	0=name color,1=player name,2=card name
GLOBAL_SOCIAL_TOAST_FRIEND_MAGE_LEVEL	<color=#{0}>{1}</color> получает {2} уровень магом.	0=name color,1=player name,2=level
GLOBAL_SOCIAL_TOAST_FRIEND_OFFLINE	<color=#{0}>{1}</color> выходит из сети.	0=name color,1=player name
GLOBAL_SOCIAL_TOAST_FRIEND_ONLINE	<color=#{0}>{1}</color> входит в сеть.	0=name color,1=player name
GLOBAL_SOCIAL_TOAST_FRIEND_PALADIN_LEVEL	<color=#{0}>{1}</color> получает {2} уровень паладином.	0=name color,1=player name,2=level
GLOBAL_SOCIAL_TOAST_FRIEND_PRIEST_LEVEL	<color=#{0}>{1}</color> получает {2} уровень жрецом.	0=name color,1=player name,2=level
GLOBAL_SOCIAL_TOAST_FRIEND_RANK_EARNED	Игрок <color=#{0}>{1}</color> достиг ранга «{2}»!	0=name color,1=player name,2=medal name
GLOBAL_SOCIAL_TOAST_FRIEND_RANK_EARNED_CLASSIC	<color=#{0}>{1}</color> получает {2}-й ранг в классическом формате!	0=name color,1=player name,2=medal name
GLOBAL_SOCIAL_TOAST_FRIEND_RANK_EARNED_WILD	Игрок <color=#{0}>{1}</color> достиг ранга {2} в вольном формате!	0=name color,1=player name,2=medal name
GLOBAL_SOCIAL_TOAST_FRIEND_RANK_LEGEND	<color=#{0}>{1}</color> становится ЛЕГЕНДОЙ!	0=name color,1=player name
GLOBAL_SOCIAL_TOAST_FRIEND_RANK_LEGEND_CLASSIC	<color=#{0}>{1}</color> становится ЛЕГЕНДОЙ в классическом формате!	0=name color,1=player name
GLOBAL_SOCIAL_TOAST_FRIEND_RANK_LEGEND_WILD	<color=#{0}>{1}</color> становится ЛЕГЕНДОЙ в вольном формате!	0=name color,1=player name
GLOBAL_SOCIAL_TOAST_FRIEND_REQUEST	Игрок <color=#{0}>{1}</color> приглашает вас добавить его в список друзей.	0=name color,1=player name
GLOBAL_SOCIAL_TOAST_FRIEND_ROGUE_LEVEL	<color=#{0}>{1}</color> получает {2} уровень разбойником.	0=name color,1=player name,2=level
GLOBAL_SOCIAL_TOAST_FRIEND_SHAMAN_LEVEL	<color=#{0}>{1}</color> получает {2} уровень шаманом.	0=name color,1=player name,2=level
GLOBAL_SOCIAL_TOAST_FRIEND_WARLOCK_LEVEL	<color=#{0}>{1}</color> получает {2} уровень чернокнижником.	0=name color,1=player name,2=level
GLOBAL_SOCIAL_TOAST_FRIEND_WARRIOR_LEVEL	<color=#{0}>{1}</color> получает {2} уровень воином.	0=name color,1=player name,2=level
GLOBAL_SOCIAL_TOAST_RECENT_OPPONENT_FRIEND_REQUEST	Ваш недавний противник хочет стать вашим другом!	
GLOBAL_SOCIAL_TOAST_SPECTATOR_ADDED	<color=#{0}>{1}</color> смотрит, как вы играете.	0=name color,1=player name
GLOBAL_SOCIAL_TOAST_SPECTATOR_INVITE_RECEIVED	<color=#{0}>{1}</color> приглашает вас посмотреть его матч!	0=name color,1=player name
GLOBAL_SOCIAL_TOAST_SPECTATOR_INVITE_SENT	Игрок <color=#{0}>{1}</color> приглашен посмотреть матч в качестве зрителя.	0=name color,1=player name
GLOBAL_SOCIAL_TOAST_SPECTATOR_REMOVED	<color=#{0}>{1}</color> больше не смотрит ваш матч.	0=name color,1=player name
GLOBAL_SPECTATE	Наблюдать	
GLOBAL_SPECTATOR_COUNT_PANEL_HEADER	Зрители	
GLOBAL_SPECTATOR_COUNT_PANEL_TEXT_ONE	{0} наблюдает за вашим матчем.	0=player name, this is shown when there's only 1 person spectating you.
GLOBAL_SPECTATOR_ERROR_CANNOT_SPECTATE_2_GAMES	Вы не можете наблюдать за двумя матчами одновременно.	
GLOBAL_SPECTATOR_ERROR_CREATE_PARTY_TEXT	Произошла ошибка при попытке создать группу зрителей.	
GLOBAL_SPECTATOR_ERROR_LEAVE_FOR_SPECTATE_PLAYER_TEXT	Произошла ошибка при попытке выйти из группы зрителей, чтобы посмотреть матч игрока {0}.	0=player name
GLOBAL_SPECTATOR_KICK_PROMPT_HEADER	Удалить зрителя	
GLOBAL_SPECTATOR_KICK_PROMPT_TEXT	Вы уверены, что хотите удалить игрока {0} из числа зрителей? Если вы отключите возможность «Друзья могут наблюдать за моими матчами» в меню «Настройки», у ваших матчей не будет зрителей.	0=player name
GLOBAL_SPECTATOR_LEAVE_PROMPT_HEADER	Выход из режима зрителя	
GLOBAL_SPECTATOR_LEAVE_PROMPT_TEXT	Вы уверены, что хотите прервать просмотр матча?	
GLOBAL_SPECTATOR_MODE_INDICATOR_TEXT	Режим зрителя	text that shows up on the bottom left of screen showing that you're currently in Spectator Mode.
GLOBAL_SPECTATOR_REMOVED_PROMPT_APPEAR_OFFLINE_TEXT	Выйдя из сети, вы покинете режим зрителя.	
GLOBAL_SPECTATOR_REMOVED_PROMPT_HEADER	Зритель удален	
GLOBAL_SPECTATOR_REMOVED_PROMPT_TEXT	Вы были исключены из числа зрителей.	
GLOBAL_SPECTATOR_SERVER_REJECTED_HEADER	Зритель вышел	
GLOBAL_SPECTATOR_SERVER_REJECTED_TEXT	В игре, к которой вы попытались подключиться, больше нет мест для зрителей, она завершена либо закрыта для зрителей.	
GLOBAL_SPECTATOR_WAITING_FOR_NEXT_GAME_HEADER	Режим зрителя	
GLOBAL_SPECTATOR_WAITING_FOR_NEXT_GAME_TEXT	Вы ждете начала следующего матча игрока {0} ({1}).	0=player name, 1=player's current activity -- will be filled in with values PRESENCE_STATUS_* and PRESENCE_SCENARIO_*_NORMAL_SCENARIO_* from PRESENCE.txt (e.g. "Jane Doe is Heading into Traditional Hearthstone")
GLOBAL_SPECTATOR_WAITING_FOR_NEXT_GAME_TEXT_BATTLING	Вы ждете начала следующего матча.\n\n{0} сражается с боссом: {1}.	0=player name, 1=player's current activity -- will be filled in with values PRESENCE_SCENARIO_*_HEROIC_* from PRESENCE.txt (e.g. "Jane Doe is Battling Heroic Gothik the Harvester")
GLOBAL_SPECTATOR_WAITING_FOR_NEXT_GAME_TEXT_ENTERING	Вы ждете начала следующего матча.\n\n{0} начинает приключение: {1}.	0=player name, 1=player's current activity -- will be filled in with values PRESENCE_ADVENTURE_MODE_* from PRESENCE.txt (e.g. "Jane Doe is entering Naxxramas")
GLOBAL_SPECTATOR_WAITING_FOR_NEXT_GAME_TEXT_OFFLINE	Вы ждете начала следующего матча.\n\n{0} не в сети.	0=player name; shown when player is offline.
GLOBAL_SPECTATOR_WAITING_FOR_NEXT_GAME_TEXT_ONLINE	В ожидании следующего матча.\n\n{0} в сети.	0=player name; shown when there is no current activity string available.
GLOBAL_SPECTATOR_WAITING_FOR_NEXT_GAME_TEXT_PLAYING	Вы ждете начала следующего матча.\n\n{0} проходит {1}.	0=player name, 1=player's current activity -- will be filled in with values PRESENCE_SCENARIO_*_CLASS_CHALLENGE_* from PRESENCE.txt (e.g. "Jane Doe is playing Naxxramas Paladin Challenge")
GLOBAL_SPECTATOR_WAITING_FOR_NEXT_GAME_TIMEOUT	Игрок, за которым вы наблюдаете в качестве зрителя, слишком долго не начинает следующий матч. Режим зрителя отменен.	
GLOBAL_SPELL_SCHOOL_ARCANE	Тайная магия	
GLOBAL_SPELL_SCHOOL_FEL	Скверна	
GLOBAL_SPELL_SCHOOL_FIRE	Огонь	
GLOBAL_SPELL_SCHOOL_FROST	Лед	
GLOBAL_SPELL_SCHOOL_HOLY	Свет	
GLOBAL_SPELL_SCHOOL_NATURE	Природа	
GLOBAL_SPELL_SCHOOL_PHYSICAL_COMBAT	Атака	
GLOBAL_SPELL_SCHOOL_SHADOW	Тьма	
GLOBAL_SPLASH_CLOSED_RECONNECTING	Подключение...	
GLOBAL_SPLASH_CLOSED_SIGN_TITLE	Закрыто	
GLOBAL_STANDARD	Стандартный	
GLOBAL_STORE_MOBILE_NAME_AMAZON	магазине Amazon Appstore	
GLOBAL_STORE_MOBILE_NAME_APPLE	магазине Apple App Store	
GLOBAL_STORE_MOBILE_NAME_DEFAULT	магазине Blizzard	
GLOBAL_STORE_MOBILE_NAME_GOOGLE	магазине Google Play	
GLOBAL_SUPPORT	Поддержка	
GLOBAL_SWITCH_ACCOUNT	Переключить	
GLOBAL_TAVERN_BRAWL	Потасовка	
GLOBAL_TAVERN_BRAWL_ERROR_NOT_ACTIVE	Простите, но эта потасовка пока недоступна. Пожалуйста, повторите попытку через несколько минут.	
GLOBAL_TAVERN_BRAWL_ERROR_SEASON_INCREMENTED	Извините! Текущая потасовка закончилась, но скоро начнется новая!	
GLOBAL_TOOLTIP_FRIEND_BUTTON_DESC	Общайтесь с друзьями и устраивайте с ними поединки.	
GLOBAL_TOOLTIP_FRIEND_BUTTON_HEADER	Друзья	
GLOBAL_TOOLTIP_MENU_DESC	Здесь вы можете найти настройки, выход из игры и многое другое.	
GLOBAL_TOOLTIP_MENU_HEADER	Меню	
GLOBAL_TOOLTIP_MENU_OFFLINE_DESC	Вы не в сети. Щелкните, чтобы подключиться.	
GLOBAL_TOOLTIP_MENU_OFFLINE_HEADER	Не в сети	
GLOBAL_TUTORIAL_ATTACK	Атака	
GLOBAL_TUTORIAL_ATTACKER	Атакующий	
GLOBAL_TUTORIAL_COST	Стоимость	
GLOBAL_TUTORIAL_DEFENDER	Защитник	
GLOBAL_TUTORIAL_HEALTH	Здоровье	
GLOBAL_TUTORIAL_HERO_POWER	Сила героя	
GLOBAL_TUTORIAL_MINION	Существо	
GLOBAL_TUTORIAL_TAUNT	Провокация	
GLOBAL_TUTORIAL_TAUNT_DESCRIPTION	Противники вынуждены атаковать это существо.	
GLOBAL_TUTORIAL_USED	Использована	
GLOBAL_TUTORIAL_YOUR_MANA	Ваша мана	
GLOBAL_TUTORIAL_YOUR_TURN	Ваш ход	
GLOBAL_UPDATE	Обновить	
GLOBAL_VERSION	Версия	
GLOBAL_WAIT_FOR_OPPONENT_RECONNECT	Ожидание повторного подключения противника...({0} мин. {1} сек.)\nВы можете перейти в меню настроек, чтобы закончить игру.	
GLOBAL_WAIT_FOR_OPPONENT_RECONNECT_HEADER	Матч приостановлен	
GLOBAL_WAIT_FOR_OPPONENT_RECONNECT_SPECTATOR	Ожидание повторного подключения игрока...({0} мин.{1} сек.)	
GLOBAL_WILD	Вольный	
GLOBAL_WINS	Победы	
