TAG	TEXT	COMMENT
ChromaggusBoss_Death_1	Р-р-р-р!	
ChromaggusBoss_EmoteResponse_1	*Рычит*	
ChromaggusBoss_Start_1	Р-р-р!	
GiantRat_LOOTA_BOSS_18h_DefeatPlayer	<Писк>	
GiantRat_LOOTA_BOSS_18h_EmoteResponse	<Писк>	
LOE_07_MINE_CART_EMOTES	ДЗЫНЬ	
LOOTA_BOSS_21h_GnoshTheGreatWorm_EmoteResponse	<Рык>	
LOOTA_BOSS_47h_Lava_FilledRoom_Emote	<Ярость>	
LOOTA_BOSS_52h_TreasureVault_Emote	<Дзынь>	
OnyxiaBoss_Death_1	Р-р-р-р-р!	
OnyxiaBoss_EmoteResponse_1	*Рычит*	
OnyxiaBoss_Start_1	Р-р-р!	
POPUP_FROST_BRAWL	Усталость! Побеждает тот, у кого к концу следующего хода будет больше здоровья. 	
POPUP_FROST_BRAWL_ARMOR	Никакой брони в этой потасовке!	
TheMothergloop_LOOTA_BOSS_24h_EmoteResponse	<Бульк>	
TrappedRoom_LOOTA_BOSS_48h_EmoteResponse	<Щелк>	
VO_Ahune_Male_Elemental_Brawl_01	ДА! СОКРУШИ РАГНАРОСА!	
VO_Ahune_Male_Elemental_Brawl_02	КТО ТЕПЕРЬ СИЛЬНЕЕ, ПЫЛАЮЩИЙ ГЛУПЕЦ?!	
VO_Ahune_Male_Elemental_Brawl_03	ВОТ МОЕ ВОЗМЕЗДИЕ!	
VO_Ahune_Male_Elemental_Brawl_04	И КТО ТЕПЕРЬ «САМЫЙ ЧАСТО УБИВАЕМЫЙ БОСС АЗЕРОТА»?!	
VO_Ahune_Male_Elemental_Brawl_05	КТО ТЕПЕРЬ «НАСЕКОМОЕ»?!	
VO_Ahune_Male_Elemental_Brawl_07	КАМЕНЬ ЛЬДА РАСТАЯЛ!	
VO_Ahune_Male_Elemental_Brawl_08	КТО СОКРУШИТ БОЛЬШЕ ГЛУПЦОВ?!	
VO_Ahune_Male_Elemental_Brawl_11	ОТЛИЧНЫЙ РЕЗУЛЬТАТ!	
VO_Ahune_Male_Elemental_Brawl_15	УБИВАЙ РАГНАРОСА! УБИВАЙ ЕГО ПОЛНОСТЬЮ!	
VO_Ahune_Male_Elemental_Brawl_16	ОГО! ТЫ И ПРАВДА НЕНАВИДИШЬ РАГНАРОСА!	
VO_Aran_Male_Shade_AranCrackle_01	Хм... В былые времена «Разряд» всегда наносил шесть единиц урона.	
VO_Aran_Male_Shade_AranDeath_02	Что, опять?..	
VO_Aran_Male_Shade_AranEmoteResponse_01	Прочь! Прочь!	
VO_Aran_Male_Shade_AranHeroPower_01	Горите синим пламенем!	
VO_Aran_Male_Shade_AranMedivhSkin_01	Медив? Нет, нет, я гостей не обижал...	
VO_Aran_Male_Shade_AranOpen_01	Сейчас я вас проучу!	
VO_Aran_Male_Shade_AranSpell_03	Убирайтесь в холодный мрак!	
VO_Aran_Male_Shade_AranSpell_04	Хозяин могуч, но и я кое-что умею!	
VO_Aran_Male_Shade_AranTrons_02	Нет! Нет! Что за ужасный шум? Что за "Привет"?!	
VO_Aran_Male_Shade_AranTurn1_01	Никаких вечеринок в башне!	
VO_Aran_Male_Shade_AranTurn5_01	Я не какой-то жалкий фокусник! Я Ниелас Аран!	
VO_Barnes_Male_Human_FinalNazraTurn5_02	О ужас! У нас кончились бананы! Мукла громит кладовую!	
VO_Barnes_Male_Human_JulianneTurn5_01	Что за вечеринка без спектакля? И что за спектакль без зрителей?	
VO_Barnes_Male_Human_JulianneWin_01	Первый акт закончен, но впереди еще два!	
VO_Barnes_Male_Human_Wing2Intro_02	Добро пожаловать в театр! Меня зовут Барнс, я конферансье. Порталы наверху, но сначала придется посмотреть представление!	
VO_Barnes_Male_Human_WolfBigMinion_01	Какие у тебя большие друзья!	
VO_Barnes_Male_Human_WolfClaws_01	Не бойтесь! Эти огромные когти – для красоты!	
VO_Barnes_Male_Human_WolfTurn5_01	Обожаю, когда зрители участвуют в спектакле! Беги, милый гость, беги!	
VO_Barnes_Male_Human_WolfTurn9_01	Ха-ха! Отличный спектакль! Куда лучше, чем с огром на прошлой неделе!	
VO_Barnes_Male_Human_WolfWin_01	Ага! Грядет заключительный акт!	
VO_BigBadWolf_Male_Worgen_WolfBigMinion_01	Это чтоб быстрее тебя сокрушить!	
VO_BigBadWolf_Male_Worgen_WolfDeath_01	Меня подстрелили? Нет...	
VO_BigBadWolf_Male_Worgen_WolfDireWolfAlpha_01	*рычит*	
VO_BigBadWolf_Male_Worgen_WolfDireWolfAlpha_02	*воет*	
VO_BigBadWolf_Male_Worgen_WolfEmoteResponse_01	Мммм...\nВкусно.	
VO_BigBadWolf_Male_Worgen_WolfOpen_01	Беги, малышка, беги!	
VO_BigBadWolf_Male_Worgen_WolfScarletCrusader_01	О, красный плащик, куда ты идешь?	
VO_BigBadWolf_Male_Worgen_WolfTurn1_01	Только посмотри на своих существ. Они съежились от ужаса!	
VO_BlackKing_Male_ChessPiece_ChessEmoteGreetings_01	Конечно.	
VO_BlackKing_Male_ChessPiece_ChessEmoteOops_01	Или ловушка?	
VO_BlackKing_Male_ChessPiece_ChessEmoteSorry_01	Необходимая жертва.	
VO_BlackKing_Male_ChessPiece_ChessEmoteThanks	Пустяки.	
VO_BlackKing_Male_ChessPiece_ChessEmoteThanks_01	Пустяки.	
VO_BlackKing_Male_ChessPiece_ChessEmoteThreaten_01	А я – в три.	
VO_BlackKing_Male_ChessPiece_ChessEmoteWellPlayed_01	Еще нет.	
VO_BlackKing_Male_ChessPiece_ChessEmoteWow_01	Естественно.	
VO_BlackKing_Male_ChessPiece_ChessOpen_01	Никто не пройдет!	
VO_BOSS_AYA_Female_Pandaren_BC_0_Jade_Golem_02	Еще големы? Круто!	
VO_BOSS_AYA_Female_Pandaren_BC_0_Jade_Golem_03	Хи-хи-хи! Вперед, моя армия!	
VO_BOSS_AYA_Female_Pandaren_BC_0_Jade_Golem_04	Еще! Еще!	
VO_BOSS_AYA_Female_Pandaren_BC_2_1st_Turn_Start_01	Размечтались... Этот город будет моим!	
VO_BOSS_AYA_Female_Pandaren_BC_2_2nd_Turn_Start_01	Прибамбасск принадлежит «Нефритовому лотосу», а «лотос» – мне!	
VO_BOSS_AYA_Female_Pandaren_BC_2_Arms_Dealing1_01	Оружие! Очень оригинально!	
VO_BOSS_AYA_Female_Pandaren_BC_2_Fill1_01	О-о-о, это будет весело...	
VO_BOSS_AYA_Female_Pandaren_BC_2_Fill2_01	Ну уж нет! Им здесь нравится!	
VO_BOSS_AYA_Female_Pandaren_BC_2_Goons_Win_01	Как же так? Это неправильно!	
VO_BOSS_AYA_Female_Pandaren_BC_2_Goons_Winning_02	Теперь я понимаю, что тебе НАДО ЗАТКНУТЬСЯ!	
VO_BOSS_AYA_Female_Pandaren_BC_2_Jade_Win_01	«Нефритовый лотос» снова побеждает! Я – лучшая!	
VO_BOSS_AYA_Female_Pandaren_BC_2_Lotus_Winning_01	Ха-ха, давай, мы еще не закончили!	
VO_BOSS_AYA_Female_Pandaren_BC_3_1st_Turn_Start_01	Прибамбасск такой классный! Все, беру!	
VO_BOSS_AYA_Female_Pandaren_BC_3_1st_Turn_Start_02	Ха-ха, договорились...	
VO_BOSS_AYA_Female_Pandaren_BC_3_2nd_Turn_Start_01	Вы там все такие скучные?	
VO_BOSS_AYA_Female_Pandaren_BC_3_Fill1_01	Прекрасный денек – правда, Каззик?	
VO_BOSS_AYA_Female_Pandaren_BC_3_Fill2_01	Расслабься, Каззик! Повеселись! Тебе не помешает.	
VO_BOSS_AYA_Female_Pandaren_BC_3_Jade_Golem3_01	Ха-ха-ха!	
VO_BOSS_AYA_Female_Pandaren_BC_3_Kabal_Winning_01	Это потому что ты нудный.	
VO_BOSS_AYA_Female_Pandaren_BC_3_Kabal_Wins_01	Нет! Это невозможно! Не-е-ет!	
VO_BOSS_AYA_Female_Pandaren_BC_3_Lotus_Winning_01	Что-то пошло не так? Каззик, не вешай нос!	
VO_BOSS_AYA_Female_Pandaren_BC_3_Lotus_Wins_01	Мне понравилось. Спасибо за игру, Каззик!	
VO_BOSS_AYA_Female_Pandaren_BC_3_Potion1_02	Зелья, зелья... Заткнись уже и давай ДРАТЬСЯ!	
VO_BOSS_AYA_Female_Pandaren_BC_3_Potion3_01	Фу! Ну и мерзость!	
VO_BOSS_AYA_Female_Pandaren_Concede_01	Хм, скукотища...	
VO_BOSS_AYA_Female_Pandaren_Greetings_01	Приветик!	
VO_BOSS_AYA_Female_Pandaren_Oops_01	Опачки!	
VO_BOSS_AYA_Female_Pandaren_START_01	Големы, к бою!	
VO_BOSS_AYA_Female_Pandaren_Thanks_02	Спасибки!	
VO_BOSS_AYA_Female_Pandaren_Threaten_02	Пожалуй, придется тебя убить.	
VO_BOSS_AYA_Female_Pandaren_Well_Played_01	Вот это было здорово!	
VO_BOSS_AYA_Female_Pandaren_Wow_02	Ух ты!	
VO_BOSS_CHO_Male_Ogre_BC_1_1st_Turn_Start_01	ЗДЕСЬ ТАКИМ КАК ТЫ НЕ РАДЫ!	
VO_BOSS_CHO_Male_Ogre_BC_1_Fill2_01	ЗА ДЕЛО, ПАРНИ!	
VO_BOSS_CHO_Male_Ogre_BC_2_Fill1_01	ДА ОНА ЧОКНУТАЯ!	
VO_BOSS_CHO_Male_Ogre_Concede_01	ДА! НЕТ, ТЫ!	
VO_BOSS_CHO_Male_Ogre_Oops_02	ОШИБОЧКА ВЫШЛА!	
VO_BOSS_CHO_Male_Ogre_Thanks_01	СПАСИБО.	
VO_BOSS_HAN_Male_Ogre_BC_0_Arms_Dealing_01	Тут что-то выпало из кузова... Хе-хе...	
VO_BOSS_HAN_Male_Ogre_BC_0_Arms_Dealing_02	Бугаи, ко мне!	
VO_BOSS_HAN_Male_Ogre_BC_0_Arms_Dealing_03	Снарядите этого Бугая и тащите его сюда!	
VO_BOSS_HAN_Male_Ogre_BC_0_Arms_Dealing_04	«Ржавые Бугаи», всем собраться!	
VO_BOSS_HAN_Male_Ogre_BC_1_1st_Turn_Start_01	А туда ли ты зашел, Казакус?	
VO_BOSS_HAN_Male_Ogre_BC_1_2nd_Turn_Start_01	В этом городе заправляют Бугаи.	
VO_BOSS_HAN_Male_Ogre_BC_1_2nd_Turn_Start_02	Это, конечно, здорово, но здесь все принадлежит Бугаям.	
VO_BOSS_HAN_Male_Ogre_BC_1_Fill1_01	Побереги свои склянки, тролль.	
VO_BOSS_HAN_Male_Ogre_BC_1_Fill2_01	Эй, Чо, зови Бугаев. Покажем троллю, кто тут хозяин.	test
VO_BOSS_HAN_Male_Ogre_BC_1_Goons_Win_01	Ничего личного, Казакус. Только бизнес.	
VO_BOSS_HAN_Male_Ogre_BC_1_Goons_Winning_01	Похоже, твой план не сработал, Казакус?..	
VO_BOSS_HAN_Male_Ogre_BC_1_Kabal_Win_02	Мы еще... встретимся... Казакус.	
VO_BOSS_HAN_Male_Ogre_BC_1_Kabal_Winning_02	Неплохо для старика.	
VO_BOSS_HAN_Male_Ogre_BC_1_Potion1_01	Никогда не любил зелья...	
VO_BOSS_HAN_Male_Ogre_BC_1_Potion2_01	Смотри, в кого склянки кидаешь!	
VO_BOSS_HAN_Male_Ogre_BC_2_1st_Turn_Start_01	Прибамбасск наш! Проваливай, козявка!	
VO_BOSS_HAN_Male_Ogre_BC_2_1st_Turn_Start_04	Минуточку, «Ржавым Бугаям» есть что возразить.	
VO_BOSS_HAN_Male_Ogre_BC_2_Fill1_01	Э-э... не нравится мне твой взгляд, Айя.	
VO_BOSS_HAN_Male_Ogre_BC_2_Goons_Win_01	Передохни, Айя. Тебе не повредит.	
VO_BOSS_HAN_Male_Ogre_BC_2_Goons_Winning_01	Теперь ты понимаешь, с кем связалась?	
VO_BOSS_HAN_Male_Ogre_BC_2_Jade_Golem2_01	Как меня достали эти нефритовые болваны.	
VO_BOSS_HAN_Male_Ogre_BC_2_Lotus_Win_01	Прибамбасск... будет... нашим...	
VO_BOSS_HAN_Male_Ogre_BC_2_Lotus_Winning_01	Кто-нибудь, уведите отсюда эту девчонку!	
VO_BOSS_HAN_Male_Ogre_Concede_01	Это все ты виноват!	
VO_BOSS_HAN_Male_Ogre_Greetings_01	Добро пожаловать в Прибамбасск!	
VO_BOSS_HAN_Male_Ogre_INTRO_PACK_OPEN_7	Хо-хо-хо! А это что у нас тут за красавчик?	
VO_BOSS_HAN_Male_Ogre_Oops_01	Нехорошо.	
VO_BOSS_HAN_Male_Ogre_START_01	Это наша территория!	
VO_BOSS_HAN_Male_Ogre_Thanks_01	Мы ценим твои усилия.	test
VO_BOSS_HAN_Male_Ogre_Threaten_01	От наших предложений никто не отказывается.	
VO_BOSS_HAN_Male_Ogre_Well_Played_02	Ну ты даешь! Я впечатлен!	
VO_BOSS_HAN_Male_Ogre_WOW_01	Неплохо!	
VO_BOSS_KAZAKUS_Male_Troll_BC_0_Potion_01	О! Освежает.	
VO_BOSS_KAZAKUS_Male_Troll_BC_0_Potion_02	Получи!	
VO_BOSS_KAZAKUS_Male_Troll_BC_0_Potion_04	Пей до дна... ха-ха-ха!	
VO_BOSS_KAZAKUS_Male_Troll_BC_0_Potion_05	Нравится?	
VO_BOSS_KAZAKUS_Male_Troll_BC_1_1st_Turn_Start_01	Прибамбасск будет моим, Хан'Чо!	
VO_BOSS_KAZAKUS_Male_Troll_BC_1_2nd_Turn_Start_01	«Кабал» повсюду! Нам служит весь Прибамбасск.	
VO_BOSS_KAZAKUS_Male_Troll_BC_1_Arms_Dealing1_01	А Бугаи, как обычно, трусят. Хватит прятаться в руке!	
VO_BOSS_KAZAKUS_Male_Troll_BC_1_Fill1_01	Мощь «Кабала» безгранична.	
VO_BOSS_KAZAKUS_Male_Troll_BC_1_Goons_Win_01	Я вернусь и буду еще сильнее, чем прежде!	
VO_BOSS_KAZAKUS_Male_Troll_BC_1_Goons_Winning_01	Тебя ждут страшные муки, Хан'Чо!	
VO_BOSS_KAZAKUS_Male_Troll_BC_1_Kabal_Win_01	Не думаю.	
VO_BOSS_KAZAKUS_Male_Troll_BC_1_Kabal_Winning_01	Твоя участь предрешена, Хан'Чо.	
VO_BOSS_KAZAKUS_Male_Troll_BC_3_1st_Turn_Start_01	Ха-ха-ха. Ты получишь этот город только через мой труп.	
VO_BOSS_KAZAKUS_Male_Troll_BC_3_Fill1_01	НЕ СМЕЙ МЕНЯ ТАК НАЗЫВАТЬ, НАГЛАЯ ДЕВЧОНКА!	
VO_BOSS_KAZAKUS_Male_Troll_BC_3_Fill2_01	На колени перед мощью «Кабала»!	
VO_BOSS_KAZAKUS_Male_Troll_BC_3_Jade_Golem2_01	Ты смеешь бросать вызов сильнейшему из владык Прибамбасска?!	
VO_BOSS_KAZAKUS_Male_Troll_BC_3_Jade_Golem3_01	Наглая девчонка! Мне надоели твои дурацкие големы.	
VO_BOSS_KAZAKUS_Male_Troll_BC_3_Kabal_Winning_01	У тебя утомленный вид, детка!	
VO_BOSS_KAZAKUS_Male_Troll_BC_3_Kabal_Winning_02	Что?! Я покончу с тобой, наглая девчонка!	test
VO_BOSS_KAZAKUS_Male_Troll_BC_3_Kabal_Wins_01	Ха-ха! Еще один враг повержен всесильным «Кабалом»!	
VO_BOSS_KAZAKUS_Male_Troll_BC_3_Lotus_Winning_01	Наглая букашка...	
VO_BOSS_KAZAKUS_Male_Troll_BC_3_Lotus_Wins_01	Мы с тобой еще встретимся...	
VO_BOSS_KAZAKUS_Male_Troll_BC_3_Potion1_01	Познай всю силу зелий «Кабала»!	
VO_BOSS_KAZAKUS_Male_Troll_Concede_01	Этот город... мой.	
VO_BOSS_KAZAKUS_Male_Troll_Greetings_02	Здравствуйте, тупицы.	test
VO_BOSS_KAZAKUS_Male_Troll_Mirror_Start_01	Вижу, ты кое-что умеешь.	
VO_BOSS_KAZAKUS_Male_Troll_Oops_01	Досадный просчет.	
VO_BOSS_KAZAKUS_Male_Troll_START_01	Я слышу зов маны.	
VO_BOSS_KAZAKUS_Male_Troll_Thanks_01	Благодарю тебя, слуга.	
VO_BOSS_KAZAKUS_Male_Troll_Threaten_01	Я ПРИБАМБАССКОМ КОМАНДУЮ!	
VO_BOSS_KAZAKUS_Male_Troll_Well_Played_02	Я чувствую в тебе силу.	
VO_BOSS_KAZAKUS_Male_Troll_Wow_01	Сколько силы!	
VO_BRANN_MITHRIL_ALT_02	Потрясающе! Эти мифриловые руны содержат охранный код. Должно быть, они созданы в эпоху титанов!	
VO_BRANN_WIN_07_ALT_07	Все, отстали! Навершие в следующей комнате!	
VO_BRM_027h_Death_63	Нет! НЕТ! НЕЕЕЕЕЕЕЕЕЕЕЕТ!!!	
VO_BRMA01_1_CARD_05	Ну-ка, устроим им теплый прием!	
VO_BRMA01_1_DEATH_09	Ой-ой-ой! Что? А? Мне это совсем не нравится, но ничего не поделаешь.	
VO_BRMA01_1_ETC_06	Пришла пора хорошенько зажечь! Встречайте вождя тауренов!	
VO_BRMA01_1_HERO_POWER_04	Ха-ха-ха! Куча мала!	
VO_BRMA01_1_RESPONSE_03	Ха-ха-ха! Ик!.. Ой, извиняюсь.	
VO_BRMA01_1_START_01	Приветствую в «Угрюмом обжоре»!	
VO_BRMA01_1_SUCCUBUS_08	Госпожа Нагмара! Нашего «друга» мучает жажда.	
VO_BRMA01_1_TURN1_02	Эй, народ! Смотрите-ка! У нас гость!	
VO_BRMA01_1_WARGOLEM_07	О-хо-хо! Сейчас Фаланг тебе покажет!	
VO_BRMA02_1_ALAKIR_34	Перед вами – не выносящий насекомых повелитель элементалей! Ал'акир!	
VO_BRMA02_1_ALEXSTRAZA_32	Королева драконов, Хранительница Жизни, боец арены Черного Железа! Это – Алекстраза!	
VO_BRMA02_1_BEAST_22	Гномы – его любимая пища, но он готов к экспериментам! Это – Чудовище!	
VO_BRMA02_1_BOOM_28	Надеюсь, никого не заденет осколками. Наш следующий гость – доктор Бум!	
VO_BRMA02_1_CAIRNE_20	Он воспитывает своего сына настоящим мууужчиной! Кэрн Кровавое Копыто!	
VO_BRMA02_1_CHO_07	Хотите послушать сказку? Встречайте – Хранитель истории Чо!	
VO_BRMA02_1_DEATH_38	Ый! А? Ой! *умирает*	
VO_BRMA02_1_DEATHWING_35	О-о-о! Дамы и джентльдворфы! Единственный и неповторимый – Смертокрыл!	
VO_BRMA02_1_ETC_18	А теперь – вождь, таурен, легенда! Встречайте – «Вождь тауренов»!	
VO_BRMA02_1_FEUGEN_15	Аплодисменты Фойгену!	
VO_BRMA02_1_FOEREAPER_29	Его настроили на максимальное разрушение. Аплодисменты Врагорезу 4000!	
VO_BRMA02_1_GEDDON_13	О-о-о! На арене становится жарко! Встречайте – Барон Геддон!	
VO_BRMA02_1_GELBIN_21	Прямиком из Нового Города Механиков к нам приехал предводитель гномов – Гелбин Меггакрут!	
VO_BRMA02_1_GRUUL_31	Титул драконобоя надо заслужить! Бурные аплодисменты Груулу!	
VO_BRMA02_1_HERO_POWER_05	Публика хочет зрелищ! Ха-ха!	
VO_BRMA02_1_HOGGER_27	Гнолл одиннадцатого уровня и живая легенда! Поприветствуйте Дробителя!	
VO_BRMA02_1_ILLIDAN_23	К чему глаза, если есть парные клинки? Иллидан тоже так считает!	
VO_BRMA02_1_LEVIATHAN_12	«Огненный Левиафан», отремонтирован и готов сокрушать!	
VO_BRMA02_1_LOATHEB_16	Задержите дыхание и поприветствуйте нашего вонючего друга Лотхиба!	
VO_BRMA02_1_MAEXXNA_24	Огромный голодный паук – скажите, как ее зовут? Мексна!	
VO_BRMA02_1_MILLHOUSE_09	Эй, это шутка?! Его-то кто пустил на арену?	
VO_BRMA02_1_MOGOR_25	Огр Могор не слишком разговорчив, зато черепа крушить он мастак!	
VO_BRMA02_1_MUKLA_10	Встречайте властелина бананов – короля Муклу!	
VO_BRMA02_1_NOZDORMU_36	Дамы и... ой! Время вышло!	
VO_BRMA02_1_ONYXIA_33	Прямиком из Пылевых топей и крепости Штормграда – сама Ониксия!	
VO_BRMA02_1_PAGLE_08	Прямо с рыбалки к нам завернул Нат Пэгл!	
VO_BRMA02_1_RESPONSE_04	Никто не выстоит против всех этих легендарных бойцов!	
VO_BRMA02_1_SNEED_30	Наш следующий гость скрывается за рычагами ржавого крошшера. Кто бы это мог быть?	
VO_BRMA02_1_STALAGG_14	Сможет ли Сталагг выжить на арене? Посмотрим!	
VO_BRMA02_1_START_01	Новый претендент!	
VO_BRMA02_1_SYLVANAS_19	Ее вечная ненависть горит ярким пламенем! Встречайте Сильвану Ветрокрылую!	
VO_BRMA02_1_THALNOS_06	Встречайте скелета в модном платье – нас посетил маг крови Талнос!	
VO_BRMA02_1_THAURISSAN_37	Прямиком из следующей битвы к нам спешит император Тауриссан!	
VO_BRMA02_1_TINKMASTER_11	Ваши аплодисменты великому мехмастеру Замыкальцу!	
VO_BRMA02_1_TOSHLEY_26	Поприветствуйте гнома вдалеке от дома! Тошли!	
VO_BRMA02_1_TURN1_02	Леди и джентльдворфы! Сегодня мы покажем вам отменное шоу!	
VO_BRMA02_1_TURN1_PT2_03	Легенды Азерота против одинокого искателя приключений!	
VO_BRMA02_1_VOLJIN_17	Минуточку внимания! К нам заглянул особый гость – Вол'джин!	
VO_BRMA03_1_CARD_04	Рагнарос наделил меня своей мощью!	
VO_BRMA03_1_DEATH_09	Ааааааааа!	
VO_BRMA03_1_HERO_POWER_06	Умри!	
VO_BRMA03_1_MOIRA_DEATH_05	Нет! Мойра!!! Ты за это заплатишь!!!	
VO_BRMA03_1_RESPONSE_03	Закрой рот, а не то я помогу!	
VO_BRMA03_1_START_01	Дворфы Черного Железа непобедимы!	
VO_BRMA03_1_TURN1_02	Эй! Оставь мою жену в покое!	
VO_BRMA03_1_VS_RAG_07	Рагнарос?! Нет! Хватит!!!	
VO_BRMA04_1_CARD_04	Слуги огня, вперед!	
VO_BRMA04_1_DEATH_06	Аррррррррр!	
VO_BRMA04_1_HERO_POWER_05	Магма!	
VO_BRMA04_1_RESPONSE_03	Против камня нет приема.	
VO_BRMA04_1_START_01	Я сотру тебя в порошок!	
VO_BRMA04_1_TURN1_02	Поехали.	
VO_BRMA05_1_CARD_05	Тик-так, смертный!	
VO_BRMA05_1_DEATH_04	Последняя услуга...	
VO_BRMA05_1_HERO_POWER_06	Сгори!	
VO_BRMA05_1_RESPONSE_03	Армагеддон!	
VO_BRMA05_1_START_01	Ты сгоришь!	
VO_BRMA05_1_TURN1_02	Рагнарос поглотит тебя!	
VO_BRMA06_1_DEATH_04	Я сдаюсь! Сдаюсь!	
VO_BRMA06_1_RESPONSE_03	Думаешь, победа за тобой? Похоже, придется преподать тебе еще один урок!	
VO_BRMA06_1_START_01	Никто не сможет устоять против Живого Пламени!	
VO_BRMA06_1_SUMMON_RAG_05	Узри Рагнароса! Того, кто видел зарю этого мира!	
VO_BRMA06_1_TURN1_02_ALT	Уничтожить их!	
VO_BRMA06_3_INTRO_01	Слишком... рано! Ты разбудил меня слишком рано, Экзекутус!	
VO_BRMA06_3_RESPONSE_03	Что это за незваные гости?!	
VO_BRMA06_3_TURN1_02	Презренные смертные! Вы осмелились вторгнуться в мои владения?	
VO_BRMA07_1_CARD_04	Круши-и-ить!!	
VO_BRMA07_1_DEATH_06	Арррргх!	
VO_BRMA07_1_HERO_POWER_05	Я крушить! Ты умирать!	
VO_BRMA07_1_RESPONSE_03	Р-р-р! Крушить!	
VO_BRMA07_1_START_01	Я тебя раздавлю!	
VO_BRMA07_1_TURN1_02	Давить или крушить? Тяжко!	
VO_BRMA08_1_CARD_05	Пик Черной горы выстоит!	
VO_BRMA08_1_DEATH_06	Аррргх!	
VO_BRMA08_1_RESPONSE_04	ПОЧЕМУ?! Скажи мне! Мы же были на одной стороне!	
VO_BRMA08_1_START_01	А ты что здесь делаешь?	
VO_BRMA08_1_TURN1_03	Лорд Нефарий! Я думал, это существо убило для нас Рагнароса!	
VO_BRMA08_1_TURN1_ALT_02	Хочешь помочь мне уничтожить жалких смертных?	
VO_BRMA09_1_CARD_05	Пик принадлежит нам!	
VO_BRMA09_1_DEATH_11	Аааааааа!	
VO_BRMA09_1_HERO_POWER1_06	Открыть врата!	
VO_BRMA09_1_HERO_POWER2_07	Убить того, позади!	
VO_BRMA09_1_HERO_POWER3_08	Все на героя, идиоты!	
VO_BRMA09_1_HERO_POWER4_09	Вместе мы непобедимы!	
VO_BRMA09_1_RESPONSE_04	Ха-ха-ха-ха-ха.	
VO_BRMA09_1_START_01	Мы – истинная Орда!	
VO_BRMA09_1_TURN1_03	Твой выбор пал на неправильную гору!	
VO_BRMA09_1_TURN1_ALT_02	Нас никто не остановит! Умри!	
VO_BRMA10_1_DEATH_08	Рррррррррах!	
VO_BRMA10_1_EGG_DEATH_1_05	Недоумки! Эти яйца ценнее, чем вы думаете!	
VO_BRMA10_1_EGG_DEATH_2_06	Да сколько же можно?! Вы заплатите за это головой!	
VO_BRMA10_1_EGG_DEATH_3_07	Я это так не оставлю!	
VO_BRMA10_1_HERO_POWER_04	Держись подальше от кладки!	
VO_BRMA10_1_RESPONSE_03	Я омлет из тебя сделаю!	
VO_BRMA10_1_START_01	Узри оскверненную кладку новых драконов!	
VO_BRMA10_1_TURN1_02	Эти яйца принесут тебе погибель!	
VO_BRMA11_1_ALEXSTRAZA_07	Хранительница Жизни, спаси меня!	
VO_BRMA11_1_CARD_04	Ярость Черной горы бежит по моим венам!	
VO_BRMA11_1_DEATH_ALT_08	Наконец-то мои мучения прекратятся...	
VO_BRMA11_1_HERO_POWER_05	А-а-а! Разрушение!	
VO_BRMA11_1_KILL_PLAYER_06	Прости, я подвел тебя.	
VO_BRMA11_1_RESPONSE_03	Тебе следовало бежать, пока можно было, смертный!	
VO_BRMA11_1_START_01	Беги, пока я еще могу себя удержать!	
VO_BRMA11_1_TURN1_02	Слишком поздно! Проклятие Нефариана поработило меня!	
VO_BRMA13_1_DEATH_ALT_23	Нет! Нет! Я еще вернусь!	
VO_BRMA13_1_DEATHWING_19	Папа?..	
VO_BRMA13_1_HP_DRUID_14	Дикая природа теперь подвластна мне, друид!	
VO_BRMA13_1_HP_GENERIC_18	Теперь я владею твоей магией!	
VO_BRMA13_1_HP_HUNTER_12	Охотник становится добычей!	
VO_BRMA13_1_HP_MAGE_11	Тебе следует осторожнее вести себя с магией!	
VO_BRMA13_1_HP_PALADIN_07	Неужели Свет оставил тебя, паладин?	
VO_BRMA13_1_HP_PRIEST_08	Теперь Свет служит мне, жрец!	
VO_BRMA13_1_HP_ROGUE_15	Хватит прятаться! Выйди и сразись со мной!	
VO_BRMA13_1_HP_SHAMAN_13	Стихии теперь подчиняются мне, шаман!	
VO_BRMA13_1_HP_WARLOCK_10	Ты играешь с магией, недоступной твоему разумению!	
VO_BRMA13_1_HP_WARRIOR_09	Твоя сила стала твоей слабостью, воин!	
VO_BRMA13_1_RESPONSE_05	Я здесь главный!	
VO_BRMA13_1_START_01	Добро пожаловать в мою резиденцию, герой!	
VO_BRMA13_1_TURN1_PT1_02	Познай истинную силу Нефариана!	
VO_BRMA13_1_TURN1_PT2_03	Бесконечная мана! Бронированная чешуя!	
VO_BRMA14_1_CARD_09	Перенаправляю избыток энергии.	
VO_BRMA14_1_DEATH_08	Защитные системы уничтожены. Отключение...	
VO_BRMA14_1_HP1_03	Модуль «Электрон» включен.	
VO_BRMA14_1_HP2_04	Модуль «Токситрон» включен.	
VO_BRMA14_1_HP3_05	Модуль «Чаротрон» включен.	
VO_BRMA14_1_HP4_06	Модуль «Магматрон» включен.	
VO_BRMA14_1_HP5_07	Защитный модуль подключен.	
VO_BRMA14_1_RESPONSE1_10	Бип-бип-бип.	
VO_BRMA14_1_RESPONSE2_11	Идет попытка подключения...	
VO_BRMA14_1_RESPONSE3_12	Подключение завершено. Загружаю обновление системы.	
VO_BRMA14_1_RESPONSE4_13	Обновление установлено. ПРИВЕТ, ПРИВЕТ, ПРИВЕТ.	
VO_BRMA14_1_RESPONSE5_14	ПРИВЕТ, ПРИВЕТ, ПРИВЕТ.	
VO_BRMA14_1_START_01	Обнаружено вторжение.	
VO_BRMA14_1_TURN1_02	Первичная защитная матрица активирована.	
VO_BRMA15_1_CARD_05	Мои неудачные творения станут вашей погибелью!	
VO_BRMA15_1_DEATH_04	Аааааааааах!	
VO_BRMA15_1_HERO_POWER_06	Помешивая, довести до кипения...	
VO_BRMA15_1_RESPONSE_03	Ничто не пропадет впустую!	
VO_BRMA15_1_START_01	Нельзя прерывать процесс!	
VO_BRMA15_1_TURN1_02	Нельзя заставлять господина ждать! Больше нельзя ошибаться!	
VO_BRMA16_1_CARD_04	Тебе не спрятаться!	
VO_BRMA16_1_DEATH_06	Ррррраааааах!	
VO_BRMA16_1_GONG1_10	А-а! Этот звук!	
VO_BRMA16_1_GONG2_11	Нет! Почти!	
VO_BRMA16_1_GONG3_12	Мои уши!	
VO_BRMA16_1_HERO_POWER_05	Тебя выдает неловкая поступь и отвратительный запах!	
VO_BRMA16_1_RESPONSE_03	Да, говори! Я уже рядом!	
VO_BRMA16_1_START_01	Я слышу, как бьется твое сердце!	
VO_BRMA16_1_TRIGGER1_07	О! Я тебя слышу...	
VO_BRMA16_1_TRIGGER2_08	Я слышу шаги.	
VO_BRMA16_1_TRIGGER3_09	Биение сердца... Тебе не сбежать!	
VO_BRMA16_1_TURN1_02	Смерть ждет во тьме!	
VO_BRMA17_1_CARD_86	Надеюсь, вы умеете плавать... в кипящей лаве!	
VO_BRMA17_1_DEATH_97	А-а-а-а-а!	
VO_BRMA17_1_DEATH_HEROIC_98	Ааааааааа!	
VO_BRMA17_1_DEATHWING_88	Папа?	
VO_BRMA17_1_HERO_POWER_87	Смотри, как темное пламя вдыхает жизнь в их кости!	
VO_BRMA17_1_NEF_AIR1_89	Узри летящее с неба пламя! Одна единица урона – это только начало!	
VO_BRMA17_1_NEF_AIR2_90	Два огненных шара! Я низвергаю их с высоты!	
VO_BRMA17_1_NEF_AIR3_91	На этот раз обойдусь одним огненным шаром. Зато дальше тебя ждет сюрприз!	
VO_BRMA17_1_NEF_AIR4_92	Хо-хо! Три шара! На-ка! Получи с высоты!	
VO_BRMA17_1_NEF_AIR5_93	Дальше буду бросать по одному огненному шару!	
VO_BRMA17_1_NEF_AIR6_94	Пошутил, пошутил! Получи четыре! Ха-ха-ха!	
VO_BRMA17_1_NEF_AIR7_95	Не буду пока тратить на тебя пламя... Но будь начеку...	
VO_BRMA17_1_NEF_AIR8_96	Двадцать огненных шаров! А-ха-ха-ха-ха-ха!!!	
VO_BRMA17_1_RESPONSE_85	Разум смертных... так легко подчинить.	
VO_BRMA17_1_RESURRECT1_82	Я сокрушу вас с высоты!	
VO_BRMA17_1_RESURRECT2_83	Пока я здесь, наверху, на земле вас ждет сюрприз!	
VO_BRMA17_1_RESURRECT3_84	Прошу приветствовать мое лучшее творение! Проснись, сестра! Проснись, Ониксия!	
VO_BRMA17_1_START_78	Ха-ха! Тебе удалось дойти до самого конца!	
VO_BRMA17_1_TRANSFORM1_80	Я пытался следовать законам гостеприимства, но ты все никак не умрешь!	
VO_BRMA17_1_TRANSFORM2_81	Придется отбросить условности и просто... УБИТЬ ВАС ВСЕХ!	
VO_BRMA17_1_TURN1_79	Мое лучшее творение ждет тебя.	
VO_COOP02_00	Я избавлю вас от Проклятия Плоти!	
VO_COOP02_02	Чтобы победить, одолейте Механизатора Механозода вместе!	
VO_COOP02_ABILITY_05	Увеличить обороты!	
VO_COOP02_ABILITY_06	История не нужна, хранитель истории Чо!	
VO_COOP03_01	Я здесь главный!	
VO_COOP03_02	Нет... Нет! Я тебя уничтожу!	
VO_COOP03_03	Разум смертных... так легко подчинить.	
VO_COOP03_04	Я пытался следовать законам гостеприимства, но ты все никак не умрешь!	
VO_COOP03_05	Придется отбросить условности и просто... УБИТЬ ВАС ВСЕХ!	
VO_COOP03_06	Теперь Свет служит мне, жрец!	
VO_COOP03_07	Стихии теперь подчиняются мне, шаман!	
VO_COOP03_08	Ха-ха-ха... Познай истинную силу Нефариана!	
VO_COOP03_09	Хе-хе-хе! Тебе удалось дойти до самого конца!	
VO_Crone_Female_Troll_CroneDeath_02	Нет! Я до тебя доберусь! Доберусь...	
VO_Crone_Female_Troll_CroneEmoteResponse_02	Хахахаха!	
VO_Crone_Female_Troll_CroneFlyingMonkeys_01	Привести девчонку ко мне!	
VO_Crone_Female_Troll_CroneHeroPower_02	Хе-хе-хе!	
VO_Crone_Female_Troll_CroneOpen_01	Ха-ха-ха-ха-ха! Бегите, мои крошки!	
VO_Curator_Male_ArcaneGolem_CuratorArcaneGolem_01	Любопытно. Удивительное сходство.	
VO_Curator_Male_ArcaneGolem_CuratorBeasts_01	У Смотрителя аллергия на зверей.	
VO_Curator_Male_ArcaneGolem_CuratorDemons_01	Демонам не место в зверинце.	
VO_Curator_Male_ArcaneGolem_CuratorDragons_01	Больше никакого драконьего помета.	
VO_Curator_Male_ArcaneGolem_CuratorEmoteResponse_01	Ваш запрос не может быть обработан.	
VO_Curator_Male_ArcaneGolem_CuratorHarrison_02	Обнаружен жулик! Присутствие Харрисона Джонса недопустимо.	
VO_Curator_Male_ArcaneGolem_CuratorMechs_01	Перепрограммирую помощников.	
VO_Curator_Male_ArcaneGolem_CuratorMedivhSkin_01	Ненастоящий Медив. Выдают безумные глаза.	
VO_Curator_Male_ArcaneGolem_CuratorMurlocs_01	Рыбешки свободны.	
VO_Curator_Male_ArcaneGolem_CuratorPirates_01	Пиратам – бутылку рома!	
VO_Curator_Male_ArcaneGolem_CuratorReno_02	Обнаружен жулик! Присутствие Рено Джексона недопустимо.	
VO_Curator_Male_ArcaneGolem_CuratorTurn1_01	Смотритель снабжен всем необходимым для управления зверинцем.	
VO_Curator_Male_ArcaneGolem_CuratorTurn5_01	Пожалуйста, соблюдайте правила галереи.	
VO_Curator_Male_ArcaneGolem_CuratorTurn9_01	Гости должны оставаться в зверинце.	
VO_Curator_Male_ArcaneGolem_IllhoofKilrekResponse_01	Смотрителю все равно. Ритуалы призыва запрещены.	
VO_Curator_Male_ArcaneGolem_IllhoofSenseDemons_01	Обнаружено много демонов.	
VO_Curator_Male_ArcaneGolem_IllhoofTurn1_01	Ритуалы призыва запрещены.	
VO_Curator_Male_ArcaneGolem_IllhoofTurn5_01	Ритуалы вредят экспонатам. Демона нужно устранить.	
VO_Curator_Male_ArcaneGolem_IllhoofWin_01	Смотритель благодарен. Зверинец будет восстановлен.	
VO_Curator_Male_ArcaneGolem_NightbaneCorruption_01	Нет! Осквернять зверинец запрещено!	
VO_Curator_Male_ArcaneGolem_NightbaneTour_01	Дракон Ночная Погибель, ранее Арканагос. Магия поработила его разум.	
VO_Curator_Male_ArcaneGolem_NightbaneTour_02	Слева – бюст Арана. Справа – Лампада силы.	
VO_Curator_Male_ArcaneGolem_NightbaneTurn1_01	На воле экспонатам угрожает опасность. Их нужно вернуть в зверинец.	
VO_Curator_Male_ArcaneGolem_NightbaneTurn3_01	Спасать живых существ разрешено. Проходите.	
VO_Curator_Male_ArcaneGolem_NightbaneUnstablePortal_01	Рекомендуется осторожность. Дракон боится нестабильной магии.	
VO_Curator_Male_ArcaneGolem_NightbaneWin_01	Нужна дальнейшая помощь.	
VO_Curator_Neither_ArcaneGolem_CuratorDeath_04	Отключение сис-те-мы...	
VO_Curator_Neither_ArcaneGolem_CuratorOpen_01	Экспонаты руками не трогать.	
VO_ELISE_LOE16_ALT_1_FIRST_HALF_02	Рафаам неуязвим, пока заряжает посох.	
VO_ELISE_LOE16_ALT_1_SECOND_HALF_03	Когда он закончит, у нас будет время дать ему отпор, но перед этим придется разобраться с призванным существом!	
VO_ELISE_WEIRD_DECK_05	Извини, колода и впрямь странная. Мы собрали ее на турнир в прошлом году и с тех пор ничего в ней не меняли.	
VO_EMOTE_HERO_TBKTRAF_KT_DRAWING_BOARD	Эх... Ладно, попробуем снова.	
VO_EMOTE_HERO_TBKTRAF_KT_GLOAT	Моли о пощаде.	
VO_EMOTE_HERO_TBKTRAF_KT_MINIONS_SERVANTS	Соратники, слуги, солдаты холодной тьмы...	
VO_FP1_014t_EnterPlay_01	Теперь ты познаешь боль!	
VO_FP1_031_Attack_07	Да начнется бойня!	
VO_FP1_031_EnterPlay_06	Плеть поглотит тебя!	
VO_HeadlessHorseman_Male_Human_HallowsEve_01	Здесь я, ты, жалкое подобие тела!	
VO_HeadlessHorseman_Male_Human_HallowsEve_02	Будьте вы прокляты, горите в огне! От судьбы не уйти ни вам и ни мне!	
VO_HeadlessHorseman_Male_Human_HallowsEve_04	Разгорайся, костер, да поярче гори! Твое время настало, смирись и умри!	
VO_HeadlessHorseman_Male_Human_HallowsEve_07	Иссяк огонь мой; торжествует враг. Я погружаюсь в беспросветный мрак!	
VO_HeadlessHorseman_Male_Human_HallowsEve_08	Своим мечом ты кровь мне не прольешь! Сруби же тыкву: ты меня убьешь!	
VO_HeadlessHorseman_Male_Human_HallowsEve_10	ХА-ХА-ХА-ХА-ХА АХ-ХА-ХА-ХА-А-А!	
VO_HeadlessHorseman_Male_Human_HallowsEve_11	А-А-А-ХА-ХА-ХА ХА-ХА-ХА-ХА-ХА!	
VO_HeadlessHorseman_Male_Human_HallowsEve_12	Готовьтесь, презренные, гибель все ближе. Спасайте скорей стариков и детишек.	
VO_HeadlessHorseman_Male_Human_HallowsEve_13	Гремят над землей грозовые раскаты. Пощады не будет! Настал час расплаты!	
VO_HeadlessHorseman_Male_Human_HallowsEve_17	ХА-ХА-ХА-ХА-ХА!	
VO_HRW_DEBUG_01	1	
VO_HRW_DEBUG_02	2	
VO_HRW_DEBUG_03	3	
VO_HRW_DEBUG_04	4	
VO_HRW_DEBUG_05	5	
VO_HRW_TEST_00	I will cleanse you both of the Curse of Flesh!	
VO_HRW_TEST_01	Well done!  You've defeated the boss together.\n\nBoth players win!	
VO_HRW_TEST_02	Defeat Gearmaster Mechazod together to win!	
VO_HRW_TEST_ABILITY_00	Damaging a hero.	
VO_HRW_TEST_ABILITY_01	Destroying highest attack minion.	
VO_HRW_TEST_ABILITY_02	Throwing 3 bombs.	
VO_HRW_TEST_ABILITY_03	Damaging all other characters.	
VO_HRW_TEST_ABILITY_04	Gaining 2 attack.	
VO_HRW_TEST_ABILITY_05	Dealing damage to both heroes.	
VO_HRW_TEST_ABILITY_06	Silencing Lorewalker Cho. Permanently.	
VO_HRW_TEST_ABILITY_98	Target board full.  Clearing target board.	
VO_ICC_841_Female_Sanlayn_Death_02	Но... мы ведь так хорошо... ладили...	
VO_ICC01_Jaina_Female_Human_DrawsRager_01	Да ты шутишь?!	
VO_ICC01_Jaina_Female_Human_JainaDKIntro_05	Я слышу зов... мертвых...	
VO_ICC01_Jaina_Female_Human_PostDeath_02	Мы должны... выстоять...	
VO_ICC01_LichKing_Male_Human_EmoteResponse_01	Твои мольбы о пощаде никто не услышит.	
VO_ICC01_LichKing_Male_Human_EndOfTurn2_01	Ха-ха-ха! Вот каким должен быть первый ход!	
VO_ICC01_LichKing_Male_Human_EndOfTurn2_02	И это даже не агрессивная колода!	
VO_ICC01_LichKing_Male_Human_Idle_01	Давай, завершай ход. И я тебя уничтожу.	
VO_ICC01_LichKing_Male_Human_Intro_01	Осторожнее выбирай карты. Другого шанса не будет.	
VO_ICC01_LichKing_Male_Human_JainaDKIntro_01	Восстань, маг! Твой долг еще не исполнен.	
VO_ICC01_LichKing_Male_Human_JainaDKIntro_02	Сражайся за меня, и живые будут трепетать, а мертвые – склонятся.	
VO_ICC01_LichKing_Male_Human_JainaDKIntro_03	Враги станут бояться тебя больше смерти...	
VO_ICC01_LichKing_Male_Human_JainaDKintro_06	А теперь, герой, смети эту падаль с моего порога.	
VO_ICC01_LichKing_Male_Human_PlaysFrostmourne_01	Твой рейтинг познает СТРАДАНИЯ!	
VO_ICC01_LichKing_Male_Human_Turn1_01	Вот это карты...	
VO_ICC01_LichKing_Male_Human_Turn11_01	Возглавь мои орды нежити.	
VO_ICC01_LichKing_Male_Human_Turn13_01	Заставь их страдать.	
VO_ICC01_LichKing_Male_Human_Turn15_01	Жалость – удел слабых.	
VO_ICC01_LichKing_Male_Human_Turn2_02	Узри мою силу.	
VO_ICC01_LichKing_Male_Human_Turn4_01	Тебя ничто не спасет.	
VO_ICC01_LichKing_Male_Human_Turn4_02	Моя сила безгранична.	
VO_ICC01_LichKing_Male_Human_Turn5_01	Все падут предо мной.	
VO_ICC01_LichKing_Male_Human_Turn5_02	И ты покоришься мне.	
VO_ICC01_Tirion_Male_Human_AFKay_01	Не отвлекайся!	
VO_ICC01_Tirion_Male_Human_EmoteResponse_02	Я больше тебя не знаю!	
VO_ICC01_Tirion_Male_Human_EndOfTurn4_01	Так держать, герой!	
VO_ICC01_Tirion_Male_Human_EndOfTurn4_02	Я верю, что в час нужды само провидение поможет тебе.	
VO_ICC01_Tirion_Male_Human_EndOfTurn4_03	Верь, в час нужды сама судьба поможет тебе.	
VO_ICC01_Tirion_Male_Human_Flavor01_01	Придется найти героев поискуснее...	
VO_ICC01_Tirion_Male_Human_Flavor02_01	Джайна, ты стала чудовищем!	
VO_ICC01_Tirion_Male_Human_Flavor03_01	Король-лич заплатит за это злодеяние!	
VO_ICC01_Tirion_Male_Human_JainaDKintro_05	Что с тобой? Кем ты стала?!	
VO_ICC01_Tirion_Male_Human_PauseDeath_02	Остановись!	
VO_ICC01_Tirion_Male_Human_PostDeath_01	Герой, не дай сломить свою волю. Сопротивляйся зову Короля-лича!	
VO_ICC01_Tirion_Male_Human_TerribleTank_01	А почему ты не провоцируешь?	
VO_ICC01_Tirion_Male_Human_Turn2_01	Отринь страх, герой! Мы уже в пути!	
VO_ICC01_Tirion_Male_Human_Turn3_01	Мы почти у цели! Как там дела? Нормально?	
VO_ICC01_Tirion_Male_Human_Turn6_01	Герой, мы уже почти...	
VO_ICC01_Tirion_Male_Human_Turn6_02	Что?!	
VO_ICC01_Tirion_Male_Human_Turn8_01	Ты сразишься с величайшими героями Азерота!	
VO_ICC04_LichKing_Male_Human_BreathNoMinion_01	Что?! Синдрагосе некого заморозить? Возмутительно.	
VO_ICC04_LichKing_Male_Human_Lose_01	Твои замерзшие останки послужат напоминанием другим...	
VO_ICC04_LichKing_Male_Human_Turn5_01	Ты сейчас думаешь, как тебе избавиться от ледяных глыб?	
VO_ICC04_LichKing_Male_Human_Turn5_02	НИКАК, ХА-ХА-ХА!	
VO_ICC04_LichKing_Male_Human_Win_02	ВСЯ КОЛОДА ДОЛЖНА БЫТЬ УНИЧТОЖЕНА!	
VO_ICC04_Sindragosa_Female_Dragon_Bounce_01	А ну верни!	
VO_ICC04_Sindragosa_Female_Dragon_BreathNoRoomLeft_01	Тебе больше не за кем прятаться.	
VO_ICC04_Sindragosa_Female_Dragon_Death_01	<Полный агонии рык>	
VO_ICC04_Sindragosa_Female_Dragon_EmoteResponse_01	Эти игры меня утомляют!	
VO_ICC04_Sindragosa_Female_Dragon_Intro_01	Глупцы, зачем вы сюда явились?!	
VO_ICC04_Sindragosa_Female_Dragon_LichKing_01	Меня предали!	
VO_ICC04_Sindragosa_Female_Dragon_Malygos_01	Малигос... любовь моя!	
VO_ICC04_Sindragosa_Female_Dragon_PlayerPlaysMinion_02	Выбирай жертв мудро. Ледяная хватка смерти ждет всех.	
VO_ICC04_Sindragosa_Female_Dragon_SecondBreath_01	Почувствуйте мощь господина и погрузитесь в отчаяние!	
VO_ICC04_Sindragosa_Female_Dragon_Sindragosa_01	Наша жалкая магия предала нас!	
VO_ICC04_Sindragosa_Female_Dragon_Sindragosa_02	Наша жалкая магия предала нас!	
VO_ICC04_Sindragosa_Female_Dragon_TransformDK_01	Я повинуюсь только моему господину!	
VO_ICC04_Sindragosa_Female_Dragon_UnchainedMagic_02	Ваша жалкая магия предала вас!	
VO_ICC04_Sindragosa_Female_Dragon_UnchainedMagic_04	Страдай!	
VO_ICC05_Lanathel_Female_Sanlayn_BiteOoze_01	Фу! Ты укусишь ЭТУ пакость?!	
VO_ICC05_Lanathel_Female_Sanlayn_BitePoisonous_01	Не забудь потом сплюнуть яд.	
VO_ICC05_Lanathel_Female_Sanlayn_BiteReminder_01	Память подводит? Жажда иссушит тебя заживо!	
VO_ICC05_Lanathel_Female_Sanlayn_BiteReminderAcolyte_01	Не мешкай! Питайся! Насыться кровью спящих!	
VO_ICC05_Lanathel_Female_Sanlayn_BiteShell_01	Зубки не сломай.	
VO_ICC05_Lanathel_Female_Sanlayn_BiteSpikes_01	Герой плакал, но продолжал кусать что попало...	
VO_ICC05_Lanathel_Female_Sanlayn_BloodEssence_01	Здесь становится тесновато.	
VO_ICC05_Lanathel_Female_Sanlayn_BloodEssence_02	Они же тебе не нужны, правда?	
VO_ICC05_Lanathel_Female_Sanlayn_BloodEssence_03	Давай-ка нарушим твои планы!	
VO_ICC05_Lanathel_Female_Sanlayn_BloodPrince_01	Предатель! Я – твоя королева!	
VO_ICC05_Lanathel_Female_Sanlayn_BossBite_01	Я голодна!	
VO_ICC05_Lanathel_Female_Sanlayn_EmoteResponse_01	Ты со мной... флиртуешь?	
VO_ICC05_Lanathel_Female_Sanlayn_Intro_01	Это было... неразумное... решение.	
VO_ICC05_Lanathel_Female_Sanlayn_LichKing_01	Ты!..	
VO_ICC05_Lanathel_Female_Sanlayn_PlayerBiteAcolyte_01	Изумительная ирония!	
VO_ICC05_Lanathel_Female_Sanlayn_PlayerBloodBite_01	Слишком поздно, я уже давно обратилась!	
VO_ICC05_Lanathel_Female_Sanlayn_TransformDK_01	А ты мне нравишься.	
VO_ICC05_Lanathel_Female_Sanlayn_Turn3_01	Почему бы не насытиться кем-нибудь из МОИХ слуг?	
VO_ICC05_Lanathel_Female_Sanlayn_Turn3_02	Они дремлют... Такие восхитительные... Такие вкусные.	
VO_ICC05_Lanathel_Female_Sanlayn_Wounded_01	И это все, что ты можешь?	
VO_ICC05_LichKing_Male_Human_BossBite_02	О да. Укус Сан'лейн.	
VO_ICC05_LichKing_Male_Human_BossBite_03	Помни о чудовищной жажде, питайся каждый ход!	
VO_ICC05_LichKing_Male_Human_LichKing_02	Это крепкий орешек.	
VO_ICC05_LichKing_Male_Human_Lose_01	Боишься кусать своих же существ? Ты в Ледяной Короне, детство кончилось!	
VO_ICC05_LichKing_Male_Human_Win_01	Лана'тель... Благо, ты уже не теряешь звезды на своем ранге.	
VO_ICC06_LichKing_Male_Human_LichKing_02	Ничего личного, Ребрад.	
VO_ICC06_LichKing_Male_Human_Win_01	Я создам нового костяного монстра. Может, даже золотого.	
VO_ICC06_Marrowgar_Male_BoneWraith_Alexstraza_01	Этот дракон меня лизнул!	
VO_ICC06_Marrowgar_Male_BoneWraith_AncientOne_01	Я НИ О ЧЕМ не жалею!	
VO_ICC06_Marrowgar_Male_BoneWraith_AuchenaiSoulpriest_01	Ха-ха, теперь твоя жрица у меня. Погоди-ка. Нет! Иди прочь! Кыш!	
VO_ICC06_Marrowgar_Male_BoneWraith_BigHeal_01	Смерть вечна, непреклонна...	
VO_ICC06_Marrowgar_Male_BoneWraith_Bonespike_01	Единственный выход – это смерть!	
VO_ICC06_Marrowgar_Male_BoneWraith_Bonespike_02	Ты достанешься повелителю.	
VO_ICC06_Marrowgar_Male_BoneWraith_Bonespike_03	Плоть слетает с костей от моих касаний.	
VO_ICC06_Marrowgar_Male_BoneWraith_Bonespike_04	Пришло время жатвы.	
VO_ICC06_Marrowgar_Male_BoneWraith_Bonespike_05	О эта опасность. Это великолепие!	
VO_ICC06_Marrowgar_Male_BoneWraith_BonespikePlayerHit_01	Во мне бушует ярость господина!	
VO_ICC06_Marrowgar_Male_BoneWraith_BonespikeStolen_01	Ах ты... костекрад!	
VO_ICC06_Marrowgar_Male_BoneWraith_Bonestorm_01	Вихрь костей!	
VO_ICC06_Marrowgar_Male_BoneWraith_Bonestorm_02	Вихрь косте-ей!	
VO_ICC06_Marrowgar_Male_BoneWraith_Bonestorm_03	Вихрь косте-е-е-ей!	
VO_ICC06_Marrowgar_Male_BoneWraith_Bonestorm_04	Вихрь косте-е-е-е-е-е-ей!	
VO_ICC06_Marrowgar_Male_BoneWraith_Bonestorm_05	ВИХР-Р-Р-РЬ КОСТЕ-Е-Е-Е-Е-Е-ЕЙ!	
VO_ICC06_Marrowgar_Male_BoneWraith_BonestormFast_01	Вихрькостей.	
VO_ICC06_Marrowgar_Male_BoneWraith_Death_01	Прах к праху...	
VO_ICC06_Marrowgar_Male_BoneWraith_DKTransform_01	Да. Прими свою судьбу, услышь зов господина!	
VO_ICC06_Marrowgar_Male_BoneWraith_EmoteResponse_01	Ха! У меня нет ушей!	
VO_ICC06_Marrowgar_Male_BoneWraith_Idle_01	Хм-м-м...	
VO_ICC06_Marrowgar_Male_BoneWraith_Intro_01	Никто не смеет входить в обитель господина!	
VO_ICC06_Marrowgar_Male_BoneWraith_LichKing_01	Господин?!	
VO_ICC06_Marrowgar_Male_BoneWraith_Skeleton_01	Кто это у нас такой костяной, мм?	
VO_ICC07_LichKing_Male_Human_LichKing_02	Не люблю отсиживаться в тылах.	
VO_ICC07_LichKing_Male_Human_Lose_01	Мерзоцид, твоя колода отвратительна. Я тебя недооценил.	
VO_ICC07_LichKing_Male_Human_Win_02	Мерзоцид, ничтожество! Твое место – в колоде охотника, а не в моей цитадели.	
VO_ICC07_Putricide_Male_Undead_Aviana_01	Твоя наука сильнее моей!	
VO_ICC07_Putricide_Male_Undead_CloakedHuntress_01	Думаю, это лишнее.	
VO_ICC07_Putricide_Male_Undead_Death_01	Плохие новости, народ...	
VO_ICC07_Putricide_Male_Undead_EaglehornBow_01	А мне такой можно?	
VO_ICC07_Putricide_Male_Undead_EaterOfSecrets_01	Мои секреты! Работа всей моей жизни!	
VO_ICC07_Putricide_Male_Undead_EmoteResponse_01	Это невежливо.	
VO_ICC07_Putricide_Male_Undead_EquipWeapon_01	Ох ты...	
VO_ICC07_Putricide_Male_Undead_EquipWeapon_02	Я и не знал, что у меня есть ТАКОЕ.	
VO_ICC07_Putricide_Male_Undead_EquipWeapon_03	Да, сгодится.	
VO_ICC07_Putricide_Male_Undead_EquipWeapon_04	А это откуда взялось?	
VO_ICC07_Putricide_Male_Undead_EquipWeapon_05	О эта опасность. Это великолепие!	
VO_ICC07_Putricide_Male_Undead_EtherealArcanist_01	Не верь эфириалам. У них не видно лиц!	
VO_ICC07_Putricide_Male_Undead_FestergutDeath_01	Тухлопуз, ты всегда был моим любимчиком... После Гниломорда!	
VO_ICC07_Putricide_Male_Undead_Intro_02	Отличные новости, народ! Я починил трубы для подачи ядовитой слизи!	
VO_ICC07_Putricide_Male_Undead_LichKing_01	Ой, а вы-то какими судьбами?	
VO_ICC07_Putricide_Male_Undead_MysteriousChallenger_01	Нет! Я тут самый загадочный!	
VO_ICC07_Putricide_Male_Undead_Ooze_01	О-о-о, слизь!	
VO_ICC07_Putricide_Male_Undead_PhaseTransition_01	Щупальца! Они что, наделены разумом?	
VO_ICC07_Putricide_Male_Undead_PhaseTransition_03	Хммм, интересно...	
VO_ICC07_Putricide_Male_Undead_Putricide_02	Как так? Он же совсем как я!	
VO_ICC07_Putricide_Male_Undead_Putricide_03	Отличные новости... я!	
VO_ICC07_Putricide_Male_Undead_Putricide_04	Что за самозванец с щупальцами? Разве это отличные новости?!	
VO_ICC07_Putricide_Male_Undead_Rotface_01	Гниломорд! Как ты мог?!	
VO_ICC07_Putricide_Male_Undead_RotfaceDeath_01	Только не Гниломорд! Ну чем, чем он тебе не угодил?	
VO_ICC07_Putricide_Male_Undead_Scientist_01	Это что за утечка мозгов?!	
VO_ICC07_Putricide_Male_Undead_Slime_01	Отличные новости, народ! Слизь снова потекла!	
VO_ICC07_Putricide_Male_Undead_TentaclesForArms_01	Вот это по-настоящему стильное оружие!	
VO_ICC07_Putricide_Male_Undead_TransformDK_01	Что-о-о?! У тебя изменилась прическа?!	
VO_ICC07_Rotface_Male_Abomination_Rotface_02	Гниломорду НАДО ПУ-ПУ.	
VO_ICC08_Anduin_Male_Human_Muted_02	Ммффф!	
VO_ICC08_Anduin_Male_Human_Muted_03	Мрмфрх?	
VO_ICC08_Anduin_Male_Human_Muted_06	Ммффф!	
VO_ICC08_Anduin_Male_Human_Muted_07	Мммммфмммф!!!	
VO_ICC08_Anduin_Male_Human_Muted_11	Мгмммх...	
VO_ICC08_Anduin_Male_Human_Muted_13	Мгмммх...	
VO_ICC08_Anduin_Male_Human_WinA_01	Всегда должен быть...	
VO_ICC08_Anduin_Male_Human_WinB_01	Король-лич...	
VO_ICC08_Garrosh_Male_Orc_WinA_01	Всегда должен быть...	
VO_ICC08_Garrosh_Male_Orc_WinB_01	Король-лич...	
VO_ICC08_Guldan_Male_Orc_WinA_01	Всегда должен быть...	
VO_ICC08_Guldan_Male_Orc_WinB_01	Король-лич...	
VO_ICC08_Jaina_Female_Human_WinA_01	Всегда должен быть...	
VO_ICC08_Jaina_Female_Human_WinB_01	Король-лич...	
VO_ICC08_LichKing_Male_Human_Archmage Antonidas_01	Я уже убивал тебя, старик. Могу повторить.	
VO_ICC08_LichKing_Male_Human_Arfas_01	Плохой пес!	
VO_ICC08_LichKing_Male_Human_Bolvar_01	Сломить его было очень трудно.	
VO_ICC08_LichKing_Male_Human_Death_01	Мой взор... застилает тьма...	
VO_ICC08_LichKing_Male_Human_DeathPunisher_01	Нечестно! Это нечестно!	
VO_ICC08_LichKing_Male_Human_EmoteResponse_01	Никто не смеет мне приказывать!	
VO_ICC08_LichKing_Male_Human_EndOfTurn4_01	Ни одна карта не помешает моему триумфу.	
VO_ICC08_LichKing_Male_Human_Frostmourne_01	Ледяная Скорбь жаждет крови...	
VO_ICC08_LichKing_Male_Human_Frostmourne_02	Ледяная Скорбь жаждет крови... Хотя, на самом деле, душ.	
VO_ICC08_LichKing_Male_Human_Frostmourne_07	Узри силу Ледяной Скорби!	
VO_ICC08_LichKing_Male_Human_GenericStart_03	Сперва я уничтожу твою колоду. А затем – ДУШУ!	
VO_ICC08_LichKing_Male_Human_Horsemen_01	Если я соберу всех четырех, тебе будет ОЧЕНЬ неловко.	
VO_ICC08_LichKing_Male_Human_Hunter_01	Одинокий охотник. Разогнать всех твоих маленьких друзей – и что от тебя останется?	
VO_ICC08_LichKing_Male_Human_Illidan_01	Ледяной Трон мой! Прочь с дороги, демон.	
VO_ICC08_LichKing_Male_Human_IndestructableWeapon_01	Жалкая попытка.	
VO_ICC08_LichKing_Male_Human_Intro_01	О твоих страданиях сложат легенды. Но не о твоем рейтинге.	
VO_ICC08_LichKing_Male_Human_Intro_02	В конце концов все будут служить мне.	
VO_ICC08_LichKing_Male_Human_Intro_03	И ты называешь эту стопку карт колодой?	
VO_ICC08_LichKing_Male_Human_Intro_04	Я есть начало и конец. Я – НОВАЯ МЕТА!	
VO_ICC08_LichKing_Male_Human_Intro_06	Уж не надеешься ли ты на пощаду?	
VO_ICC08_LichKing_Male_Human_Intro_07	Это твоя колода? Больше похоже на мольбу о помощи.	
VO_ICC08_LichKing_Male_Human_Intro_08	Твои отчаянные крики послужат доказательством моей безупречной игры.	
VO_ICC08_LichKing_Male_Human_Intro_09	Что движет тобой?.. Праведность? Не думаю...	
VO_ICC08_LichKing_Male_Human_Kelthuzad_01	Кел'Тузад! Но ты в другом приключении!	
VO_ICC08_LichKing_Male_Human_Lanathel_01	Твое предательство меня не удивляет, Лана'тель.	
VO_ICC08_LichKing_Male_Human_LichKing_01	Ну здравствуй, красавец.	
VO_ICC08_LichKing_Male_Human_LichKing_02	А я неплох.	
VO_ICC08_LichKing_Male_Human_LichKingMuted_01	Стой! Ты не...	
VO_ICC08_LichKing_Male_Human_LichKingMutedResponse_01	Мммх.	
VO_ICC08_LichKing_Male_Human_LichKingMutedResponse_02	Ммфм мф ммф мфмф!	
VO_ICC08_LichKing_Male_Human_LichKingMutedResponse_03	Ммммфх!	
VO_ICC08_LichKing_Male_Human_LichKingMutedResponse_04	Мммфрммм...	
VO_ICC08_LichKing_Male_Human_LilLich_01	Мне... мне он нравится!	
VO_ICC08_LichKing_Male_Human_Lose_03	Присоединись ко мне во Тьме.	
VO_ICC08_LichKing_Male_Human_Mage_01	Маг! Только мне подвластен черный хлад смерти!	
VO_ICC08_LichKing_Male_Human_MageSpellReflect_01	Кто это тестировал?!	
VO_ICC08_LichKing_Male_Human_MageSpellReflect_02	Эти приключения вообще тестируют?!	
VO_ICC08_LichKing_Male_Human_Mograine_01	Могрейн! Я устал следить за твоими метаниями. Ты сегодня хороший или плохой?	
VO_ICC08_LichKing_Male_Human_MutedResponse_01	Молчать!	
VO_ICC08_LichKing_Male_Human_MutedResponse_02	Тссс!	
VO_ICC08_LichKing_Male_Human_MutedResponse_03	Тсссс!	
VO_ICC08_LichKing_Male_Human_MutedResponse_04	Умолкни.	
VO_ICC08_LichKing_Male_Human_MutedResponse_05	Ну все, хватит.	
VO_ICC08_LichKing_Male_Human_MutedResponse_06	Замолчи уже.	
VO_ICC08_LichKing_Male_Human_Paladin_01	Здесь тебя не защитит Свет, паладин. Ничто тебя не защитит...	
VO_ICC08_LichKing_Male_Human_Phase03_01	Встречай трагический финал...	
VO_ICC08_LichKing_Male_Human_PhaseTransition_02	Мое оружие понерфили?	
VO_ICC08_LichKing_Male_Human_PowerReplace_01	Моя сила тебе неподвластна.	
VO_ICC08_LichKing_Male_Human_Priest_01	Умолкни, жрец! Свет не услышит твоих криков о помощи.	
VO_ICC08_LichKing_Male_Human_Putricide_01	Никогда тебя не любил.	
VO_ICC08_LichKing_Male_Human_Rogue_01	Все разбойники одинаковые. Выйди из тени! Кто ты без своих уловок?	
VO_ICC08_LichKing_Male_Human_Shaman_01	Шаман, твои существа трепещут перед моей силой!	
VO_ICC08_LichKing_Male_Human_Sindragosa_01	Это МОЯ карта! А ну, верни!	
VO_ICC08_LichKing_Male_Human_Sylvanas_01	После всего, на что ты меня обрекла, не надейся на смертный покой.	
VO_ICC08_LichKing_Male_Human_Tirion_01	А тебя я оставлю в живых до конца, Фордринг.	
VO_ICC08_LichKing_Male_Human_TransformDK_01	Да... Прими свою новую силу... Я уже победил...	
VO_ICC08_LichKing_Male_Human_Turn6_01	Из всех твоих неудачных ходов этот был самым жалким.	
VO_ICC08_LichKing_Male_Human_Turn6_03	Ты играешь так же, как правил мой отец. Никчемно.	
VO_ICC08_LichKing_Male_Human_Turn6_04	Тебе не становится дурно при виде собственной колоды?	
VO_ICC08_LichKing_Male_Human_Turn6_05	Каждая сыгранная карта приближает тебя к погибели.	
VO_ICC08_LichKing_Male_Human_Turn6_06	Никакими эмоциями не передать всей глубины твоего позора.	
VO_ICC08_LichKing_Male_Human_Turn6_07	Кто собрал за тебя эту колоду?	
VO_ICC08_LichKing_Male_Human_Turn6_08	С ней даже против Дробителя играть стыдно.	
VO_ICC08_LichKing_Male_Human_Warlock_01	Прими свою судьбу, чернокнижник. Скоро все твои чудовища будут служить МНЕ.	
VO_ICC08_LichKing_Male_Human_Warrior_01	Воин. Когда я сломлю тебя, ты станешь отличным рыцарем смерти.	
VO_ICC08_LichKing_Male_Human_Wounded_01	Надежда тает...	
VO_ICC08_LichKing_Male_Human_Wounded_02	Невозможно... НЕ МОЖЕТ БЫТЬ!	
VO_ICC08_LichKing_Male_Human_YoungArthas_01	Что это? Трагическое воплощение моей внутренней борьбы?	
VO_ICC08_Malfurion_Male_NightElf_WinA_01	Всегда должен быть...	
VO_ICC08_Malfurion_Male_NightElf_WinB_01	Король-лич...	
VO_ICC08_Rexxar_Male_Orc_WinA_01	Всегда должен быть...	
VO_ICC08_Rexxar_Male_Orc_WinB_01	Король-лич...	
VO_ICC08_Thrall_Male_Orc_WinA_01	Всегда должен быть...	
VO_ICC08_Thrall_Male_Orc_WinB_01	Король-лич...	
VO_ICC08_Tirion_Male_Human_Win_01	У тебя получилось!	
VO_ICC08_Tirion_Male_Human_Win_02	Теперь, когда Плеть лишилась своего короля, она станет еще опаснее.	
VO_ICC08_Uther_Male_Human_WinA_01	Всегда должен быть...	
VO_ICC08_Uther_Male_Human_WinB_01	Король-лич...	
VO_ICC08_Valeera_Female_Human_WinA_01	Всегда должен быть...	
VO_ICC08_Valeera_Female_Human_WinB_01	Король-лич...	
VO_ICC09_LichKing_Male_Human_LichKing_02	Не бойся, я не могу тебя атаковать.	
VO_ICC09_LichKing_Male_Human_Lose_01	Кто придет без меча... от него и умрет. Ха.	
VO_ICC09_LichKing_Male_Human_Win_01	Это была моя любимая легендарная карта! Теперь придется ее распылить.	
VO_ICC09_Saurfang_Male_Orc_AttackedByPlayer_01	Не смеши!	
VO_ICC09_Saurfang_Male_Orc_AttacksPlayer_01	Познай могущество Плети!	
VO_ICC09_Saurfang_Male_Orc_AttacksPlayer_02	Я един со смертью!	
VO_ICC09_Saurfang_Male_Orc_AttacksPlayer_03	Король-лич получит все.	
VO_ICC09_Saurfang_Male_Orc_AttacksPlayer_04	Сражайся и умри! Твоя судьба предрешена.	
VO_ICC09_Saurfang_Male_Orc_BloodBeast_01	Веселитесь, слуги мои!	
VO_ICC09_Saurfang_Male_Orc_BloodBeast_02	Сожри их!	
VO_ICC09_Saurfang_Male_Orc_BloodBeast_03	Моя сила растет.	
VO_ICC09_Saurfang_Male_Orc_BloodBeast_04	Мой гнев обратился в плоть!	
VO_ICC09_Saurfang_Male_Orc_BloodBeastStolen_01	Учти, этот запах никогда не выветрится.	
VO_ICC09_Saurfang_Male_Orc_CursedBlade_01	Ну и кто это придумал?	
VO_ICC09_Saurfang_Male_Orc_Death_01	Я... свободен...	
VO_ICC09_Saurfang_Male_Orc_DKTransform_01	Наконец-то! Достойный противник!	
VO_ICC09_Saurfang_Male_Orc_Doomerang_01	Хмм... Надо и мне такой...	
VO_ICC09_Saurfang_Male_Orc_EmoteResponse_01	Трусливая тварь.	
VO_ICC09_Saurfang_Male_Orc_EquipWeapon_01	Во имя Короля-лича!	
VO_ICC09_Saurfang_Male_Orc_EquipWeapon_02	Впечатляет.	
VO_ICC09_Saurfang_Male_Orc_Intro_01	Хочешь узнать, сколь могущественна Плеть?!	
VO_ICC09_Saurfang_Male_Orc_LichKing_01	А что ТЫ здесь делаешь?	
VO_ICC09_Saurfang_Male_Orc_WeaponDestroyed_01	(злобный рык)	
VO_ICC10_Deathwhisper_Female_Lich_DamageByValithria_01	(полный боли крик)	
VO_ICC10_Deathwhisper_Female_Lich_Death_01	Невозможно!..	
VO_ICC10_Deathwhisper_Female_Lich_DKTransform_01	Господин и тебя наделил частицей своей силы...	
VO_ICC10_Deathwhisper_Female_Lich_EmoteResponse_01	Это что, угроза?	
VO_ICC10_Deathwhisper_Female_Lich_Equality_01	Это не слишком удачная идея.	
VO_ICC10_Deathwhisper_Female_Lich_HeroPower_01	Плоть так слаба...	
VO_ICC10_Deathwhisper_Female_Lich_HeroPower_02	Твоя плоть – твое проклятие.	
VO_ICC10_Deathwhisper_Female_Lich_HeroPower_03	Ты осознаешь бессмысленность своих действий?	
VO_ICC10_Deathwhisper_Female_Lich_HeroPower_04	Тьма примет тебя...	
VO_ICC10_Deathwhisper_Female_Lich_HeroPowerInitial_01	Смерть взывает к тебе...	
VO_ICC10_Deathwhisper_Female_Lich_Intro_01	Что? Нарушитель? Значит, мой долг еще не исполнен.	
VO_ICC10_Deathwhisper_Female_Lich_LichKing_01	Господин... Прошу... Я убиваю их так быстро, как могу!	
VO_ICC10_Deathwhisper_Female_Lich_PlayerPlaysEnrage_01	А твои существа любят боль!	
VO_ICC10_Deathwhisper_Female_Lich_StoneskinGargoyle_01	Что?! Здесь работают карты из вольного формата?	
VO_ICC10_Deathwhisper_Female_Lich_ValithriaBlessedChampion_01	Наложи руки на что-нибудь еще, паладин!	
VO_ICC10_Deathwhisper_Female_Lich_ValithriaDivineShield_01	Руки прочь от дракона! И длани тоже!	
VO_ICC10_Deathwhisper_Female_Lich_ValithriaResurrect_01	Мне больше не нравится эта игра.	
VO_ICC10_Deathwhisper_Female_Lich_ValithriaTaunt_01	Теперь я ненавижу эту рептилию еще сильнее.	
VO_ICC10_Deathwhisper_Female_Lich_ValithriaWindfury_01	Омерзительно.	
VO_ICC10_LichKing_Male_Human_DamageByValithria_02	Этот дракон разрушит все, чего мы достигли! Убей ее, Смертный Шепот!	
VO_ICC10_LichKing_Male_Human_Lose_01	А теперь попробуй с лечением!	
VO_ICC10_LichKing_Male_Human_Turn2_01	Смертный Шепот! Я же сказал – прикончить этого дракона!	
VO_ICC10_LichKing_Male_Human_Turn2_02	Для лидера культа смерти ты слишком нерасторопна.	
VO_ICC10_LichKing_Male_Human_Win_01	Твоя колода подвела меня, Смертный Шепот. Радуйся, что ты недолго мучилась.	
VO_ICC10_LichKing_Male_Human_Wounded_01	Хватит играть со своей жертвой, Смертный Шепот.	
VO_ICC10_LichKing_Male_Human_Wounded_02	И почему в твоей колоде нет «Чародейского взрыва»?	
VO_ICCA08_033_Male_HumanGhost_Flavor_01	...помоги нам...	
VO_ICCA08_033_Male_HumanGhost_Flavor_02	...спаси нас...	
VO_ICCA08_033_Male_HumanGhost_Flavor_03	...отсюда не сбежать...	
VO_ICCA08_033_Male_HumanGhost_Flavor_04	...а может, все-таки сбежать?..	
VO_ICCA08_033_Male_HumanGhost_Flavor_05	...тссс!	
VO_ICCA10_001_Female_GreenDragon_Healed_01	Я... излечилась!	
VO_ICCA10_001_Female_GreenDragon_Start_01	Помоги мне, герой... Я... должна выстоять...	
VO_Illhoof_Male_Demon_IlhoofKilrek_01	Иди сюда, Кил'рек. Пора завершить ритуал!	
VO_Illhoof_Male_Demon_IllhoofDeath_02	Нет! Еще немного! Сарге...	
VO_Illhoof_Male_Demon_IllhoofEmoteResponse_01	Твоя сущность питает ритуал!	
VO_Illhoof_Male_Demon_IllhoofOpen_01	О, как раз вовремя!	
VO_Illhoof_Male_Demon_IllhoofSummonImps_01	Придите, живущие во тьме! Явитесь по моему зову!	
VO_Illhoof_Male_Demon_IllhoofSummoningPortal_01	Портал без ритуала? Это гораздо проще...	
VO_Illhoof_Male_Demon_IllhoofTurn1_01	Да начнется ритуал!	
VO_Illhoof_Male_Demon_IllhoofWounded_01	Собирайтесь, слуги мои. Нужно завершить ритуал!	
VO_INNKEEPER_Male_Dwarf_HSNewYearBrawl_02	Год Ворона немного... пострашнее, чем остальные.	
VO_INNKEEPER_Male_Dwarf_HSNewYearBrawl_03	Глядите-ка, кто к нам пожаловал! Предвестник года Ворона!	
VO_INNKEEPER_Male_Dwarf_HSNewYearBrawl_05	В год Ворона творятся очень странные дела.	
VO_INNKEEPER_Male_Dwarf_HSNewYearBrawl_08	Чудовища, что прятались в тенях, становятся смелее.	
VO_INNKEEPER_Male_Dwarf_HSNewYearBrawl_09	Создания тьмы выходят на охоту.	
VO_INNKEEPER_Male_Dwarf_HSNewYearBrawl_10	Монстры с болот подползают ближе...	
VO_Jaraxxus_Male_Demon_FinalMalchezaarJaraxxus_01	Глупый принц. Лучше пой караоке, как Джараксус!	
VO_Jaraxxus_Male_Demon_FinalMalchezaarJaraxxus_02	Исследуем... \nвесь мир вокруг... \nвступа-ай в ряды отважных!	
VO_Julianne_Female_Human_JulianneDeath_01	Ромуло! Я выпью этот кубок за тебя...	
VO_Julianne_Female_Human_JulianneEmoteResponse_01	Не на мой ли счет ты грызешь ноготь?	
VO_Julianne_Female_Human_JulianneFeignDeath_03	И после них очнуться освеженной...	
VO_Julianne_Female_Human_JulianneHeroPower_01	Приди же, ласковая ночь, верни мне моего Ромуло!	
VO_Julianne_Female_Human_JulianneOpen_01	Что ты за дьявол?	
VO_KAR03_MOROES_MALE_HUMAN_CHESS_TURN_1	Фигуры атакуют автоматически в конце вашего хода.	
VO_KAR03_MOROES_MALE_HUMAN_CHESS_TURN_3	Если ваша фигура находится между двумя вражескими, она атакует обе!	
VO_KAR03_MOROES_MALE_HUMAN_CHESS_TURN_5	Правильное расположение – ключ к победе. Используйте двойные атаки!	
VO_KARA_04_01_Female_Human_CroneHuffer_01	Сдается мне, Хаффер, что мы уже не в Западном Крае...	
VO_KARA_04_01_Female_Human_CroneLionTigerBear_02	Львы, драконы и медведи! Кошмар!	
VO_KARA_04_01_Female_Human_CroneTurn1_01	О нет! Она ведь меня не обидит?	
VO_KARA_04_01_Female_Human_CroneTurn3_01	Возьмемся за руки, друзья! Вместе мы сильнее!	
VO_KARA_06_01_Male_Human_JulianneDeadlyPoison_02	Дай мне яду!	
VO_KARA_06_01_Male_Human_JulianneTurn1_01	Ты хочешь драться? Берегись, дитя!	
VO_KT_ANTI_CHEESE1_65	Это героический режим. Я не потерплю таких дешевых уловок.	
VO_KT_ANTI_CHEESE2_66	Вестник рока? Думаешь, ты умнее всех?	
VO_KT_ANTI_CHEESE3_67	Равенство? Только не у меня дома.	
VO_KT_ANUB2_43	НЕ-Е-ЕТ! То есть... неважно. Тебе никогда не победить Великую вдову.	
VO_KT_BARON2_64	Слуги из Военного квартала подвели меня! В наши дни так сложно найти хороших солдат...	
VO_KT_FAERLINA2_45	Фарлина – всего лишь пешка. А вот Паучья Королева С ЛЕГКОСТЬЮ разорвет тебя на куски.	
VO_KT_GLUTH2_73	Я попросил зомби сожрать твои мозги, а они сказали, что не могут питаться воздухом. АХАХАХАХАХА.	
VO_KT_GLUTH2_ALT_74	За проигрыш Глуту дают достижение. Я уверен.	
VO_KT_GLUTH3_75	АХАХАХАХАХА, НИКАКОГО ДОСТИЖЕНИЯ ЗА ПРОИГРЫШ ГЛУТУ НЕ ДАЮТ!	
VO_KT_GLUTH4_76	Нет! И кому теперь скармливать лишних зомби?	
VO_KT_GLUTH5_77	Что может быть лучше истребления? Ну разве что заморозка крови в жилах!	
VO_KT_GLUTH6_78	Хороший пес! Хор-р-р-роший!	
VO_KT_GOTHIK2_62	Ну почему Готик не превращается в Призрачного Готика? Так не интересно!	
VO_KT_GROBBULUS2_71	Да... Над ним еще работать и работать...	
VO_KT_HEIGAN2_55	Я просто вне себя от гнева. Я весь БУРЛЮ.	
VO_KT_LOATHEB2_57	Сколько можно УБИВАТЬ МОИХ СЛУГ! Хватит! Прекрати немедленно!	
VO_KT_MAEXXNA2_47	Ее яд убьет тебя безболезненно. Ну... почти.	
VO_KT_MAEXXNA3_48	Морской великан?! Мексна, ты почему его взяла без разрешения?!	
VO_KT_MAEXXNA4_49	Это невозможно! Ты за это еще заплатишь!	
VO_KT_MAEXXNA6_51	Как назвать игрока, чье существо застряло в паутине? ОБРЕЧЕННЫЙ!	
VO_KT_NOTH2_53	Очуметь, какой поганый день!	
VO_KT_PATCHWERK2_69	Мое поганище! Надо было шить его из кого получше...	
VO_KT_RAZUVIOUS2_59	Ну и кто теперь будет тренировать моих рыцарей смерти?! Я же не могу сам этим заниматься, у меня ДЕЛА!	
VO_KT_SAPPHIRON2_84	Взгляни на этого бедного гнома. Его ТОЖЕ сюда никто не звал.	
VO_KT_SAPPHIRON3_85	Сколько можно прятаться за этой глыбой льда!	
VO_KT_SAPPHIRON4_ALT_87	Сапфирон, переходим к плану «ЗАМОРОЗИТЬ КРОВЬ У НИХ В ЖИЛАХ»!	
VO_KT_SAPPHIRON5_88	Мой дракон! ТЫ МНЕ НЕ НРАВИШЬСЯ.	
VO_KT_THADDIUS2_81	Ну все, незваный гость! Это была последняя капля!	
VO_LichKing_Male_Human_Brawl_01	Вся таверна должна быть уничтожена!	
VO_LichKing_Male_Human_Brawl_03	Выходите против меня, глупцы! Все, кто хочет. Вам не победить!	
VO_LichKing_Male_Human_Brawl_05	Узрите мой запас здоровья и погрузитесь в отчаяние!	
VO_LichKing_Male_Human_ExpansionIntro_02	Ледяная Корона! Явитесь за безграничной мощью... и умрите.	
VO_LichKing_Male_Human_FinaleFirstVictory_01	Не может быть... невозможно! Продолжим до пяти побед?	
VO_LichKing_Male_Human_FinaleLock_01	Тебе не одолеть меня! По крайней мере, пока заблокировано это крыло.	
VO_LichKing_Male_Human_FinaleUnlock_03	Мне бросить Ледяную Скорбь и сдаться на твою милость? Этого не будет.	
VO_LichKing_Male_Human_LowerCitadelUnlock_01	Ледяная Корона! Здесь я собрал самых жутких существ, созданных из чародейной пыли... и моей НЕНАВИСТИ!	
VO_LichKing_Male_Human_PrologueBossCoin_01	Ну же, герой! Я уничтожу тебя, а потом распылю и создам что-то более достойное!	
VO_LichKing_Male_Human_PrologueBossCoin_02	Я сотворил это костяное создание из останков своих лишних карт.	
VO_LichKing_Male_Human_PrologueBossCoin_03	Саурфанг – мой первый легендарный прислужник. Я выстроил все приключение вокруг него.	
VO_LichKing_Male_Human_PrologueBossCoin_04	Это леди Смертный Шепот. Причем ДО нерфа!	
VO_LichKing_Male_Human_PrologueBossCoin_05	Мерзоцид делает мне новые карты, но у него выходят только газ и слизь. Терпеть не могу.	
VO_LichKing_Male_Human_PrologueBossCoin_07	Лана'тель! На МОИХ картах следы ЗУБОВ! Я же говорил – используй ПРОТЕКТОРЫ!	
VO_LichKing_Male_Human_PrologueBossCoin_08	Синдрагоса – мое сильнейшее творение! Не трогать! Она – моя!	
VO_LichKing_Male_Human_PrologueBossCoin_09	Ты будешь МОЛИТЬ о пощаде и судорожно жать на кнопку «Сдаться», но она не сработает.	
VO_LichKing_Male_Human_PrologueBossCoin_11	Посмотри на свою руку, герой. Задумайся, так ли мы несхожи?	
VO_LichKing_Male_Human_PrologueBossCoin_12	И вот я стою, аки лев пред агнцами, и не дрожат они.	
VO_LichKing_Male_Human_ResponseAnubaArak_01	Служи мне, Ануб'арак!	
VO_LichKing_Male_Human_ResponseMalganis_01	Сколько еще раз мне придется тебя одолеть, Мал'Ганис?!	
VO_LichKing_Male_Human_UpperReachesLock_01	Хочешь обратить мою силу против меня? Подожди, пока я найду суперколоду, которая погрузит весь мир во Тьму!	
VO_LichKing_Male_Human_UpperReachesUnlock_01	Ты хочешь обратить мою силу против меня? Ты хоть знаешь, сколько раз я добивался ранга легенды?	
VO_LOE_01_DEATH_2	Орсис! Отомсти за меня!	
VO_LOE_01_RESPONSE	Трепещи перед яростью солнца!	
VO_LOE_01_STAFF	Ха-ха! Он мой!	
VO_LOE_01_STAFF_2	Ты сгоришь!	
VO_LOE_01_STAFF_2_RENO	Постарайся не упускать жезл. Он очень ценный.	
VO_LOE_01_START	Я неуязвим!	
VO_LOE_01_WIN	Ха-ха! Видел бы меня Харрисон!	
VO_LOE_01_WIN_2	Хватай посох!	
VO_LOE_01_WIN_2_ALT_2	А это нормально, что у нас земля уходит из-под ног?	
VO_LOE_01_WOUNDED	Я загнал его в угол! Прикончи его!	
VO_LOE_02_DEATH	Только не в лампу! Неееееееет!	
VO_LOE_02_INTRO	Жезл Солнца мой!	
VO_LOE_02_MORE_WISHES	Поверить не могу, что это сработало.	
VO_LOE_02_PHAERIX_STAFF_RECOVER	Ты не осознаешь всей силы жезла!	
VO_LOE_02_RESPONSE	Феноменальная, безграничная мощь!	
VO_LOE_02_START	Наконец я свободен! Я вознагражу тебя быстрой смертью!	
VO_LOE_02_START2	Исследователь! Я Рено Джексон, всемирно известный археолог, искатель сокровищ и приключений!	
VO_LOE_02_START3	У которого вечно руки чешутся что-то потрогать.	
VO_LOE_02_TURN_10	Представь себе – Жезл Солнца! Он же стоит миллионы!	
VO_LOE_02_TURN_6	Я уже рассказывал, как однажды замаскировался под огра Забытого Города?	
VO_LOE_02_TURN_6_2	А потом прокрался в Лицей Черной горы, чтобы раздобыть...	
VO_LOE_02_WIN	Вперед! Жезл там, в следующем зале!	
VO_LOE_02_WISH	Как это мило: убивает нас, но при этом просит загадывать желания.	
VO_LOE_03_RESPONSE	Торопись!	
VO_LOE_03_TURN_1	Потолок обваливается, повсюду монстры! Поторопись!	
VO_LOE_03_TURN_10	Мы почти выбрались! Я уже вижу свет!	
VO_LOE_03_TURN_2	Ого! Сияющее озеро! Как любопытно...	
VO_LOE_03_TURN_2_2	Сейчас не время!	
VO_LOE_03_TURN_3	Хмм... Налево или направо?	
VO_LOE_03_TURN_3_BOULDER	Берегись, гигантский валун! Он летит прямо в тебя!	
VO_LOE_03_TURN_3_WARNING	Грохот усиливается! Потолок вот-вот обвалится!	
VO_LOE_03_TURN_4	Берегись! Яма с кольями!	
VO_LOE_03_TURN_4_BAD	О-го-го! Это было совсем не смешно.	
VO_LOE_03_TURN_4_GOOD	Без сучка, без задоринки. Почти как я.	
VO_LOE_03_TURN_4_NEITHER	Ты там ползешь по кольям? Поторопись!	
VO_LOE_03_TURN_5	Какая милая статуя. И блестящий рубинчик...	
VO_LOE_03_TURN_5_4	Ой, он, кажется, недоволен... Может, вернем ему камешек?	
VO_LOE_03_TURN_6	Берегись! Потолок рушится!	
VO_LOE_03_TURN_6_2	Уф! Хорошо, что я оказался рядом. Ой, не благодари.	
VO_LOE_03_TURN_7	Не видно ни зги, но с этой штукой мы найдем выход. Вперед!	
VO_LOE_03_TURN_7_2	На моей карте отметка: «Туда нельзя».	
VO_LOE_03_TURN_8	Уф! Становится жарковато. Не будем медлить!	
VO_LOE_03_TURN_9	Фу. Опять жуки.	
VO_LOE_03_WIN	Ура! Я даже рад снова оказаться в этой пустыне... погоди, а где моя фляжка с водой?	
VO_LOE_04_RESPONSE	Трогги бить болванов!	
VO_LOE_04_SCARVASH_TURN_2	Трогг не болван! Трогг как жахнет – увидишь, кто болван!	
VO_LOE_04_START	Ульдаман – только для троггов!	
VO_LOE_04_WIN	Их еще много! Сюда, запрыгивай в вагонетку!	
VO_LOE_07_RESPONSE	Думаешь, у нас есть на это время?	
VO_LOE_07_START	Берегись, за нами погоня!	
VO_LOE_07_WIN	Ха-ха! Кататься в вагонетке и раскидывать бомбы – вот это жизнь!	
VO_LOE_08_ANIMATE_STONE	Пробудитесь, земля и камень!	
VO_LOE_08_LANDSLIDE	Я тебя закопаю!	
VO_LOE_08_RESPONSE	Прах к праху.	
VO_LOE_08_START	У кого хватило дерзости прогневать Создателей?	
VO_LOE_08_WIN	Навершие у нас! Остался всего один фрагмент!	
VO_LOE_092_Attack_02	Получай!	
VO_LOE_10_NYAH	Мррглмрргл! Ня!	
VO_LOE_10_RESPONSE	Мррглмрргл!	
VO_LOE_10_RESPONSE_ALT_read	А ты что здесь делаешь, Средний Плавник?	
VO_LOE_10_START	Мррглмрргл!	
VO_LOE_10_START_2	Я не ослышался? Как грубо.	
VO_LOE_10_TURN_2_GIANTFIN	Мрггггл! Мррглмрргл!	
VO_LOE_10_TURN1	Мрггггл! Мррглмрргл!	
VO_LOE_10_WIN	Какая жалость. При должном воспитании из него мог выйти неплохой парень.	
VO_LOE_12_NAZJAR_PEARL	Поразительно! Жемчужина Приливов превзошла все мои ожидания!	
VO_LOE_12_NAZJAR_TURN_1	Я – клинок Азшары. Ты – ничто передо мной!	
VO_LOE_12_NAZJAR_TURN_1_FINLEY	Я – сэр Финли Мрргглтон. Мое почтение.	
VO_LOE_12_NAZJAR_TURN_3_FINLEY	Элиза, как далеко продвинулись остальные?	
VO_LOE_12_NAZJAR_TURN_5	Армии глубин, поднимитесь из пучины и смойте наших врагов!	
VO_LOE_12_NAZJAR_TURN_5_FINLEY	К чему такие крайности?	
VO_LOE_12_NAZJAR_TURN_7_FINLEY	Мрггггл! Мррглмрргл!	
VO_LOE_12_NAZJAR_TURN_7_FINLEY_2	Прошу прощения, иногда я забываюсь.	
VO_LOE_12_RESPONSE	Я владею силой жемчужины!	
VO_LOE_12_START	Мощь прилива поглотит тебя!	
VO_LOE_12_WIN	Браво! Жемчужина наша! Пора возвращаться в Зал Исследователей, где мы наконец-то соберем посох воедино.	
VO_LOE_13_RESPONSE	АРРРРР!	
VO_LOE_13_START_2	Р-р-р!	
VO_LOE_13_TURN_1	Посох проклят! Он призвал в наши хранилища эфириала, который крадет все подряд!	
VO_LOE_13_TURN_1_2	Не все. Только лучшее.	
VO_LOE_13_TURN_5	Это правда печатка Артаса? Да еще и в превосходном состоянии!	
VO_LOE_13_TURN_5_2	Рено, Бранн, прячьте артефакты!	
VO_LOE_13_TURN_9	Он оживляет армию! Элиза, останови его!	
VO_LOE_13_TURN_9_2	Те-заксус налоре! Посох слишком силен, но я его задержу!	
VO_LOE_13_WIN	Мы разберемся с экспонатами. А ты займись Рафаамом!	
VO_LOE_14_RESPONSE	ЩЕЛК!	
VO_LOE_14_START	Это же броня Лотара! Ради нее мне пришлось целый месяц просеивать драконий навоз в Черной Горе!	
VO_LOE_14_TURN_13	Бранн, он оживляет библиотечные книги! Я разберусь с летающими молотами с лордеронской выставки.	
VO_LOE_14_TURN_5	Я обезвредил ожившие мечи в восточном зале. Куда теперь?	
VO_LOE_14_TURN_5_2	Иди к Рено в главное хранилище! Его окружили взрыв-боты!	
VO_LOE_14_TURN_9	Пока никто не видит, я, пожалуй, прикарманю эту брошку.	
VO_LOE_14_WIN	Музей в безопасности! Ступай, разберись с Рафаамом!	
VO_LOE_15_RESPONSE	Какие чудесные карты!	
VO_LOE_15_SPARE	Исследователь! Держи, у нас есть свободная колода!	
VO_LOE_16_BOOM_BOT	Ой, у нас таких на свалке полно. В утиль его!	
VO_LOE_16_CROWN	Чувствуешь чары черного чародея?	
VO_LOE_16_EYE	Занятно... Как эта штука оказалась в моем кармане? Бери, мне не жалко.	
VO_LOE_16_FIRST_ITEM	Мы осмотрим музей в поисках полезных вещиц. Если тебе что-то понадобится – зови!	
VO_LOE_16_GOBLET	Ненавижу змей.	
VO_LOE_16_GREAVE	Хорошо хоть часть доспехов Лотара осталась неповрежденной.	
VO_LOE_16_LOCKET	В этом медальоне томятся духи Каражана.	
VO_LOE_16_PIPE	Лови! Только Бранну не говори – он обожает эту трубку!	
VO_LOE_16_RAFAAM_DEATH2	Нет! Меня не победить!	
VO_LOE_16_SHARD	Это было в коробке с надписью «Не открывать». Так что удачи.	
VO_LOE_16_SPLINTER	А эту штуку я нашел в Огненных Недрах. Мажордом ей в зубах ковырял.	
VO_LOE_16_START_2	Берегись! Посох заряжается!	
VO_LOE_16_TEAR	Это священный артефакт моего народа. Быстрее, пей!	
VO_LOE_16_TURN_2	Посох почти зарядился! Приготовься!	
VO_LOE_16_TURN_2_2	Ха-ха! Меня переполняет мощь!	
VO_LOE_16_TURN_2_3	Посох перегружен! Не упусти шанс!	
VO_LOE_16_TURN_3	Я неуязвим! Вам не справиться со мной!	
VO_LOE_16_TURN_3_2	Посох снова заряжается. Еще немного – и у нас снова появится шанс нанести удар.	
VO_LOE_16_TURN_4	Посох почти готов. А ты?	
VO_LOE_16_TURN_5	Ха-ха! Меня переполняет мощь!	
VO_LOE_16_TURN_5_2	Его щиты пали! Бей!	
VO_LOE_16_TURN_6	Берегись, он снова под защитой.	
VO_LOE_16_VIAL	Тут написано «Выпей меня», но мы нашли этот сосуд в Наксрамасе, так что побоялись пробовать.	
VO_LOE_ARCHAEDAS_TURN_1_CARTOGRAPHER	Если б отвлекся от своих попыток похоронить вас под камнями.	
VO_LOE_GIANTFIN_TIDEHUNTER_2	Нет, Финли. Думаю, ты уже тогда мечтал о чем-то большем.	
VO_LOE_NAZJAR_TURN_3_CARTOGRAPHER	Рено уже вернулся с жезлом Солнца. Бранн скоро будет.	
VO_LOE_SCARVASH_TURN_6_CARTOGRAPHER	Сосредоточься, Бранн!	
VO_LOE_ZINAAR_TURN_10_CARTOGRAPHER_2	Мы его не продадим.	
VO_LOE_ZINAAR_TURN_6_CARTOGRAPHER_2	Да.	
VO_LOE_ZINAAR_TURN_6_CARTOGRAPHER_2_ALT	Да.	
VO_LOE10_DEAD_MURLOCS	Столько погибших... Как нерационально.	
VO_LOE10_NYAH_FINLEY	Как не стыдно! Ведешь себя как ребенок!	
VO_LOE10_TIDEHUNTER	До того, как меня нашла Элиза, я всерьез готовился к карьере волнолова. Неужели я бы стал таким же, как они?	
VO_LOE10_TURN_2_FINLEY	Собратья! Неужели мы не можем решить дело миром?	
VO_LOE10_TURN_2_FINLEY_2	Полагаю, этого следовало ожидать.	
VO_LOEA04_BRANN_TURN_1	Когда я тут был в последний раз, Скарваш еще под стол пешком ходил. А теперь гляди, какой болван вымахал!	
VO_LOEA04_BRANN_TURN_6	Потрясающе! Эти мифриловые руны содержат охранный код. Должно быть, они созданы в эпоху титанов!	
VO_LOEA07_MINE_ALMOST_DONE	Уже иду! Интересно, а для чего эта кнопка?..	
VO_LOEA07_MINE_ARCHAEDAS	Клянусь бородой Магни! Это же сам Аркедас?!	
VO_LOEA07_MINE_BARREL_FORWARD	Летим на всех парах!	
VO_LOEA07_MINE_BOOM	Прыгающие бомбы! Получите!	
VO_LOEA07_MINE_BOOMZOOKA	Бум! Сейчас еще заряжу!	
VO_LOEA07_MINE_DETONATE	Хочешь подорвать шахту? Ты в своем уме?	
VO_LOEA07_MINE_DYNAMITE	Эй, осторожнее! Так можно и вагонетку опрокинуть!	
VO_LOEA07_MINE_HUNKER_DOWN	Ложись!	
VO_LOEA07_MINE_PARROT	Лети, Джинни!	
VO_LOEA07_MINE_RAMMING	Ха-ха! Прочь с дороги!	
VO_LOEA07_MINE_REPAIRS	Немного зелья из потрошков – и все как новое!	
VO_LOEA07_MINE_SPIKED_DECOY	Эй, глупые трогги! Сюда! Поймайте меня!	
VO_LOEA08_TURN_1_BRANN	Слуга древних Титанов... Сколько историй он мог бы нам рассказать!	
VO_LOEA09_1_RESPONSE	А вот и десерт пожаловал!	
VO_LOEA09_1_TURN1	Вы посмели проникнуть в разрушенный город?	
VO_LOEA09_FINLEY_DEATH	Я пока отдохну... А ты разберись с нагой!	
VO_LOEA09_HERO_POWER	Время обедать! Блюдо дня – суп из мурлока!	
VO_LOEA09_HERO_POWER1	Здравствуй, исследователь. У меня возникли небольшие затруднения. Не поможешь коллеге?	
VO_LOEA09_HERO_POWER2	Здесь ужасно темно.	
VO_LOEA09_HERO_POWER3	Ой, мамочки. Становится жарковато.	
VO_LOEA09_HERO_POWER4	Надо заметить, все это крайне неприятно.	
VO_LOEA09_HERO_POWER5	Уффф... Как же тут жарко!	
VO_LOEA09_HERO_POWER6	Я бы не отказался от помощи.	
VO_LOEA09_QUOTE1	Спасибо! Я едва не погиб.	
VO_LOEA09_UNSTABLE	А ну-ка вернись в котел!	
VO_LOEA09_WIN	Благодарю, исследователь. Ну что, пойдем за последним фрагментом?	
VO_LOEA10_1_MIDDLEFIN	А ты что здесь делаешь, Средний Плавник?	
VO_LOEA15_1_LOSS_11	Твоя колода – полный хлам! Возьму-ка я лучше свою.	
VO_LOEA15_1_LOW_HEALTH_10	Ох, зря я взял твою колоду...	
VO_LOEA15_1_MAGMA_RAGER_09	Магмовый яростень? Кто вообще играет такими картами?!	
VO_LOEA15_1_START_07	Мне нравится твоя колода. Давай-ка, я ее заберу.	
VO_LOEA15_1_TURN1_08	О-о, да! Отличные картишки.	
VO_LOEA15_1_WIN_12	Прекрасная колода! Ха-ха...	
VO_LOEA15_GOLDEN	Да ладно? Вся колода – золотая? Мне нравится твоя коллекция...	
VO_LOEA16_1_CARD_04	Я собрал артефакты из сотен миров!	
VO_LOEA16_1_RESPONSE_03	Да! Да!	
VO_LOEA16_1_START_01	Узри всю мощь Посоха!	
VO_LOEA16_1_TURN1_02	Я неуязвим! В моих руках сила титанов!	
VO_LOOT_329_Male_Elemental_Attack_01	Иссохни.	
VO_LOOT_329_Male_Elemental_Death_01	<Умирает>	
VO_LOOT_329_Male_Elemental_Play_01	Жизнь загнивает. Гниль живет.	
VO_LOOT_541_Male_Kobold_BOSS_AFKay_01	Все на нее! Колотить людишку, пока не очнулась!	
VO_LOOT_541_Male_Kobold_BOSS_Blackseed_01	Чернозерн копаться глубоко, скрываться. А появляться... с цеплялками.	
VO_LOOT_541_Male_Kobold_BOSS_Brimstone_01	Тс-с! У статуин глаза! Мигучие такие! Не будить!	
VO_LOOT_541_Male_Kobold_BOSS_Candlebeard_01	Свечебород думать, что раз кобольд нашел клад, то он уже пират.	
VO_LOOT_541_Male_Kobold_BOSS_Chronomancer_01	Временная магичка! Мы снова встретиться в первый раз!	
VO_LOOT_541_Male_Kobold_BOSS_Everrot_01	Не трогать споры! Пусть существа их трогать!	
VO_LOOT_541_Male_Kobold_BOSS_Flurgl_01	Кобольды не понимать мурлоков. Они говорить много-непонятно.	
VO_LOOT_541_Male_Kobold_BOSS_GeorgeKarl_01	Эти дурак приходить сюда из джунглей.	
VO_LOOT_541_Male_Kobold_BOSS_Gnosh_01	Этот тоннель — вообще не тоннель. Большой рот! Зубастый!	
VO_LOOT_541_Male_Kobold_BOSS_Graves_01	Весь такой святоша-святоша. Всякие Светы-милосердия. Убей его!	
VO_LOOT_541_Male_Kobold_BOSS_Gutmook_01	Трогги. Тьфу! Твоя молчать, а твоя существа бить морду!	
VO_LOOT_541_Male_Kobold_BOSS_Hamm_01	Хамм лучшие тоннели копать. «Лучшие» быть эфермизм.	
VO_LOOT_541_Male_Kobold_BOSS_Jeeru_01	Ой, не-не-не-не! Не тереть лампу, это хитрый ловушка!	
VO_LOOT_541_Male_Kobold_BOSS_Lyris_01	Чокнутый эльфийка. Твоя следить за ее подлыми горящими змеюками.	
VO_LOOT_541_Male_Kobold_BOSS_MagmaRager_01	Кобольды заколачивать тоннель с лавой, но он как-то расколачивается!	
VO_LOOT_541_Male_Kobold_BOSS_Mothergloop_01	Берегися Матери слизней. Из ее слизи все слизни выслизиваться!	
VO_LOOT_541_Male_Kobold_BOSS_Mushhuckster_01	Грибопродавец Макс выползти из подземный трущоба!	
VO_LOOT_541_Male_Kobold_BOSS_Russell_01	Этот бард петь так плохо, что мне хотеться бить в лицо!	
VO_LOOT_541_Male_Kobold_BOSS_Seriona_01	Дурацкий сумеречный дракон делать кобольдов слабыми! Эм, слабее.	
VO_LOOT_541_Male_Kobold_BOSS_Sturmi_01	Стурми делать дружков из воска! Ей радоваться у нас на вечеринках!	
VO_LOOT_541_Male_Kobold_BOSS_TrappedRoom_01	Т-с-с... Не трогать... НИЧЕГО!	
VO_LOOT_541_Male_Kobold_BOSS_TreasureVault_01	Сокровище! Здесь клад! Твоя ломать и грабить!	
VO_LOOT_541_Male_Kobold_BOSS_Troll_01	В каждый уважаемый подземелье для баланса нужен быть босс-тролль!	
VO_LOOT_541_Male_Kobold_BOSS_Whopwhisker_01	Старина Усач-убивач есть самый сердитый кобольд!	
VO_LOOT_541_Male_Kobold_DefeatPlayer_01	Столько сокровищ! Хе-хе... Мое-мое-мое-мое.	
VO_LOOT_541_Male_Kobold_EmoteResponse_01	Хватит языком шлепать.	
VO_LOOT_541_Male_Kobold_LOOT_Backpacks_01	Мешки, ранцы! Много сокровищ таскать!	
VO_LOOT_541_Male_Kobold_LOOT_Boombox_01	Ящик бабах – лучший ящик бабах среди всех ящиков бабах!	
VO_LOOT_541_Male_Kobold_LOOT_Candle1_01	Не трогай свечу!	
VO_LOOT_541_Male_Kobold_LOOT_Candle2_01	Я говорить! Я говорить не трогать, а ты все равно трогать!	
VO_LOOT_541_Male_Kobold_LOOT_CapturedFlag_01	Альянс и Орда всегда беситься, когда трогать их флаг.	
VO_LOOT_541_Male_Kobold_LOOT_Cube_01	Чокнутый коробка! Побеждать — это не для твоя, да?	
VO_LOOT_541_Male_Kobold_LOOT_Invisibility_01	Тряпка невидимости! Моя терять ее, она невидимая!	
VO_LOOT_541_Male_Kobold_LOOT_QuelDelar_01	Кель'делар! Легендарный меч ломайся надвое. Моя не виноват!	
VO_LOOT_541_Male_Kobold_LOOT_QuelDelarForged_01	Красивость! Блестит! И прям такой... меч!	
VO_LOOT_541_Male_Kobold_LOOT_Wand_01	Кобольды любить карту «Палка-сжигалка», она испытывать навыки!	
VO_LOOT_541_Male_Kobold_LOOT_WaxRager_01	Восковой яростень очень сильный друг. Твоя не спрашивай, откуда воск. Из ушей он.	
VO_LOOT_541_Male_Kobold_TUT_AdventureSelect_01	Чем пахнет? Кожа? Железки? Факелы... ПРИКЛЮЧАТЕЛИ! Фу! Приключатели гадкие.	
VO_LOOT_541_Male_Kobold_TUT_BossHeroPower_01	Каждый чудище делать что-то свое, но всегда гадкое. Твоя щелкай и смотри!	
VO_LOOT_541_Male_Kobold_TUT_BountyBoard_01	Стоять! Назад! Большие кучи блестяшек МНЕ, а не ТЕБЕ.	
VO_LOOT_541_Male_Kobold_TUT_CharacterSelect_01	Кто посметь прийти за сокровищами кобольдов? Мечемахатель? Огнепускатель?	
VO_LOOT_541_Male_Kobold_TUT_Final_Boss_Azari_01	Пожирателя выпустили! Все бежать!	
VO_LOOT_541_Male_Kobold_TUT_Final_Boss_Darkness_01	Темнота — смертопасно! Поэтому кобольды носят свечку!	
VO_LOOT_541_Male_Kobold_TUT_Final_Boss_KoboldKing_01	Мой ход, хи-хи! Моя собирай все блестяхи, которые твоя копить отовсюду.	
VO_LOOT_541_Male_Kobold_TUT_Final_Boss_Vustrasz_01	Твоя забирай, что ныкать дракоша? О-о, она сильно сердиться...	
VO_LOOT_541_Male_Kobold_TUT_Final_Boss_Xol_01	Твоя не смотреть Зол в глаза! У нее куча глазов — ни в какие не смотреть!	
VO_LOOT_541_Male_Kobold_TUT_Game1Begin1_01	Сперва твоя находить слабый монстры. Прямо как ты слабый.	
VO_LOOT_541_Male_Kobold_TUT_Game1Begin2_01	Твоя их бить и забирать их добро себе, чтобы стать сильнее!	
VO_LOOT_541_Male_Kobold_TUT_Game1Defeat_01	Ничего. Умереть молодым более лучше, чем не умереть совсем.	
VO_LOOT_541_Male_Kobold_TUT_Game1Victory_01	Твоя победить! Теперь хватай клад. Ха-ха, классический приключатель.	
VO_LOOT_541_Male_Kobold_TUT_Game2Begin1_01	Когда твоя сильнее, чудища тоже сильнее.	
VO_LOOT_541_Male_Kobold_TUT_Game2Begin2_01	Финансовая эластичность является важным элементом экономической доктрины смешанного рынка империи кобольдов.	
VO_LOOT_541_Male_Kobold_TUT_GeneralDefeat1_01	Плохо. Совсем для тебя плохо. Когда приключатели умирать, король кобольдов забирать их сокровища!	
VO_LOOT_541_Male_Kobold_TUT_GeneralDefeat2_01	Моя хотеть еще больше приключателей! Больше сокровищ, блестяшек, кладов!	
VO_LOOT_541_Male_Kobold_TUT_MainBoss1_01	В империи кобольдов твоя находить много чудищ. Каждый бой делай тебя сильнее! Или мертвее.	
VO_LOOT_541_Male_Kobold_TUT_MainBoss3_01	За один заход в подземелье драться с восемь чудищ! Сколько пальцев, столько чудищ!	
VO_LOOT_541_Male_Kobold_TUT_TreasureSelect1_01	О-о-о, большой блестяха! Твоя брать только одну. Твоя мудро выбирать.	
VO_LOOT_541_Male_Kobold_TUT_TreasureSelect2_01	Карты, которые ты хватай, потом класть в колода подземелий.	
VO_LOOT_541_Male_Kobold_TUT_TreasureSelect3_01	Твоя делать колоду, чтобы колотить чудищ. Это твоя колода, пока твоя не умирай!	
VO_LOOT_541_Male_Kobold_TUT_TreasureSelect4_01	Больше чудищ бить, больше блестяшек забирать! Так все кобольды делают.	
VO_LOOT_541_Male_Kobold_TUT_Victory1_01	Что?! Никто не уходить просто так с блестяхами кобольдов!	
VO_LOOT_541_Male_Kobold_TUT_Victory2_01	Точно не девять разных раз!	
VO_LOOT_541_Male_Kobold_TUT_VictoryComplete_01	Твоя бить подземелья, как не бить никто, даже самые крутые подземельные мастеры!	
VO_LOOT_541_Male_Kobold_TUT_VictoryComplete_02	У твоя получайся!\nТвоя теперь мастер!	
VO_LOOTA_829_Male_Human_Event_01	Будь я проклят за это неожиданное, но неизбежное предательство!	
VO_LOOTA_BOSS_04h_Female_Kobold_Death_01	<Умирает>	
VO_LOOTA_BOSS_04h_Female_Kobold_DefeatPlayer_01	Не шевелись. Дай воску застыть... Тебе так хорошо! Очень-очень!	
VO_LOOTA_BOSS_04h_Female_Kobold_EmoteResponse_01	Моя воскомант, а не воскоскреб.	
VO_LOOTA_BOSS_04h_Female_Kobold_EventWaxOff_01	Воск разотри...	
VO_LOOTA_BOSS_04h_Female_Kobold_EventWaxOn_01	Воск нанеси...	
VO_LOOTA_BOSS_04h_Female_Kobold_EventWaxRagerPlay_01	Ого... Кр-р-расота!	
VO_LOOTA_BOSS_04h_Female_Kobold_EventWaxRagerRespawn_01	Он снова вернуться, да?	
VO_LOOTA_BOSS_04h_Female_Kobold_Intro1_01	О да, гхм, у воска есть глаза...	
VO_LOOTA_BOSS_04h_Female_Kobold_Intro2_01	Моя делать красоту. Восковую красивую красоту.	
VO_LOOTA_BOSS_05h_Male_Kobold_Death_01	<Умирает>	
VO_LOOTA_BOSS_05h_Male_Kobold_DefeatPlayer_01	Бам! Ай да Хамм!	
VO_LOOTA_BOSS_05h_Male_Kobold_EmoteResponse_01	Не трогай бум-бум.	
VO_LOOTA_BOSS_05h_Male_Kobold_EventBoomBots_01	Чудно. ЧУДНО! Чуд-нень-ко!	
VO_LOOTA_BOSS_05h_Male_Kobold_EventMadBomberDeath_01	Ну кто так делает...	
VO_LOOTA_BOSS_05h_Male_Kobold_HeroPower1_01	Ба-бах, детка! БА-БАХ!	
VO_LOOTA_BOSS_05h_Male_Kobold_HeroPower2_01	Ха-ха-ха!	
VO_LOOTA_BOSS_05h_Male_Kobold_HeroPower3_01	Ха-ха-ха-ха.	
VO_LOOTA_BOSS_05h_Male_Kobold_Intro_01	Время разрушать!	
VO_LOOTA_BOSS_06h_Male_Furbolg_Death_01	В глубинах... ждет другой...	
VO_LOOTA_BOSS_06h_Male_Furbolg_DefeatPlayer_01	Я... убил это создание? Что же я натворил?..	
VO_LOOTA_BOSS_06h_Male_Furbolg_EmoteResponse_01	Ты просто еще один... голос...	
VO_LOOTA_BOSS_06h_Male_Furbolg_EventPlayerEvolves_01	Я чую в тебе касание тьмы.	
VO_LOOTA_BOSS_06h_Male_Furbolg_HeroPower1_01	Я слышу зов...	
VO_LOOTA_BOSS_06h_Male_Furbolg_HeroPower2_01	Эти пещеры глубоки.	
VO_LOOTA_BOSS_06h_Male_Furbolg_HeroPower3_01	Все не то, чем кажется...	
VO_LOOTA_BOSS_06h_Male_Furbolg_HeroPower4_01	И кто здесь чудовище?	
VO_LOOTA_BOSS_06h_Male_Furbolg_HeroPower5_01	Ты не видишь теней... но они видят тебя.	
VO_LOOTA_BOSS_06h_Male_Furbolg_Intro_01	В этих пещерах затаилось нечто зловещее...	
VO_LOOTA_BOSS_09h_Female_Furbolg_Death_01	<Умирает>	
VO_LOOTA_BOSS_09h_Female_Furbolg_DefeatPlayer_01	Вот так решают проблемы в Зимних Ключах.	
VO_LOOTA_BOSS_09h_Female_Furbolg_EmoteResponse_01	Какой холодный тон.	
VO_LOOTA_BOSS_09h_Female_Furbolg_EventFrostMagic1_01	Вижу, ты тоже любишь холод.	
VO_LOOTA_BOSS_09h_Female_Furbolg_EventFrostMagic2_01	<Дрожит>	
VO_LOOTA_BOSS_09h_Female_Furbolg_EventFrostMagic3_01	Мороз по шкуре!	
VO_LOOTA_BOSS_09h_Female_Furbolg_HeroPower1_01	Постой тут.	
VO_LOOTA_BOSS_09h_Female_Furbolg_HeroPower2_01	О нет. Какая жалость.	
VO_LOOTA_BOSS_09h_Female_Furbolg_HeroPower3_01	Замри.	
VO_LOOTA_BOSS_09h_Female_Furbolg_Intro_01	Сколько раз вам, кобольдам, говорить... о, а это кто у нас?	
VO_LOOTA_BOSS_10h_Male_Human_Death_01	Так и было... предначертано...	
VO_LOOTA_BOSS_10h_Male_Human_DefeatPlayer_02	Я реквизирую эти сокровища! Во имя Света! И для себя.	
VO_LOOTA_BOSS_10h_Male_Human_EmoteResponse_01	Не моли о пощаде, это не поможет!	
VO_LOOTA_BOSS_10h_Male_Human_EventOverdraw_01	Это какой-то североземский синдром...	
VO_LOOTA_BOSS_10h_Male_Human_HeroPower1_01	Уверуйте!	
VO_LOOTA_BOSS_10h_Male_Human_HeroPower2_01	Исцелитесь!	
VO_LOOTA_BOSS_10h_Male_Human_HeroPower3_01	Отриньте тьму!	
VO_LOOTA_BOSS_10h_Male_Human_HeroPower4_01	Свет дарует милосердие.	
VO_LOOTA_BOSS_10h_Male_Human_HeroPower5_01	Славно!	
VO_LOOTA_BOSS_10h_Male_Human_Intro_01	Стоять! Во имя Света я реквизирую эти сокровища!	
VO_LOOTA_BOSS_11h_Male_Trogg_Death_01	<Умирает>	
VO_LOOTA_BOSS_11h_Male_Trogg_DefeatPlayer_01	Настоящий лидер — это тот, кто указывает путь и хлещет отстающих.	
VO_LOOTA_BOSS_11h_Male_Trogg_EmoteResponse_01	Болтовня не поможет. А вот ХЛЫСТ — да!	
VO_LOOTA_BOSS_11h_Male_Trogg_EventEquality_01	Этих уже высекли.	
VO_LOOTA_BOSS_11h_Male_Trogg_HeroPower1_01	Шевелись!	
VO_LOOTA_BOSS_11h_Male_Trogg_HeroPower2_01	Живей!	
VO_LOOTA_BOSS_11h_Male_Trogg_HeroPower3_01	Быстрее!	
VO_LOOTA_BOSS_11h_Male_Trogg_HeroPower4_01	Не стой без дела!	
VO_LOOTA_BOSS_11h_Male_Trogg_HeroPower5_01	Хлыста, еще хлыста!	
VO_LOOTA_BOSS_11h_Male_Trogg_Intro_01	Время боли!	
VO_LOOTA_BOSS_12h_Male_Kobold_CandleAttack1_01	Твоя делай свечу очень злым!	
VO_LOOTA_BOSS_12h_Male_Kobold_CandleAttack2_01	Не дразни свечу!	
VO_LOOTA_BOSS_12h_Male_Kobold_CandleAttack3_01	Раканишу!	
VO_LOOTA_BOSS_12h_Male_Kobold_CandleAttack4_01	Свеча давай твоя по мордам!	
VO_LOOTA_BOSS_12h_Male_Kobold_CandleAttack5_01	Не злить свечу! По морде давать.	
VO_LOOTA_BOSS_12h_Male_Kobold_Death_01	Не... трогай...	
VO_LOOTA_BOSS_12h_Male_Kobold_Death1_01	Вот и меня протащили под килем...	
VO_LOOTA_BOSS_12h_Male_Kobold_Death2_01	Йо-хо... ох-х...	
VO_LOOTA_BOSS_12h_Male_Kobold_Death3_01	Меня? На корм акулам?!	
VO_LOOTA_BOSS_12h_Male_Kobold_DefeatPlayer_01	Ха, твой план рванул, как трюм от кулеврины!	
VO_LOOTA_BOSS_12h_Male_Kobold_DefeatPlayer_02	Столько блестяшек! Ха-ха, теперь нести и показывать все Рафааму...	
VO_LOOTA_BOSS_12h_Male_Kobold_EmoteResponse_01	Закройся, сухопутная крыса!	
VO_LOOTA_BOSS_12h_Male_Kobold_EventCandleStolen_01	ЧТО?! Политика нетрогания свечи непонятная?	
VO_LOOTA_BOSS_12h_Male_Kobold_EventChargeBigMinion_01	Йо-хо-хо... ОГО!	
VO_LOOTA_BOSS_12h_Male_Kobold_EventFindCandle_01	О, милый свечечка! Тише, маленький, я брать... я...	
VO_LOOTA_BOSS_12h_Male_Kobold_EventPlayCandle_01	МОЯ ГОВОРИТЬ НЕ ТРОГАЙ!	
VO_LOOTA_BOSS_12h_Male_Kobold_EventPlayerPlaysCrab_01	А ну, убери! Убери!!!	
VO_LOOTA_BOSS_12h_Male_Kobold_EventPlayerPlaysPatches_01	Нет! Я здесь главный! Я!	
VO_LOOTA_BOSS_12h_Male_Kobold_EventPlayKoboldKing_01	Твоя цареубийца.	
VO_LOOTA_BOSS_12h_Male_Kobold_GetTreasure1_01	Моя тоже брать сокровище!	
VO_LOOTA_BOSS_12h_Male_Kobold_GetTreasure2_01	Королям кобольдов — королевские блестяшки!	
VO_LOOTA_BOSS_12h_Male_Kobold_GetTreasure3_01	Что моя получай? О-о, хорошо получай!	
VO_LOOTA_BOSS_12h_Male_Kobold_GetTreasure4_01	М-м! Блестяшка!	
VO_LOOTA_BOSS_12h_Male_Kobold_GetTreasure5_01	Мой подземелье! Мой сокровища!	
VO_LOOTA_BOSS_12h_Male_Kobold_Intro_01	Твоя ронять все сокровища! Моя брать! Все мое!	
VO_LOOTA_BOSS_12h_Male_Kobold_Intro1_01	Растудыть меня книппелем!	
VO_LOOTA_BOSS_12h_Male_Kobold_Intro2_01	Шлюп мне в глотку!	
VO_LOOTA_BOSS_12h_Male_Kobold_Intro3_01	Это... Стеньгу мне под килем!	
VO_LOOTA_BOSS_13h_Female_Undead_Death_01	<Умирает>	
VO_LOOTA_BOSS_13h_Female_Undead_DefeatPlayer_01	Так, посмотрим, что тут у тебя... Серьезно? Да кто в своем уме возьмет эти карты?	
VO_LOOTA_BOSS_13h_Female_Undead_EmoteResponse_01	Ты здесь впервые, да? У нас тут не особо болтают.	
VO_LOOTA_BOSS_13h_Female_Undead_EventBagOfCoins_01	О, ничего так состояньице...	
VO_LOOTA_BOSS_13h_Female_Undead_EventStealQuest_01	Держи вора!	
VO_LOOTA_BOSS_13h_Female_Undead_HeroPower_01	Прячься!	
VO_LOOTA_BOSS_13h_Female_Undead_HeroPower1_01	Назад.	
VO_LOOTA_BOSS_13h_Female_Undead_HeroPower2_01	Живее.	
VO_LOOTA_BOSS_13h_Female_Undead_HeroPower3_01	Тебя скрывают тени...	
VO_LOOTA_BOSS_13h_Female_Undead_HeroPower4_01	Никогда не подставляйся.	
VO_LOOTA_BOSS_13h_Female_Undead_Intro_01	Отдай сокровища, и я убью тебя быстро.	
VO_LOOTA_BOSS_15h_Male_Human_Death_01	<Умирает>	
VO_LOOTA_BOSS_15h_Male_Human_DefeatPlayer_01	Если мы хотим вернуться в Ун'горо, может, нам стоит пойти ВОН ТУДА?	
VO_LOOTA_BOSS_15h_Male_Human_EmoteResponse_01	Я тебя в Ун'горо не встречал?	
VO_LOOTA_BOSS_15h_Male_Human_Intro_01	Свет тебя побери, Карл! Ну и куда нас занесло?!	
VO_LOOTA_BOSS_15h_Male_Human_PartnerDeath_01	Свет милостивый, они убили Карла!	
VO_LOOTA_BOSS_15h_Male_Human_TaggedIn1_01	Подвинься, теперь я главный.	
VO_LOOTA_BOSS_15h_Male_Human_TaggedIn2_01	Хватит глупостей. Давай сюда карты.	
VO_LOOTA_BOSS_15h_Male_Human_TaggedIn3_01	Пусти. Теперь МОЯ очередь.	
VO_LOOTA_BOSS_16h_Male_Troll_Death_01	Теперь я буду говорить сам с собой!	
VO_LOOTA_BOSS_16h_Male_Troll_DefeatPlayer_01	Эй, не бойся, маленький труп. Азун тебя не бросит.	
VO_LOOTA_BOSS_16h_Male_Troll_EmoteResponse_01	Я говорю с мертвяками. А ты говори с рукой.	
VO_LOOTA_BOSS_16h_Male_Troll_EventPlayerDeathrattle1_01	О! О! А вот это неплохо.	
VO_LOOTA_BOSS_16h_Male_Troll_EventPlayerDeathrattle2_01	Тут никто не покоится с миром.	
VO_LOOTA_BOSS_16h_Male_Troll_EventPlayerDeathrattle3_01	А давай-ка я помогу.	
VO_LOOTA_BOSS_16h_Male_Troll_EventPlayerDeathrattle4_01	Вот кому смерть точно к лицу.	
VO_LOOTA_BOSS_16h_Male_Troll_EventPlayerDeathrattle5_01	Умираем всего дважды.	
VO_LOOTA_BOSS_16h_Male_Troll_Intro_01	Я говорю с мертвяками! Пнятно? Пнятно.	
VO_LOOTA_BOSS_17h_Male_Troll_Death_01	<Умирает>	
VO_LOOTA_BOSS_17h_Male_Troll_DefeatPlayer_01	Хочешь от Джин'зо драки? Получишь от Джин'зо только боль!	
VO_LOOTA_BOSS_17h_Male_Troll_EmoteResponse_01	Не время болтать. Время КРИЧАТЬ!	
VO_LOOTA_BOSS_17h_Male_Troll_EventPlayerBattlecry1_01	О, вот это мне нравится.	
VO_LOOTA_BOSS_17h_Male_Troll_EventPlayerBattlecry2_01	Джин'зо одобряет!	
VO_LOOTA_BOSS_17h_Male_Troll_EventPlayerBattlecry3_01	Да! Такое Джин'зо понимает!	
VO_LOOTA_BOSS_17h_Male_Troll_EventPlayerBrann_01	Маленький дворф думает, что кричит громче Джин'зо? МЕЧТАЙ!	
VO_LOOTA_BOSS_17h_Male_Troll_Intro_01	У Джин'зо на тебя БОЛЬШИЕ планы!	
VO_LOOTA_BOSS_19h_Male_Trogg_Death_01	<Умирает>	
VO_LOOTA_BOSS_19h_Male_Trogg_DefeatPlayer_01	Когда хитришь, всегда получаешь по башке.	
VO_LOOTA_BOSS_19h_Male_Trogg_EmoteResponse_01	Нравятся трогги? У меня их много.	
VO_LOOTA_BOSS_19h_Male_Trogg_EventHandFull_01	Так, тихо... Я это... Их слишком много!	
VO_LOOTA_BOSS_19h_Male_Trogg_HeroPower1_01	Трогг, ко мне!	
VO_LOOTA_BOSS_19h_Male_Trogg_HeroPower2_01	Ага, болтай. У меня еще трогги есть.	
VO_LOOTA_BOSS_19h_Male_Trogg_HeroPower3_01	Мои трогги чуют магию.	
VO_LOOTA_BOSS_19h_Male_Trogg_HeroPowerHard1_01	Сколько силы.	
VO_LOOTA_BOSS_19h_Male_Trogg_HeroPowerHard2_01	Ага, болтай.	
VO_LOOTA_BOSS_19h_Male_Trogg_HeroPowerHard3_01	М-м-м... магия...	
VO_LOOTA_BOSS_19h_Male_Trogg_Intro_01	НА КОЛЕНИ перед ТРОГГАМИ!	
VO_LOOTA_BOSS_20h_Male_Earthen_Death_01	Спа-а-а-ать...	
VO_LOOTA_BOSS_20h_Male_Earthen_DefeatPlayer_01	Святилищу ничто не грозит.	
VO_LOOTA_BOSS_20h_Male_Earthen_EmoteResponse_01	Меня ничто не остановит.	
VO_LOOTA_BOSS_20h_Male_Earthen_EventPlayerSilence_01	Даже так... Благодарю.	
VO_LOOTA_BOSS_20h_Male_Earthen_EventStatueDestroyed1_01	Ты оттягиваешь неизбежное.	
VO_LOOTA_BOSS_20h_Male_Earthen_EventStatueDestroyed2_01	Твое поражение — лишь вопрос времени.	
VO_LOOTA_BOSS_20h_Male_Earthen_EventStatueDestroyed3_01	Ты оскверняешь это святилище.	
VO_LOOTA_BOSS_20h_Male_Earthen_EventStatueDestroyed4_01	Я должен... защищать... святилище...	
VO_LOOTA_BOSS_20h_Male_Earthen_EventStatueDestroyed5_01	Мою волю не сломить...	
VO_LOOTA_BOSS_20h_Male_Earthen_HeroPower_01	ПРОБУДИТЕСЬ!	
VO_LOOTA_BOSS_20h_Male_Earthen_HeroPowerNoStatues_01	ПРОБУДИТЕСЬ! Ой...	
VO_LOOTA_BOSS_20h_Male_Earthen_Intro_01	Уходи прочь! Здесь нет ничего ценного.	
VO_LOOTA_BOSS_22h_Male_Murloc_Death_01	<Умирает>	
VO_LOOTA_BOSS_22h_Male_Murloc_DeathSpecial_01	...!!	
VO_LOOTA_BOSS_22h_Male_Murloc_DefeatPlayer_01	...! ...?	
VO_LOOTA_BOSS_22h_Male_Murloc_EmoteResponse_01	...?!	
VO_LOOTA_BOSS_22h_Male_Murloc_EventFishUpChest_01	...	
VO_LOOTA_BOSS_22h_Male_Murloc_EventSummonCrab_01	...!!	
VO_LOOTA_BOSS_22h_Male_Murloc_FishLarge_02	...!	
VO_LOOTA_BOSS_22h_Male_Murloc_FishMedium_01	...?	
VO_LOOTA_BOSS_22h_Male_Murloc_FishSmall_01	...	
VO_LOOTA_BOSS_22h_Male_Murloc_Intro_01	...!	
VO_LOOTA_BOSS_23h_Male_Furbolg_Death_01	<Умирает>	
VO_LOOTA_BOSS_23h_Male_Furbolg_DefeatPlayer_01	Оставлю твои кости в назидание другим.	
VO_LOOTA_BOSS_23h_Male_Furbolg_EmoteResponse_01	Говори, говори... Мои звери быстрее тебя найдут.	
VO_LOOTA_BOSS_23h_Male_Furbolg_EventPlayBigMinion1_01	Охота... закончилась!	
VO_LOOTA_BOSS_23h_Male_Furbolg_EventPlayBigMinion2_01	Спасения нет.	
VO_LOOTA_BOSS_23h_Male_Furbolg_EventPlayBigMinion3_01	Они чуют твой страх!	
VO_LOOTA_BOSS_23h_Male_Furbolg_HeroPower1_01	Близится твой час...	
VO_LOOTA_BOSS_23h_Male_Furbolg_HeroPower2_01	Моя сила только растет.	
VO_LOOTA_BOSS_23h_Male_Furbolg_HeroPower3_01	Мои звери НАЙДУТ тебя.	
VO_LOOTA_BOSS_23h_Male_Furbolg_HeroPower4_01	Я знаю эти пещеры. А ты ничего не знаешь.	
VO_LOOTA_BOSS_23h_Male_Furbolg_HeroPower5_01	Здесь охочусь ТОЛЬКО Я!	
VO_LOOTA_BOSS_23h_Male_Furbolg_Intro_01	Здесь ТЫ жертва! А я — охотник.	
VO_LOOTA_BOSS_25h_Male_Dragon_Death_01	<Умирает>	
VO_LOOTA_BOSS_25h_Male_Dragon_DefeatPlayer_01	Эти древние сокровища бесценны. Они останутся здесь.	
VO_LOOTA_BOSS_25h_Male_Dragon_EmoteResponse_01	Я приму это во внимание.	
VO_LOOTA_BOSS_25h_Male_Dragon_EventMarinTheFox_01	Марин Лис! Тебе хватило наглости вернуться?!	
VO_LOOTA_BOSS_25h_Male_Dragon_HeroPower1_01	Чужаков ждет огонь.	
VO_LOOTA_BOSS_25h_Male_Dragon_HeroPower2_01	Ненавижу воров!	
VO_LOOTA_BOSS_25h_Male_Dragon_HeroPower3_01	Страдайте!	
VO_LOOTA_BOSS_25h_Male_Dragon_HeroPower4_01	Сгиньте в огне!	
VO_LOOTA_BOSS_25h_Male_Dragon_HeroPower5_01	От меня никто не спрячется.	
VO_LOOTA_BOSS_25h_Male_Dragon_Intro_01	Выходи, мерзкий вор. Покажись.	
VO_LOOTA_BOSS_25h_Male_Dragon_TreasureDestroy1_01	Это не твое!	
VO_LOOTA_BOSS_25h_Male_Dragon_TreasureDestroy2_01	Держи вора!	
VO_LOOTA_BOSS_25h_Male_Dragon_TreasureDestroy3_01	А ну верни!	
VO_LOOTA_BOSS_25h_Male_Dragon_TreasureDestroy4_02	Глупое дитя!	
VO_LOOTA_BOSS_25h_Male_Dragon_TreasureDestroy5_01	Ты заплатишь за свою жадность!	
VO_LOOTA_BOSS_26h_Female_Demon_Death_01	<Умирает>	
VO_LOOTA_BOSS_26h_Female_Demon_DefeatPlayer_01	Не стоило сюда приходить. Я все вижу.	
VO_LOOTA_BOSS_26h_Female_Demon_EmoteResponse_01	Я наблюдаю только за тобой.	
VO_LOOTA_BOSS_26h_Female_Demon_EyeStalkConfuse_01	С-с-смущение.	
VO_LOOTA_BOSS_26h_Female_Demon_EyeStalkDeath_01	С-с-смерть.	
VO_LOOTA_BOSS_26h_Female_Demon_EyeStalkDevitalize_01	Ус-сталос-сть.	
VO_LOOTA_BOSS_26h_Female_Demon_EyeStalkFear_01	С-с-страх.	
VO_LOOTA_BOSS_26h_Female_Demon_EyeStalkFire_01	С-с-сгори.	
VO_LOOTA_BOSS_26h_Female_Demon_EyeStalkFrost_01	С-с-стужа.	
VO_LOOTA_BOSS_26h_Female_Demon_Intro_01	Тебе удалось зайти так далеко... Позволь на тебя взглянуть...	
VO_LOOTA_BOSS_32h_Male_Human_Death_01	<Умирает>	
VO_LOOTA_BOSS_32h_Male_Human_EmoteResponse_01	Я не разговариваю с незнакомцами.	
VO_LOOTA_BOSS_32h_Male_Human_PartnerDeath_01	О нет, только не Джордж!	
VO_LOOTA_BOSS_32h_Male_Human_TaggedIn1_01	Дай мне попробовать!	
VO_LOOTA_BOSS_32h_Male_Human_TaggedIn2_01	Дай-ка я помогу, Джордж!	
VO_LOOTA_BOSS_32h_Male_Human_TaggedIn3_01	Можно я, Джордж? Можно?	
VO_LOOTA_BOSS_34h_Male_Demon_Death_01	<Умирает>	
VO_LOOTA_BOSS_34h_Male_Demon_DefeatPlayer_01	Мне нужно больше... БОЛЬШЕ!	
VO_LOOTA_BOSS_34h_Male_Demon_EmoteResponse_01	Твой страх, твое раскаяние... Я насыщаюсь ими.	
VO_LOOTA_BOSS_34h_Male_Demon_HeroPower1_01	Я... насыщаюсь.	
VO_LOOTA_BOSS_34h_Male_Demon_HeroPower2_01	Еще...	
VO_LOOTA_BOSS_34h_Male_Demon_HeroPower3_01	Дай мне еще...	
VO_LOOTA_BOSS_34h_Male_Demon_HeroPower4_01	Я поглощу этот мир.	
VO_LOOTA_BOSS_34h_Male_Demon_HeroPower5_01	Вот твоя погибель.	
VO_LOOTA_BOSS_34h_Male_Demon_Intro_01	Я ГОЛОДЕН!	
VO_LOOTA_BOSS_35h_Male_Furbolg_Death_01	Остановись... Дальше — только смерть.	
VO_LOOTA_BOSS_35h_Male_Furbolg_DefeatPlayer_01	Твое тело останется здесь. Но твоя душа теперь свободна!	
VO_LOOTA_BOSS_35h_Male_Furbolg_EmoteResponse_01	Если хочешь покоя, оставь сокровища и уходи.	
VO_LOOTA_BOSS_35h_Male_Furbolg_Intro_01	Уходи! Твоей магии здесь не место!	
VO_LOOTA_BOSS_35h_Male_Furbolg_SpellCountered1_01	Твоя магия только придает нам сил.	
VO_LOOTA_BOSS_35h_Male_Furbolg_SpellCountered2_01	Молчать!	
VO_LOOTA_BOSS_35h_Male_Furbolg_SpellCountered3_01	Твоя сила тает.	
VO_LOOTA_BOSS_35h_Male_Furbolg_SpellCountered4_01	Моя магия сильнее твоей...	
VO_LOOTA_BOSS_35h_Male_Furbolg_SpellCountered5_01	Тебе не сладить с древней мощью.	
VO_LOOTA_BOSS_37h_Female_BloodElf_Death_01	Я горю!	
VO_LOOTA_BOSS_37h_Female_BloodElf_DefeatPlayer_01	Не могу понять, ты сгораешь от стыда... или не от стыда? Ха-ха-ха!	
VO_LOOTA_BOSS_37h_Female_BloodElf_EmoteResponse_01	Вижу, ты сгораешь от любопытства! Или не от него!	
VO_LOOTA_BOSS_37h_Female_BloodElf_EventFireball_01	Огонь... ОГОНЬ!	
VO_LOOTA_BOSS_37h_Female_BloodElf_EventPyroblast_01	Просто ОГОНЬ!	
VO_LOOTA_BOSS_37h_Female_BloodElf_EventRagnaros_01	Вот такие бои мне по нраву!	
VO_LOOTA_BOSS_37h_Female_BloodElf_EventTheCandle_01	Так вот кто трогал свечу!	
VO_LOOTA_BOSS_37h_Female_BloodElf_Flamewakers_01	Устроим фейерверк?	
VO_LOOTA_BOSS_37h_Female_BloodElf_HeroPower1_01	Нужно больше силы...	
VO_LOOTA_BOSS_37h_Female_BloodElf_HeroPower2_01	Еще... еще!	
VO_LOOTA_BOSS_37h_Female_BloodElf_HeroPower3_01	Заклинания — это так весело!	
VO_LOOTA_BOSS_37h_Female_BloodElf_Intro_01	Пламя заставит тебя танцевать!	
VO_LOOTA_BOSS_38h_Male_Kobold_Death_01	Моя всех проклинать!	
VO_LOOTA_BOSS_38h_Male_Kobold_DefeatPlayer_01	Моя знай, что мое вуду сильнее!	
VO_LOOTA_BOSS_38h_Male_Kobold_EmoteResponse_01	Вот тебе сглаз!	
VO_LOOTA_BOSS_38h_Male_Kobold_EventBrann_01	Дворфово вуду — странное вуду.	
VO_LOOTA_BOSS_38h_Male_Kobold_EventPlayerBattlecries1_01	А крику-то...	
VO_LOOTA_BOSS_38h_Male_Kobold_EventPlayerBattlecries2_01	Зачем так шуметь?..	
VO_LOOTA_BOSS_38h_Male_Kobold_EventPlayerBattlecries3_01	Какие шумные.	
VO_LOOTA_BOSS_38h_Male_Kobold_EventPlayerDeathrattles1_01	Вот это хрипит!	
VO_LOOTA_BOSS_38h_Male_Kobold_EventPlayerDeathrattles3_01	О, эта штука делать убойное вуду.	
VO_LOOTA_BOSS_38h_Male_Kobold_EventRivendare_01	Мертвый вуду — самый плохой вуду!	
VO_LOOTA_BOSS_38h_Male_Kobold_Intro_01	Моя тоже уметь вуду!	
VO_LOOTA_BOSS_39h_Male_Golem_Death_01	Я... разбит...	
VO_LOOTA_BOSS_39h_Male_Golem_DefeatPlayer_01	Сокровища в безопасности.	
VO_LOOTA_BOSS_39h_Male_Golem_EmoteResponse_01	Ты не мой хозяин.	
VO_LOOTA_BOSS_39h_Male_Golem_HeroPower1_01	Крушить.	
VO_LOOTA_BOSS_39h_Male_Golem_HeroPower2_01	Топтать.	
VO_LOOTA_BOSS_39h_Male_Golem_HeroPower3_01	Никто не пройдет!	
VO_LOOTA_BOSS_39h_Male_Golem_HeroPower4_01	Такие... мелкие...	
VO_LOOTA_BOSS_39h_Male_Golem_HeroPower5_01	Сгиньте!	
VO_LOOTA_BOSS_39h_Male_Golem_Intro_01	Защищать... сокровища...	
VO_LOOTA_BOSS_40h_Female_Dragon_Death_01	<Умирает>	
VO_LOOTA_BOSS_40h_Female_Dragon_DefeatPlayer_01	Сумеречные драконы вернутся!	
VO_LOOTA_BOSS_40h_Female_Dragon_EmoteResponse_01	Согласна не согласиться.	
VO_LOOTA_BOSS_40h_Female_Dragon_EventPlayTwilightDrake_01	Не предавай нас, дитя.	
VO_LOOTA_BOSS_40h_Female_Dragon_EventPlayTwilightWhelp_01	Вернись в семью, дитя!	
VO_LOOTA_BOSS_40h_Female_Dragon_HeroPower1_01	Еще!..	
VO_LOOTA_BOSS_40h_Female_Dragon_HeroPower2_01	Твоя сила питает меня.	
VO_LOOTA_BOSS_40h_Female_Dragon_HeroPower3_01	Сумеречные драконы переживут всех.	
VO_LOOTA_BOSS_40h_Female_Dragon_HeroPower4_01	Покорись сумеркам.	
VO_LOOTA_BOSS_40h_Female_Dragon_Intro_01	Я чувствую твою силу. Подойди поближе...	
VO_LOOTA_BOSS_41h_Male_Kobold_Death_01	<Умирает>	
VO_LOOTA_BOSS_41h_Male_Kobold_DefeatPlayer_01	Моя трогать свечу. А твоя НИЧЕГО не трогать.	
VO_LOOTA_BOSS_41h_Male_Kobold_EmoteResponse_01	Молчать! Драться!	
VO_LOOTA_BOSS_41h_Male_Kobold_EventHornOfCenarius_01	Что? ЧТО?! Так нечестно!	
VO_LOOTA_BOSS_41h_Male_Kobold_HeroPower1_01	Все! Драться! Живо!	
VO_LOOTA_BOSS_41h_Male_Kobold_HeroPower2_01	Потасовка!	
VO_LOOTA_BOSS_41h_Male_Kobold_HeroPower3_01	Навались!	
VO_LOOTA_BOSS_41h_Male_Kobold_Intro_01	Верни свечу!	
VO_LOOTA_BOSS_42h_Female_Furbolg_Armor10_01	Хвала предкам за этот дар.	
VO_LOOTA_BOSS_42h_Female_Furbolg_Armor15_01	Истинная мощь идет от древних!	
VO_LOOTA_BOSS_42h_Female_Furbolg_Armor20_01	Отдай сокровища мне. Тебе не на что надеяться.	
VO_LOOTA_BOSS_42h_Female_Furbolg_Armor5_01	Я не ведаю страха.	
VO_LOOTA_BOSS_42h_Female_Furbolg_Death_01	Я возвращаюсь... к предкам.	
VO_LOOTA_BOSS_42h_Female_Furbolg_DefeatPlayer_01	Хвала древним духам! Моей защите и моему спасению.	
VO_LOOTA_BOSS_42h_Female_Furbolg_EmoteResponse_01	Древние духи... вообще-то не любят таких как ты.	
VO_LOOTA_BOSS_42h_Female_Furbolg_Intro_01	Древние духи! Я взываю к вам!	
VO_LOOTA_BOSS_43h_Female_Djinn_Death_01	<Умирает>	
VO_LOOTA_BOSS_43h_Female_Djinn_DefeatPlayer_01	Разве не этого тебе хотелось?..	
VO_LOOTA_BOSS_43h_Female_Djinn_EmoteResponse_01	Ты потратишь желание на ЭТО?	
VO_LOOTA_BOSS_43h_Female_Djinn_HeroAbility1_01	Чего ты желаешь?	
VO_LOOTA_BOSS_43h_Female_Djinn_HeroAbility2_01	Раз... Два... Три...	
VO_LOOTA_BOSS_43h_Female_Djinn_HeroAbility3_01	Желание исполнено!	
VO_LOOTA_BOSS_43h_Female_Djinn_HeroAbilityHandFull1_01	Хе-хе-хе.	
VO_LOOTA_BOSS_43h_Female_Djinn_HeroAbilityHandFull2_01	Кажется, я перестаралась?	
VO_LOOTA_BOSS_43h_Female_Djinn_HeroAbilityHandFull3_01	Будь осторожнее в своих желаниях.	
VO_LOOTA_BOSS_43h_Female_Djinn_Intro_01	Твое желание для меня закон... Но цену ты знаешь!	
VO_LOOTA_BOSS_44h_Female_Dragon_Death_01	<Умирает>	
VO_LOOTA_BOSS_44h_Female_Dragon_DefeatPlayer_01	Все умерли! Пока-пока!	
VO_LOOTA_BOSS_44h_Female_Dragon_EmoteResponse_01	Не шути про мою маму!	
VO_LOOTA_BOSS_44h_Female_Dragon_Intro_01	Пора кушать?	
VO_LOOTA_BOSS_45h_Male_Gnome_Death_01	<Умирает>	
VO_LOOTA_BOSS_45h_Male_Gnome_DefeatPlayer_01	Контролируемая клептомания — занятие весьма доходное.	
VO_LOOTA_BOSS_45h_Male_Gnome_EmoteResponse_01	Здесь... будто лабиринт из пещер. И все одинаковые!	
VO_LOOTA_BOSS_45h_Male_Gnome_HeroPower1_01	Ух ты, блестит!	
VO_LOOTA_BOSS_45h_Male_Gnome_HeroPower2_01	Хе-хе...	
VO_LOOTA_BOSS_45h_Male_Gnome_HeroPower3_01	Орел! Я победил.	
VO_LOOTA_BOSS_45h_Male_Gnome_HeroPower4_01	Решка! Победа за мной!	
VO_LOOTA_BOSS_45h_Male_Gnome_Intro_01	Вижу, ты несешь тяжкое бремя... В карманах! Могу выручить.	
VO_LOOTA_BOSS_46h_Male_Murloc_Death_01	<Умирает>	
VO_LOOTA_BOSS_46h_Male_Murloc_DefeatPlayer_01	... ...? ...!	
VO_LOOTA_BOSS_46h_Male_Murloc_EmoteResponse_01	<Утробные звуки>	
VO_LOOTA_BOSS_46h_Male_Murloc_HeroPower1_01	...	
VO_LOOTA_BOSS_46h_Male_Murloc_HeroPower2_01	...?	
VO_LOOTA_BOSS_46h_Male_Murloc_HeroPower3_01	...	
VO_LOOTA_BOSS_46h_Male_Murloc_Intro_01	...!!	
VO_LOOTA_BOSS_49h_Male_Elemental_Death_01	<Умирает>	
VO_LOOTA_BOSS_49h_Male_Elemental_DefeatPlayer_01	Ха-ха-ха...	
VO_LOOTA_BOSS_49h_Male_Elemental_EmoteResponse_01	Я трогаю свечи. Такое у меня хобби.	
VO_LOOTA_BOSS_49h_Male_Elemental_HeroPower1_01	Тьма...	
VO_LOOTA_BOSS_49h_Male_Elemental_HeroPower2_01	Беги скорее...	
VO_LOOTA_BOSS_49h_Male_Elemental_HeroPower3_01	Ха-ха-ха-ха.	
VO_LOOTA_BOSS_49h_Male_Elemental_Intro_01	Твой свет гаснет...	
VO_LOOTA_BOSS_50h_Male_Kobold_Death_01	<Умирает>	
VO_LOOTA_BOSS_50h_Male_Kobold_DefeatPlayer_01	У-у-у, забористая штука!	
VO_LOOTA_BOSS_50h_Male_Kobold_EmoteResponse_01	НЕТ. Моя деньги не возвращать.	
VO_LOOTA_BOSS_50h_Male_Kobold_EventKazakus_01	Казакус хотеть добавки?	
VO_LOOTA_BOSS_50h_Male_Kobold_EventMakePotion1_01	Что это?.. Очень плохо.	
VO_LOOTA_BOSS_50h_Male_Kobold_EventMakePotion2_01	Во, плохо! О-очень плохо!	
VO_LOOTA_BOSS_50h_Male_Kobold_EventMakePotion3_01	Что, хотеть попробовать? Хе. А моя не дай!	
VO_LOOTA_BOSS_50h_Male_Kobold_EventUsePotion1_01	Ой, вот это плохо. На, понюхай!	
VO_LOOTA_BOSS_50h_Male_Kobold_EventUsePotion2_01	Да! Ха-ха! Да!	
VO_LOOTA_BOSS_50h_Male_Kobold_EventUsePotion3_01	Ох... На вкус так плохо, что аж хорошо.	
VO_LOOTA_BOSS_50h_Male_Kobold_Intro_01	Эй... Эй... Купи грибочков, а?	
VO_LOOTA_BOSS_51h_Male_Dwarf_Death_01	Спокойной ночи, Азерот!	
VO_LOOTA_BOSS_51h_Male_Dwarf_DefeatPlayer_02	Спасибо тебе за существ!	
VO_LOOTA_BOSS_51h_Male_Dwarf_EmoteResponse_01	Ка-ак остроумно. 	
VO_LOOTA_BOSS_51h_Male_Dwarf_EventBoombox_01	Эй! Выключи сейчас же!	
VO_LOOTA_BOSS_51h_Male_Dwarf_Intro_01	Постой и послушай!	
VO_LOOTA_BOSS_51h_Male_Dwarf_KillingBlowReady_01	Катакомбы и кобольды!	
VO_LOOTA_BOSS_51h_Male_Dwarf_Song1A_01	Пробил твой час, игра началась...	
VO_LOOTA_BOSS_51h_Male_Dwarf_Song1B_01	Богатства манят смельчаков!	
VO_LOOTA_BOSS_51h_Male_Dwarf_Song1C_01	Вперед же, не стой, но знай — под землей...
VO_LOOTA_BOSS_51h_Male_Dwarf_Song1D_01	В темных залах придется нелегко.	
VO_LOOTA_BOSS_51h_Male_Dwarf_Song2A_01	Похитив огонек, пускайся наутек...	
VO_LOOTA_BOSS_51h_Male_Dwarf_Song2B_01	Бросай свою добычу и еду.	
VO_LOOTA_BOSS_51h_Male_Dwarf_Song2C_01	Чудовища ревут! Ловушки там и тут...	
VO_LOOTA_BOSS_51h_Male_Dwarf_Song2D_01	И как бы карту не уронить на ходу!	
VO_LOOTA_BOSS_51h_Male_Dwarf_Song3A_01	Все ближе шаги, скорее беги...	
VO_LOOTA_BOSS_51h_Male_Dwarf_Song3B_01	А иначе не скрыться тебе от беды!	
VO_LOOTA_BOSS_51h_Male_Dwarf_Song3C_01	Дадут тебе клад или жизни лишат...	
VO_LOOTA_BOSS_51h_Male_Dwarf_Song3D_01	Катакомбы и кобольды?	
VO_LOOTA_BOSS_51h_Male_Dwarf_Steal_01	Иди сюда!	
VO_LOOTA_BOSS_51h_Male_Dwarf_Steal_02	Сюда!	
VO_LOOTA_BOSS_51h_Male_Dwarf_Steal_03	Пора веселиться!	
VO_LOOTA_BOSS_51h_Male_Dwarf_StealDoomsayer_01	Худший. Менеджер. Во всем мире!	
VO_LOOTA_BOSS_51h_Male_Dwarf_StealMinstrel_01	Споем дуэтом!	
VO_LOOTA_BOSS_53h2_Female_Undead_Death_01	Это же парадокс!	
VO_LOOTA_BOSS_53h2_Female_Undead_DefeatPlayer_01	Я знала, что одержу верх. Я видела свое будущее.	
VO_LOOTA_BOSS_53h2_Female_Undead_EmoteResponse_01	Я перехитрила бронзовых драконов. Ты мне уж точно не ровня.	
VO_LOOTA_BOSS_53h2_Female_Undead_EventManaDestroyed_01	Ты просто отдаляешь неизбежное!	
VO_LOOTA_BOSS_53h2_Female_Undead_EventPlayerTimeWalk_01	Тебе тоже доводилось бывать на Вневременном острове?	
VO_LOOTA_BOSS_53h2_Female_Undead_Intro_01	Время можно распутать. А тебя — развоплотить.	
VO_LOOTA_BOSS_53h2_Female_Undead_RitualPrep1_01	Близится твой час...	
VO_LOOTA_BOSS_53h2_Female_Undead_RitualPrep2_01	Моя мощь растет.	
VO_LOOTA_BOSS_53h2_Female_Undead_RitualPrep3_01	Тик-так...	
VO_LOOTA_BOSS_53h2_Female_Undead_TimeRewindPlayCard1_01	С каждым разом выходит все лучше.	
VO_LOOTA_BOSS_53h2_Female_Undead_TimeRewindPlayCard2_01	Мы это уже проходили.	
VO_LOOTA_BOSS_53h2_Female_Undead_TimeRewindPlayCard3_01	Время на моей стороне.	
VO_LOOTA_BOSS_53h2_Female_Undead_TimeRewindPlayCard4_01	Кто повелевает временем, владеет вечностью!	
VO_LOOTA_BOSS_53h2_Female_Undead_TimeRewindPlayCard5_01	Покончим с этим!	
VO_LOOTA_BOSS_53h2_Female_Undead_TimeRewindStart1_01	Узри мое открытие!	
VO_LOOTA_BOSS_53h2_Female_Undead_TimeRewindStart2_01	Время пришло!	
VO_LOOTA_BOSS_53h2_Female_Undead_TimeRewindStart3_01	Повторим все еще раз!	
VO_LOOTA_BOSS_53h2_Female_Undead_TimeRewindStart4_01	Пришло мое время!	
VO_LOOTA_BOSS_54h_Female_Human_Death_01	Я была не готова!	
VO_LOOTA_BOSS_54h_Female_Human_DefeatPlayer_01	Ладно, теперь я готова!	
VO_LOOTA_BOSS_54h_Female_Human_EmoteResponse_01	Отойду на минутку. Позовите там, когда бой начнется!	
VO_LOOTA_BOSS_54h_Female_Human_Intro_01	<Рассеянно насвистывает>	
VO_LOOTA_BOSS_54h_Female_Human_Intro_02	<Насвистывает>	
VO_LOOTA_BOSS_54h_Female_Human_Intro_03	<Насвистывает>	
VO_LOOTA_BOSS_54h_Female_Human_Intro_04	<Насвистывает>	
VO_LOOTA_BOSS_54h_Female_Human_Intro_07	<Насвистывает>	
VO_LOOTA_BOSS_54h_Female_Human_WakeUp_01	Ой, так мы сражаемся?	
VO_Maiden_Female_Titan_FinalMaidenEmoteResponse_01	Я не потерплю такого поведения.	
VO_Maiden_Female_Titan_FinalMaidenEyeForAnEye_01	Правосудие свершилось.	
VO_Maiden_Female_Titan_FinalMaidenHeroPower_01	Отбрось свои грязные мысли.	
VO_Maiden_Female_Titan_FinalMaidenHumility_01	Да! На колени и проси пощады!	
VO_Maiden_Female_Titan_FinalMaidenOpen_01	Кто посмел призвать слугу титанов?	
VO_Maiden_Female_Titan_FinalMaidenTurn5_01	Мы вечны! А ты не стоишь моего внимания!	
VO_Malchezaar_Male_Demon_Brawl_06	Смирись и прими свою смерть!	
VO_Malchezaar_Male_Demon_EmoteParty_01	Малчезар тоже любит веселиться!	
VO_Malchezaar_Male_Demon_FinalAltOpening_01	Глупцы!	
VO_Malchezaar_Male_Demon_FinalMalchezaarDeath_01	Нет! Нет! Только не это!	
VO_Malchezaar_Male_Demon_FinalMalchezaarEmoteResponse_01	Я стану твоей погибелью!	
VO_Malchezaar_Male_Demon_FinalMalchezaarHeroPower_01	Ты противостоишь не только Малчезару, но и всем подвластным мне легионам!	
VO_Malchezaar_Male_Demon_FinalMalchezaarJaraxxus_01	Эй, ты! Это мое приглашение!	
VO_Malchezaar_Male_Demon_FinalMalchezaarMedivhSkin_01	У вас тут маскарад? Хм... И почему я об этом не подумал?	
VO_Malchezaar_Male_Demon_FinalMalchezaarSacrificialPact_03	Ха! На эредарских повелителей это не действует!	
VO_Malchezaar_Male_Demon_FinalMalchezaarTurn1_01	Волшебник могуч, но как ты надеешься противостоять столь невероятной силе?	
VO_Malchezaar_Male_Demon_FinalMalchezaarTurn7_01	Я слышу музыку! Это Ме-дивы! Вечеринка! Я буду зажигать всю ночь!	
VO_Malchezaar_Male_Demon_FinalThirdSequence_01	Меня призвали обратно в Каражан? О, да тут вечеринка!	
VO_Malchezaar_Male_Demon_FinalThirdSequence_04	Прочь с дороги!	
VO_Malchezaar_Male_Demon_PrologueEmoteResponse_01	Глупец!	
VO_Malchezaar_Male_Demon_PrologueHeroPower_01	Мне открыты все реальности, все измерения!	
VO_Malchezaar_Male_Demon_PrologueOpen_01	Ты не пригласил МЕНЯ?	
VO_Malchezaar_Male_Demon_PrologueTurn1_04	Ты не пригласил меня?! Эредарского принца?!	
VO_Malchezaar_Male_Demon_PrologueTurn11_02	Кто позвал этого слюнтяя Джараксуса?	
VO_Malchezaar_Male_Demon_PrologueWin_01	Я заберу тебя с собой!	
VO_Mediva_01_Female_Blood Elf_AranSpell_04	Ой, бр-р.	
VO_Mediva_01_Female_Blood Elf_ChessEmoteOops_06	Ой-ой-ой!	
VO_Mediva_01_Female_Blood Elf_PrologueTurn5_06	Ме-дивы!	
VO_Mediva_02_Female_Draenei_JulianneDeadlyPoison_02	Какая трагедия.	
VO_Mediva_02_Female_Draenei_PrologueTurn5_05	Да?	
VO_Mediva_03_Male_Night Elf_AranHeroPower_01	Гори, детка, гори!	
VO_Mediva_03_Male_Night Elf_CuratorBeasts_04	Ааааа-апчхи!	
VO_Mediva_03_Male_Night Elf_PrologueTurn5_01	Вызывали?	
VO_Medivas_Multiple_Multiple_CroneLionTigerBear_01	Кошмар!	
VO_Medivas_Multiple_Multiple_IllhoofWounded_01	Поджилки трясутся.	
VO_Medivas_Multiple_Multiple_NetherspiteTurn1_01	Лучи!	
VO_Medivh_Male_Human_EmoteGreetings_01	А ты что здесь делаешь?	
VO_Medivh_Male_Human_EmoteOops_01	Твой план не сработал?	
VO_Medivh_Male_Human_EmoteSorry_01	Ой! Не сработало...	
VO_Medivh_Male_Human_EmoteThanks_01	Премного благодарен.	
VO_Medivh_Male_Human_EmoteThreaten_01	У тебя нет шансов!	
VO_Medivh_Male_Human_EmoteWellPlayed_01	Неплохо, демон.	
VO_Medivh_Male_Human_EmoteWow_01	Ха-ха! Это было великолепно!	
VO_Medivh_Male_Human_FinalMalchezaarTurn5_01	Ты хорошо поработал, Мороуз! Вечеринка в самом разгаре!	
VO_Medivh_Male_Human_FinalMalchezaarWin_01	Отлично! Идем, пора веселиться!	
VO_Medivh_Male_Human_FinalMedivhMedivhSkin_01	Опа! Это же я! Только из будущего! Скажи, у нас же будет крутая вечеринка, правда? Лучше всех?	
VO_Medivh_Male_Human_FinalThirdSequence_01	О, здравствуй! Пожалуйста, вышвырни демона. Меня уже гости заждались!	
VO_Medivh_Male_Human_FinalThirdSequence_02	Он забрал твои карты? Не стесняйся, используй порталы.	
VO_Medivh_Male_Human_FinalThirdSequence_03	Возьми мой посох, он управляет порталами. Только не поцарапай!	
VO_Medivh_Male_Human_PrologueDeath_02	Что? Невозможно...	
VO_Medivh_Male_Human_PrologueHeroPower_01	Кроме этой вечеринки!	
VO_Medivh_Male_Human_PrologueOpen_01	Опять ты?!	
VO_Medivh_Male_Human_PrologueTurn1_02	Мы еще с прошлого раза дыру в крыше не заделали!	
VO_Medivh_Male_Human_PrologueTurn11_01	Ты слышал, как он поет в караоке? Это нечто!	
VO_Medivh_Male_Human_PrologueTurn3_02	Мороуз, проверь шахматы. Настоящие гости вот-вот прибудут.	
VO_Medivh_Male_Human_PrologueTurn9_01	Шарики! Мороуз, мы забыли надуть шарики!	
VO_Medivh_Male_Human_PrologueWin_01	Возвращайся в Пустоту, демон!	
VO_Medivh_Male_Human_Wing0Intro_01	Мы оживили посуду, отрепетировали оперу, подготовили зверинец. Сегодня будет незабываемый вечер!	
VO_Medivh_Male_Human_Wing4Win_01	Проходи, не стесняйся. Веселись!	
VO_Mirror_Male_Mirror_MirrorDeath_01	Эй! Так нечестно! Я хочу отыграться!	
VO_Mirror_Male_Mirror_MirrorEmoteResponse_01	Нет, ты!	
VO_Mirror_Male_Mirror_MirrorFirstCard_01	О нет! У тебя есть эта карта?!	
VO_Mirror_Male_Mirror_MirrorMedivhSkin_01	Ой! Господин Медив! Я смотрю в оба... Э-э-э... Погоди. Ты не Медив!	
VO_Mirror_Male_Mirror_MirrorMirrorImage_01	Эй, это моя любимая карта! А твоя какая? Магмовый яростень?	
VO_Mirror_Male_Mirror_MirrorOpen_02	ПРИВЕЕЕЕЕТ!	
VO_Mirror_Male_Mirror_MirrorTurn1_01	Ого! Ну вы и уроды!	
VO_Mirror_Male_Mirror_MirrorTurn3_01	Свет мой, зеркальце, скажи: кто на свете всех милее?	
VO_Mirror_Male_Mirror_MirrorTurn3_03	Не ты, дедуля.	
VO_Mirror_Male_Mirror_MirrorTurn5_02	Нефарий? Я буду звать его Обжорий, ладно? Ха-ха-ха!	
VO_Mirror_Male_Mirror_MirrorWellPlayedResponse_01	Жаль, что не могу сказать того же! ДЗЫНЬ!	
VO_Moroes_Male_Human_AranTurn1_01	Эх... Аран, самый занудный призрак в Азероте.	
VO_Moroes_Male_Human_AranTurn9_04	Драконы сожрали все, что было на столе, и поглядывают на мурлоков!	
VO_Moroes_Male_Human_AranWin_01	Портал в следующем зале! Мы еще успеваем!	
VO_Moroes_Male_Human_ChessForfeit_02	У вас кончились фигуры. Вы проиграли.	
VO_Moroes_Male_Human_ChessTurn1_03	Фигуры атакуют автоматически в конце вашего хода.	
VO_Moroes_Male_Human_ChessTurn3_01	Если ваша фигура находится между двумя вражескими, она атакует обе!	
VO_Moroes_Male_Human_ChessTurn5_01	Правильное расположение – ключ к победе. Используйте двойные атаки!	
VO_Moroes_Male_Human_ChessTurn7_01	Гости уже толпятся у дверей! Оперный зал близко, но мы должны поторопиться!	
VO_Moroes_Male_Human_ChessTurn7_02	У вас осталось мало фигур. Вы проиграете, если они закончатся.	
VO_Moroes_Male_Human_ChessTurn7_03	Сэр, у вас осталось мало фигур. Вы проиграете, если они закончатся.	
VO_Moroes_Male_Human_ChessWin_01	Ура! Скорее в оперу!	
VO_Moroes_Male_Human_CroneTurn5_02	Мажордом Экзекутус ждет внизу. Сказать ему, что еще слишком рано?	
VO_Moroes_Male_Human_CroneWin_01	Наконец-то! Теперь освободим волшебника!	
VO_Moroes_Male_Human_CuratorTurn3_01	Смотритель сошел с ума! Нужно остановить его, пока все животные не разбежались!	
VO_Moroes_Male_Human_CuratorWin_01	Та-ак... Тут нужно подкрутить... и все, как новенький!	
VO_Moroes_Male_Human_EndWing1_01	Превосходно! Оперный зал вверх по лестнице! Уверен, Барнс пропустит нас без проблем.	
VO_Moroes_Male_Human_FinalAltTurn5_01	Сколько порталов... Интересно, что за этим?	
VO_Moroes_Male_Human_FinalMaidenTurn1_01	Простите! Разберитесь с ней, а я попытаюсь найти нужный переключатель.	
VO_Moroes_Male_Human_FinalMaidenTurn7_03	О, сколько щупалец! Этот мир нам точно не нужен.	
VO_Moroes_Male_Human_FinalNazraTurn7_02	Прогоните орчиху, и мы попробуем открыть еще один портал!	
VO_Moroes_Male_Human_FinalSecondSequence_01	Отлично! Теперь попробуем этот...	
VO_Moroes_Male_Human_FInalStartSequence_01	Так... Посмотрим. Может, этот?	
VO_Moroes_Male_Human_FinalThirdSequence_01	Есть!	
VO_Moroes_Male_Human_FinalTurn1_02	Ой! Это не тот портал. Прогоните орчиху, и я попробую еще раз.	
VO_Moroes_Male_Human_IllhoofKilrekResponse_01	Кого это они призывают?	
VO_Moroes_Male_Human_JulianneTurn5_01	Барнс, пропусти нас! Если не спасти Медива, вечеринка будет испорчена!	
VO_Moroes_Male_Human_JulianneTurn9_02	Прибыл Иллидан! Мы не готовы!	
VO_Moroes_Male_Human_MedivhSkinResponse_01	Костюм Медива? Что я могу сказать? Сходство потрясающее!	
VO_Moroes_Male_Human_MirrorTurn3_01	Хм...	
VO_Moroes_Male_Human_MirrorTurn5_01	Скоро придет лорд Нефарий. Боюсь даже представить его реакцию.	
VO_Moroes_Male_Human_MirrorWin_02	Отлично! Лестница в оперный зал – перед вами!	
VO_Moroes_Male_Human_NetherspiteTurn1_01	Лучи питают дракона. Заблокируй их существами!	
VO_Moroes_Male_Human_NetherspiteTurn5_01	Скажи, в котором из них Медив!	
VO_Moroes_Male_Human_NetherspiteTurn7_01	Нам нужны порталы! Гости уже швыряют книги в бассейн с маной!	
VO_Moroes_Male_Human_NetherspiteWin_01	Превосходно! Теперь бы вспомнить, как эта штука работает...	
VO_Moroes_Male_Human_NightbaneTurn3_01	Смотритель, мы должны спасти Медива!	
VO_Moroes_Male_Human_NightbaneTurn7_01	Лига Исследователей прибыла в полном составе. РЕНО, НЕ ТРОГАЙ СТОЛОВОЕ СЕРЕБРО!	
VO_Moroes_Male_Human_PrologueTurn11_01	*Кхм* И он даже не спалил библиотеку...	
VO_Moroes_Male_Human_PrologueTurn5_03	Сэр, Ме-дивы уже в обеденном зале. Барнс репетирует с ними.	
VO_Moroes_Male_Human_PrologueTurn7_01	Сэр, взгляните в окно. Рейдовые боссы требуют, чтобы их тоже пригласили.	
VO_Moroes_Male_Human_PrologueTurn9_02	Сэр, мурлоки боятся шариков. Вы забыли?	
VO_Moroes_Male_Human_PrologueWin_02	Ой, беда, беда. Что же делать...	
VO_Moroes_Male_Human_SilverwareResponse_01	Ох... это была ценная вещица.	
VO_Moroes_Male_Human_SilverwareTurn3_02	Столовые приборы действуют сообща! Мы окружены!	
VO_Moroes_Male_Human_SilverwareWin_01	Ох, что за бардак.	
VO_Moroes_Male_Human_Wing1Intro_02	Я Мороуз, дворецкий Каражана, и мне нужна ваша помощь! Медив исчез! Нужно спасти его и вовремя начать вечеринку!	
VO_Moroes_Male_Human_Wing1Win_01	Отлично! Так мы скоро доберемся до вершины, и вечеринка будет спасена!	
VO_Moroes_Male_Human_Wing2Win_01	Вперед! Наверху нас ждет зверинец, который охраняет смотритель. Надеюсь, он в порядке...	
VO_Moroes_Male_Human_Wing3Open_02	Смотритель охраняет зверинец с самыми экзотическими существами Азерота. За ним – покои хозяина и портал!	
VO_Moroes_Male_Human_Wing3Win_02	Мы почти на вершине! Надо спасти Медива, пока гости не передрались!	
VO_Moroes_Male_Human_Wing4Intro_01	Наконец-то! Вершина башни! Нужно отыскать правильный портал и вернуть Медива!	
VO_Moroes_Male_Human_Wing4Win_01	Получилось! Вечеринка началась вовремя. Приходите через неделю! У Медива день рождения, и мне... не помешает помощь.	
VO_Moroes_Male_Human_WolfClaws_03	Хм-м-м... Что-то я сомневаюсь...	
VO_NAX1_01_CARD_02	Посмотрим, какие вы на вкус!	
VO_NAX1_01_DEATH_05	Ну почему?!	
VO_NAX1_01_EMOTE_04	Оно разговаривает!	
VO_NAX1_01_HP_03	Подойдите ближе, лакомые кусочки.	
VO_NAX1_01_START_01	Добро пожаловать!	
VO_NAX10_01_DEATH_LINE_03	Что... случилось... с Лоску...	
VO_NAX10_01_EMOTE1_04	Пора играть?	
VO_NAX10_01_EMOTE2_05	Да! Да! Играть!	
VO_NAX10_01_HP_02	Больше не хочешь играть?	
VO_NAX10_01_START_01	Лоскутик хочет поиграть!	
VO_NAX11_01_CARD_03	Слизь.	
VO_NAX11_01_DEATH_05	*ух ox ах аррр грлаааааа*	
VO_NAX11_01_EMOTE_04	Молчи.	
VO_NAX11_01_HP_02	Отрава.	
VO_NAX11_01_START_01	Мясо.	
VO_NAX12_01_CARD_01	*Рычит*	
VO_NAX12_01_DEATH_01	*Скулит*	
VO_NAX12_01_EMOTE_01	*Ворчит*	
VO_NAX12_01_EMOTE_02	*Грррр*	
VO_NAX12_01_EMOTE_03	*Грррооооо*	
VO_NAX12_01_HP_01	*Рррр – ХРУМ*	
VO_NAX12_01_START_01	*Рычит*	
VO_NAX13_01_DEATH_LINE_03	Благодарю тебя.	
VO_NAX13_01_EMOTE_04	Убью!	
VO_NAX13_01_HP_02	Сейчас ты умрешь!	
VO_NAX13_01_START_01	Я... должен... повиноваться...	
VO_NAX14_01_CARD_01	*ррррАААХ*	
VO_NAX14_01_DEATH_01	*аррррр...*	
VO_NAX14_01_EMOTE_01	*ррр Ррраххх!*	
VO_NAX14_01_EMOTE_02	*грррраааааах*	
VO_NAX14_01_EMOTE_03	*арррррррр*	
VO_NAX14_01_HP_01	*гррррррр*	
VO_NAX14_01_START_01	*АРРРРРРР*	
VO_NAX15_01_BIGGLES_32	Да что ж вы все к нему лезете?!	
VO_NAX15_01_DEATH_LINE_08	Это еще не конец... Есть еще героический режим!	
VO_NAX15_01_DEATH_LINE2_09	Неееееееееееееет!	
VO_NAX15_01_EMOTE_HELLO_26	Ты всегда любезничаешь с теми, кто хочет тебя убить?	
VO_NAX15_01_EMOTE_OOPS_29	Это точно.	
VO_NAX15_01_EMOTE_SORRY_28	Ничего страшного, незваный гость, мы все ошибаемся.	
VO_NAX15_01_EMOTE_THANKS_27	Эм... Всегда к твоим услугам.	
VO_NAX15_01_EMOTE_THREATEN_30	Ой-ой-ой-ой! Как страшно!	
VO_NAX15_01_EMOTE_WP_25	Бррр, а как еще я мог сыграть?! Я же Кел'Тузад, а не кто попало!	
VO_NAX15_01_HP_07	Я заморожу кровь в твоих жилах!	
VO_NAX15_01_HP2_05	Теперь твоя душа служит мне!	
VO_NAX15_01_HP3_06	Тебе не уйти!	
VO_NAX15_01_HURRY_31	Мое терпение не безгранично.	
VO_NAX15_01_PHASE2_10	Твои силы были потрачены впустую!	
VO_NAX15_01_PHASE2_ALT_11	Все! Хватит! Теперь ходить буду Я!	
VO_NAX15_01_RESPOND_ANDUIN_24	Святая простота! Напомнить, что случилось с Утером?	
VO_NAX15_01_RESPOND_GARROSH_15	Боюсь, все-таки смерть.	
VO_NAX15_01_RESPOND_GARROSH_ALT_16	Это предложение? Тогда я выбираю победу.	
VO_NAX15_01_RESPOND_GULDAN_22	А не много ли ты на себя берешь?	
VO_NAX15_01_RESPOND_JAINA_23	Ну вы только посмотрите! Вломилась в мой некрополис, да еще и чем-то недовольна!	
VO_NAX15_01_RESPOND_MALFURION_ALT_21	Да? А Наксрамас тут при чем?	
VO_NAX15_01_RESPOND_REXXAR_19	Ну если ты так настаиваешь...	
VO_NAX15_01_RESPOND_THRALL_17	Сражаешься за молот? М-м-м... ладно.	
VO_NAX15_01_RESPOND_UTHER_14	А я – с мощными заклинаниями и толстыми прислужниками. Удачи!	
VO_NAX15_01_RESPOND_VALEERA_18	Поверь мне, я буду.	
VO_NAX15_01_START_13	Наконец-то мы встретились.	
VO_NAX15_01_SUMMON_ADDS_12	Вперед, слуги мои!	
VO_NAX2_01_CARD_02	Убивайте во имя господина!	
VO_NAX2_01_CUSTOM_03	Ты подвел меня!	
VO_NAX2_01_DEATH_LINE_05	Господин отомстит за меня!	
VO_NAX2_01_EMOTE_06	Ха-ха-ха!	
VO_NAX2_01_HP_04	Склонись предо мной, червь!	
VO_NAX2_01_START_01	Мои адепты подчиняются мне беспрекословно!	
VO_NAX3_01_CARD_01	*гргргргргргр*	
VO_NAX3_01_DEATH_01	*шипит*	
VO_NAX3_01_EMOTE_01	*шипит*	
VO_NAX3_01_EMOTE_02	*шипит*	
VO_NAX3_01_EMOTE_03	*шипит*	
VO_NAX3_01_EMOTE_04	*шипит*	
VO_NAX3_01_EMOTE_05	*шипит*	
VO_NAX3_01_HP_01	*шипит*	
VO_NAX3_01_START_01	*щелкает жвалами*	
VO_NAX4_01_CARD_03	Чума никого не щадит.	
VO_NAX4_01_DEATH_LINE_04	Я буду служить господину...	
VO_NAX4_01_EMOTE_06	Ты умрешь!	
VO_NAX4_01_HP_02	Восстаньте, мои воины! Восстаньте и сражайтесь вновь!	
VO_NAX4_01_START_01	Еще одна душа для моей «коллекции».	
VO_NAX5_01_CARD_03	Я взорву ваш МОЗГ!	
VO_NAX5_01_DEATH_LINE_04	Надо было принять душ...	
VO_NAX5_01_EMOTE_05	У меня нет времени на эту ерунду.	
VO_NAX5_01_HP_02	Танцуйте, глупцы!	
VO_NAX5_01_START_01	Думаешь, здесь ты в безопасности?	
VO_NAX6_01_CARD_03	Конец близок.	
VO_NAX6_01_DEATH_LINE_04	*урррррррр*	
VO_NAX6_01_EMOTE_05	Ты впустую сотрясаешь воздух.	
VO_NAX6_01_HP_02	Теперь ты принадлежишь мне!	
VO_NAX6_01_START_01	Я тебя вижу.	
VO_NAX7_01_CARD_03	И что тебе дома не сиделось?	
VO_NAX7_01_DEATH_LINE_04	Достойная смерть...	
VO_NAX7_01_EMOTE_05	Ну что, разомнемся?	
VO_NAX7_01_HP_02	Йааааа!	
VO_NAX7_01_START_01	Нет... Нет! Мои ученики! Верни их!	
VO_NAX8_01_CARD_02	Можешь убивать моих слуг сколько вздумается... Их души тебя еще навестят.	
VO_NAX8_01_CUSTOM_03	Хахаха! Я – Жнец душ!	
VO_NAX8_01_CUSTOM2_04	Мертвые восстают!	
VO_NAX8_01_DEATH_LINE_05	Меня больше нет.	
VO_NAX8_01_EMOTE1_06	Ты слишком торопишься на встречу со смертью!	
VO_NAX8_01_EMOTE2_07	Тебе никогда не понять, сколь велика сила, потревоженная тобой.	
VO_NAX8_01_EMOTE3_08	Чтобы проникнуть в царство Жнеца, тебе пришлось отчаянно сражаться.	
VO_NAX8_01_EMOTE4_09	Теперь перед тобой лежит лишь один путь...	
VO_NAX8_01_EMOTE5_10	...войти в меню игры и нажать кнопку «Сдаться».	
VO_NAX8_01_START_01	Моих слуг не остановит даже смерть.	
VO_NAX9_01_CUSTOM_02	Хватит болтать. Готовьтесь к бою.	
VO_NAX9_01_DEATH_LINE_03	Мне нужно больше времени!	
VO_NAX9_01_EMOTE_04	Ты ищешь смерти?	
VO_NAX9_01_START_01	Мы сотрем тебя в порошок.	
VO_NAX9_02_CUSTOM_01	Незваный гость! Беги, пока не поздно!	
VO_NAX9_03_CUSTOM_01	Ну что ты, Зелиек, давай повеселимся.	
VO_NAX9_04_CUSTOM_01	Давай, размазня, нападай!	
VO_Nazra_Female_Orc_FinalNazraChogall_02	Клан Сумеречного Молота? Как вас сюда занесло?	
VO_Nazra_Female_Orc_FinalNazraDeath_01	За Орду...	
VO_Nazra_Female_Orc_FinalNazraEmoteResponse_01	Назра сокрушит тебя!	
VO_Nazra_Female_Orc_FinalNazraGrom_01	Громмаш?! Давно не виделись!	
VO_Nazra_Female_Orc_FinalNazraHeroPower_01	Назра будет править этим жалким мирком!	
VO_Nazra_Female_Orc_FinalStartSequence_01	Падите на колени пред Ордой!	
VO_NEFARIAN_ATRAMEDES_DEATH_76	Убить слепого дракона! Тебе не стыдно?	
VO_NEFARIAN_BARON_GEDDON_DEAD_40	Хорошо. Да. Да!	
VO_NEFARIAN_CHROMAGGUS_DEAD_63	Хромаггус был самым слабым прислужником. А ты, наверно, гордишься собой?	
VO_NEFARIAN_CHROMAGGUS1_59	У него две головы, потому что в двух головах вдвое больше зубов!	
VO_NEFARIAN_CHROMAGGUS2_60	Я наделил его силой драконов всех цветов! Он – просто совершенство!	
VO_NEFARIAN_CHROMAGGUS3_61	Молодец, Хромаггус, хороший мальчик.	
VO_NEFARIAN_CHROMAGGUS4_62	Что, карт многовато? А-ха-ха! Хороший пес.	
VO_NEFARIAN_COREN_DEAD_28	«Угрюмый обжора», как мило.	
VO_NEFARIAN_DRAKKISATH_DEAD_50	Ты начинаешь меня раздражать.	
VO_NEFARIAN_DRAKKISATH_RESPOND_48	Да, Драккисат. Герой, ты все еще находишься на НЕПРАВИЛЬНОЙ стороне горы!	
VO_NEFARIAN_DRAKKISATH1_49	Иди-ка поиграй в рейтинговые игры. Это приключение не для тебя.	
VO_NEFARIAN_GARR_DEAD1_38	Возьми кусочек Гарра и пусти «блинчик» по озеру лавы Рагнароса. Он будет в восторге.	
VO_NEFARIAN_GARR2_35	Ты поосторожнее с этими камнями, ладно?	
VO_NEFARIAN_GARR3_36	Постарайся не взорваться. Тебе еще Повелителя элементалей изгонять.	
VO_NEFARIAN_GARR4_37	А мне нравится за тобой наблюдать.	
VO_NEFARIAN_GRIMSTONE_DEAD1_30	Продолжай в том же духе, и скоро Рагнарос покинет эту гору!	
VO_NEFARIAN_HEROIC_BLOCK_77	Не в героическом режиме.	
VO_NEFARIAN_MALORIAK_DEATH_PT1_72	Поздравляю! Удивительное достижение!	
VO_NEFARIAN_MALORIAK_DEATH_PT2_73	Думаю, по такому случаю я придумаю для тебя новый титул.	
VO_NEFARIAN_MALORIAK_DEATH_PT3_74	«Убийца глупых, неумелых и никчемных прислужников». Да, то, что надо.	
VO_NEFARIAN_MALORIAK_TURN2_71	Малориак, постарайся не проиграть.	
VO_NEFARIAN_NEF_MISSION_66	Так нечестно! Я этого не потерплю!	
VO_NEFARIAN_NEF2_65	Нет! Нет! Я тебя уничтожу!	
VO_NEFARIAN_OMNOTRON_DEAD_69	Спасибо, хоть на починку тратиться не придется.	
VO_NEFARIAN_OMOKK_DEAD_46	Бессмыслица какая-то.	
VO_NEFARIAN_OMOKK1_44	Что ты здесь делаешь? Рагнарос мертв. Иди, празднуй с друзьями.	
VO_NEFARIAN_OMOKK2_45	Не понимаю. Нет здесь больше Рагнароса. Кончился. Задание выполнено. Уходи!	
VO_NEFARIAN_RAZORGORE_DEAD_55	Эти яйца предназначались для великих экспериментов!	
VO_NEFARIAN_REND_DEAD_53	Так, смертный. Со мной твои штучки не пройдут.	
VO_NEFARIAN_REND1_52	Даже этот орк знает, что ты все делаешь не так.	
VO_NEFARIAN_THAURISSAN_DEAD_32	Надо было и другого дворфа убить! Живых не оставлять!	
VO_NEFARIAN_THAURISSAN_DEAD2_33	Тебе удалось убить обоих дворфов? Я впечатлен.	
VO_NEFARIAN_VAEL_DEAD_57	Ха! А ведь он был хорошим! Тебе, наверно, очень грустно.	
VO_Netherspite_Male_Dragon_NetherspiteAngryChicken_01	Опять ты? Что ты делаешь в моих порталах?	
VO_Netherspite_Male_Dragon_NetherspiteDeath_01	Моя работа...	
VO_Netherspite_Male_Dragon_NetherspiteEmoteResponse_01	Хочешь сразиться с драконом в его лаборатории?	
VO_Netherspite_Male_Dragon_NetherspiteEmpowerment_01	Сколько миров! Сколько можно узнать!	
VO_Netherspite_Male_Dragon_NetherspiteOpen_01	Кто мешает моим исследованиям?	
VO_Netherspite_Male_Dragon_NetherspiteShadowBreath_01	Прочь!	
VO_Netherspite_Male_Dragon_NetherspiteTurn12_01	Хммм... Если 12 мурлоков выйдут из красного портала в 4, а К’Тун прибудет ровно в пять.... Надо подумать…	
VO_Netherspite_Male_Dragon_NetherspiteTurn3_02	Не мешай моим экспериментам!	
VO_Netherspite_Male_Dragon_NetherspiteTurn5_01	Хватит трогать мои порталы! Они очень тонко настроены!	
VO_Netherspite_Male_Dragon_NetherspiteTurn7_01	Зачем вы сюда пришли? Идите на свою вечеринку!	
VO_Netherspite_Male_Dragon_NetherspiteUnstablePortal_01	Любопытно. Резонансные отклонения выявляют фундаментальную нестабильность.	
VO_Netherspite_Male_Dragon_NetherspiteUnstablePortal_02	Любопытно. Фундаментальная нестабильность.	
VO_Nightbane_Roar	*РЫК*	
VO_PrinceKeleseth_Male_Vampire_ResponseLanaThel_01	Моя королева!	
VO_PrinceTaldaram_Male_Vampire_ResponseLanaThel_01	Моя королева... меня мучает жажда.	
VO_PrinceValanar_Male_Vampire_ResponseLanaThel_01	Королева Лана'тель!	
VO_RAGNAROS_GRIMSTONE_DEAD2_66	Я УНИЧТОЖУ ТЕБЯ, ЧЕШУЙЧАТОЕ ОТРОДЬЕ!	
VO_RAGNAROS_NEF1_71	Похоже, тебе не помешает помощь, герой.	
VO_RAGNAROS_NEF3_72	Я отомщу! Очистись огнем!!!	
VO_RAGNAROS_NEF4_73	Мои слуги уничтожат тебя, Крыло Тьмы!	
VO_RAGNAROS_NEF5_74	Обрати этого пафосного дракона в прах!	
VO_RAGNAROS_NEF6_75	Подарочек из Огненных Просторов!	
VO_RAGNAROS_NEF7_76	Тебе не загасить пламя Повелителя Огня!	
VO_RAGNAROS_NEF8_77	Я отомщу тебе, дракон!	
VO_Rakanishu_Male_Elemental_CastSpell1_01	Не трогай... МЕНЯ!	
VO_Rakanishu_Male_Elemental_CastSpell2_01	Очистись огнем!	
VO_Rakanishu_Male_Elemental_CastSpell3_01	Умри, приключенец!	
VO_Rakanishu_Male_Elemental_CastSpell4_01	За Рафаама!	
VO_Rakanishu_Male_Elemental_CastSpell5_01	Все сгорит!	
VO_Rakanishu_Male_Elemental_EventRagnaros_02	Мой герой!	
VO_Rakanishu_Male_Elemental_Intro_01	Уничтожить! Забрать сокровища!	
VO_SilverwareGolem_Male_SilverwareGolem_SilverwareDeath_02	Кто уберет посуду?..	
VO_SilverwareGolem_Male_SilverwareGolem_SilverwareEmoteResponse_01	Пора мыть посуду!	
VO_SilverwareGolem_Male_SilverwareGolem_SilverwareForkedLightning_01	Хотите вилок? Их есть у меня!	
VO_SilverwareGolem_Male_SilverwareGolem_SilverwareHeroPower_01	Накрываем на стол! 	
VO_SilverwareGolem_Male_SilverwareGolem_SilverwareKnifeJuggler_01	Ловкость рук!	
VO_SilverwareGolem_Male_SilverwareGolem_SilverwareOpen_01	Обожаю танцевать!	
VO_SilverwareGolem_Male_SilverwareGolem_SilverwarePlateTossing_01	Держи тарелку! И тебе тарелку! Всем по тарелке!	
VO_TB_MEDIVA1_001	Горите!	
VO_TB_MEDIVA1_002	Осторожно!	
VO_TB_MEDIVA1_003	Бедный Тито!	
VO_TB_MEDIVA1_004	Не болей...	
VO_TB_MEDIVA1_005	Зверство!	
VO_TB_MEDIVA1_006	Ах, пушистики.	
VO_TB_MEDIVA1_007	Нет! Только не яд.	
VO_TB_MEDIVA1_008	Как красиво!	
VO_TB_MEDIVA1_009	Вызывали?	
VO_TB_MEDIVA2_001	Жарко!	
VO_TB_MEDIVA2_002	Страшно.	
VO_TB_MEDIVA2_003	Ух, как холодно.	
VO_TB_MEDIVA2_004	О нет! Это ловушка!	
VO_TB_MEDIVA2_005	Я не могу на это смотреть!	
VO_TB_MEDIVA2_006	Ой, милашка.	
VO_TB_MEDIVA2_007	Обожаю бесов.	
VO_TB_MEDIVA2_008	Как красиво!	
VO_TB_MEDIVA2_009	Апчхи!	
VO_TB_MEDIVA2_010	Вызывали?	
VO_TB_MEDIVA3_001	Жарко!	
VO_TB_MEDIVA3_002	...и снеговик нас ждет давно!	
VO_TB_MEDIVA3_003	Страшный мрак!	
VO_TB_MEDIVA3_004	Ловушка!	
VO_TB_MEDIVA3_005	Каких еще зверей?	
VO_TB_MEDIVA3_006	Его слуги самые милые!	
VO_TB_MEDIVA3_007	О нет! Беда...	
VO_TB_MEDIVA3_008	Вот это яд.	
VO_TB_MEDIVA3_009	Встречайте: Ме-дивы!	
VO_TB_MEDIVA3_010	Да!	
VO_Terenas_Male_Human_ICCDruidVictory_01	Некогда он лелеял жизнь в лесах Азерота. Теперь же Малфурион Пагубный следит за равновесием в природе, ухаживая за садом смерти.	
VO_Terenas_Male_Human_ICCHunterVictory_01	Рексар освободил души, некогда захваченные Королем-личом. Он вытащил черную стрелу из своего колчана. «Идем, Миша, – проговорил он. – Охота начинается...»	
VO_Terenas_Male_Human_ICCMageVictory_01	Надев корону, лич льда окинула взором свои владения.	
VO_Terenas_Male_Human_ICCPaladinVictory_01	Некогда благородному паладину достался новый удел. Теперь он вершит судьбы мертвых, проявляя снисхождение к праведникам и карая грешников.	
VO_Terenas_Male_Human_ICCPriestVictory_01	Юного принца окутали тени. «Наконец-то я прозрел», — произнес Андуин, и его глаза запылали синим пламенем.	
VO_Terenas_Male_Human_ICCRogueVictory_01	Валира Иссохшая растворилась в ночи. Ее тени видят все, и никому не укрыться от ее ледяных клинков…	
VO_Terenas_Male_Human_ICCShamanVictory_01	Разум шамана заполонили голоса мертвых. Провидец смерти закрыл глаза и прошептал лишь одно слово: «Усните...»	
VO_Terenas_Male_Human_ICCWarlockVictory_01	Гул'дан наконец-то занял Ледяной Трон. Темный портал открылся вновь, и бессчетные миры содрогнулись.	
VO_Terenas_Male_Human_ICCWarriorVictory_01	Бывший Вождь Орды принял новообретенную силу. Он поднял из мертвых поверженных врагов и заставил их служить своей ледяной воле.	
VO_TIRION_INTRO_03	Кто из этих благородных рыцарей будет назван победителем?	
VO_WhiteKing_Male_ChessPiece_ChessDeath_01	Шах и мат...	
VO_WhiteKing_Male_ChessPiece_ChessEmoteGreetings_01	Сыграем партию?	
VO_WhiteKing_Male_ChessPiece_ChessEmoteOops_01	Промашка.	
VO_WhiteKing_Male_ChessPiece_ChessEmoteSorry_01	Неудачное развитие событий.	
VO_WhiteKing_Male_ChessPiece_ChessEmoteThanks_01	Как благородно.	
VO_WhiteKing_Male_ChessPiece_ChessEmoteThinking_01	Хм-м, ладья на А3...	
VO_WhiteKing_Male_ChessPiece_ChessEmoteThinking_02	Конь на F6...	
VO_WhiteKing_Male_ChessPiece_ChessEmoteThinking_03	Ферзь на E5... Э, нет, нет...	
VO_WhiteKing_Male_ChessPiece_ChessEmoteThreaten_01	Вижу мат в четыре хода.	
VO_WhiteKing_Male_ChessPiece_ChessEmoteWellPlayed_01	Шах и мат.	
VO_WhiteKing_Male_ChessPiece_ChessEmoteWow_01	О, превосходно!	
VO_WhiteKing_Male_ChessPiece_ChessOpen_02	Ангард!	
VOX_Nightbane_Start_01	Р-р-р!	
