TAG	TEXT	COMMENT
GAMEPLAY_EMOTE_EX1_323h_CONCEDE	Tú ganas... ¡PERO TU MUNDO SIGUE TENIENDO LOS DÍAS CONTADOS!	
GAMEPLAY_EMOTE_EX1_323h_ERROR_FULL_MINIONS	HAY DEMASIADOS ESBIRROS.	
GAMEPLAY_EMOTE_EX1_323h_ERROR_GENERIC	ESO NO SE PUEDE HACER.	
GAMEPLAY_EMOTE_EX1_323h_ERROR_HAND_FULL	¡HAY DEMASIADAS CARTAS!	
GAMEPLAY_EMOTE_EX1_323h_ERROR_I_ATTACKED	YA ATAQUÉ.	
GAMEPLAY_EMOTE_EX1_323h_ERROR_JUST_PLAYED	¡ACABA DE ENTRAR!	
GAMEPLAY_EMOTE_EX1_323h_ERROR_MINION_ATTACKED	ESA COSA YA ATACÓ.	
GAMEPLAY_EMOTE_EX1_323h_ERROR_NEED_MANA	¡NO HAY SUFICIENTE MANÁ!	
GAMEPLAY_EMOTE_EX1_323h_ERROR_NEED_WEAPON	¿PARA DÓNDE SE FUE A PARAR MI ARMA?	
GAMEPLAY_EMOTE_EX1_323h_ERROR_PLAY	NO PUEDO HACER ESA JUGADA.	
GAMEPLAY_EMOTE_EX1_323h_ERROR_STEALTH	ESTÁ EN SIGILO.	
GAMEPLAY_EMOTE_EX1_323h_ERROR_TARGET	NO ES VÁLIDO.	
GAMEPLAY_EMOTE_EX1_323h_ERROR_TAUNT	¡ESE ESBIRRO CON PROVOCACIÓN ESTÁ EN MI CAMINO!	
GAMEPLAY_EMOTE_EX1_323h_FIRE_FESTIVAL	¡ENCIENDAN LAS LLAMAS!	
GAMEPLAY_EMOTE_EX1_323h_GOOD_GAME	¡BUENA PARTIDA!	
GAMEPLAY_EMOTE_EX1_323h_GREETINGS	¡Te enfrentas a Jaraxxus, señor Eredar de la Legión Ardiente!	
GAMEPLAY_EMOTE_EX1_323h_HALLOWS_END	¡LA MUERTE TE VISITARÁ EN HALLOWEEN!	
GAMEPLAY_EMOTE_EX1_323h_LOW_CARDS	¡Mi mazo! ¡ME ESTOY QUEDANDO SIN CARTAS!	
GAMEPLAY_EMOTE_EX1_323h_LUNAR_NEW_YEAR	¡FELIZ AÑO NUEVO!	
GAMEPLAY_EMOTE_EX1_323h_NO_CARDS	¡NOOOOO! ¡NO ME QUEDAN CARTAS!	
GAMEPLAY_EMOTE_EX1_323h_NOBLEGARDEN	¡FELIZ JARDÍN NOBLE!	
GAMEPLAY_EMOTE_EX1_323h_OOPS	¡ERROR!	
GAMEPLAY_EMOTE_EX1_323h_PIRATE_DAY	¡SOY JARRRRRRAXXUS!	
GAMEPLAY_EMOTE_EX1_323h_SORRY	JARAXXUS lo... lo siente.	
GAMEPLAY_EMOTE_EX1_323h_THANKS	GRACIAS.	
GAMEPLAY_EMOTE_EX1_323h_THINK1	Mmm...	
GAMEPLAY_EMOTE_EX1_323h_THINK2	Me pregunto...	
GAMEPLAY_EMOTE_EX1_323h_THINK3	Cómo te destruiré...	
GAMEPLAY_EMOTE_EX1_323h_THREATEN	¡OLVIDO!	
GAMEPLAY_EMOTE_EX1_323h_TIMER	¡SE ACABA EL TIEMPO!	
GAMEPLAY_EMOTE_EX1_323h_WELL_PLAYED	¡BUENA JUGADA!	
GAMEPLAY_EMOTE_EX1_323h_WINTERVEIL_GREETINGS	ESTE FESTIVAL DE INVIERNO, ¡ME DARÉ UN FESTÍN CON TU ALMA!	
GAMEPLAY_EMOTE_EX1_323h_WOW_04	¡ALUCINANTE!	
GAMEPLAY_EMOTE_HERO_01_CONCEDE	¡Elijo la muerte!	
GAMEPLAY_EMOTE_HERO_01_ERROR_FULL_MINIONS	Tengo demasiados esbirros.	
GAMEPLAY_EMOTE_HERO_01_ERROR_GENERIC	No puedo hacer eso.	
GAMEPLAY_EMOTE_HERO_01_ERROR_HAND_FULL	¡Mi mano está llena!	
GAMEPLAY_EMOTE_HERO_01_ERROR_I_ATTACKED	Ya ataqué.	
GAMEPLAY_EMOTE_HERO_01_ERROR_JUST_PLAYED	Ese esbirro necesita un turno de descanso.	
GAMEPLAY_EMOTE_HERO_01_ERROR_MINION_ATTACKED	Ese esbirro ya atacó.	
GAMEPLAY_EMOTE_HERO_01_ERROR_NEED_MANA	No tengo suficiente maná.	
GAMEPLAY_EMOTE_HERO_01_ERROR_NEED_WEAPON	Necesito un arma.	
GAMEPLAY_EMOTE_HERO_01_ERROR_PLAY	No puedo hacer esa jugada.	
GAMEPLAY_EMOTE_HERO_01_ERROR_STEALTH	No puedo hacer objetivo en esbirros en Sigilo.	
GAMEPLAY_EMOTE_HERO_01_ERROR_TARGET	Ese objetivo no es válido.	
GAMEPLAY_EMOTE_HERO_01_ERROR_TAUNT	Hay un esbirro con Provocación en el camino.	
GAMEPLAY_EMOTE_HERO_01_EVENT_FIRE_FESTIVAL	¡Enciendan las piras!	
GAMEPLAY_EMOTE_HERO_01_EVENT_LUNAR_NEW_YEAR	¡Feliz año nuevo!	
GAMEPLAY_EMOTE_HERO_01_GOOD_GAME	Buena partida.	
GAMEPLAY_EMOTE_HERO_01_GREETINGS	Heh, encantado.	
GAMEPLAY_EMOTE_HERO_01_GREETINGS_RESPONSE	Ja, ja. Encantado.	
GAMEPLAY_EMOTE_HERO_01_HALLOWS_END	Feliz Halloween.	
GAMEPLAY_EMOTE_HERO_01_LOW_CARDS	¡Casi no me quedan cartas!	
GAMEPLAY_EMOTE_HERO_01_MIRROR_START	¡Ja, ja! ¡Veamos qué tienes!	
GAMEPLAY_EMOTE_HERO_01_NO_CARDS	¡No me quedan cartas!	
GAMEPLAY_EMOTE_HERO_01_NOBLEGARDEN	¡Feliz Jardín Noble!	
GAMEPLAY_EMOTE_HERO_01_OOPS	Fue un error.	
GAMEPLAY_EMOTE_HERO_01_PIRATE_DAY	¡YARRRRTY JARRRTY JARRR-TI-JAR!	
GAMEPLAY_EMOTE_HERO_01_SORRY	Lo siento mucho.	
GAMEPLAY_EMOTE_HERO_01_START	¡Victoria o muerte!	
GAMEPLAY_EMOTE_HERO_01_THANKS	Te lo agradezco.	
GAMEPLAY_EMOTE_HERO_01_THINK1	Mmm...	
GAMEPLAY_EMOTE_HERO_01_THINK2	Mmm... me pregunto...	
GAMEPLAY_EMOTE_HERO_01_THINK3	Ahora qué...	
GAMEPLAY_EMOTE_HERO_01_THREATEN	¡Te aplastaré!	
GAMEPLAY_EMOTE_HERO_01_TIMER	¡Debo elegir!	
GAMEPLAY_EMOTE_HERO_01_WELL_PLAYED	Buena jugada.	
GAMEPLAY_EMOTE_HERO_01_WINTERVEIL_GREETINGS	¡Feliz festín del Festival de Invierno!	
GAMEPLAY_EMOTE_HERO_01_WOW	¡Increíble!	
GAMEPLAY_EMOTE_HERO_01A_CELEBRATE	¡Hip, hip, hurra!	
GAMEPLAY_EMOTE_HERO_01A_CONCEDE	Me has vencido.	
GAMEPLAY_EMOTE_HERO_01A_ERROR_FULL_MINIONS	Tengo demasiados esbirros.	
GAMEPLAY_EMOTE_HERO_01A_ERROR_GENERIC	No puedo hacer eso.	
GAMEPLAY_EMOTE_HERO_01A_ERROR_HAND_FULL	¡Mi mano está completa!	
GAMEPLAY_EMOTE_HERO_01A_ERROR_I_ATTACKED	Ya he atacado.	
GAMEPLAY_EMOTE_HERO_01A_ERROR_JUST_PLAYED	Ese esbirro necesita un turno de descanso.	
GAMEPLAY_EMOTE_HERO_01A_ERROR_MINION_ATTACKED	Ese esbirro ya atacó.	
GAMEPLAY_EMOTE_HERO_01A_ERROR_NEED_MANA	No tengo suficiente maná.	
GAMEPLAY_EMOTE_HERO_01A_ERROR_NEED_WEAPON	Necesito un arma.	
GAMEPLAY_EMOTE_HERO_01A_ERROR_PLAY	No puedo hacer esa jugada.	
GAMEPLAY_EMOTE_HERO_01A_ERROR_STEALTH	No puedo hacer objetivo en esbirros en Sigilo.	
GAMEPLAY_EMOTE_HERO_01A_ERROR_TARGET	Ese no es un objetivo válido.	
GAMEPLAY_EMOTE_HERO_01A_ERROR_TAUNT	Debo atacar a ese esbirro con Provocación.	
GAMEPLAY_EMOTE_HERO_01A_EVENT_LUNAR_NEW_YEAR	¡Feliz año nuevo!	
GAMEPLAY_EMOTE_HERO_01A_FIRE_FESTIVAL	¡Feliz Festival de Fuego del Solsticio de Verano!	
GAMEPLAY_EMOTE_HERO_01A_GOOD_GAME	Buena partida.	
GAMEPLAY_EMOTE_HERO_01A_GREETINGS	Saludos.	
GAMEPLAY_EMOTE_HERO_01A_GREETINGS_RESPONSE	Saludos para ti.	
GAMEPLAY_EMOTE_HERO_01A_HALLOWS_END	Que tengas un feliz Halloween.	
GAMEPLAY_EMOTE_HERO_01A_LOW_CARDS	Casi no me quedan cartas.	
GAMEPLAY_EMOTE_HERO_01A_MIRROR_START	¡Sí, Khaz'Modan!	
GAMEPLAY_EMOTE_HERO_01A_NO_CARDS	¡No me quedan cartas!	
GAMEPLAY_EMOTE_HERO_01A_NOBLEGARDEN	¡Feliz Jardín Noble!	
GAMEPLAY_EMOTE_HERO_01A_OOPS	Eso... no salió como esperaba.	
GAMEPLAY_EMOTE_HERO_01A_PIRATE_DAY	¡Arrr! ¡Soy el rey de los mares!	
GAMEPLAY_EMOTE_HERO_01A_SORRY	Oh, lo siento tanto.	
GAMEPLAY_EMOTE_HERO_01A_START	¡Por Khaz Modan!	
GAMEPLAY_EMOTE_HERO_01A_THANKS	¡Gracias!	
GAMEPLAY_EMOTE_HERO_01A_THINK1	Mmm...	
GAMEPLAY_EMOTE_HERO_01A_THINK2	¿Qué tal si...? No, no...	
GAMEPLAY_EMOTE_HERO_01A_THINK3	Tantas opciones...	
GAMEPLAY_EMOTE_HERO_01A_THREATEN	¡Siente la furia de la montaña!	
GAMEPLAY_EMOTE_HERO_01A_TIMER	¡Tengo que moverme!	
GAMEPLAY_EMOTE_HERO_01A_WELL_PLAYED	Buena jugada.	
GAMEPLAY_EMOTE_HERO_01A_WINTERVEIL_GREETINGS	¡Feliz festín del Festival de Invierno!	
GAMEPLAY_EMOTE_HERO_01A_WOW	¡Por mi barba!	
GAMEPLAY_EMOTE_HERO_02_CONCEDE	Esta vez ganas, amigo.	
GAMEPLAY_EMOTE_HERO_02_ERROR_FULL_MINIONS	Tengo demasiados esbirros.	
GAMEPLAY_EMOTE_HERO_02_ERROR_GENERIC	No puedo hacer eso.	
GAMEPLAY_EMOTE_HERO_02_ERROR_HAND_FULL	¡Mi mano está demasiado llena!	
GAMEPLAY_EMOTE_HERO_02_ERROR_I_ATTACKED	Ya ataqué.	
GAMEPLAY_EMOTE_HERO_02_ERROR_JUST_PLAYED	Ese esbirro necesita un turno de descanso.	
GAMEPLAY_EMOTE_HERO_02_ERROR_MINION_ATTACKED	Ese esbirro ya atacó.	
GAMEPLAY_EMOTE_HERO_02_ERROR_NEED_MANA	No tengo suficiente maná.	
GAMEPLAY_EMOTE_HERO_02_ERROR_NEED_WEAPON	Necesito un arma.	
GAMEPLAY_EMOTE_HERO_02_ERROR_PLAY	No puedo hacer esa jugada.	
GAMEPLAY_EMOTE_HERO_02_ERROR_STEALTH	No puedo hacer objetivo en esbirros en Sigilo.	
GAMEPLAY_EMOTE_HERO_02_ERROR_TARGET	Ese objetivo no es válido.	
GAMEPLAY_EMOTE_HERO_02_ERROR_TAUNT	Hay un esbirro con Provocación en el camino.	
GAMEPLAY_EMOTE_HERO_02_EVENT_FIRE_FESTIVAL	¡Un festival digno de los elementos!	
GAMEPLAY_EMOTE_HERO_02_EVENT_LUNAR_NEW_YEAR	¡Feliz año nuevo!	
GAMEPLAY_EMOTE_HERO_02_GOOD_GAME	Buena partida.	
GAMEPLAY_EMOTE_HERO_02_GREETINGS	Mucho gusto.	
GAMEPLAY_EMOTE_HERO_02_GREETINGS_RESPONSE	¡Me alegra verte!	
GAMEPLAY_EMOTE_HERO_02_HALLOWS_END	Feliz Halloween.	
GAMEPLAY_EMOTE_HERO_02_LOW_CARDS	¡Casi no me quedan cartas!	
GAMEPLAY_EMOTE_HERO_02_MIRROR_START	¡Por los Lobos gélidos!	
GAMEPLAY_EMOTE_HERO_02_NO_CARDS	¡No me quedan cartas!	
GAMEPLAY_EMOTE_HERO_02_NOBLEGARDEN	Feliz Jardín Noble.	
GAMEPLAY_EMOTE_HERO_02_OOPS	Eso fue un error.	
GAMEPLAY_EMOTE_HERO_02_PIRATE_DAY	Arrrrrr, ¡ha llegado el Día de los Piratas, camarada!	
GAMEPLAY_EMOTE_HERO_02_SORRY	Lo siento mucho.	
GAMEPLAY_EMOTE_HERO_02_START	¡Por Martillo Maldito!	
GAMEPLAY_EMOTE_HERO_02_THANKS	Gracias.	
GAMEPLAY_EMOTE_HERO_02_THINK1	Mmm...	
GAMEPLAY_EMOTE_HERO_02_THINK2	Me pregunto...	
GAMEPLAY_EMOTE_HERO_02_THINK3	Mmm... qué debería hacer...	
GAMEPLAY_EMOTE_HERO_02_THREATEN	¡Los Elementos te destruirán!	
GAMEPLAY_EMOTE_HERO_02_TIMER	¡Queda poco tiempo!	
GAMEPLAY_EMOTE_HERO_02_WELL_PLAYED	Buena jugada.	
GAMEPLAY_EMOTE_HERO_02_WINTERVEIL_GREETINGS	¡Feliz festín del Festival de Invierno!	
GAMEPLAY_EMOTE_HERO_02_WOW	¡Increíble!	
GAMEPLAY_EMOTE_HERO_02A_CELEBRATE	<¡Celebraciones!>	
GAMEPLAY_EMOTE_HERO_02A_CONCEDE	<Me han derrotado.>	
GAMEPLAY_EMOTE_HERO_02A_ERROR_FULL_MINIONS	<Tengo \ndemasiados esbirros.>	
GAMEPLAY_EMOTE_HERO_02A_ERROR_GENERIC	<Eso\nes imposible.>	
GAMEPLAY_EMOTE_HERO_02A_ERROR_HAND_FULL	<Mi mano\nestá llena.>	
GAMEPLAY_EMOTE_HERO_02A_ERROR_I_ATTACKED	<Ya\nataqué.>	VO_HERO_15_ERROR04_43.wav
GAMEPLAY_EMOTE_HERO_02A_ERROR_JUST_PLAYED	<Ese esbirro\ntiene que esperar.>	
GAMEPLAY_EMOTE_HERO_02A_ERROR_MINION_ATTACKED	<Ese esbirro\nya atacó.>	
GAMEPLAY_EMOTE_HERO_02A_ERROR_NEED_MANA	<Necesito más maná.>	
GAMEPLAY_EMOTE_HERO_02A_ERROR_NEED_WEAPON	<Necesito un arma.>	
GAMEPLAY_EMOTE_HERO_02A_ERROR_PLAY	<No puedo hacer esa jugada.>	
GAMEPLAY_EMOTE_HERO_02A_ERROR_STEALTH	<¡No puedo enfrentarme\na un esbirro en Sigilo!>	
GAMEPLAY_EMOTE_HERO_02A_ERROR_TARGET	<Ese objetivo\nno es válido.>	
GAMEPLAY_EMOTE_HERO_02A_ERROR_TAUNT	<No puedo evitar\nal esbirro con Provocación.>	
GAMEPLAY_EMOTE_HERO_02A_EVENT_LUNAR_NEW_YEAR	<¡Que tengas un próspero\naño nuevo!>	
GAMEPLAY_EMOTE_HERO_02A_FIRE_FESTIVAL	<De donde yo vengo no hay Festival\nde Fuego.>	
GAMEPLAY_EMOTE_HERO_02A_GREETINGS	<Hola, camarada.>	
GAMEPLAY_EMOTE_HERO_02A_GREETINGS_RESPONSE	<Saludos.>	
GAMEPLAY_EMOTE_HERO_02A_HALLOWS_END	<Que tengan un espeluznante\nHalloween, renacuajos.>	
GAMEPLAY_EMOTE_HERO_02A_LOW_CARDS	<¡Estoy quedándome\nsin cartas!>	
GAMEPLAY_EMOTE_HERO_02A_MIRROR_START	<¿¡Joven!? Tienes\nmucho que aprender.>	
GAMEPLAY_EMOTE_HERO_02A_NO_CARDS	<¡No me quedan cartas!>	
GAMEPLAY_EMOTE_HERO_02A_NOBLEGARDEN	<¡Feliz Jardín Noble!>	
GAMEPLAY_EMOTE_HERO_02A_OOPS	<¡Maldición!>	
GAMEPLAY_EMOTE_HERO_02A_PIRATE_DAY	<¡¿Piratas?! ¡Pero si nosotros\nllegamos primero!>	
GAMEPLAY_EMOTE_HERO_02A_SORRY	<Lo siento,\njoven.>	
GAMEPLAY_EMOTE_HERO_02A_START	<¡Es hora de una lección,\njovencito!>	
GAMEPLAY_EMOTE_HERO_02A_THANKS	<Mi más sincero\nagradecimiento.>	
GAMEPLAY_EMOTE_HERO_02A_THINK1	<¿Qué tal si....?>	VO_HERO_15_Thinking1_13.wav
GAMEPLAY_EMOTE_HERO_02A_THINK2	<Qué idea\ntan interesante....>	
GAMEPLAY_EMOTE_HERO_02A_THINK3	<Una posibilidad...>	
GAMEPLAY_EMOTE_HERO_02A_THREATEN	<¡Enfréntate a la sabiduría\nde las mareas!>	
GAMEPLAY_EMOTE_HERO_02A_TIMER	<¡Rápido, \nrápido!>	
GAMEPLAY_EMOTE_HERO_02A_WELL_PLAYED	<Bien hecho.>	
GAMEPLAY_EMOTE_HERO_02A_WINTERVEIL_GREETINGS	<¡Que tengas un feliz\nFestival de Invierno!>	
GAMEPLAY_EMOTE_HERO_02A_WOW	<¡Inconcebible!>	
GAMEPLAY_EMOTE_HERO_03_CONCEDE	Me rindo.	
GAMEPLAY_EMOTE_HERO_03_ERROR_FULL_MINIONS	Tengo demasiados esbirros.	
GAMEPLAY_EMOTE_HERO_03_ERROR_GENERIC	No puedo hacer eso.	
GAMEPLAY_EMOTE_HERO_03_ERROR_HAND_FULL	¡Mi mano está demasiado llena!	
GAMEPLAY_EMOTE_HERO_03_ERROR_I_ATTACKED	Ya ataqué.	
GAMEPLAY_EMOTE_HERO_03_ERROR_JUST_PLAYED	Ese esbirro necesita un turno de descanso.	
GAMEPLAY_EMOTE_HERO_03_ERROR_MINION_ATTACKED	Ese esbirro ya atacó.	
GAMEPLAY_EMOTE_HERO_03_ERROR_NEED_MANA	No tengo suficiente maná.	
GAMEPLAY_EMOTE_HERO_03_ERROR_NEED_WEAPON	Necesito un arma.	
GAMEPLAY_EMOTE_HERO_03_ERROR_PLAY	No puedo hacer esa jugada.	
GAMEPLAY_EMOTE_HERO_03_ERROR_STEALTH	No puedo hacer objetivo en esbirros en Sigilo.	
GAMEPLAY_EMOTE_HERO_03_ERROR_TARGET	Ese objetivo no es válido.	
GAMEPLAY_EMOTE_HERO_03_ERROR_TAUNT	Hay un esbirro con Provocación en el camino.	
GAMEPLAY_EMOTE_HERO_03_EVENT_LUNAR_NEW_YEAR	¡Feliz año nuevo!	
GAMEPLAY_EMOTE_HERO_03_FIRE_FESTIVAL	Feliz Solsticio de Verano.	
GAMEPLAY_EMOTE_HERO_03_GOOD_GAME	Buena partida.	
GAMEPLAY_EMOTE_HERO_03_GREETINGS	El placer es mío.	
GAMEPLAY_EMOTE_HERO_03_GREETINGS_RESPONSE	Es todo mío. ¡Ja!	
GAMEPLAY_EMOTE_HERO_03_HALLOWS_END	Feliz Halloween.	
GAMEPLAY_EMOTE_HERO_03_LOW_CARDS	¡Casi no me quedan cartas!	
GAMEPLAY_EMOTE_HERO_03_MIRROR_START	SIEMPRE tengo cuidado.	
GAMEPLAY_EMOTE_HERO_03_NO_CARDS	¡No me quedan cartas!	
GAMEPLAY_EMOTE_HERO_03_NOBLEGARDEN	Feliz Jardín Noble.	
GAMEPLAY_EMOTE_HERO_03_OOPS	Se han cometido errores.	
GAMEPLAY_EMOTE_HERO_03_PIRATE_DAY	¡Aarrrr!	
GAMEPLAY_EMOTE_HERO_03_SORRY	Lo siento.	
GAMEPLAY_EMOTE_HERO_03_START	Ten cuidado.	
GAMEPLAY_EMOTE_HERO_03_THANKS	Gracias.	
GAMEPLAY_EMOTE_HERO_03_THINK1	Mmm...	
GAMEPLAY_EMOTE_HERO_03_THINK2	Me pregunto...	
GAMEPLAY_EMOTE_HERO_03_THINK3	Tantas posibilidades...	
GAMEPLAY_EMOTE_HERO_03_THREATEN	¡Seré tu muerte!	
GAMEPLAY_EMOTE_HERO_03_TIMER	¡Debo decidir pronto!	
GAMEPLAY_EMOTE_HERO_03_WELL_PLAYED	Buena jugada.	
GAMEPLAY_EMOTE_HERO_03_WINTERVEIL_GREETINGS	Feliz festín del Festival de Invierno.	
GAMEPLAY_EMOTE_HERO_03_WOW	Increíble.	
GAMEPLAY_EMOTE_HERO_04_CONCEDE	La victoria es tuya.	
GAMEPLAY_EMOTE_HERO_04_ERROR_FULL_MINIONS	Tengo demasiados esbirros.	
GAMEPLAY_EMOTE_HERO_04_ERROR_GENERIC	No puedo hacer eso.	
GAMEPLAY_EMOTE_HERO_04_ERROR_HAND_FULL	¡Mi mano está demasiado llena!	
GAMEPLAY_EMOTE_HERO_04_ERROR_I_ATTACKED	Ya ataqué.	
GAMEPLAY_EMOTE_HERO_04_ERROR_JUST_PLAYED	Ese esbirro necesita un turno de descanso.	
GAMEPLAY_EMOTE_HERO_04_ERROR_MINION_ATTACKED	Ese esbirro ya atacó.	
GAMEPLAY_EMOTE_HERO_04_ERROR_NEED_MANA	No tengo suficiente maná.	
GAMEPLAY_EMOTE_HERO_04_ERROR_NEED_WEAPON	Necesito un arma.	
GAMEPLAY_EMOTE_HERO_04_ERROR_PLAY	No puedo hacer esa jugada.	
GAMEPLAY_EMOTE_HERO_04_ERROR_STEALTH	No puedo hacer objetivo en esbirros en Sigilo.	
GAMEPLAY_EMOTE_HERO_04_ERROR_TARGET	Ese objetivo no es válido.	
GAMEPLAY_EMOTE_HERO_04_ERROR_TAUNT	Hay un esbirro con Provocación en el camino.	
GAMEPLAY_EMOTE_HERO_04_EVENT_LUNAR_NEW_YEAR	¡Feliz año nuevo, adalid!	
GAMEPLAY_EMOTE_HERO_04_FIRE_FESTIVAL	¡Feliz Festival de Fuego del Solsticio de Verano!	
GAMEPLAY_EMOTE_HERO_04_GOOD_GAME	Buena partida.	
GAMEPLAY_EMOTE_HERO_04_GREETINGS	¡Un gusto!	
GAMEPLAY_EMOTE_HERO_04_GREETINGS_RESPONSE	¡El gusto es todo mío!	
GAMEPLAY_EMOTE_HERO_04_HALLOWS_END	¡Feliz Halloween, adalid!	VO_HERO_04_HAPPY_HALLOWEEN_13.wav
GAMEPLAY_EMOTE_HERO_04_LOW_CARDS	¡Casi no me quedan cartas!	
GAMEPLAY_EMOTE_HERO_04_MIRROR_START	¡Dominaré la Luz!	
GAMEPLAY_EMOTE_HERO_04_NO_CARDS	¡No me quedan cartas!	
GAMEPLAY_EMOTE_HERO_04_NOBLEGARDEN	¡Feliz Jardín Noble, adalid!	VO_HERO_04_HAPPY_NOBLEGARDEN_17.wav
GAMEPLAY_EMOTE_HERO_04_OOPS	Eso fue un error.	
GAMEPLAY_EMOTE_HERO_04_PIRATE_DAY	¡A cubierta, perros de agua dulce!	VO_HERO_04_PIRATE_DAY_33.wav
GAMEPLAY_EMOTE_HERO_04_SORRY	Lo siento.	
GAMEPLAY_EMOTE_HERO_04_START	¡Pelearé con honor!	
GAMEPLAY_EMOTE_HERO_04_THANKS	Gracias.	
GAMEPLAY_EMOTE_HERO_04_THINK1	Mmm...	
GAMEPLAY_EMOTE_HERO_04_THINK2	Me pregunto...	
GAMEPLAY_EMOTE_HERO_04_THINK3	Déjame pensar...	
GAMEPLAY_EMOTE_HERO_04_THREATEN	¡La justicia exige represalias!	
GAMEPLAY_EMOTE_HERO_04_TIMER	¡Debo moverme rápido!	
GAMEPLAY_EMOTE_HERO_04_WELL_PLAYED	Buena jugada.	
GAMEPLAY_EMOTE_HERO_04_WINTERVEIL_GREETINGS	¡Feliz festín del Festival de Invierno, adalid!	
GAMEPLAY_EMOTE_HERO_04_WOW	¡Por la Luz sagrada!	
GAMEPLAY_EMOTE_HERO_04A_CELEBRATE	¡La Luz brilla este glorioso día!	
GAMEPLAY_EMOTE_HERO_04A_CONCEDE	Tú ganas. Me rindo.	
GAMEPLAY_EMOTE_HERO_04A_ERROR_FULL_MINIONS	Tengo demasiados esbirros.	
GAMEPLAY_EMOTE_HERO_04A_ERROR_GENERIC	No puedo hacer eso.	
GAMEPLAY_EMOTE_HERO_04A_ERROR_HAND_FULL	¡Mi mano está completa!	
GAMEPLAY_EMOTE_HERO_04A_ERROR_I_ATTACKED	Ya he atacado.	
GAMEPLAY_EMOTE_HERO_04A_ERROR_JUST_PLAYED	Ese esbirro necesita un turno de descanso.	
GAMEPLAY_EMOTE_HERO_04A_ERROR_MINION_ATTACKED	Ese esbirro ya atacó.	
GAMEPLAY_EMOTE_HERO_04A_ERROR_NEED_MANA	No tengo suficiente maná.	
GAMEPLAY_EMOTE_HERO_04A_ERROR_NEED_WEAPON	Necesito un arma.	
GAMEPLAY_EMOTE_HERO_04A_ERROR_PLAY	No puedo hacer esa jugada.	
GAMEPLAY_EMOTE_HERO_04A_ERROR_STEALTH	No puedo hacer objetivo en esbirros en Sigilo.	
GAMEPLAY_EMOTE_HERO_04A_ERROR_TARGET	Ese objetivo no es válido.	
GAMEPLAY_EMOTE_HERO_04A_ERROR_TAUNT	Debo atacar a ese esbirro con Provocación.	
GAMEPLAY_EMOTE_HERO_04A_FIRE_FESTIVAL	¡Feliz Festival de Fuego!	
GAMEPLAY_EMOTE_HERO_04A_GOOD_GAME	Buena partida.	
GAMEPLAY_EMOTE_HERO_04A_GREETINGS	Saludos, rival.	
GAMEPLAY_EMOTE_HERO_04A_GREETINGS_RESPONSE	¡Saludos!	
GAMEPLAY_EMOTE_HERO_04A_HALLOWS_END	Feliz Halloween.	
GAMEPLAY_EMOTE_HERO_04A_LOW_CARDS	¡Casi no me quedan cartas!	
GAMEPLAY_EMOTE_HERO_04A_LUNAR_NEW_YEAR	¡Feliz año nuevo!	
GAMEPLAY_EMOTE_HERO_04A_MIRROR_START	Fuego sagrado es mi segundo nombre.	
GAMEPLAY_EMOTE_HERO_04A_NO_CARDS	¡No me quedan cartas!	
GAMEPLAY_EMOTE_HERO_04A_NOBLEGARDEN	Feliz Jardín Noble.	
GAMEPLAY_EMOTE_HERO_04A_OOPS	Un error, sin dudas.	
GAMEPLAY_EMOTE_HERO_04A_PIRATE_DAY	Yarrr, ahora me llevaré tu tesoro.	
GAMEPLAY_EMOTE_HERO_04A_SORRY	Mis disculpas.	
GAMEPLAY_EMOTE_HERO_04A_START	¡Mi espada arde con fuego sagrado!	
GAMEPLAY_EMOTE_HERO_04A_THANKS	Tienes mi más sincero agradecimiento.	
GAMEPLAY_EMOTE_HERO_04A_THINK1	Mmm...	
GAMEPLAY_EMOTE_HERO_04A_THINK2	Opciones, opciones...	
GAMEPLAY_EMOTE_HERO_04A_THINK3	Quizá deba... Mmm...	
GAMEPLAY_EMOTE_HERO_04A_THREATEN	¡Pagarás por eso, miserable!	
GAMEPLAY_EMOTE_HERO_04A_TIMER	¡Vamos!	
GAMEPLAY_EMOTE_HERO_04A_WELL_PLAYED	Buena jugada.	
GAMEPLAY_EMOTE_HERO_04A_WINTERVEIL_GREETINGS	¡Feliz festín del Festival de Invierno!	
GAMEPLAY_EMOTE_HERO_04A_WOW	¡Increíble!	
GAMEPLAY_EMOTE_HERO_05_CONCEDE	Buena pelea. Admito mi derrota.	
GAMEPLAY_EMOTE_HERO_05_ERROR_FULL_MINIONS	Tengo demasiados esbirros.	
GAMEPLAY_EMOTE_HERO_05_ERROR_GENERIC	No puedo hacer eso.	
GAMEPLAY_EMOTE_HERO_05_ERROR_HAND_FULL	¡Mi mano está demasiado llena!	
GAMEPLAY_EMOTE_HERO_05_ERROR_I_ATTACKED	Ya ataqué.	
GAMEPLAY_EMOTE_HERO_05_ERROR_JUST_PLAYED	Ese esbirro necesita un turno de descanso.	
GAMEPLAY_EMOTE_HERO_05_ERROR_MINION_ATTACKED	Ese esbirro ya atacó.	
GAMEPLAY_EMOTE_HERO_05_ERROR_NEED_MANA	No tengo suficiente maná.	
GAMEPLAY_EMOTE_HERO_05_ERROR_NEED_WEAPON	Necesito un arma.	
GAMEPLAY_EMOTE_HERO_05_ERROR_PLAY	No puedo hacer esa jugada.	
GAMEPLAY_EMOTE_HERO_05_ERROR_STEALTH	No puedo hacer objetivo en esbirros en Sigilo.	
GAMEPLAY_EMOTE_HERO_05_ERROR_TARGET	Ese objetivo no es válido.	
GAMEPLAY_EMOTE_HERO_05_ERROR_TAUNT	Hay un esbirro con Provocación en el camino.	
GAMEPLAY_EMOTE_HERO_05_EVENT_LUNAR_NEW_YEAR	¡Feliz año nuevo!	
GAMEPLAY_EMOTE_HERO_05_FIRE_FESTIVAL	Feliz Solsticio de Verano.	
GAMEPLAY_EMOTE_HERO_05_GOOD_GAME	Buena partida.	
GAMEPLAY_EMOTE_HERO_05_GREETINGS	Qué tal, viajero.	
GAMEPLAY_EMOTE_HERO_05_GREETINGS_RESPONSE	¡Muy bien!	
GAMEPLAY_EMOTE_HERO_05_HALLOWS_END	Feliz Halloween.	
GAMEPLAY_EMOTE_HERO_05_LOW_CARDS	¡Casi no me quedan cartas!	
GAMEPLAY_EMOTE_HERO_05_MIRROR_START	¡Veamos qué tienes!	
GAMEPLAY_EMOTE_HERO_05_NO_CARDS	¡No me quedan cartas!	
GAMEPLAY_EMOTE_HERO_05_NOBLEGARDEN	¡Feliz Jardín Noble!	
GAMEPLAY_EMOTE_HERO_05_OOPS	No funcionó como esperaba.	
GAMEPLAY_EMOTE_HERO_05_PIRATE_DAY	¡Suelten a los canes de agua dulce!	
GAMEPLAY_EMOTE_HERO_05_SORRY	Discúlpame.	
GAMEPLAY_EMOTE_HERO_05_START	¡Que empiece la cacería!	
GAMEPLAY_EMOTE_HERO_05_THANKS	Gracias.	
GAMEPLAY_EMOTE_HERO_05_THINK1	Mmm...	
GAMEPLAY_EMOTE_HERO_05_THINK2	Me pregunto...	
GAMEPLAY_EMOTE_HERO_05_THINK3	Mmm...	
GAMEPLAY_EMOTE_HERO_05_THREATEN	¡Te cazaré!	
GAMEPLAY_EMOTE_HERO_05_TIMER	¡El tiempo pasa rápido!	
GAMEPLAY_EMOTE_HERO_05_WELL_PLAYED	Buena jugada.	
GAMEPLAY_EMOTE_HERO_05_WINTERVEIL_GREETINGS	¡Feliz festín del Festival de Invierno!	
GAMEPLAY_EMOTE_HERO_05_WOW	¡Increíble!	
GAMEPLAY_EMOTE_HERO_05A_CELEBRATE	¡Ja, ja, sí! ¡SÍ!	
GAMEPLAY_EMOTE_HERO_05A_CONCEDE	¡Brillante! Me rindo.	
GAMEPLAY_EMOTE_HERO_05A_ERROR_FULL_MINIONS	Tengo demasiados esbirros.	
GAMEPLAY_EMOTE_HERO_05A_ERROR_GENERIC	No puedo hacer eso.	
GAMEPLAY_EMOTE_HERO_05A_ERROR_HAND_FULL	¡Mi mano está completa!	
GAMEPLAY_EMOTE_HERO_05A_ERROR_I_ATTACKED	Ya he atacado.	
GAMEPLAY_EMOTE_HERO_05A_ERROR_JUST_PLAYED	Ese esbirro necesita un turno de descanso.	
GAMEPLAY_EMOTE_HERO_05A_ERROR_MINION_ATTACKED	Ese esbirro ya atacó.	
GAMEPLAY_EMOTE_HERO_05A_ERROR_NEED_MANA	No tengo suficiente maná.	
GAMEPLAY_EMOTE_HERO_05A_ERROR_NEED_WEAPON	Necesito un arma.	
GAMEPLAY_EMOTE_HERO_05A_ERROR_PLAY	No puedo hacer esa jugada.	
GAMEPLAY_EMOTE_HERO_05A_ERROR_STEALTH	No puedo hacer objetivo en esbirros en Sigilo.	
GAMEPLAY_EMOTE_HERO_05A_ERROR_TARGET	Ese no es un objetivo válido.	
GAMEPLAY_EMOTE_HERO_05A_ERROR_TAUNT	Debo atacar al esbirro con Provocación.	
GAMEPLAY_EMOTE_HERO_05A_EVENT_FIRE_FESTIVAL	Se acerca el Festival de Fuego.	
GAMEPLAY_EMOTE_HERO_05A_EVENT_HALLOWS_END	Feliz Halloween.	
GAMEPLAY_EMOTE_HERO_05A_EVENT_LUNAR_NEW_YEAR	¡Feliz año nuevo!	
GAMEPLAY_EMOTE_HERO_05A_EVENT_NOBLEGARDEN	Feliz Jardín Noble.	
GAMEPLAY_EMOTE_HERO_05A_EVENT_PIRATE_DAY	¡Yarrr! ¡Te enviaré al fondo del mar!	
GAMEPLAY_EMOTE_HERO_05A_GOOD_GAME	Buena partida.	
GAMEPLAY_EMOTE_HERO_05A_GREETINGS	Hola, caminante.	
GAMEPLAY_EMOTE_HERO_05A_GREETINGS_RESPONSE	Ja. Hola a ti también.	
GAMEPLAY_EMOTE_HERO_05A_LOW_CARDS	Casi no me quedan cartas.	
GAMEPLAY_EMOTE_HERO_05A_MIRROR_START	Yo nunca tiemblo.	
GAMEPLAY_EMOTE_HERO_05A_NO_CARDS	¡No me quedan cartas!	
GAMEPLAY_EMOTE_HERO_05A_OOPS	Un error.	
GAMEPLAY_EMOTE_HERO_05A_SORRY	Lo lamento.	
GAMEPLAY_EMOTE_HERO_05A_START	¡Tiembla ante el poder de los elfos!	
GAMEPLAY_EMOTE_HERO_05A_THANKS	Gracias.	
GAMEPLAY_EMOTE_HERO_05A_THINK1	Mmm...	
GAMEPLAY_EMOTE_HERO_05A_THINK2	¿A quién le dispararé?	
GAMEPLAY_EMOTE_HERO_05A_THINK3	¿Qué debería hacer?	
GAMEPLAY_EMOTE_HERO_05A_THREATEN	¡Mi venganza será rápida!	
GAMEPLAY_EMOTE_HERO_05A_TIMER	¡A moverse! ¡Ahora!	
GAMEPLAY_EMOTE_HERO_05A_WELL_PLAYED	Buena jugada.	
GAMEPLAY_EMOTE_HERO_05A_WINTERVEIL_GREETING	Feliz festín del Festival de Invierno.	
GAMEPLAY_EMOTE_HERO_05A_WOW	¡Increíble!	
GAMEPLAY_EMOTE_HERO_06_CONCEDE	Admito mi derrota.	
GAMEPLAY_EMOTE_HERO_06_ERROR_FULL_MINIONS	Tengo demasiados esbirros.	
GAMEPLAY_EMOTE_HERO_06_ERROR_GENERIC	No puedo hacer eso.	
GAMEPLAY_EMOTE_HERO_06_ERROR_HAND_FULL	¡Mi mano está demasiado llena!	
GAMEPLAY_EMOTE_HERO_06_ERROR_I_ATTACKED	Ya ataqué.	
GAMEPLAY_EMOTE_HERO_06_ERROR_JUST_PLAYED	Ese esbirro necesita un turno de descanso.	
GAMEPLAY_EMOTE_HERO_06_ERROR_MINION_ATTACKED	Ese esbirro ya atacó.	
GAMEPLAY_EMOTE_HERO_06_ERROR_NEED_MANA	No tengo suficiente maná.	
GAMEPLAY_EMOTE_HERO_06_ERROR_NEED_WEAPON	Necesito un arma.	
GAMEPLAY_EMOTE_HERO_06_ERROR_PLAY	No puedo hacer esa jugada.	
GAMEPLAY_EMOTE_HERO_06_ERROR_STEALTH	No puedo hacer objetivo en esbirros en Sigilo.	
GAMEPLAY_EMOTE_HERO_06_ERROR_TARGET	Ese objetivo no es válido.	
GAMEPLAY_EMOTE_HERO_06_ERROR_TAUNT	Hay un esbirro con Provocación en el camino.	
GAMEPLAY_EMOTE_HERO_06_EVENT_LUNAR_NEW_YEAR	¡Feliz año nuevo!	
GAMEPLAY_EMOTE_HERO_06_FIRE_FESTIVAL	¡Feliz Solsticio de Verano! Y cuidado con los incendios forestales.	
GAMEPLAY_EMOTE_HERO_06_GOOD_GAME	Buena partida.	
GAMEPLAY_EMOTE_HERO_06_GREETINGS	Qué tal.	
GAMEPLAY_EMOTE_HERO_06_GREETINGS_RESPONSE	¡Saludos!	
GAMEPLAY_EMOTE_HERO_06_HALLOWS_END	¡Feliz Halloween!	
GAMEPLAY_EMOTE_HERO_06_LOW_CARDS	¡Casi no me quedan cartas!	
GAMEPLAY_EMOTE_HERO_06_MIRROR_START	¡Debo proteger a la naturaleza!	
GAMEPLAY_EMOTE_HERO_06_NO_CARDS	¡No me quedan cartas!	
GAMEPLAY_EMOTE_HERO_06_NOBLEGARDEN	¡Feliz Jardín Noble!	
GAMEPLAY_EMOTE_HERO_06_OOPS	Un error natural.	
GAMEPLAY_EMOTE_HERO_06_PIRATE_DAY	¡Yarrrrr!	
GAMEPLAY_EMOTE_HERO_06_SORRY	Lo siento.	
GAMEPLAY_EMOTE_HERO_06_START	¡Debo proteger a lo salvaje!	
GAMEPLAY_EMOTE_HERO_06_START_TYRANDE	Mi amada Tyrande.	
GAMEPLAY_EMOTE_HERO_06_THANKS	Te lo agradezco.	
GAMEPLAY_EMOTE_HERO_06_THINK1	Mmm...	
GAMEPLAY_EMOTE_HERO_06_THINK2	Mmm... me pregunto...	
GAMEPLAY_EMOTE_HERO_06_THINK3	Qué debo hacer...	
GAMEPLAY_EMOTE_HERO_06_THREATEN	¡La naturaleza se alzará contra ti!	
GAMEPLAY_EMOTE_HERO_06_TIMER	¡El tiempo no espera a nadie!	
GAMEPLAY_EMOTE_HERO_06_WELL_PLAYED	Mmm... buena jugada.	
GAMEPLAY_EMOTE_HERO_06_WINTERVEIL_GREETINGS	Feliz festín del Festival de Invierno.	
GAMEPLAY_EMOTE_HERO_06_WOW	¡Espectacular!	
GAMEPLAY_EMOTE_HERO_07_CONCEDE	Ganaste... esta vez.	
GAMEPLAY_EMOTE_HERO_07_ERROR_FULL_MINIONS	Tengo demasiados esbirros.	
GAMEPLAY_EMOTE_HERO_07_ERROR_GENERIC	No puedo hacer eso.	
GAMEPLAY_EMOTE_HERO_07_ERROR_HAND_FULL	¡Mi mano está demasiado llena!	
GAMEPLAY_EMOTE_HERO_07_ERROR_I_ATTACKED	Ya ataqué.	
GAMEPLAY_EMOTE_HERO_07_ERROR_JUST_PLAYED	Ese esbirro necesita un turno de descanso.	
GAMEPLAY_EMOTE_HERO_07_ERROR_MINION_ATTACKED	Ese esbirro ya atacó.	
GAMEPLAY_EMOTE_HERO_07_ERROR_NEED_MANA	No tengo suficiente maná.	
GAMEPLAY_EMOTE_HERO_07_ERROR_NEED_WEAPON	Necesito un arma.	
GAMEPLAY_EMOTE_HERO_07_ERROR_PLAY	No puedo hacer esa jugada.	
GAMEPLAY_EMOTE_HERO_07_ERROR_STEALTH	No puedo hacer objetivo en esbirros en Sigilo.	
GAMEPLAY_EMOTE_HERO_07_ERROR_TARGET	Ese objetivo no es válido.	
GAMEPLAY_EMOTE_HERO_07_ERROR_TAUNT	Hay un esbirro con Provocación en el camino.	
GAMEPLAY_EMOTE_HERO_07_EVENT_LUNAR_NEW_YEAR	¡Feliz año nuevo!	
GAMEPLAY_EMOTE_HERO_07_FIRE_FESTIVAL	Que las llamas ardan.	
GAMEPLAY_EMOTE_HERO_07_GOOD_GAME	Buena partida.	
GAMEPLAY_EMOTE_HERO_07_GREETINGS	Un placer.	
GAMEPLAY_EMOTE_HERO_07_GREETINGS_RESPONSE	El placer es mío.	
GAMEPLAY_EMOTE_HERO_07_HALLOWS_END	¡Halloween! Mi festividad favorita.	
GAMEPLAY_EMOTE_HERO_07_LOW_CARDS	¡Casi no me quedan cartas!	
GAMEPLAY_EMOTE_HERO_07_MIRROR_START	¡Soy tu pesadilla!	
GAMEPLAY_EMOTE_HERO_07_NO_CARDS	¡No me quedan cartas!	
GAMEPLAY_EMOTE_HERO_07_NOBLEGARDEN	Feliz Jardín Noble.	
GAMEPLAY_EMOTE_HERO_07_OOPS	Eso fue un error.	
GAMEPLAY_EMOTE_HERO_07_PIRATE_DAY	¿Día de los Piratas? No entiendo.	
GAMEPLAY_EMOTE_HERO_07_SORRY	Lo siento.	
GAMEPLAY_EMOTE_HERO_07_START	¡Tu alma será mía!	
GAMEPLAY_EMOTE_HERO_07_THANKS	Gracias.	
GAMEPLAY_EMOTE_HERO_07_THINK1	Mmm...	
GAMEPLAY_EMOTE_HERO_07_THINK2	Me pregunto...	
GAMEPLAY_EMOTE_HERO_07_THINK3	Hay tantas posibilidades...	
GAMEPLAY_EMOTE_HERO_07_THREATEN	¡Tu alma sufrirá!	
GAMEPLAY_EMOTE_HERO_07_TIMER	¡Casi no me queda tiempo!	
GAMEPLAY_EMOTE_HERO_07_WELL_PLAYED	Buena jugada.	
GAMEPLAY_EMOTE_HERO_07_WINTERVEIL_GREETINGS	Que tengas un grato festín del Festival de Invierno...	
GAMEPLAY_EMOTE_HERO_07_WOW	Extraordinario.	
GAMEPLAY_EMOTE_HERO_08_CONCEDE	Ganaste esta vez.	
GAMEPLAY_EMOTE_HERO_08_ERROR_FULL_MINIONS	Tengo demasiados esbirros.	
GAMEPLAY_EMOTE_HERO_08_ERROR_GENERIC	No puedo hacer eso.	
GAMEPLAY_EMOTE_HERO_08_ERROR_HAND_FULL	¡Mi mano está demasiado llena!	
GAMEPLAY_EMOTE_HERO_08_ERROR_I_ATTACKED	Ya ataqué.	
GAMEPLAY_EMOTE_HERO_08_ERROR_JUST_PLAYED	Ese esbirro necesita un turno de descanso.	
GAMEPLAY_EMOTE_HERO_08_ERROR_MINION_ATTACKED	Ese esbirro ya atacó.	
GAMEPLAY_EMOTE_HERO_08_ERROR_NEED_MANA	No tengo suficiente maná.	
GAMEPLAY_EMOTE_HERO_08_ERROR_NEED_WEAPON	Necesito un arma.	
GAMEPLAY_EMOTE_HERO_08_ERROR_PLAY	No puedo hacer esa jugada.	
GAMEPLAY_EMOTE_HERO_08_ERROR_STEALTH	No puedo hacer objetivo en esbirros en Sigilo.	
GAMEPLAY_EMOTE_HERO_08_ERROR_TARGET	Ese objetivo no es válido.	
GAMEPLAY_EMOTE_HERO_08_ERROR_TAUNT	Hay un esbirro con Provocación en el camino.	
GAMEPLAY_EMOTE_HERO_08_EVENT_LUNAR_NEW_YEAR	¡Feliz año nuevo!	
GAMEPLAY_EMOTE_HERO_08_FIRE_FESTIVAL	¡Feliz Festival de Fuego del Solsticio de Verano!	
GAMEPLAY_EMOTE_HERO_08_GOOD_GAME	Buena partida.	
GAMEPLAY_EMOTE_HERO_08_GREETINGS	Hola.	
GAMEPLAY_EMOTE_HERO_08_GREETINGS_RESPONSE	Hola, rival.	
GAMEPLAY_EMOTE_HERO_08_HALLOWS_END	Feliz Halloween.	
GAMEPLAY_EMOTE_HERO_08_LOW_CARDS	¡Casi no me quedan cartas!	
GAMEPLAY_EMOTE_HERO_08_MIRROR_START	¡Y tú lo lamentarás!	
GAMEPLAY_EMOTE_HERO_08_NO_CARDS	¡No me quedan cartas!	
GAMEPLAY_EMOTE_HERO_08_NOBLEGARDEN	Feliz Jardín Noble.	
GAMEPLAY_EMOTE_HERO_08_OOPS	Ups.	
GAMEPLAY_EMOTE_HERO_08_PIRATE_DAY	¡Arrr! ¡Alcen las velas!	
GAMEPLAY_EMOTE_HERO_08_SORRY	Lo siento.	
GAMEPLAY_EMOTE_HERO_08_START	¡Tú te lo buscaste!	
GAMEPLAY_EMOTE_HERO_08_THANKS	Gracias.	
GAMEPLAY_EMOTE_HERO_08_THINK1	Mmm...	
GAMEPLAY_EMOTE_HERO_08_THINK2	Me pregunto...	
GAMEPLAY_EMOTE_HERO_08_THINK3	Qué debería hacer... qué debería hacer...	
GAMEPLAY_EMOTE_HERO_08_THREATEN	¡Mi magia te hará pedazos!	
GAMEPLAY_EMOTE_HERO_08_TIMER	¡Se acaba el tiempo!	
GAMEPLAY_EMOTE_HERO_08_WELL_PLAYED	Buena jugada.	
GAMEPLAY_EMOTE_HERO_08_WINTERVEIL_GREETINGS	¡Feliz festín del Festival de Invierno!	
GAMEPLAY_EMOTE_HERO_08_WOW	Alucinante.	
GAMEPLAY_EMOTE_HERO_08A_CELEBRATE	¡Sí, sí! ¡Ja, ja!	
GAMEPLAY_EMOTE_HERO_08A_CONCEDE	¡Jaque mate! Bien hecho.	
GAMEPLAY_EMOTE_HERO_08A_ERROR_FULL_MINIONS	¡Tengo demasiados esbirros!	
GAMEPLAY_EMOTE_HERO_08A_ERROR_GENERIC	No puedo hacer eso.	
GAMEPLAY_EMOTE_HERO_08A_ERROR_HAND_FULL	¡Mi mano está completa!	
GAMEPLAY_EMOTE_HERO_08A_ERROR_I_ATTACKED	Ya he atacado.	
GAMEPLAY_EMOTE_HERO_08A_ERROR_JUST_PLAYED	Ese esbirro necesita un turno de descanso.	
GAMEPLAY_EMOTE_HERO_08A_ERROR_MINION_ATTACKED	Ese esbirro ya atacó.	
GAMEPLAY_EMOTE_HERO_08A_ERROR_NEED_MANA	No tengo suficiente maná.	
GAMEPLAY_EMOTE_HERO_08A_ERROR_NEED_WEAPON	Necesito un arma.	
GAMEPLAY_EMOTE_HERO_08A_ERROR_PLAY	No puedo hacer esa jugada.	
GAMEPLAY_EMOTE_HERO_08A_ERROR_STEALTH	No puedo hacer objetivo en esbirros en Sigilo.	
GAMEPLAY_EMOTE_HERO_08A_ERROR_TARGET	Ese no es un objetivo válido.	
GAMEPLAY_EMOTE_HERO_08A_ERROR_TAUNT	Debo atacar a ese esbirro con Provocación.	
GAMEPLAY_EMOTE_HERO_08A_FIRE_FESTIVAL	¡El Festival de Fuego del Solsticio de Verano ha llegado! 	
GAMEPLAY_EMOTE_HERO_08A_GOOD_GAME	Buena partida.	
GAMEPLAY_EMOTE_HERO_08A_GREETINGS	Ah, saludos.	
GAMEPLAY_EMOTE_HERO_08A_GREETINGS_RESPONSE	Saludos para ti, Guardián.	
GAMEPLAY_EMOTE_HERO_08A_HALLOWS_END	Feliz Halloween.	
GAMEPLAY_EMOTE_HERO_08A_LOW_CARDS	Casi no me quedan cartas.	
GAMEPLAY_EMOTE_HERO_08A_LUNAR_NEW_YEAR	¡Feliz año nuevo!	
GAMEPLAY_EMOTE_HERO_08A_MIRROR_START	Oh, ya han comenzado.	
GAMEPLAY_EMOTE_HERO_08A_NO_CARDS	¡No me quedan cartas!	
GAMEPLAY_EMOTE_HERO_08A_NOBLEGARDEN	¡Feliz Jardín Noble!	
GAMEPLAY_EMOTE_HERO_08A_OOPS	Eso fue imprudente.	
GAMEPLAY_EMOTE_HERO_08A_PIRATE_DAY	¡Soy Medivh, el guarrrrrdián!	
GAMEPLAY_EMOTE_HERO_08A_SORRY	Mis más sinceras disculpas.	
GAMEPLAY_EMOTE_HERO_08A_START	¡Que comiencen los juegos!	
GAMEPLAY_EMOTE_HERO_08A_THANKS	Te lo agradezco.	
GAMEPLAY_EMOTE_HERO_08A_THINK1	Mmm...	
GAMEPLAY_EMOTE_HERO_08A_THINK2	Qué interesante...	
GAMEPLAY_EMOTE_HERO_08A_THINK3	Mmm.... Tal vez.	
GAMEPLAY_EMOTE_HERO_08A_THREATEN	¡Nada puede detenerme! ¡Nada!	
GAMEPLAY_EMOTE_HERO_08A_TIMER	¡No debo confiarme tanto!	
GAMEPLAY_EMOTE_HERO_08A_WELL_PLAYED	Buena jugada.	
GAMEPLAY_EMOTE_HERO_08A_WINTERVEIL_GREETINGS	Feliz festín, digno oponente.	
GAMEPLAY_EMOTE_HERO_08A_WOW	Increíble	
GAMEPLAY_EMOTE_HERO_08B_CONCEDE	Bien hecho. Me has vencido.	
GAMEPLAY_EMOTE_HERO_08B_ERROR_FULL_MINIONS	Tengo demasiados esbirros.	
GAMEPLAY_EMOTE_HERO_08B_ERROR_GENERIC	No puedo hacer eso.	
GAMEPLAY_EMOTE_HERO_08B_ERROR_HAND_FULL	¡Mi mano está llena!	
GAMEPLAY_EMOTE_HERO_08B_ERROR_I_ATTACKED	Ya he atacado.	
GAMEPLAY_EMOTE_HERO_08B_ERROR_JUST_PLAYED	Ese esbirro necesita un turno de descanso.	
GAMEPLAY_EMOTE_HERO_08B_ERROR_MINION_ATTACKED	Ese esbirro ya atacó.	
GAMEPLAY_EMOTE_HERO_08B_ERROR_NEED_MANA	No tengo suficiente maná.	
GAMEPLAY_EMOTE_HERO_08B_ERROR_NEED_WEAPON	Necesito un arma.	
GAMEPLAY_EMOTE_HERO_08B_ERROR_PLAY	No puedo hacer esa jugada.	
GAMEPLAY_EMOTE_HERO_08B_ERROR_STEALTH	No puedo hacer objetivo en esbirros en Sigilo.	
GAMEPLAY_EMOTE_HERO_08B_ERROR_TARGET	Ese objetivo no es válido.	
GAMEPLAY_EMOTE_HERO_08B_ERROR_TAUNT	Hay un esbirro con Provocación en el camino.	
GAMEPLAY_EMOTE_HERO_08B_FIRE_FESTIVAL	Que tengas un Solsticio de Verano espléndido.	
GAMEPLAY_EMOTE_HERO_08B_GOOD_GAME	¡Esta sí que ha sido una buena partida!	
GAMEPLAY_EMOTE_HERO_08B_GREETINGS	Te saludo, compañero en la búsqueda de la verdad.	
GAMEPLAY_EMOTE_HERO_08B_GREETINGS_RESPONSE	Que encontremos aquello que buscamos.	
GAMEPLAY_EMOTE_HERO_08B_HALLOWS_END	Feliz Halloween.	
GAMEPLAY_EMOTE_HERO_08B_LOW_CARDS	Casi no me quedan cartas.	
GAMEPLAY_EMOTE_HERO_08B_LUNAR_NEW_YEAR	¡Feliz año nuevo!	
GAMEPLAY_EMOTE_HERO_08B_MIRROR_START	Espero que aprendamos mucho juntos.	
GAMEPLAY_EMOTE_HERO_08B_NO_CARDS	¡No me quedan cartas!	
GAMEPLAY_EMOTE_HERO_08B_NOBLEGARDEN	¡Feliz Jardín Noble!	
GAMEPLAY_EMOTE_HERO_08B_OOPS	Ay. Qué pena.	
GAMEPLAY_EMOTE_HERO_08B_PIRATE_DAY	Ah, ¿ahora celebramos el día de los delincuentes marinos?	
GAMEPLAY_EMOTE_HERO_08B_SORRY	Oh, lo siento mucho.	
GAMEPLAY_EMOTE_HERO_08B_START	El conocimiento es poder.	
GAMEPLAY_EMOTE_HERO_08B_THANKS	Te lo agradezco.	
GAMEPLAY_EMOTE_HERO_08B_THINK1	Mmm...	
GAMEPLAY_EMOTE_HERO_08B_THINK2	Observar y reflexionar...	
GAMEPLAY_EMOTE_HERO_08B_THINK3	Debe haber una forma...	
GAMEPLAY_EMOTE_HERO_08B_THREATEN	¡Hora de la lección, cría insolente!	
GAMEPLAY_EMOTE_HERO_08B_TIMER	¡Mira la hora que es!	
GAMEPLAY_EMOTE_HERO_08B_WELL_PLAYED	Buena jugada.	
GAMEPLAY_EMOTE_HERO_08B_WINTERVEIL_GREETINGS	¡Feliz festín del Festival de Invierno!	
GAMEPLAY_EMOTE_HERO_08B_WOW	Maravilloso.	
GAMEPLAY_EMOTE_HERO_09_CONCEDE	Me has vencido.	
GAMEPLAY_EMOTE_HERO_09_ERROR_FULL_MINIONS	Tengo demasiados esbirros.	
GAMEPLAY_EMOTE_HERO_09_ERROR_GENERIC	No puedo hacer eso.	
GAMEPLAY_EMOTE_HERO_09_ERROR_HAND_FULL	¡Mi mano está demasiado llena!	
GAMEPLAY_EMOTE_HERO_09_ERROR_I_ATTACKED	Ya ataqué.	
GAMEPLAY_EMOTE_HERO_09_ERROR_JUST_PLAYED	Ese esbirro necesita un turno de descanso.	
GAMEPLAY_EMOTE_HERO_09_ERROR_MINION_ATTACKED	Ese esbirro ya atacó.	
GAMEPLAY_EMOTE_HERO_09_ERROR_NEED_MANA	No tengo suficiente maná.	
GAMEPLAY_EMOTE_HERO_09_ERROR_NEED_WEAPON	Necesito un arma.	
GAMEPLAY_EMOTE_HERO_09_ERROR_PLAY	No puedo hacer esa jugada.	
GAMEPLAY_EMOTE_HERO_09_ERROR_STEALTH	No puedo hacer objetivo en esbirros en Sigilo.	
GAMEPLAY_EMOTE_HERO_09_ERROR_TARGET	Ese objetivo no es válido.	
GAMEPLAY_EMOTE_HERO_09_ERROR_TAUNT	Hay un esbirro con Provocación en el camino.	
GAMEPLAY_EMOTE_HERO_09_EVENT_LUNAR_NEW_YEAR	¡Feliz año nuevo!	
GAMEPLAY_EMOTE_HERO_09_FIRE_FESTIVAL	¡No veo la hora de que lleguen los fuegos artificiales!	
GAMEPLAY_EMOTE_HERO_09_GOOD_GAME	Buena partida.	
GAMEPLAY_EMOTE_HERO_09_GREETINGS	Un placer saludarte.	
GAMEPLAY_EMOTE_HERO_09_GREETINGS_DISABLED	¡Mmm!	
GAMEPLAY_EMOTE_HERO_09_GREETINGS_RESPONSE	Hola, amigo.	
GAMEPLAY_EMOTE_HERO_09_HALLOWS_END	¡Feliz Halloween!	
GAMEPLAY_EMOTE_HERO_09_LOW_CARDS	¡Casi no me quedan cartas!	
GAMEPLAY_EMOTE_HERO_09_MIRROR_START	¡Y sonreirá sobre los justos!	
GAMEPLAY_EMOTE_HERO_09_NO_CARDS	¡No me quedan cartas!	
GAMEPLAY_EMOTE_HERO_09_NOBLEGARDEN	¡Feliz Jardín Noble!	
GAMEPLAY_EMOTE_HERO_09_OOPS	No era lo que tenía en mente.	
GAMEPLAY_EMOTE_HERO_09_OOPS_DISABLED	¿Mmm?	
GAMEPLAY_EMOTE_HERO_09_PIRATE_DAY	¡Arrrr! ¡Unámonos a la Tripulación aterradora!	
GAMEPLAY_EMOTE_HERO_09_SORRY	Discúlpame.	
GAMEPLAY_EMOTE_HERO_09_START	¡La Luz traerá la victoria!	
GAMEPLAY_EMOTE_HERO_09_THANKS	Gracias.	
GAMEPLAY_EMOTE_HERO_09_THANKS_DISABLED	Mmm.	
GAMEPLAY_EMOTE_HERO_09_THINK1	Mmm...	
GAMEPLAY_EMOTE_HERO_09_THINK2	Me pregunto...	
GAMEPLAY_EMOTE_HERO_09_THINK3	Debo pensar...	
GAMEPLAY_EMOTE_HERO_09_THREATEN	¡La Luz te quemará!	
GAMEPLAY_EMOTE_HERO_09_THREATEN_DISABLED	¡Mmmmmm!	
GAMEPLAY_EMOTE_HERO_09_TIMER	¡Debo decidir rápido!	
GAMEPLAY_EMOTE_HERO_09_WELL_PLAYED	Buena jugada.	
GAMEPLAY_EMOTE_HERO_09_WELL_PLAYED_DISABLED	Mmm...	
GAMEPLAY_EMOTE_HERO_09_WINTERVEIL_GREETINGS	¡Feliz festín del Festival de Invierno!	
GAMEPLAY_EMOTE_HERO_09_WOW	Guau...	
GAMEPLAY_EMOTE_HERO_09_WOW_DISABLED	¡Mmmmmmm…!	
GAMEPLAY_EMOTE_HERO_EVILBRM_START	¡Hmm!	
GAMEPLAY_EMOTE_HERO_EVILBRM_WOW	*Risa maligna*	
GAMEPLAY_EMOTE_HERO_TBKTRAF_KT_CONCEDE	Re... gresaré...	
GAMEPLAY_EMOTE_HERO_TBKTRAF_KT_GREETINGS	¡Al fin nos conocemos!	
GAMEPLAY_EMOTE_HERO_TBKTRAF_KT_LOW_CARDS	¡Me estoy quedando sin cartas!	
GAMEPLAY_EMOTE_HERO_TBKTRAF_KT_NO_CARDS	¡No! ¡Maldito seas, intruso!	
GAMEPLAY_EMOTE_HERO_TBKTRAF_KT_OOPS	*suspiro* A dibujar otra vez.	
GAMEPLAY_EMOTE_HERO_TBKTRAF_KT_SORRY	¡NO! ¡MALDITO SEAS, INTRUSO!	
GAMEPLAY_EMOTE_HERO_TBKTRAF_KT_START	Ven y enfréntate a mí, intruso.	
GAMEPLAY_EMOTE_HERO_TBKTRAF_KT_THANKS	Ehh... ¿de nada?	
GAMEPLAY_EMOTE_HERO_TBKTRAF_KT_THINK1	Tal vez. 	
GAMEPLAY_EMOTE_HERO_TBKTRAF_KT_THINK2	¡Sí... sí!	
GAMEPLAY_EMOTE_HERO_TBKTRAF_KT_THINK3	¿Qué opinas, Baldomero?	
GAMEPLAY_EMOTE_HERO_TBKTRAF_KT_THREATEN	¡Te congelaré la sangre de las venas!	
GAMEPLAY_EMOTE_HERO_TBKTRAF_KT_WELL_PLAYED	Pfff, qué novedad... ¡Soy el maldito Kel'Thuzad!	
GAMEPLAY_EMOTE_HERO_TBKTRAF_RAF_CONCEDE	¡NO! NADIE PUEDE DERROTARME...	
GAMEPLAY_EMOTE_HERO_TBKTRAF_RAF_GREETINGS	Hola, explorador.	
GAMEPLAY_EMOTE_HERO_TBKTRAF_RAF_LOW_CARDS	¡Me estoy quedando sin cartas!	
GAMEPLAY_EMOTE_HERO_TBKTRAF_RAF_NO_CARDS	¡Mis hermosos tesoros!	
GAMEPLAY_EMOTE_HERO_TBKTRAF_RAF_OOPS	¡Error!	
GAMEPLAY_EMOTE_HERO_TBKTRAF_RAF_SORRY	Me das pena.	
GAMEPLAY_EMOTE_HERO_TBKTRAF_RAF_START	¡RAFAAM, EL ARQUEÓLOGO SUPREMO!	
GAMEPLAY_EMOTE_HERO_TBKTRAF_RAF_THANKS	Ah, gracias.	
GAMEPLAY_EMOTE_HERO_TBKTRAF_RAF_THINK1	Mmm...	
GAMEPLAY_EMOTE_HERO_TBKTRAF_RAF_THINK2	¿Qué me llevaré?	
GAMEPLAY_EMOTE_HERO_TBKTRAF_RAF_THINK3	Tentador...	
GAMEPLAY_EMOTE_HERO_TBKTRAF_RAF_THREATEN	¡PODER SOBRECOGEDOR!	
GAMEPLAY_EMOTE_HERO_TBKTRAF_RAF_WELL_PLAYED	Bien hecho...	
GAMEPLAY_EMOTE_HERO_TBMECHWAR01_CONCEDE	<Rendición>	The text is in brackets because the VO files is just Annoy-o-Tron's greeting
GAMEPLAY_EMOTE_HERO_TBMECHWAR01_ERROR_FULL_MINIONS	<¡Error!>	The text is in brackets because the VO files is just Annoy-o-Tron's greeting
GAMEPLAY_EMOTE_HERO_TBMECHWAR01_ERROR_HAND_FULL	<¡Error!>	The text is in brackets because the VO files is just Annoy-o-Tron's greeting
GAMEPLAY_EMOTE_HERO_TBMECHWAR01_ERROR_I_ATTACKED	<¡Error!>	The text is in brackets because the VO files is just Annoy-o-Tron's greeting
GAMEPLAY_EMOTE_HERO_TBMECHWAR01_ERROR_JUST_PLAYED	<¡Error!>	The text is in brackets because the VO files is just Annoy-o-Tron's greeting
GAMEPLAY_EMOTE_HERO_TBMECHWAR01_ERROR_MINION_ATTACKED	<¡Error!>	The text is in brackets because the VO files is just Annoy-o-Tron's greeting
GAMEPLAY_EMOTE_HERO_TBMECHWAR01_ERROR_NEED_MANA	<¡Error!>	The text is in brackets because the VO files is just Annoy-o-Tron's greeting
GAMEPLAY_EMOTE_HERO_TBMECHWAR01_ERROR_NEED_WEAPON	<¡Error!>	The text is in brackets because the VO files is just Annoy-o-Tron's greeting
GAMEPLAY_EMOTE_HERO_TBMECHWAR01_ERROR_PLAY	<¡Error!>	The text is in brackets because the VO files is just Annoy-o-Tron's greeting
GAMEPLAY_EMOTE_HERO_TBMECHWAR01_ERROR_STEALTH	<¡Error!>	The text is in brackets because the VO files is just Annoy-o-Tron's greeting
GAMEPLAY_EMOTE_HERO_TBMECHWAR01_ERROR_TARGET	<¡Error!>	The text is in brackets because the VO files is just Annoy-o-Tron's greeting
GAMEPLAY_EMOTE_HERO_TBMECHWAR01_ERROR_TAUNT	<¡Error!>	The text is in brackets because the VO files is just Annoy-o-Tron's greeting
GAMEPLAY_EMOTE_HERO_TBMECHWAR01_GREETINGS	<Saludos>	The text is in brackets because the VO files is just Annoy-o-Tron's greeting
GAMEPLAY_EMOTE_HERO_TBMECHWAR01_LOW_CARDS	<Pocas cartas>	The text is in brackets because the VO files is just Annoy-o-Tron's greeting
GAMEPLAY_EMOTE_HERO_TBMECHWAR01_NO_CARDS	<Sin cartas>	The text is in brackets because the VO files is just Annoy-o-Tron's greeting
GAMEPLAY_EMOTE_HERO_TBMECHWAR01_OOPS	<Error>	The text is in brackets because the VO files is just Annoy-o-Tron's greeting
GAMEPLAY_EMOTE_HERO_TBMECHWAR01_SORRY	<Lo siento>	The text is in brackets because the VO files is just Annoy-o-Tron's greeting
GAMEPLAY_EMOTE_HERO_TBMECHWAR01_START	<Comenzar>	The text is in brackets because the VO files is just Annoy-o-Tron's greeting
GAMEPLAY_EMOTE_HERO_TBMECHWAR01_THANKS	<Gracias>	The text is in brackets because the VO files is just Annoy-o-Tron's greeting
GAMEPLAY_EMOTE_HERO_TBMECHWAR01_THINK1	<Procesando...>	The text is in brackets because the VO files is just Annoy-o-Tron's greeting
GAMEPLAY_EMOTE_HERO_TBMECHWAR01_THINK2	<Buscando objetivo...>	The text is in brackets because the VO files is just Annoy-o-Tron's greeting
GAMEPLAY_EMOTE_HERO_TBMECHWAR01_THINK3	<Ciclos desperdiciados...>	The text is in brackets because the VO files is just Annoy-o-Tron's greeting
GAMEPLAY_EMOTE_HERO_TBMECHWAR01_THREATEN	<Amenazar>	The text is in brackets because the VO files is just Annoy-o-Tron's attack
GAMEPLAY_EMOTE_HERO_TBMECHWAR01_TIMER	<Poco tiempo>	The text is in brackets because the VO files is just Annoy-o-Tron's greeting
GAMEPLAY_EMOTE_HERO_TBMECHWAR01_WELL_PLAYED	<Buena jugada>	The text is in brackets because the VO files is just Annoy-o-Tron's greeting
GAMEPLAY_EMOTE_HERO_TBMECHWAR01_WOW	<¡Increíble!>	The text is in brackets because the VO files is just Annoy-o-Tron's greeting
GAMEPLAY_EMOTE_HERO_TBMECHWAR02_CONCEDE	<Fin del camino>	The text is in brackets because the VO files is just Boom Bot's greeting
GAMEPLAY_EMOTE_HERO_TBMECHWAR02_ERROR_FULL_MINIONS	<¡Error!>	The text is in brackets because the VO files is just Boom Bot's greeting
GAMEPLAY_EMOTE_HERO_TBMECHWAR02_ERROR_HAND_FULL	<¡Error!>	The text is in brackets because the VO files is just Boom Bot's greeting
GAMEPLAY_EMOTE_HERO_TBMECHWAR02_ERROR_I_ATTACKED	<¡Error!>	The text is in brackets because the VO files is just Boom Bot's greeting
GAMEPLAY_EMOTE_HERO_TBMECHWAR02_ERROR_JUST_PLAYED	<¡Error!>	The text is in brackets because the VO files is just Boom Bot's greeting
GAMEPLAY_EMOTE_HERO_TBMECHWAR02_ERROR_MINION_ATTACKED	<¡Error!>	The text is in brackets because the VO files is just Boom Bot's greeting
GAMEPLAY_EMOTE_HERO_TBMECHWAR02_ERROR_NEED_MANA	<¡Error!>	The text is in brackets because the VO files is just Boom Bot's greeting
GAMEPLAY_EMOTE_HERO_TBMECHWAR02_ERROR_NEED_WEAPON	<¡Error!>	The text is in brackets because the VO files is just Boom Bot's greeting
GAMEPLAY_EMOTE_HERO_TBMECHWAR02_ERROR_PLAY	<¡Error!>	The text is in brackets because the VO files is just Boom Bot's greeting
GAMEPLAY_EMOTE_HERO_TBMECHWAR02_ERROR_STEALTH	<¡Error!>	The text is in brackets because the VO files is just Boom Bot's greeting
GAMEPLAY_EMOTE_HERO_TBMECHWAR02_ERROR_TARGET	<¡Error!>	The text is in brackets because the VO files is just Boom Bot's greeting
GAMEPLAY_EMOTE_HERO_TBMECHWAR02_ERROR_TAUNT	<¡Error!>	The text is in brackets because the VO files is just Boom Bot's greeting
GAMEPLAY_EMOTE_HERO_TBMECHWAR02_GREETINGS	<Saludos>	The text is in brackets because the VO files is just Annoy-o-Tron's greeting
GAMEPLAY_EMOTE_HERO_TBMECHWAR02_LOW_CARDS	<Pocas cartas>	The text is in brackets because the VO files is just Boom Bot's greeting
GAMEPLAY_EMOTE_HERO_TBMECHWAR02_NO_CARDS	<¡Sin cartas!>	The text is in brackets because the VO files is just Boom Bot's greeting
GAMEPLAY_EMOTE_HERO_TBMECHWAR02_OOPS	<¡Error!>	The text is in brackets because the VO files is just Boom Bot's greeting
GAMEPLAY_EMOTE_HERO_TBMECHWAR02_SORRY	<Disculpas>	The text is in brackets because the VO files is just Boom Bot's greeting
GAMEPLAY_EMOTE_HERO_TBMECHWAR02_START	<Comenzar>	The text is in brackets because the VO files is just Boom Bot's greeting
GAMEPLAY_EMOTE_HERO_TBMECHWAR02_THANKS	<Gracias>	The text is in brackets because the VO files is just Boom Bot's greeting
GAMEPLAY_EMOTE_HERO_TBMECHWAR02_THINK1	<Procesando...>	The text is in brackets because the VO files is just Boom Bot's greeting
GAMEPLAY_EMOTE_HERO_TBMECHWAR02_THINK2	<Buscando objetivo...>	The text is in brackets because the VO files is just Boom Bot's greeting
GAMEPLAY_EMOTE_HERO_TBMECHWAR02_THINK3	<Ciclos desperdiciados...>	The text is in brackets because the VO files is just Boom Bot's greeting
GAMEPLAY_EMOTE_HERO_TBMECHWAR02_THREATEN	<¡Amenaza!>	The text is in brackets because the VO files is just Boom Bot's Attack sound
GAMEPLAY_EMOTE_HERO_TBMECHWAR02_TIMER	<Poco tiempo>	The text is in brackets because the VO files is just Boom Bot's greeting
GAMEPLAY_EMOTE_HERO_TBMECHWAR02_WELL_PLAYED	<Buena jugada>	The text is in brackets because the VO files is just Boom Bot's greeting
GAMEPLAY_EMOTE_HERO_TBMECHWAR02_WOW	<¡Fabuloso!>	The text is in brackets because the VO files is just Annoy-o-Tron's greeting
GAMEPLAY_EMOTE_ICC_481_CONCEDE	Que la victoria te brinde un frío consuelo.	
GAMEPLAY_EMOTE_ICC_481_GREETINGS	Acepta el frío abrazo de la muerte.	
GAMEPLAY_EMOTE_ICC_481_LOW_CARDS	¡Casi no me quedan cartas!	
GAMEPLAY_EMOTE_ICC_481_NO_CARDS	¡No me quedan cartas!	
GAMEPLAY_EMOTE_ICC_481_OOPS	Un grave error.	
GAMEPLAY_EMOTE_ICC_481_START	¡Soy el corazón congelado de la Plaga!	
GAMEPLAY_EMOTE_ICC_481_THANKS	Gracias.	
GAMEPLAY_EMOTE_ICC_481_THINK1	Mmm...	
GAMEPLAY_EMOTE_ICC_481_THINK2	Los elementos están en silencio...	
GAMEPLAY_EMOTE_ICC_481_THINK3	La decisión es solo mía.	
GAMEPLAY_EMOTE_ICC_481_THREATEN	¡Te destruiré!	
GAMEPLAY_EMOTE_ICC_481_TIMER	¡Hay que elegir un camino!	
GAMEPLAY_EMOTE_ICC_481_WELL_PLAYED	Buena jugada.	
GAMEPLAY_EMOTE_ICC_481_WOW	¡Tremendo!	
GAMEPLAY_EMOTE_ICC_827_CONCEDE	El día es tuyo.	
GAMEPLAY_EMOTE_ICC_827_GREETINGS	¿Dónde te estabas escondiendo?	
GAMEPLAY_EMOTE_ICC_827_LOW_CARDS	¡Casi no me quedan cartas!	
GAMEPLAY_EMOTE_ICC_827_NO_CARDS	¡No me quedan cartas!	
GAMEPLAY_EMOTE_ICC_827_OOPS	Qué tragedia.	
GAMEPLAY_EMOTE_ICC_827_START	¡No puedes escapar a la sombra de la muerte!	
GAMEPLAY_EMOTE_ICC_827_THANKS	Gracias.	
GAMEPLAY_EMOTE_ICC_827_THINK1	Mmm...	
GAMEPLAY_EMOTE_ICC_827_THINK2	La sombra de la muerte crece...	
GAMEPLAY_EMOTE_ICC_827_THINK3	El tiempo se desvanece...	
GAMEPLAY_EMOTE_ICC_827_THREATEN	Aprenderás a temerle a tu sombra.	
GAMEPLAY_EMOTE_ICC_827_TIMER	¡Debo decidir pronto!	
GAMEPLAY_EMOTE_ICC_827_WELL_PLAYED	Encantador.	
GAMEPLAY_EMOTE_ICC_827_WOW	¡De otro mundo!	
GAMEPLAY_EMOTE_ICC_828_CONCEDE	Esta cacería te pertenece.	
GAMEPLAY_EMOTE_ICC_828_GREETINGS	Empieza a correr, presa.	
GAMEPLAY_EMOTE_ICC_828_LOW_CARDS	¡Casi no me quedan cartas!	
GAMEPLAY_EMOTE_ICC_828_MIRROR_START	¡Anda! Te daré una ventaja.	
GAMEPLAY_EMOTE_ICC_828_NO_CARDS	¡No me quedan cartas!	
GAMEPLAY_EMOTE_ICC_828_OOPS	Eso fue un error.	
GAMEPLAY_EMOTE_ICC_828_START	¡Que empiece la cacería!	
GAMEPLAY_EMOTE_ICC_828_THANKS	Te lo agradezco.	
GAMEPLAY_EMOTE_ICC_828_THINK1	Mmm...	
GAMEPLAY_EMOTE_ICC_828_THINK2	Qué huellas seguiré...	
GAMEPLAY_EMOTE_ICC_828_THINK3	Me pregunto...	
GAMEPLAY_EMOTE_ICC_828_THREATEN	Te perseguiré... para siempre.	
GAMEPLAY_EMOTE_ICC_828_TIMER	¡La esencia se desvanece!	
GAMEPLAY_EMOTE_ICC_828_WELL_PLAYED	Buena jugada.	
GAMEPLAY_EMOTE_ICC_828_WOW	Impresionante.	
GAMEPLAY_EMOTE_ICC_829_CONCEDE	Has triunfado... Esta vez.	
GAMEPLAY_EMOTE_ICC_829_GREETINGS	Ahora solo existe mi justicia.	
GAMEPLAY_EMOTE_ICC_829_LOW_CARDS	¡Casi no me quedan cartas!	
GAMEPLAY_EMOTE_ICC_829_NO_CARDS	¡No me quedan cartas!	
GAMEPLAY_EMOTE_ICC_829_OOPS	Qué decepción.	
GAMEPLAY_EMOTE_ICC_829_START	¡La justicia de la Luz ha fallado!	
GAMEPLAY_EMOTE_ICC_829_THANKS	Gracias.	
GAMEPLAY_EMOTE_ICC_829_THINK1	Mmm...	
GAMEPLAY_EMOTE_ICC_829_THINK2	Agonía de escarcha llama...	
GAMEPLAY_EMOTE_ICC_829_THINK3	El Trono Helado llama...	
GAMEPLAY_EMOTE_ICC_829_THREATEN	Suplicarás clemencia y te la negaré.	
GAMEPLAY_EMOTE_ICC_829_TIMER	¡El final está cerca!	
GAMEPLAY_EMOTE_ICC_829_WELL_PLAYED	Buena jugada.	
GAMEPLAY_EMOTE_ICC_829_WOW	¡Increíble!	
GAMEPLAY_EMOTE_ICC_830_CONCEDE	¡No, tu victoria no significa nada!	
GAMEPLAY_EMOTE_ICC_830_GREETINGS	Mi venganza será la oscuridad.	
GAMEPLAY_EMOTE_ICC_830_LOW_CARDS	¡Casi no me quedan cartas!	
GAMEPLAY_EMOTE_ICC_830_NO_CARDS	¡No me quedan cartas!	
GAMEPLAY_EMOTE_ICC_830_OOPS	Errar es humano.	
GAMEPLAY_EMOTE_ICC_830_START	¡La oscuridad anuncia la victoria!	
GAMEPLAY_EMOTE_ICC_830_THANKS	Gracias.	
GAMEPLAY_EMOTE_ICC_830_THINK1	Mmm...	
GAMEPLAY_EMOTE_ICC_830_THINK2	La oscuridad es mi compañera...	
GAMEPLAY_EMOTE_ICC_830_THINK3	Pensamientos oscuros...	
GAMEPLAY_EMOTE_ICC_830_THREATEN	¡La oscuridad te consumirá!	
GAMEPLAY_EMOTE_ICC_830_TIMER	¡Las sombras se disipan!	
GAMEPLAY_EMOTE_ICC_830_WELL_PLAYED	Buena jugada.	
GAMEPLAY_EMOTE_ICC_830_WOW	¡Asombroso!	
GAMEPLAY_EMOTE_ICC_831_CONCEDE	Tú ganas... por ahora.	
GAMEPLAY_EMOTE_ICC_831_GREETINGS	Teme mi presencia.	
GAMEPLAY_EMOTE_ICC_831_LOW_CARDS	¡Casi no me quedan cartas!	
GAMEPLAY_EMOTE_ICC_831_NO_CARDS	¡No me quedan cartas!	
GAMEPLAY_EMOTE_ICC_831_OOPS	Eso no tuvo sentido.	
GAMEPLAY_EMOTE_ICC_831_START	Un pacto sellado con sangre y sombras.	
GAMEPLAY_EMOTE_ICC_831_THANKS	Ah, gracias.	
GAMEPLAY_EMOTE_ICC_831_THINK1	Mmm...	
GAMEPLAY_EMOTE_ICC_831_THINK2	Mi sed de sangre es cada vez mayor…	
GAMEPLAY_EMOTE_ICC_831_THINK3	Tantas opciones para matar...	
GAMEPLAY_EMOTE_ICC_831_THREATEN	Tu sufrimiento será... ¡legendario!	
GAMEPLAY_EMOTE_ICC_831_TIMER	¡Debo alimentarme, ahora!	
GAMEPLAY_EMOTE_ICC_831_WELL_PLAYED	Bien hecho.	
GAMEPLAY_EMOTE_ICC_831_WOW	Malditas llamas infernales.	
GAMEPLAY_EMOTE_ICC_832_CONCEDE	Tú ganas. Ahora puedo descansar.	
GAMEPLAY_EMOTE_ICC_832_GREETINGS	El ciclo de la peste ha comenzado.	
GAMEPLAY_EMOTE_ICC_832_LOW_CARDS	¡Casi no me quedan cartas!	
GAMEPLAY_EMOTE_ICC_832_NO_CARDS	¡No me quedan cartas!	
GAMEPLAY_EMOTE_ICC_832_OOPS	La telaraña se desarma.	
GAMEPLAY_EMOTE_ICC_832_START	¡El círculo de la vida ha llegado a su fin!	
GAMEPLAY_EMOTE_ICC_832_THANKS	Te lo agradezco.	
GAMEPLAY_EMOTE_ICC_832_THINK1	Mmm...	
GAMEPLAY_EMOTE_ICC_832_THINK2	Una red enmarañada...	
GAMEPLAY_EMOTE_ICC_832_THINK3	Mis pensamientos están infestados...	
GAMEPLAY_EMOTE_ICC_832_THREATEN	Te marchitarás y te pudrirás.	
GAMEPLAY_EMOTE_ICC_832_TIMER	La muerte es eterna... ¡pero mi turno no!	
GAMEPLAY_EMOTE_ICC_832_WELL_PLAYED	Una jugada maestra.	
GAMEPLAY_EMOTE_ICC_832_WOW	¡Sorprendente!	
GAMEPLAY_EMOTE_ICC_833_CONCEDE	Me rindo ante tu poder.	
GAMEPLAY_EMOTE_ICC_833_GREETINGS	¿Por qué tiemblas? ¿Tienes miedo?	
GAMEPLAY_EMOTE_ICC_833_LOW_CARDS	¡Casi no me quedan cartas!	
GAMEPLAY_EMOTE_ICC_833_NO_CARDS	¡No me quedan cartas!	
GAMEPLAY_EMOTE_ICC_833_OOPS	Un error fatal.	
GAMEPLAY_EMOTE_ICC_833_START	El poder no debe provocar temor, ¡témanle a la mano que lo controla!	
GAMEPLAY_EMOTE_ICC_833_THANKS	Gracias.	
GAMEPLAY_EMOTE_ICC_833_THINK1	Mmm...	
GAMEPLAY_EMOTE_ICC_833_THINK2	El tiempo se desvanece...	
GAMEPLAY_EMOTE_ICC_833_THINK3	Mmm, tengo que decidir...	
GAMEPLAY_EMOTE_ICC_833_THREATEN	¡Inclínate ante tu reina!	
GAMEPLAY_EMOTE_ICC_833_TIMER	¡Es el momento de actuar!	
GAMEPLAY_EMOTE_ICC_833_WELL_PLAYED	Buena jugada.	
GAMEPLAY_EMOTE_ICC_833_WOW	¡Me quedé helada!	
GAMEPLAY_EMOTE_ICC_834_CONCEDE	Elijo la muerte.	
GAMEPLAY_EMOTE_ICC_834_GREETINGS	¡No escaparás de la ira de Grito Infernal!	
GAMEPLAY_EMOTE_ICC_834_LOW_CARDS	Casi no me quedan cartas.	
GAMEPLAY_EMOTE_ICC_834_NO_CARDS	No me quedan cartas.	
GAMEPLAY_EMOTE_ICC_834_OOPS	Error.	
GAMEPLAY_EMOTE_ICC_834_START	Este mundo arderá… ¡y reinaré sobre sus cenizas!	
GAMEPLAY_EMOTE_ICC_834_THANKS	Te lo agradezco.	
GAMEPLAY_EMOTE_ICC_834_THINK1	Mmm...	
GAMEPLAY_EMOTE_ICC_834_THINK2	Se acaba el tiempo...	
GAMEPLAY_EMOTE_ICC_834_THINK3	Ahora qué...	
GAMEPLAY_EMOTE_ICC_834_THREATEN	Serás el primero en arrodillarse.	
GAMEPLAY_EMOTE_ICC_834_TIMER	¡Debo elegir!	
GAMEPLAY_EMOTE_ICC_834_WELL_PLAYED	Un oponente digno.	
GAMEPLAY_EMOTE_ICC_834_WOW	¡Asombroso!	
VO__Female_Naga_Concede_02	La victoria es tuya... esta vez.	
VO__Female_Naga_ERROR_FULL_MINIONS_01	Tengo demasiados esbirros.	
VO__Female_Naga_ERROR_GENERIC_04	Olvídalo.	
VO__Female_Naga_ERROR_HAND_FULL_01	Mi mano está demasiado llena.	
VO__Female_Naga_ERROR_I_ATTACKED_01	Cariño, ¡estoy CANSADÍSIMA!	
VO__Female_Naga_ERROR_MINION_ATTACKED_01	Ese esbirro ya atacó.	
VO__Female_Naga_ERROR_NEED_MANA_01	Necesito maná.	
VO__Female_Naga_ERROR_NEED_WEAPON_01	Dame un arma.	
VO__Female_Naga_ERROR_PLAY_01	No puedo hacer esa jugada.	
VO__Female_Naga_ERROR_STEALTH_01	Ese esbirro está en sigilo.	
VO__Female_Naga_ERROR_SUMMON_SICKNESS_01	No, no, ese esbirro debe descansar.	
VO__Female_Naga_ERROR_TARGET_01	¡Necesito un objetivo!	
VO__Female_Naga_ERROR_TAUNT_01	¿Ves a ese esbirro idiota que me provoca?	
VO__Female_Naga_FIRE_FESTIVAL_01	Me gustaría verter un poco de agua fría sobre este ridículo Festival de Fuego.	
VO__Female_Naga_Greetings_01	Ah, una cara nueva por aquí.	
VO__Female_Naga_HAPPY_HALLOWEEN_01	Lo que me encanta de Halloween es no tener que alquilar trajes.	
VO__Female_Naga_HAPPY_HOLIDAYS_01	¡Nadie disfruta de las vacaciones como los Altonato!	
VO__Female_Naga_HAPPY_NEW_YEAR_01	¡Feliz año nuevo!	
VO__Female_Naga_HAPPY_NEW_YEAR_LUNAR_01	¡Feliz año nuevo!	
VO__Female_Naga_HAPPY_NOBLEGARDEN_01	¿Llamas a esto Jardín Noble? ¡Todos los nobles están bajo el mar!	
VO__Female_Naga_LowCards_01	Tengo pocas cartas.	
VO__Female_Naga_MIRROR_GREETINGS_01	¿Yo? ¿Una cara nueva? Tonterías.	
VO__Female_Naga_MIRROR_START_01	Encontraré la forma de sobrevivir.	
VO__Female_Naga_NoCards_01	¡No me quedan cartas!	
VO__Female_Naga_Oops_02	¡Maldición!	
VO__Female_Naga_Picked_01	¡Busca tu objetivo!	
VO__Female_Naga_PIRATE_DAY_01	¡Para mí, son todos marineros de agua dulce!	
VO__Female_Naga_Sorry_01	Eso fue... desafortunado.	
VO__Female_Naga_Start_01	¡Te ha llegado la hora!	
VO__Female_Naga_Start_Illidan_01	Es un honor, Lord Illidan.	
VO__Female_Naga_Start_Maiev_01	Ah, la pequeña celadora.	
VO__Female_Naga_Start_Morgl_01	El mar clama por ti, pequeño.	
VO__Female_Naga_Start_Tyrande_01	Diez mil años y aún me sigues molestando.	
VO__Female_Naga_Thanks_02	Te lo agradezco.	
VO__Female_Naga_Thinking_01	Mmm...	
VO__Female_Naga_Thinking_02	<suspiro exasperado>	
VO__Female_Naga_Thinking_03	Decisiones...	
VO__Female_Naga_Threaten_01	¡Te quebraré de pies a cabeza!	
VO__Female_Naga_Time_01	Queda poco tiempo.	
VO__Female_Naga_TRIGGER_ANCESTRAL_SPIRIT	Conozco las viejas costumbres.	
VO__Female_Naga_TRIGGER_EARTH_SHOCK	¡Esto te calmará!	
VO__Female_Naga_TRIGGER_EVERYFIN_IS_AWESOME	Con un mar de aletas, cumplirás todas tus metas.	
VO__Female_Naga_TRIGGER_FORKED_LIGHTNING	¡Cuida tus modales!	
VO__Female_Naga_TRIGGER_LIGHTNING_STORM	¡Que no quede nada!	
VO__Female_Naga_TRIGGER_MUTATE	El cambio conlleva poder.	
VO__Female_Naga_TRIGGER_SERPENT_WARD	<risa siniestra>	
VO__Female_Naga_TRIGGER_UNSTABLE_EVOLUTION	Yo solía ser una elfa de la noche, ¿sabías?	
VO__Female_Naga_TRIGGER_WITCHS_BREW	Delicioso.	
VO__Female_Naga_Well_Played_01	Impresionante.	
VO__Female_Naga_WOW_01	¡Increíble!	
VO__Female_Night Elf_Concede_01	¡La victoria es tuya!	
VO__Female_Night Elf_ERROR_FULL_MINIONS_01	No tengo espacio para más esbirros.	
VO__Female_Night Elf_ERROR_GENERIC_01	Absolutamente imposible.	
VO__Female_Night Elf_ERROR_HAND_FULL_02	¡No puedo sujetar más cartas!	
VO__Female_Night Elf_ERROR_I_ATTACKED_01	¡Ya ataqué!	
VO__Female_Night Elf_ERROR_MINION_ATTACKED_01	Ese esbirro está agotado.	
VO__Female_Night Elf_ERROR_NEED_MANA_02	No tengo suficiente maná.	
VO__Female_Night Elf_ERROR_NEED_WEAPON_01	Ten la amabilidad de equipar un arma.	
VO__Female_Night Elf_ERROR_PLAY_01	No lo creo.	
VO__Female_Night Elf_ERROR_STEALTH_01	Aún está en sigilo.	
VO__Female_Night Elf_ERROR_SUMMON_SICKNESS_01	Necesita una siestecita.	
VO__Female_Night Elf_ERROR_TARGET_01	Eso está fuera de mi alcance.	
VO__Female_Night Elf_ERROR_TAUNT_01	Hay algo con Provocación en el camino.	
VO__Female_Night Elf_FIRE_FESTIVAL_01	Hoy puedes jugar con fuego, pero ten cuidado.	
VO__Female_Night Elf_Greetings_01	Ey, hola.	
VO__Female_Night Elf_HAPPY_HALLOWEEN_01	¡Los orígenes de Halloween son aterradores!	
VO__Female_Night Elf_HAPPY_HOLIDAYS_01	¿Te has portado bien con el Gran Padre Invierno?	
VO__Female_Night Elf_HAPPY_NEW_YEAR_01	¡Feliz año nuevo!	
VO__Female_Night Elf_HAPPY_NEW_YEAR_LUNAR_01	¡Feliz año nuevo!	
VO__Female_Night Elf_HAPPY_NOBLEGARDEN_01	Ah, ¡me encanta el Jardín Noble!	
VO__Female_Night Elf_LowCards_01	¿Me quedan pocas cartas? Qué extraño.	
VO__Female_Night Elf_MIRROR_GREETINGS_01	¿Qué estudiaremos hoy?	
VO__Female_Night Elf_MIRROR_START_01	¿Quizás un poco de arqueología?	
VO__Female_Night Elf_NoCards_01	Ay, no... Mis preciosas cartas desaparecieron.	
VO__Female_Night Elf_Oops_01	Tomaré esto... como una lección.	
VO__Female_Night Elf_Picked_01	Soy una estudiante del bosque y maestra de muchos.	
VO__Female_Night Elf_PIRATE_DAY_01	¡Capitana BuscaestelaRRRR a su servicio, camarada!	
VO__Female_Night Elf_Sorry_01	¡Mis disculpas!	
VO__Female_Night Elf_Start_01	¡Comienza la lección!	
VO__Female_Night Elf_Thanks_02	¡Estoy sumamente agradecida!	
VO__Female_Night Elf_Thinking_01	Mm...	
VO__Female_Night Elf_Thinking_03	Qué curioso...	
VO__Female_Night Elf_Thinking_04	Tantas contradicciones...	
VO__Female_Night Elf_Threaten_03	Te daré una lección.	
VO__Female_Night Elf_Time_01	Las arenas del tiempo se agotan.	
VO__Female_Night Elf_Well_Played_01	¡Tus habilidades son legendarias!	
VO__Female_Night Elf_WOW_01	Me siento afortunada de haber presenciado eso.	
VO__Female_Val'kyr_Attack_01	¡Te concederé una vida en el olvido!	
VO__Female_Val'kyr_Concede_01	Tu valentía prevalece.	
VO__Female_Val'kyr_Death_02	Todo ha terminado…	
VO__Female_Val'kyr_ERROR_FULL_MINIONS_01	Tengo demasiados esbirros a mi cargo.	
VO__Female_Val'kyr_ERROR_GENERIC_03	No puede ser.	
VO__Female_Val'kyr_ERROR_HAND_FULL_01	Mi mano está llena.	
VO__Female_Val'kyr_ERROR_I_ATTACKED_01	Ya ataqué al enemigo.	
VO__Female_Val'kyr_ERROR_MINION_ATTACKED_01	Ese necesita descansar.	
VO__Female_Val'kyr_ERROR_NEED_MANA_01	No tengo suficiente maná.	
VO__Female_Val'kyr_ERROR_NEED_WEAPON_01	Necesito un arma para eso.	
VO__Female_Val'kyr_ERROR_PLAY_01	No puedo hacer esa jugada.	
VO__Female_Val'kyr_ERROR_STEALTH_01	Ese está oculto.	
VO__Female_Val'kyr_ERROR_SUMMON_SICKNESS_01	Aún está descansando.	
VO__Female_Val'kyr_ERROR_TARGET_01	Está fuera de mi alcance.	
VO__Female_Val'kyr_ERROR_TAUNT_01	Otro me provoca.	
VO__Female_Val'kyr_FIRE_FESTIVAL_01	¡Los dignos arderán más que nadie en el Festival de Fuego!	
VO__Female_Val'kyr_Greetings_01	Saludos, rival.	
VO__Female_Val'kyr_HAPPY_HALLOWEEN_01	Muestra tu respeto por la gloria de los muertos.	
VO__Female_Val'kyr_HAPPY_HOLIDAYS_01	Esta época del año me pone de buen humor.	
VO__Female_Val'kyr_HAPPY_NEW_YEAR_01	¡Feliz año nuevo!	
VO__Female_Val'kyr_HAPPY_NEW_YEAR_LUNAR_01	¡Feliz año nuevo!	
VO__Female_Val'kyr_HAPPY_NOBLEGARDEN_01	Tú coleccionas huevos. Yo coleccionaré guerreros.	
VO__Female_Val'kyr_LowCards_01	Me quedan pocas cartas.	
VO__Female_Val'kyr_MIRROR_GREETINGS_01	Por fin una adversaria digna.	
VO__Female_Val'kyr_MIRROR_START_01	¡Estaba a punto de hacerlo!	
VO__Female_Val'kyr_NoCards_01	Ya no tengo cartas.	
VO__Female_Val'kyr_Oops_01	Pero qué extraño.	
VO__Female_Val'kyr_Picked_01	¡Yo siempre estoy a la altura!	
VO__Female_Val'kyr_PIRATE_DAY_01	Los muertos sí hablan… ¡Si yo lo ordeno!	
VO__Female_Val'kyr_Sorry_01	Juro que repararé el daño.	
VO__Female_Val'kyr_Start_01	¡Levántate y cumple con la voluntad de nuestra ama!	
VO__Female_Val'kyr_Start_Sylvanas_01	Esta vez NO me sacrificaré por ti, ama.	
VO__Female_Val'kyr_Thanks_02	Te doy las gracias.	
VO__Female_Val'kyr_Thinking_01	Mmm...	
VO__Female_Val'kyr_Thinking_03	¿Digno o indigno?	
VO__Female_Val'kyr_Thinking_04	¿Y ahora?	
VO__Female_Val'kyr_Threaten_01	¡Ven y enfrenta tu destino!	
VO__Female_Val'kyr_Time_01	El tiempo se acaba.	
VO__Female_Val'kyr_TRIGGER_BRAWL_01	¿Quién se alzará con la victoria?	
VO__Female_Val'kyr_TRIGGER_DEAD_MANS_HAND_01	La muerte no me perturba.	
VO__Female_Val'kyr_TRIGGER_DEADLY_ARSENAL_01	¡Cuántas espadas!	
VO__Female_Val'kyr_TRIGGER_DEVASTATE_01	¡Tu fin será glorioso!	
VO__Female_Val'kyr_TRIGGER_FORGE_OF_SOULS_01	La fuerza es eterna.	
VO__Female_Val'kyr_TRIGGER_HEROIC_STRIKE_01	¡El destino llama!	
VO__Female_Val'kyr_TRIGGER_MORTAL_STRIKE_01	¡La oscuridad llama!	
VO__Female_Val'kyr_TRIGGER_RAMPAGE_01	Aún no es tu hora.	
VO__Female_Val'kyr_TRIGGER_WARPATH_01	¡Un bocado del porvenir!	
VO__Female_Val'kyr_Well_Played_01	Eres un adversario… digno.	
VO__Female_Val'kyr_WOW_01	¡Qué maravilla!	
VO__Male_Dragon_Attack_01	¡Destrucción!	
VO__Male_Dragon_Concede_02	¡Es el FIN DE TODAS LAS COSAS!	
VO__Male_Dragon_ERROR_FULL_MINIONS_02	No puedo vigilar a más necios.	
VO__Male_Dragon_ERROR_GENERIC_01	No puedo hacer eso.	
VO__Male_Dragon_ERROR_HAND_FULL_01	¡No tomaré más!	
VO__Male_Dragon_ERROR_I_ATTACKED_01	¡Ya desaté mi furia!	
VO__Male_Dragon_ERROR_MINION_ATTACKED_01	Ese esbirro ya atacó.	
VO__Male_Dragon_ERROR_NEED_MANA_02	¡Infúndeme maná!	
VO__Male_Dragon_ERROR_NEED_WEAPON_02	Necesito un arma además de mi ira.	
VO__Male_Dragon_ERROR_PLAY_01	¡Eso no se puede hacer!	
VO__Male_Dragon_ERROR_STEALTH_01	Ese cobarde desgraciado se ha ocultado. (Deathwing)	
VO__Male_Dragon_ERROR_SUMMON_SICKNESS_01	Ese esbirro debe esperar para atacar.	
VO__Male_Dragon_ERROR_TARGET_01	Necesito un objetivo.	
VO__Male_Dragon_ERROR_TAUNT_01	¡Esa basura me provoca!	
VO__Male_Dragon_FIRE_FESTIVAL_01	¡TODOS ARDERÁN DURANTE EL FESTIVAL DE FUEGO!	
VO__Male_Dragon_Greetings_01	¡Contempla al aspecto de la muerte!	
VO__Male_Dragon_HAPPY_BIRTHDAY_01	¿Conque ESTE es el día en que naciste? Ajá.	
VO__Male_Dragon_HAPPY_BREWFEST_01	¿Qué es la Fiesta de la Cerveza? ¿Por qué nada arde?	
VO__Male_Dragon_HAPPY_HALLOWEEN_01	¿Un día de muerte y melancolía? Qué encantador.	
VO__Male_Dragon_HAPPY_HOLIDAYS_01	Ah, celebra la festividad. ¡Mientras puedas!	
VO__Male_Dragon_HAPPY_NEW_YEAR_01	¡Feliz año nuevo!	
VO__Male_Dragon_HAPPY_NEW_YEAR_LUNAR_01	¡Feliz año nuevo!	
VO__Male_Dragon_HAPPY_NOBLEGARDEN_01	Roba huevos, si así lo deseas, ¡pero no del Vuelo Negro!	
VO__Male_Dragon_LowCards_01	¡Quedan pocas cartas!	
VO__Male_Dragon_MIRROR_GREETINGS_01	No eres más que una sombra del pasado.	
VO__Male_Dragon_MIRROR_START_01	Sí, se acerca lo inevitable.	
VO__Male_Dragon_NoCards_01	¡Estoy carente de cartas!	
VO__Male_Dragon_Oops_01	No siempre soy perfecto, solo casi siempre.	
VO__Male_Dragon_Picked_01	¡Devastaré este mundo!	
VO__Male_Dragon_PIRATE_DAY_01	¡Soy NelthARRRRion!	
VO__Male_Dragon_Sorry_01	El mar no pudo devorar mis remordimientos.	
VO__Male_Dragon_Start_01	¡Ven! ¡Acepta el caos!	
VO__Male_Dragon_Thanks_01	<Gruñido> Gracias.	
VO__Male_Dragon_Thinking_01	Mm...	
VO__Male_Dragon_Thinking_03	Qué dilema…	
VO__Male_Dragon_Thinking_04	Debo quemarlos a todos…	
VO__Male_Dragon_Threaten_01	Ningún refugio te protegerá de mi furia.	
VO__Male_Dragon_Time_01	¡Deprisa!	
VO__Male_Dragon_Well_Played_01	Tu tenacidad es admirable.	
VO__Male_Dragon_WOW_01	¡Cataclísmico!	
VO__Male_Mogu_Concede_01	La victoria es tuya. Esta vez.	
VO__Male_Mogu_ERROR_FULL_MINIONS_02	No puedo reclutar más.	
VO__Male_Mogu_ERROR_GENERIC_02	Eso es imposible.	
VO__Male_Mogu_ERROR_HAND_FULL_02	Ya poseo demasiadas cartas.	
VO__Male_Mogu_ERROR_I_ATTACKED_01	El trueno suena una sola vez.	
VO__Male_Mogu_ERROR_MINION_ATTACKED_02	Ese esbirro ya atacó.	
VO__Male_Mogu_ERROR_NEED_MANA_02	Deseo más maná.	
VO__Male_Mogu_ERROR_NEED_WEAPON_01	¡Dame un arma!	
VO__Male_Mogu_ERROR_PLAY_02	No puedo hacer esa jugada.	
VO__Male_Mogu_ERROR_STEALTH_01	Ese se esconde... por ahora.	
VO__Male_Mogu_ERROR_SUMMON_SICKNESS_01	Aún no puede pelear.	
VO__Male_Mogu_ERROR_TARGET_01	¡Necesito un objetivo!	
VO__Male_Mogu_ERROR_TAUNT_01	¡Alguien provoca al Rey del Trueno!	
VO__Male_Mogu_FIRE_FESTIVAL_01	¡Rinde honor al fuego y los relámpagos!	
VO__Male_Mogu_Greetings_01	Admira mi poder supremo.	
VO__Male_Mogu_HAPPY_HALLOWEEN_01	Distráete con dulces y disfraces. Yo tramaré los planes.	
VO__Male_Mogu_HAPPY_HOLIDAYS_01	Disfruta esta festividad y honra la tradición.	
VO__Male_Mogu_HAPPY_NEW_YEAR_01	¡Feliz año nuevo!	
VO__Male_Mogu_HAPPY_NEW_YEAR_LUNAR_01	¡Feliz año nuevo!	
VO__Male_Mogu_HAPPY_NOBLEGARDEN_01	No permitas que la belleza de la primavera te ablande.	
VO__Male_Mogu_LowCards_01	Tengo pocas cartas.	
VO__Male_Mogu_MIRROR_GREETINGS_01	Lo he visto antes.	
VO__Male_Mogu_MIRROR_START_01	Entonces mereces mi atención.	
VO__Male_Mogu_NoCards_01	No tengo cartas.	
VO__Male_Mogu_Oops_01	Tal vez mi mente se distrajo.	
VO__Male_Mogu_Picked_01	¡Mi poder no se puede contener!	
VO__Male_Mogu_PIRATE_DAY_01	Los piratas tendrán permitido saquear, solo si entregan el botín al rey.	
VO__Male_Mogu_Sorry_01	Me falló el juicio.	
VO__Male_Mogu_Start_01	¡Soy el asesino de reyes y dioses!	
VO__Male_Mogu_Thanks_01	Sabes obedecer.	
VO__Male_Mogu_Thinking_01	Mm...	
VO__Male_Mogu_Thinking_02	Necesito pensar...	
VO__Male_Mogu_Thinking_03	Desconcertante...	
VO__Male_Mogu_Threaten_03	¡Arrodíllate ante mí!	
VO__Male_Mogu_Time_01	¡Actúa raudamente!	
VO__Male_Mogu_Well_Played_01	Tu sed de victoria es admirable.	
VO__Male_Mogu_WOW_01	Me has sorprendido. Eso no es común.	
VO_AnnoyO_Male_Mech_Attack_01	¡HOLA!	
VO_AnnoyO_Male_Mech_Concede_02	Hola...	
VO_AnnoyO_Male_Mech_Death_01	Ho... laaaa...	
VO_AnnoyO_Male_Mech_ERROR_FULL_MINIONS_01	¡Hola!	
VO_AnnoyO_Male_Mech_ERROR_GENERIC_04	Hola.	
VO_AnnoyO_Male_Mech_ERROR_HAND_FULL_02	¡HOLA!	
VO_AnnoyO_Male_Mech_ERROR_I_ATTACKED_02	Ho... Hola.	
VO_AnnoyO_Male_Mech_ERROR_MINION_ATTACKED_01	¡Hola! Hola.	
VO_AnnoyO_Male_Mech_ERROR_NEED_MANA_01	¡Hola! Hola.	
VO_AnnoyO_Male_Mech_ERROR_NEED_WEAPON_01	Hola.	
VO_AnnoyO_Male_Mech_ERROR_PLAY_01	¡Hola!	
VO_AnnoyO_Male_Mech_ERROR_STEALTH_01	Holaaaa...	
VO_AnnoyO_Male_Mech_ERROR_SUMMON_SICKNESS_01	¿Hola? ¡Hola! Hola.	
VO_AnnoyO_Male_Mech_ERROR_TARGET_01	Hola.	
VO_AnnoyO_Male_Mech_ERROR_TAUNT_01	¡Hola!	
VO_AnnoyO_Male_Mech_FIRE_FESTIVAL_01	¿Hola? ¡Hola! ¡HOLA!	
VO_AnnoyO_Male_Mech_GG_01	¡Hola!	
VO_AnnoyO_Male_Mech_Greetings_03	¡Hola! ¡Hola! ¡Hola!	
VO_AnnoyO_Male_Mech_HAPPY_HALLOWEEN_01	¡Halloween! ¡Halloween! ¡Halloween!	
VO_AnnoyO_Male_Mech_HAPPY_HOLIDAYS_01	¡Ho- Ho- Hola!	
VO_AnnoyO_Male_Mech_HAPPY_NEW_YEAR_01	Hola. Hola. ¡HOLA!	
VO_AnnoyO_Male_Mech_HAPPY_NEW_YEAR_LUNAR_01	Hola. Hola. ¡HOLA!	
VO_AnnoyO_Male_Mech_HAPPY_NOBLEGARDEN_01	¡Holaaa!	
VO_AnnoyO_Male_Mech_LowCards_01	¡¿Hola?!	
VO_AnnoyO_Male_Mech_MIRROR_GREETINGS_02	¡Hola! ¡Hola! ¡Hola!	
VO_AnnoyO_Male_Mech_MIRROR_START_01	¿Hola? ¡Hola! ¡HOLAAAA!	
VO_AnnoyO_Male_Mech_NoCards_01	¡Holaaa!	
VO_AnnoyO_Male_Mech_Oops_01	Holaaaa.	
VO_AnnoyO_Male_Mech_Picked_01	Hola. ¡Hola! ¡Hola!	
VO_AnnoyO_Male_Mech_PIRATE_DAY_02	¡Arrr! ¡Arrr! ¡Arrr!	
VO_AnnoyO_Male_Mech_Sorry_01	Hola...	
VO_AnnoyO_Male_Mech_Start_01	¡Hola! ¡Hola! ¡Hola!	
VO_AnnoyO_Male_Mech_Thanks_01	¡Hola!	
VO_AnnoyO_Male_Mech_Thinking_02	¿Hola? ¡Holaaaa!	
VO_AnnoyO_Male_Mech_Thinking_03	¿Ho... laaa?	
VO_AnnoyO_Male_Mech_Thinking_07	Hola. Hola. ¿Hola?	
VO_AnnoyO_Male_Mech_Threaten_01	¡Hola!	
VO_AnnoyO_Male_Mech_Time_01	Hola. ¡Hola! ¡HOLA!	
VO_AnnoyO_Male_Mech_Well_Played_01	¡Holaaaa!	
VO_AnnoyO_Male_Mech_WOW_01	¡Holaaaaaa!	
VO_Arthas_Male_Human_Attack_01	¡PURIFICAREMOS el mal!	
VO_Arthas_Male_Human_CONCEDE_01	La batalla ha terminado. Tú ganas.	
VO_Arthas_Male_Human_ERROR_FULL_MINIONS_01	¡Tengo demasiados esbirros!	
VO_Arthas_Male_Human_ERROR_GENERIC_01	No puedo hacer eso.	
VO_Arthas_Male_Human_ERROR_HAND_FULL_01	¡Mi mano está llena!	
VO_Arthas_Male_Human_ERROR_I_ATTACKED_01	Ya ataqué.	
VO_Arthas_Male_Human_ERROR_JUST_PLAYED_01	Ese esbirro necesita un turno de descanso.	
VO_Arthas_Male_Human_ERROR_MINION_ATTACKED_01	Ese esbirro ya atacó.	
VO_Arthas_Male_Human_ERROR_NEED_MANA_01	No tengo suficiente maná.	
VO_Arthas_Male_Human_ERROR_NEED_WEAPON_01	Necesito un arma.	
VO_Arthas_Male_Human_ERROR_PLAY_01	No puedo hacer esa jugada.	
VO_Arthas_Male_Human_ERROR_STEALTH_01	No puedo atacar esbirros en Sigilo.	
VO_Arthas_Male_Human_ERROR_TARGET_01	Ese objetivo no es válido.	
VO_Arthas_Male_Human_ERROR_TAUNT_01	Hay un esbirro con Provocación en el camino.	
VO_Arthas_Male_Human_FIRE_FESTIVAL_01	¡Enciendan las fogatas!	
VO_Arthas_Male_Human_GREETINGS_01	Es un gusto verte.	
VO_Arthas_Male_Human_GREETINGS_RESPONSE	¡El gusto es todo mío!	
VO_Arthas_Male_Human_HAPPY_HALLOWEEN_01	Feliz Halloween...	
VO_Arthas_Male_Human_HAPPY_HOLIDAYS_01	¡Feliz festín del Festival de Invierno!	
VO_Arthas_Male_Human_HAPPY_NEW_YEAR_01	¡Feliz año nuevo!	
VO_Arthas_Male_Human_HAPPY_NEW_YEAR_LUNAR_01	¡Feliz año nuevo!	
VO_Arthas_Male_Human_HAPPY_NOBLEGARDEN	Feliz Jardín Noble.	
VO_Arthas_Male_Human_LOW_CARDS_01	Casi no me quedan cartas.	
VO_Arthas_Male_Human_MIRROR_GREETINGS_01	¡El gusto es todo mío!	
VO_Arthas_Male_Human_MIRROR_START_01	¡Por mi padre, el rey!	
VO_Arthas_Male_Human_NO_CARDS_01	¡No me quedan cartas!	
VO_Arthas_Male_Human_OOPS_01	Una equivocación.	
VO_Arthas_Male_Human_PIRATE_DAY_01	¡Aahh, marineros, se siente bien ser Arrrthas!	
VO_Arthas_Male_Human_SORRY_01	Lo siento mucho, de verdad.	
VO_Arthas_Male_Human_START_01	¡Por Lordaeron!	
VO_Arthas_Male_Human_THANKS_01	Te has ganado mi gratitud.	
VO_Arthas_Male_Human_THINK1_01	Mmm...	
VO_Arthas_Male_Human_THINK2_01	Cuál será el camino correcto...	
VO_Arthas_Male_Human_THINK3_01	¿Qué haría Uther en esta situación...?	
VO_Arthas_Male_Human_THREATEN_01	¡No tienes salvación!	
VO_Arthas_Male_Human_TIMER_01	¡Debo actuar ahora!	
VO_Arthas_Male_Human_WELL_PLAYED_01	Buena jugada.	
VO_Arthas_Male_Human_WOW_01	¡Por la Luz!	
VO_BOT_238_Male_Goblin_Concede_01	Me rindo. ¡AUTODESTRUCCIÓN!	
VO_BOT_238_Male_Goblin_Greetings_02	¡Aquí viene el BUM!	
VO_BOT_238_Male_Goblin_HAPPY_HALLOWEEN_01	¡Buu! ¡Jaja! Feliz Halloween. 	
VO_BOT_238_Male_Goblin_LowCards_01	Casi no me quedan cartas...	
VO_BOT_238_Male_Goblin_NoCards_01	¡Es todo! ¡No hay más cartas!	
VO_BOT_238_Male_Goblin_Oops_01	Meh. El fracaso ES una opción.	
VO_BOT_238_Male_Goblin_Thanks_01	¡Gracias! Te destruiré último.	
VO_BOT_238_Male_Goblin_Thinking_01	Bueno...	
VO_BOT_238_Male_Goblin_Thinking_02	Este sería un buen momento para un plan maestro...	
VO_BOT_238_Male_Goblin_Thinking_03	Mmmmm...	
VO_BOT_238_Male_Goblin_Threaten_01	¡No me obligues a tocar botones!	
VO_BOT_238_Male_Goblin_Time_03	Oh, me encanta esa mecha.	
VO_BOT_238_Male_Goblin_Well_Played_02	Ey. Tú sí que sabes jugar.	
VO_BOT_238_Male_Goblin_WOW_01	¡QUÉ BIEN!	
VO_BRM_027h__LUNAR_NEW_YEAR	¡EL AÑO NUEVO LLEGARÁ EN LLAMAS!	
VO_BRM_027h_Attack_15	¡PRUEBA LAS LLAMAS DE SULFURON!	
VO_BRM_027h_Concede_11	TÚ GANAS. ¡BIEN HECHO!	
VO_BRM_027h_Emote_Start	¡Me vengaré, dragón!	
VO_BRM_027h_ERROR01_51	NECESITO UN ARMA.	
VO_BRM_027h_ERROR02_52	NO TENGO SUFICIENTE MANÁ.	
VO_BRM_027h_ERROR03_53	YA ATACÓ.	
VO_BRM_027h_ERROR04_54	YA ATAQUÉ.	
VO_BRM_027h_ERROR05_55	LOS MORTALES NECESITAN UN TURNO DE PREPARACIÓN.	
VO_BRM_027h_ERROR06_56	HAY DEMASIADAS CARTAS.	
VO_BRM_027h_ERROR07_57	HAY DEMASIADOS ESBIRROS.	
VO_BRM_027h_ERROR08_58	ESTÁ EN SIGILO.	
VO_BRM_027h_ERROR09_59	NO PUEDO HACER ESA JUGADA.	
VO_BRM_027h_ERROR10_60	NO ES VÁLIDO.	
VO_BRM_027h_ERROR11_61	ESE ESBIRRO CON PROVOCACIÓN ESTÁ EN MI CAMINO.	
VO_BRM_027h_ERROR12_62	NO PUEDO HACER ESO.	
VO_BRM_027h_FIRE_FESTIVAL	¡ESTE ES MI FESTIVAL!	
VO_BRM_027h_GG_16	¡BUENA PARTIDA!	
VO_BRM_027h_Greetings_04	¡QUE EL FUEGO TE PURIFIQUE!	
VO_BRM_027h_GREETINGS_RESPONSE	¡PURGA! ¡PURGA¡ ¡PURGA! ¡PURGA! ¡PURGAAAA!	
VO_BRM_027h_HALLOWS_END	¡FELIZ HALLOWEEN!	
VO_BRM_027h_HAPPY_NEW_YEAR_38	¡EL AÑO NUEVO LLEGARÁ EN LLAMAS!	
VO_BRM_027h_LowCards_49	YA HE QUEMADO CASI TODAS MIS CARTAS.	
VO_BRM_027h_NOBLEGARDEN	¡NO ES JUSTO! LOS HUEVOS QUE ENCUENTRO... ¡SE COCINAN!	
VO_BRM_027h_NoCards_50	HE QUEMADO TODAS MIS CARTAS.	
VO_BRM_027h_Oops_07	¡AH! ¡UNA EQUIVOCACIÓN!	
VO_BRM_027h_PIRATE_DAY	¡CONTEMPLEN AL SEÑOR ARRRRDIENTE!	
VO_BRM_027h_Sorry_10	LO SIENTO.	
VO_BRM_027h_Thanks_09	MI MÁS CÁLIDO AGRADECIMIENTO.	
VO_BRM_027h_Thinking1_12	MMM...	
VO_BRM_027h_Thinking2_13	ME PREGUNTO...	
VO_BRM_027h_Thinking3_14	¿QUÉ QUEMARÉ PRIMERO...?	
VO_BRM_027h_Threaten_08	¡PERECERÁS EN LAS LLAMAS!	
VO_BRM_027h_Time_48	¡EL TIEMPO SE CONSUME!	
VO_BRM_027h_Well_Played_06	BUENA JUGADA.	
VO_BRM_027h_Winterveil_Greetings	¡EL INVIERNO DEBERÍA SER MÁS CÁLIDO!	
VO_BRM_027h_WOW_20	ESTO SÍ QUE ESTÁ CALIENTE.	
VO_DRG_600_Male_Dragon_Concede_01	Has derrotado a mi ejército. Felicitaciones.	
VO_DRG_600_Male_Dragon_Greetings_01	¡Arde en el fuego vil!	
VO_DRG_600_Male_Dragon_MIRROR_GREETINGS_01	¡Ya estoy ardiendo!	
VO_DRG_600_Male_Dragon_MIRROR_START_01	... ¡Y tú también!	
VO_DRG_600_Male_Dragon_Oops_01	Eso fue… doloroso.	
VO_DRG_600_Male_Dragon_Picked_01	¡Hora de hacer arder el mundo!	
VO_DRG_600_Male_Dragon_Sorry_01	Lo siento. Pero tú lo sentirás más.	
VO_DRG_600_Male_Dragon_Start_01	¡Que arda! ¡Que arda todo!	
VO_DRG_600_Male_Dragon_Thanks_01	Gracias por tus necios esfuerzos.	
VO_DRG_600_Male_Dragon_Threaten_01	La eternidad no será amable con tu alma.	
VO_DRG_600_Male_Dragon_Time_01	¡Mi tiempo se extingue!	
VO_DRG_600_Male_Dragon_Well_Played_01	Impresionante, para un mortal.	
VO_DRG_600_Male_Dragon_WOW_01	¡Eso fue maravillosamente vil!	
VO_DRG_610_Male_Dragon_Concede_01	La pesadilla termina... Tú ganas.	
VO_DRG_610_Male_Dragon_Greetings_01	Tu miedo... es exquisito.	
VO_DRG_610_Male_Dragon_MIRROR_GREETINGS_01	Solo te asustas a ti mismo.	
VO_DRG_610_Male_Dragon_MIRROR_START_01	Te enseñaré el verdadero terror.	
VO_DRG_610_Male_Dragon_Oops_01	¡Eso fue aterrador!	
VO_DRG_610_Male_Dragon_Picked_01	Conque eliges la oscuridad. Qué astuto.	
VO_DRG_610_Male_Dragon_Sorry_01	Perdón, ¿te asusté?	
VO_DRG_610_Male_Dragon_Start_01	No despertarás de esta pesadilla.	
VO_DRG_610_Male_Dragon_Thanks_01	Gracias. Te destruiré al final.	
VO_DRG_610_Male_Dragon_Threaten_01	Tus gritos son mi placer.	
VO_DRG_610_Male_Dragon_Time_01	¡La oscuridad se disipa!	
VO_DRG_610_Male_Dragon_Well_Played_01	Tu cordura es… admirable.	
VO_DRG_610_Male_Dragon_WOW_01	¡Fascinante!	
VO_DRG_620_Male_Dragon_Concede_01	La tormenta cesó. Me rindo.	
VO_DRG_620_Male_Dragon_Greetings_01	¿Podrás sobrevivir a esta tormenta?	
VO_DRG_620_Male_Dragon_MIRROR_GREETINGS_01	¡La tormenta obedece MIS caprichos!	
VO_DRG_620_Male_Dragon_MIRROR_START_01	¡Los cielos se arrodillan solo ante mí!	
VO_DRG_620_Male_Dragon_Oops_01	¡Un desastre natural!	
VO_DRG_620_Male_Dragon_Picked_01	¡Tiemblen ante la vorágine!	
VO_DRG_620_Male_Dragon_Sorry_01	Disculpa. Algunos sacrificios son necesarios.	
VO_DRG_620_Male_Dragon_Start_01	¡Yo soy la tempestad! ¡Yo soy la tormenta!	
VO_DRG_620_Male_Dragon_Thanks_01	Gracias. ¡Alimenta mis llamas!	
VO_DRG_620_Male_Dragon_Threaten_02	¿Y TÚ cómo piensas sobrevivir a una fuerza de la naturaleza?	
VO_DRG_620_Male_Dragon_Time_01	¡El ojo de la tormenta se avecina!	
VO_DRG_620_Male_Dragon_Well_Played_01	¡Una jugada que sacude a la tierra!	
VO_DRG_620_Male_Dragon_WOW_01	¡Qué remolino!	
VO_DRG_650_Male_Dragon_Concede_01	Esta vez me detuviste. Pero regresaré.	
VO_DRG_650_Male_Dragon_Greetings_01	¡Arrodíllate ante el Irrompible!	
VO_DRG_650_Male_Dragon_MIRROR_GREETINGS_01	Ya veremos quién se rompe primero.	
VO_DRG_650_Male_Dragon_MIRROR_START_01	¿Dos fuerzas imparables? Esto será divertido.	
VO_DRG_650_Male_Dragon_Oops_02	¡Un error enorme!	
VO_DRG_650_Male_Dragon_Picked_01	¡Nadie puede con mi poder!	
VO_DRG_650_Male_Dragon_Sorry_01	Disculpa, apenas lo noté.	
VO_DRG_650_Male_Dragon_Start_01	¡Tus intentos de vencer serán en vano!	
VO_DRG_650_Male_Dragon_Thanks_01	Gracias por tu diminuto regalo.	
VO_DRG_650_Male_Dragon_Threaten_01	¡Son como hormigas ante un gigante!	
VO_DRG_650_Male_Dragon_Time_01	¡Soy irrompible, pero el tiempo es efímero!	
VO_DRG_650_Male_Dragon_Well_Played_01	¡Una jugada colosal!	
VO_DRG_650_Male_Dragon_WOW_02	¡Eso! Eso es impresionante.	
VO_DRG_660_Male_Dragon_Concede_01	Me rindo. Disfruta el silencio.	
VO_DRG_660_Male_Dragon_Greetings_01	Ya te vi...	
VO_DRG_660_Male_Dragon_MIRROR_GREETINGS_01	¿Quién dijo que me estaba ocultando?	
VO_DRG_660_Male_Dragon_MIRROR_START_01	Y solo a mí.	
VO_DRG_660_Male_Dragon_Oops_01	Ay, qué horror.	
VO_DRG_660_Male_Dragon_Picked_01	¡Convertiremos su mundo en pura locura!	
VO_DRG_660_Male_Dragon_Sorry_01	Perdón. ¿En qué estaba pensando?	
VO_DRG_660_Male_Dragon_Start_01	Los susurros... ¡Me hablan!	
VO_DRG_660_Male_Dragon_Thanks_01	Tu locura es… agradable.	
VO_DRG_660_Male_Dragon_Threaten_01	Tu mente flaquea...	
VO_DRG_660_Male_Dragon_Time_01	¡¿Qué?! ¡Se acaba el tiempo!	
VO_DRG_660_Male_Dragon_Well_Played_01	Apruebo esta demencia.	
VO_DRG_660_Male_Dragon_WOW_01	Eso fue… creativo.	
VO_DRG_6x_Male_Dragon_ERROR_FULL_MINIONS_01	Mi tablero está muy lleno.	
VO_DRG_6x_Male_Dragon_ERROR_GENERIC_01	Eso es imposible.	
VO_DRG_6x_Male_Dragon_ERROR_HAND_FULL_01	Tengo demasiadas cartas.	
VO_DRG_6x_Male_Dragon_ERROR_I_ATTACKED_01	No puedo volver a atacar.	
VO_DRG_6x_Male_Dragon_ERROR_MINION_ATTACKED_01	Ese esbirro ya atacó.	
VO_DRG_6x_Male_Dragon_ERROR_NEED_MANA_01	Necesito más maná para eso.	
VO_DRG_6x_Male_Dragon_ERROR_NEED_WEAPON_01	Necesito un arma. O garras.	
VO_DRG_6x_Male_Dragon_ERROR_PLAY_01	No puedo hacer eso.	
VO_DRG_6x_Male_Dragon_ERROR_STEALTH_01	Ese esbirro tiene Sigilo.	
VO_DRG_6x_Male_Dragon_ERROR_SUMMON_SICKNESS_01	Dale a ese debilucho un turno para prepararse.	
VO_DRG_6x_Male_Dragon_ERROR_TARGET_01	No puedo hacer objetivo en eso.	
VO_DRG_6x_Male_Dragon_ERROR_TAUNT_01	Debo atacar al esbirro con Provocación.	
VO_DRG_6x_Male_Dragon_FIRE_FESTIVAL_01	Fuegos artificiales. Me encantan...	
VO_DRG_6x_Male_Dragon_HAPPY_HALLOWEEN_01	Halloween, mi festividad preferida.	
VO_DRG_6x_Male_Dragon_HAPPY_HOLIDAYS_01	Feliz festín del Festival de Invierno...	
VO_DRG_6x_Male_Dragon_HAPPY_NEW_YEAR_01	Feliz año nuevo.	
VO_DRG_6x_Male_Dragon_HAPPY_NEW_YEAR_LUNAR_01	Feliz año nuevo.	
VO_DRG_6x_Male_Dragon_HAPPY_NOBLEGARDEN_01	Jardín Noble... Lo detesto.	
VO_DRG_6x_Male_Dragon_LowCards_01	Me estoy quedando sin cartas.	
VO_DRG_6x_Male_Dragon_NoCards_01	¡No me quedan cartas!	
VO_DRG_6x_Male_Dragon_PIRATE_DAY_01	¡Arrrr! ¡Soy Galakrond, el corsario de los cielos!	
VO_DRG_6x_Male_Dragon_Thinking_01	¿Y si...?	
VO_DRG_6x_Male_Dragon_Thinking_02	¿Qué tal si...?	
VO_DRG_6x_Male_Dragon_Thinking_03	Quizás… 	
VO_EX1_323h_HAPPY_NEW_YEAR_13	¡FELIZ AÑO NUEVO!	
VO_GIL_504_Female_Orc_Concede_01	Tú ganas esta vez.	
VO_GIL_504_Female_Orc_Greetings_02	Bienvenido a mis dominios.	
VO_GIL_504_Female_Orc_GREETINGS_RESPONSE	Entonces vayamos... juntas.	
VO_GIL_504_Female_Orc_LowCards_01	¡Casi no me quedan cartas!	
VO_GIL_504_Female_Orc_NoCards_01	¡No me quedan cartas!	
VO_GIL_504_Female_Orc_Oops_01	Eso no fue sensato.	
VO_GIL_504_Female_Orc_Start_01	Los bosques son peligrosos por la noche.	
VO_GIL_504_Female_Orc_Thanks_01	Gracias.	
VO_GIL_504_Female_Orc_Thinking_01	Mmm...	
VO_GIL_504_Female_Orc_Thinking_02	Desconcertante...	
VO_GIL_504_Female_Orc_Thinking_03	Hay poca luz en esta senda...	
VO_GIL_504_Female_Orc_Threaten_02	¡La maldición se apoderará de ti!	
VO_GIL_504_Female_Orc_Time_01	¡Tengo que decidirme!	
VO_GIL_504_Female_Orc_Well_Played_01	Buena jugada.	
VO_GIL_504_Female_Orc_Wow_01	¡Por la noche!	
VO_GILA_400h_Male_Human_Concede_01	¡Eres demasiado para mí!	
VO_GILA_400h_Male_Human_Death_02	<Muerte>	
VO_GILA_400h_Male_Human_ERROR_FULL_MINIONS_01	No hay lugar para nadie más.	
VO_GILA_400h_Male_Human_ERROR_GENERIC_01	No puedo hacerlo.	
VO_GILA_400h_Male_Human_ERROR_GENERIC_04	Simplemente no puedo.	
VO_GILA_400h_Male_Human_ERROR_HAND_FULL_01	¡Tengo demasiadas cartas!	
VO_GILA_400h_Male_Human_ERROR_I_ATTACKED_01	Ya ataqué.	
VO_GILA_400h_Male_Human_ERROR_MINION_ATTACKED_01	Ese ya atacó.	
VO_GILA_400h_Male_Human_ERROR_NEED_MANA_02	¡Ya no tengo más maná!	
VO_GILA_400h_Male_Human_ERROR_NEED_WEAPON_02	¡Necesito un arma!	
VO_GILA_400h_Male_Human_ERROR_STEALTH_01	¡Qué sigiloso!	
VO_GILA_400h_Male_Human_ERROR_SUMMON_SICKNESS_01	Ese no está listo.	
VO_GILA_400h_Male_Human_ERROR_TARGET_01	No puedo hacer objetivo en eso.	
VO_GILA_400h_Male_Human_ERROR_TAUNT_01	Hay un esbirro con Provocación bloqueándonos.	
VO_GILA_400h_Male_Human_Greetings_01	No me agradas. Y a mis perros tampoco.	
VO_GILA_400h_Male_Human_GREETINGS_RESPONSE	¿Por qué no le agrado a nadie?	
VO_GILA_400h_Male_Human_LowCards_01	Casi no me quedan cartas…	
VO_GILA_400h_Male_Human_NoCards_01	¡No me quedan cartas!	
VO_GILA_400h_Male_Human_Oops_01	Eso fue de lo peor.	
VO_GILA_400h_Male_Human_Sorry_01	Lo siento tanto.	
VO_GILA_400h_Male_Human_Start_01	Mira lo que desenterraron los perros.	
VO_GILA_400h_Male_Human_Thanks_01	Gracias por eso.	
VO_GILA_400h_Male_Human_Thinking_01	Eh...	
VO_GILA_400h_Male_Human_Thinking_03	Tengo que pensarlo bien...	
VO_GILA_400h_Male_Human_Thinking_04	Vamos, vamos...	
VO_GILA_400h_Male_Human_Threaten_04	Será mejor que te hagas el muerto.	
VO_GILA_400h_Male_Human_Time_01	No queda mucho tiempo.	
VO_GILA_400h_Male_Human_Well_Played_01	¡Qué buen truco!	
VO_GILA_400h_Male_Human_WOW_01	¡Guuaau!	
VO_GILA_500h3_Female_Human_Concede_01	¡No puedo derrotarte!	
VO_GILA_500h3_Female_Human_ERROR_FULL_MINIONS_01	No hay suficiente lugar.	
VO_GILA_500h3_Female_Human_ERROR_GENERIC_04	¡Eso no está permitido!	
VO_GILA_500h3_Female_Human_ERROR_HAND_FULL_02	¡Mi mano está demasiado llena!	
VO_GILA_500h3_Female_Human_ERROR_I_ATTACKED_02	¡No puedo atacar dos veces!	
VO_GILA_500h3_Female_Human_ERROR_MINION_ATTACKED_01	Ya atacó.	
VO_GILA_500h3_Female_Human_ERROR_NEED_MANA_02	No tengo suficiente maná.	
VO_GILA_500h3_Female_Human_ERROR_NEED_WEAPON_02	Voy a necesitar un arma.	
VO_GILA_500h3_Female_Human_ERROR_PLAY_01	No puedo romper las reglas.	
VO_GILA_500h3_Female_Human_ERROR_STEALTH_01	¡No lo encuentro!	
VO_GILA_500h3_Female_Human_ERROR_SUMMON_SICKNESS_01	Ese esbirro no está listo.	
VO_GILA_500h3_Female_Human_ERROR_TARGET_01	No puedo hacer objetivo en eso.	
VO_GILA_500h3_Female_Human_ERROR_TAUNT_01	¡Hay un esbirro con Provocación bloqueándome!	
VO_GILA_500h3_Female_Human_Greetings_01	Los Descoronados envían sus saludos.	
VO_GILA_500h3_Female_Human_GREETINGS_RESPONSE	Les responderé con igual gentileza.	
VO_GILA_500h3_Female_Human_LowCards_01	No me quedan muchas cartas...	
VO_GILA_500h3_Female_Human_NoCards_01	¡No me quedan cartas!	
VO_GILA_500h3_Female_Human_Oops_02	Eso... no fue intencional.	
VO_GILA_500h3_Female_Human_Sorry_01	Lamento eso.	
VO_GILA_500h3_Female_Human_Start_01	El rastro llega hasta aquí.	
VO_GILA_500h3_Female_Human_Thanks_01	Gracias.	
VO_GILA_500h3_Female_Human_Thinking_02	Debe haber una forma...	
VO_GILA_500h3_Female_Human_Thinking_03	Piensa, Tess. Piensa.	
VO_GILA_500h3_Female_Human_Thinking_05	Ahhh... mmm.	
VO_GILA_500h3_Female_Human_Threaten_03	¡Te aniquilaré!	
VO_GILA_500h3_Female_Human_Time_01	Debo actuar rápido.	
VO_GILA_500h3_Female_Human_Well_Played_01	Muy buenas tácticas. 	
VO_GILA_500h3_Female_Human_WOW_01	Absolutamente increíble.	
VO_GILA_600h_Male_Worgen_Concede_01	¡Fuiste superior a mí!	
VO_GILA_600h_Male_Worgen_ERROR_FULL_MINIONS_02	Tengo demasiados esbirros en el campo de batalla.	
VO_GILA_600h_Male_Worgen_ERROR_GENERIC_01	Eso es imposible.	
VO_GILA_600h_Male_Worgen_ERROR_GENERIC_02	No puedo hacer eso.	
VO_GILA_600h_Male_Worgen_ERROR_HAND_FULL_01	¡Demasiadas cartas!	
VO_GILA_600h_Male_Worgen_ERROR_I_ATTACKED_01	Ya ataqué.	
VO_GILA_600h_Male_Worgen_ERROR_MINION_ATTACKED_01	Ese esbirro ya atacó.	
VO_GILA_600h_Male_Worgen_ERROR_NEED_MANA_01	No me queda maná. 	
VO_GILA_600h_Male_Worgen_ERROR_NEED_WEAPON_02	Necesito un arma.	
VO_GILA_600h_Male_Worgen_ERROR_STEALTH_01	¡Ese esbirro está ocultándose!	
VO_GILA_600h_Male_Worgen_ERROR_SUMMON_SICKNESS_01	Todavía no está listo para moverse.	
VO_GILA_600h_Male_Worgen_ERROR_TARGET_01	No puedo hacer objetivo en eso.	
VO_GILA_600h_Male_Worgen_ERROR_TAUNT_01	¡Hay un esbirro con Provocación en el camino!	
VO_GILA_600h_Male_Worgen_Greetings_01	Saluda a mi amigote.	
VO_GILA_600h_Male_Worgen_GREETINGS_RESPONSE	¡Hola, amigote!	
VO_GILA_600h_Male_Worgen_LowCards_01	Casi no me quedan cartas.	
VO_GILA_600h_Male_Worgen_NoCards_01	¡Ya no me quedan cartas!	
VO_GILA_600h_Male_Worgen_Oops_01	¡Eso estuvo mal!	
VO_GILA_600h_Male_Worgen_Sorry_01	Lo... siento.	
VO_GILA_600h_Male_Worgen_Start_01	Estoy en posición.	
VO_GILA_600h_Male_Worgen_Thanks_01	Gracias.	
VO_GILA_600h_Male_Worgen_Thinking_01	Mmm....	
VO_GILA_600h_Male_Worgen_Thinking_02	Qué puedo hacer ahora...	
VO_GILA_600h_Male_Worgen_Thinking_04	Encontraré una forma...	
VO_GILA_600h_Male_Worgen_Threaten_01	¡Te haré pedazos!	
VO_GILA_600h_Male_Worgen_Time_01	¡No me apures!	
VO_GILA_600h_Male_Worgen_Well_Played_01	Una maniobra excelente.	
VO_GILA_600h_Male_Worgen_WOW_01	¡Increíble!	
VO_GILA_900h_Female_Gnome_Concede_01	Ya lo intenté todo. ¡Tú ganas!	
VO_GILA_900h_Female_Gnome_ERROR_FULL_MINIONS_02	No puedo tener más esbirros.	
VO_GILA_900h_Female_Gnome_ERROR_GENERIC_01	No puedo hacer eso.	
VO_GILA_900h_Female_Gnome_ERROR_HAND_FULL_01	¡Tengo demasiadas cartas!	
VO_GILA_900h_Female_Gnome_ERROR_I_ATTACKED_02	¡Todavía no puedo atacar de nuevo!	
VO_GILA_900h_Female_Gnome_ERROR_MINION_ATTACKED_01	Ese esbirro ya atacó.	
VO_GILA_900h_Female_Gnome_ERROR_NEED_MANA_01	No tengo suficiente maná.	
VO_GILA_900h_Female_Gnome_ERROR_NEED_WEAPON_01	No tengo un arma.	
VO_GILA_900h_Female_Gnome_ERROR_PLAY_01	Ni siquiera yo puedo hacer eso. 	
VO_GILA_900h_Female_Gnome_ERROR_STEALTH_01	Ese objetivo sí que es sigiloso.	
VO_GILA_900h_Female_Gnome_ERROR_SUMMON_SICKNESS_01	Ese esbirro necesita tiempo para prepararse.	
VO_GILA_900h_Female_Gnome_ERROR_TARGET_01	Ese no es un buen objetivo.	
VO_GILA_900h_Female_Gnome_ERROR_TAUNT_01	¡Hay un esbirro con Provocación en el camino!	
VO_GILA_900h_Female_Gnome_GG_01	¡Vaya, qué buena partida!	
VO_GILA_900h_Female_Gnome_Greetings_01	Ah, hola. Tú otra vez.	
VO_GILA_900h_Female_Gnome_GREETINGS_RESPONSE	¿Qué tanto arruiné esta línea temporal?	
VO_GILA_900h_Female_Gnome_LowCards_01	No me quedan muchas cartas...	
VO_GILA_900h_Female_Gnome_NoCards_01	¡No me quedan cartas!	
VO_GILA_900h_Female_Gnome_Oops_02	Creo que eso fue un error.	
VO_GILA_900h_Female_Gnome_Sorry_01	Eh, ¿perdón?	
VO_GILA_900h_Female_Gnome_Start_01	¡Se te acabó el tiempo!	
VO_GILA_900h_Female_Gnome_Thanks_01	Gracias.	
VO_GILA_900h_Female_Gnome_Thinking_02	Mmm...	
VO_GILA_900h_Female_Gnome_Thinking_03	…tengo que pensar en cuatro dimensiones...	
VO_GILA_900h_Female_Gnome_Thinking_05	…las ruedas giran...	
VO_GILA_900h_Female_Gnome_Threaten_01	¡Te borraré de la línea temporal!	
VO_GILA_900h_Female_Gnome_Time_01	¿Cómo puede ser que a MÍ se me acabe el tiempo?	
VO_GILA_900h_Female_Gnome_Well_Played_01	¡No podría haberlo hecho mejor!	
VO_GILA_900h_Female_Gnome_WOW_02	¡Inconcebible!	
VO_HERO_01_HAPPY_NEW_YEAR_06	¡Feliz año nuevo!	
VO_HERO_01_Male_Orc_Emote_01	No soy malo, pero es que... no soy Thrall.	
VO_HERO_01_Male_Orc_Emote_02	¡Cuánto poder!	
VO_HERO_01_Male_Orc_Emote_03	Si tan solo pudiera resolver esto con un viaje en el tiempo…	
VO_HERO_01_Male_Orc_Emote_05	¡No hice nada malo!	
VO_HERO_01_Male_Orc_Emote_06	¡Larga vida al VERDADERO jefe de guerra!	
VO_HERO_01_Male_Orc_Emote_08	¡Sangre y trueno!	
VO_HERO_01_Male_Orc_Emote_09	¡Por la Horda!	
VO_HERO_01_Male_Orc_Emote_10	¡Lok'narosh!	
VO_HERO_01_Male_Orc_Emote_11	Los ojos de Grito Infernal están sobre ti.	
VO_HERO_01_Male_Orc_Emote_12	¡No tendré piedad!	
VO_HERO_01d_Male_Orc_Attack_01	¡Por los mag'har!	
VO_HERO_01d_Male_Orc_Greetings_01	Mok'rah.	
VO_HERO_01d_Male_Orc_MIRROR_GREETINGS_01	Saludos, camarada.	
VO_HERO_01d_Male_Orc_MIRROR_START_01	Solo si hay victoria en él.	
VO_HERO_01d_Male_Orc_Oops_01	Qué vergonzoso.	
VO_HERO_01d_Male_Orc_Start_01	Acepta tu destino.	
VO_HERO_01d_Male_Orc_Thanks_01	Gracias.	
VO_HERO_01d_Male_Orc_Threaten_01	¡Yo no le respondo a NADIE!	
VO_HERO_01d_Male_Orc_Well_Played_01	Tienes un gran honor.	
VO_HERO_01d_Male_Orc_Wow_01	Estoy impresionado.	
VO_HERO_01f_Male_Orc_Greetings_01	Te saludo.	
VO_HERO_01f_Male_Orc_MIRROR_START_01	Y a ti también.	
VO_HERO_01f_Male_Orc_Oops_01	Los errores no se perdonan.	
VO_HERO_01f_Male_Orc_Thanks_01	Estoy agradecido.	
VO_HERO_01f_Male_Orc_Wow_01	Qué espectáculo.	
VO_HERO_01g_Male_Orc_Attack_01	¡Contempla mi fuerza!	
VO_HERO_01g_Male_Orc_Greetings_01	Mantente firme.	
VO_HERO_01g_Male_Orc_IntroValeera_01	¡Claro que sí!	
VO_HERO_01g_Male_Orc_MIRROR_GREETINGS_01	Sí, firme y valiente.	
VO_HERO_01g_Male_Orc_MIRROR_START_01	¿Estás seguro?	
VO_HERO_01g_Male_Orc_Oops_01	Hasta los grandes guerreros tropiezan a veces.	
VO_HERO_01g_Male_Orc_Start_01	¡Nadie puede vencerme!	
VO_HERO_01g_Male_Orc_Thanks_01	Acepta mi agradecimiento.	
VO_HERO_01g_Male_Orc_Threaten_01	Tienes mucho que aprender...	
VO_HERO_01g_Male_Orc_Well_Played_01	Pues sí que estás a la altura.	
VO_HERO_01g_Male_Orc_Wow_01	¡Increíble!	
VO_HERO_01i_Female_Orc_Attack_01	¡Lobo Gélido!	
VO_HERO_01i_Female_Orc_Greetings_01	Saludos.	
VO_HERO_01i_Female_Orc_MIRROR_GREETINGS_01	Para ti también.	
VO_HERO_01i_Female_Orc_MIRROR_START_01	¡Pues actúa como una!	
VO_HERO_01i_Female_Orc_Oops_01	¡Ups!	
VO_HERO_01i_Female_Orc_Picked_01	Un día seré una heroína grandiosa.	
VO_HERO_01i_Female_Orc_Start_01	¡Quiero ser guerrera!	
VO_HERO_01i_Female_Orc_Thanks_01	Esto me alegra mucho.	
VO_HERO_01i_Female_Orc_Threaten_01	¡Cobarde!	
VO_HERO_01i_Female_Orc_Well_Played_01	Buena pelea.	
VO_HERO_01i_Female_Orc_Wow_01	No puedo creerlo.	
VO_HERO_01j_Female_Orc_Attack_01	¡Los fuertes sobreviven!	
VO_HERO_01j_Female_Orc_Greetings_01	Soy Rokara del clan Lobo Gélido.	
VO_HERO_01j_Female_Orc_MIRROR_GREETINGS_01	Ya sé, tontita.	
VO_HERO_01j_Female_Orc_MIRROR_START_01	Y a toda hora.	
VO_HERO_01j_Female_Orc_Oops_01	Eso no fue a propósito.	
VO_HERO_01j_Female_Orc_Picked_01	Debemos restaurar la vida en las tierras de la Horda.	
VO_HERO_01j_Female_Orc_Start_01	¡Lucharé en todo lugar!	
VO_HERO_01j_Female_Orc_Thanks_01	Te debo mucho.	
VO_HERO_01j_Female_Orc_Threaten_01	Te enseñaré lo que significa la derrota.	
VO_HERO_01j_Female_Orc_Well_Played_01	Corre con la manada.	
VO_HERO_01j_Female_Orc_Wow_01	¡In-cre-íble!	
VO_HERO_01k_Female_Orc_Attack_01	¡Por la Horda!	
VO_HERO_01k_Female_Orc_Greetings_01	Nuestra batalla será gloriosa.	
VO_HERO_01k_Female_Orc_MIRROR_GREETINGS_01	Una batalla para la historia.	
VO_HERO_01k_Female_Orc_MIRROR_START_01	Aquí estoy, no grites.	
VO_HERO_01k_Female_Orc_Oops_01	Los errores mellan la espada, pero afilan la destreza.	
VO_HERO_01k_Female_Orc_Picked_01	¡No soy muy joven para pelear!	
VO_HERO_01k_Female_Orc_Start_01	¡Sal a jugar!	
VO_HERO_01k_Female_Orc_Thanks_01	Eres muy amable.	
VO_HERO_01k_Female_Orc_Threaten_01	¡Pareces un wendigo y apestas como bestia de nieve!	
VO_HERO_01k_Female_Orc_Well_Played_01	Estas son las peleas de mis sueños.	
VO_HERO_01k_Female_Orc_Wow_01	Por Azeroth, ¡¿qué es eso?!	
VO_HERO_01l_Female_Orc_Attack_02	<Estertor de ataque>	
VO_HERO_01l_Female_Orc_Attack_03	<Estertor de ataque>	
VO_HERO_01l_Female_Orc_BRB_01	¡Un segundo!	
VO_HERO_01l_Female_Orc_CELEBRATE_01	¡Celebraremos este triunfo!	
VO_HERO_01l_Female_Orc_CHEER_01	¡Lok'tar!	
VO_HERO_01l_Female_Orc_Concede_01	¡Imposible!	
VO_HERO_01l_Female_Orc_CONGRATULATIONS_01	Te mereces tu éxito.	
VO_HERO_01l_Female_Orc_CRY_01	<llanto>	
VO_HERO_01l_Female_Orc_DAY_OF_THE_DEAD_01	El día de hoy honramos a quienes han caído.	
VO_HERO_01l_Female_Orc_Death_01	<Estertor de muerte>	
VO_HERO_01l_Female_Orc_END_OF_SEASON_01	Al final de cada temporada, cuento las fisuras en mi hacha.	
VO_HERO_01l_Female_Orc_ERROR_FULL_MINIONS_01	No hay espacio para más esbirros.	
VO_HERO_01l_Female_Orc_ERROR_GENERIC_01	No funcionará.	
VO_HERO_01l_Female_Orc_ERROR_GENERIC_02	Si tan solo pudiera.	
VO_HERO_01l_Female_Orc_ERROR_HAND_FULL_01	¡Mi mano está llena!	
VO_HERO_01l_Female_Orc_ERROR_I_ATTACKED_01	¡Ya ataqué!	
VO_HERO_01l_Female_Orc_ERROR_MINION_ATTACKED_01	Ese esbirro está exhausto.	
VO_HERO_01l_Female_Orc_ERROR_NEED_MANA_01	Necesito más maná.	
VO_HERO_01l_Female_Orc_ERROR_NEED_WEAPON_01	Necesito un arma.	
VO_HERO_01l_Female_Orc_ERROR_PLAY_01	¡No puedo hacer esa jugada!	
VO_HERO_01l_Female_Orc_ERROR_STEALTH_01	Vil esbirro. ¡Muéstrate!	
VO_HERO_01l_Female_Orc_ERROR_SUMMON_SICKNESS_01	Ese esbirro necesita un turno de descanso.	
VO_HERO_01l_Female_Orc_ERROR_TARGET_01	No puedo hacer objetivo en eso.	
VO_HERO_01l_Female_Orc_ERROR_TAUNT_01	Hay un esbirro con Provocación que debe morir.	
VO_HERO_01l_Female_Orc_FACTION_CRY_01	¡Por la Horda!	
VO_HERO_01l_Female_Orc_FIDGET_01	No estoy segura.	
VO_HERO_01l_Female_Orc_FIRE_FESTIVAL_01	¡Qué disfrutes el Festival de Fuego!	
VO_HERO_01l_Female_Orc_GG_01	Siempre recordaré esto.	
VO_HERO_01l_Female_Orc_Greetings_01	Fuerza y honor.	
VO_HERO_01l_Female_Orc_HAPPY_BIRTHDAY_01	¡Feliz cumpleaños! Yo siempre celebro afilando mis armas.	
VO_HERO_01l_Female_Orc_HAPPY_BREWFEST_01	¿Fiesta de la Cerveza? ¡Bebamos por Durotan!	
VO_HERO_01l_Female_Orc_HAPPY_EVENT_01	Me alegra celebrar ocasiones felices.	
VO_HERO_01l_Female_Orc_HAPPY_HALLOWEEN_01	¡Feliz Halloween! Guff se comió mis dulces.	
VO_HERO_01l_Female_Orc_HAPPY_HOLIDAYS_01	¡Feliz festín del Festival de Invierno!	
VO_HERO_01l_Female_Orc_HAPPY_NEW_YEAR_01	¡Feliz año nuevo!	
VO_HERO_01l_Female_Orc_HAPPY_NEW_YEAR_LUNAR_01	¡Feliz año nuevo!	
VO_HERO_01l_Female_Orc_HAPPY_NOBLEGARDEN_01	¿Jardín Noble? Yo cazaba conejos en el Valle de Alterac.	
VO_HERO_01l_Female_Orc_HUNGRY_01	Muero de hambre. ¿Tienes costillas de jabalí? Comería hasta galletas de maná.	
VO_HERO_01l_Female_Orc_INDEED_01	Sin dudas.	
VO_HERO_01l_Female_Orc_KIDS_WEEK_01	Tengo muchas ganas de conocer a los jóvenes brutos en el campo de entrenamiento.	
VO_HERO_01l_Female_Orc_KISS_01	<Sonido de beso> 	
VO_HERO_01l_Female_Orc_LAUGH_01	<Risa>	
VO_HERO_01l_Female_Orc_LowCards_01	Estoy en apuros aquí.	
VO_HERO_01l_Female_Orc_MIRROR_GREETINGS_04	¡Por los Lobo Gélido!	
VO_HERO_01l_Female_Orc_MIRROR_START_01	Siempre que todos cumplan su parte.	
VO_HERO_01l_Female_Orc_NICE_CARD_BACK_01	Me encanta el dorso.	
VO_HERO_01l_Female_Orc_NoCards_01	Mi mazo se terminó. Es ahora o nunca.	
VO_HERO_01l_Female_Orc_Oops_01	¡Oh, oh!	
VO_HERO_01l_Female_Orc_PARTY_01	¡Festejemos como en Alterac!	
VO_HERO_01l_Female_Orc_Picked_01	¡Resistimos juntos!	
VO_HERO_01l_Female_Orc_PIRATE_DAY_01	¡Io jo! Tengo cañones que disparar y grietas que tapar.	
VO_HERO_01l_Female_Orc_SALUTE_01	Como dirían mis ancestros, zug-zug.	
VO_HERO_01l_Female_Orc_Sorry_01	¡Lo siento!	
VO_HERO_01l_Female_Orc_Start_01	Es un buen día para luchar.	
VO_HERO_01l_Female_Orc_Start_Brukan_01	Te mostraré lo que he aprendido.	
VO_HERO_01l_Female_Orc_Start_Guff_01	No te contengas, Guff.	
VO_HERO_01l_Female_Orc_START_OF_SEASON_01	¡Comienza una temporada nueva! No puedo esperar a mejorar.	
VO_HERO_01l_Female_Orc_Start_Tavish_01	El clan Lobo Gélido no se rendirá.	
VO_HERO_01l_Female_Orc_Thanks_01	¡Gracias!	
VO_HERO_01l_Female_Orc_Thinking_01	A ver…	
VO_HERO_01l_Female_Orc_Thinking_02	Mmm.	
VO_HERO_01l_Female_Orc_Thinking_03	Debe haber una forma.	
VO_HERO_01l_Female_Orc_Thinking_04	¿Qué haría Garrosh?	
VO_HERO_01l_Female_Orc_Threaten_01	¡Puede que sea joven, pero te derrotaré!	
VO_HERO_01l_Female_Orc_Time_01	Debo apurarme.	
VO_HERO_01l_Female_Orc_TRIGGER_BRAWL_01	¡Pelea! ¡Pelea! ¡Pelea! ¡Pelea!	
VO_HERO_01l_Female_Orc_TRIGGER_CONDITIONING_01	¡Voy a ser la mejor!	
VO_HERO_01l_Female_Orc_TRIGGER_EXECUTE_01	¡Esto se termina!	
VO_HERO_01l_Female_Orc_TRIGGER_GOREHOWL_01	¡Oh, sí!	
VO_HERO_01l_Female_Orc_TRIGGER_GOREHOWL_02	No le digas a nadie que tomé esto.	
VO_HERO_01l_Female_Orc_TRIGGER_HEAVYPLATE_01	¡Lista!	
VO_HERO_01l_Female_Orc_TRIGGER_RAIDTHEDOCKS_01	¡Adelante, camaradas!	
VO_HERO_01l_Female_Orc_TRIGGER_RANCOR_01	¡Basta!	
VO_HERO_01l_Female_Orc_TRIGGER_SHIELDSLAM_01	¡Bong!	
VO_HERO_01l_Female_Orc_TRIGGER_WARCACHE_01	¡Genial! ¡Botín!	
VO_HERO_01l_Female_Orc_VALENTINES_01	Feliz día de San Valentín, pero mi único amor es la lucha.	
VO_HERO_01l_Female_Orc_WELCOME_01	Te doy la bienvenida.	
VO_HERO_01l_Female_Orc_Well_Played_01	Que tus armas nunca pierdan filo.	
VO_HERO_01l_Female_Orc_WOW_01	¡Imposible!	
VO_HERO_02_HAPPY_NEW_YEAR_07	¡Feliz año nuevo!	
VO_HERO_02b_Male_Troll_Concede_01	Luchas bien. ¡No tengo más que hacer aquí!	
VO_HERO_02b_Male_Troll_ERROR_FULL_MINIONS_02	Tengo demasiados esbirros.	
VO_HERO_02b_Male_Troll_ERROR_GENERIC_02	No. Eso no sucederá.	
VO_HERO_02b_Male_Troll_ERROR_HAND_FULL_01	¡Mi mano está llena!	
VO_HERO_02b_Male_Troll_ERROR_I_ATTACKED_02	Ya ataqué.	
VO_HERO_02b_Male_Troll_ERROR_MINION_ATTACKED_01	Ese esbirro ya atacó.	
VO_HERO_02b_Male_Troll_ERROR_NEED_MANA_01	Necesito maná.	
VO_HERO_02b_Male_Troll_ERROR_NEED_WEAPON_01	Necesito un arma.	
VO_HERO_02b_Male_Troll_ERROR_PLAY_01	No puedo hacer eso.	
VO_HERO_02b_Male_Troll_ERROR_STEALTH_01	¡Ese se oculta de mí!	
VO_HERO_02b_Male_Troll_ERROR_SUMMON_SICKNESS_01	Dale tiempo para prepararse.	
VO_HERO_02b_Male_Troll_ERROR_TARGET_01	Necesito un objetivo.	
VO_HERO_02b_Male_Troll_ERROR_TAUNT_02	Debo atacar a ese esbirro con Provocación.	
VO_HERO_02b_Male_Troll_FIRE_FESTIVAL_01	¡El Festival de Fuego ha llegado!	
VO_HERO_02b_Male_Troll_Greetings_01	¡Te doy la bienvenida! Ahora, haz tu reverencia.	
VO_HERO_02b_Male_Troll_HAPPY_HALLOWEEN_01	Je, je, je, je. Es Halloween.	
VO_HERO_02b_Male_Troll_HAPPY_HOLIDAYS_01	Te deseo felices fiestas.	
VO_HERO_02b_Male_Troll_HAPPY_NEW_YEAR_01	Que todos tengan un próspero año nuevo.	
VO_HERO_02b_Male_Troll_HAPPY_NEW_YEAR_LUNAR_01	Que todos tengan un próspero año nuevo.	
VO_HERO_02b_Male_Troll_HAPPY_NOBLEGARDEN_01	No lo repito más, ¡no hay huevos en mi sombrero!	
VO_HERO_02b_Male_Troll_LowCards_01	¡Me estoy quedando sin cartas!	
VO_HERO_02b_Male_Troll_MIRROR_GREETINGS_01	No me hagas perder el estilo.	
VO_HERO_02b_Male_Troll_MIRROR_START_01	Y pronto, uno de nosotros se arrodillará.	
VO_HERO_02b_Male_Troll_NoCards_01	¡No me quedan cartas!	
VO_HERO_02b_Male_Troll_Oops_02	Cosas que pasan.	
VO_HERO_02b_Male_Troll_Picked_01	Es bueno ser el rey.	
VO_HERO_02b_Male_Troll_PIRATE_DAY_01	Cuando el rey lo permite, la piratería es legal.	
VO_HERO_02b_Male_Troll_Sorry_01	Lo siento.	
VO_HERO_02b_Male_Troll_Start_02	¡Estás ante el Rey Rastakhan!	
VO_HERO_02b_Male_Troll_Thanks_01	Te lo agradezco.	
VO_HERO_02b_Male_Troll_Thinking_05	Ah... Mmmm...	
VO_HERO_02b_Male_Troll_Thinking_11	Por mi gloria...	
VO_HERO_02b_Male_Troll_Thinking_15	Los loa me hablan...	
VO_HERO_02b_Male_Troll_Threaten_04	¡Tiembla ante mí!	
VO_HERO_02b_Male_Troll_Time_01	¡Cómo te atreves a apresurarme!	
VO_HERO_02b_Male_Troll_Well_Played_01	Impresionante.	
VO_HERO_02b_Male_Troll_WOW_01	¡¿Cómo es posible?!	
VO_HERO_02f_Male_Orc_Attack_01	¡Por la gloria y el honor!	
VO_HERO_02f_Male_Orc_Greetings_01	Te oigo.	
VO_HERO_02f_Male_Orc_MIRROR_GREETINGS_01	Dije… ¿dije algo?	
VO_HERO_02f_Male_Orc_MIRROR_START_01	¡Que resuene por toda la tierra!	
VO_HERO_02f_Male_Orc_Oops_01	Eso fue un error.	
VO_HERO_02f_Male_Orc_Picked_01	El fuego fue el primero en responder a mi llamado.	
VO_HERO_02f_Male_Orc_Start_01	¡Traigo la furia de los elementos!	
VO_HERO_02f_Male_Orc_Thanks_01	Te doy las gracias	
VO_HERO_02f_Male_Orc_Threaten_01	Tú te lo buscaste.	
VO_HERO_02f_Male_Orc_Well_Played_01	Me honras.	
VO_HERO_02f_Male_Orc_Wow_01	¡Estoy asombrado!	
VO_HERO_02g_Male_Orc_Attack_01	¡Basta!	
VO_HERO_02g_Male_Orc_Greetings_01	Te veo, adalid.	
VO_HERO_02g_Male_Orc_MIRROR_GREETINGS_01	Claro que sí.	
VO_HERO_02g_Male_Orc_MIRROR_START_01	Y a ti también.	
VO_HERO_02g_Male_Orc_Oops_01	¿Qué fue eso?	
VO_HERO_02g_Male_Orc_Picked_01	¿Dónde está el enemigo?	
VO_HERO_02g_Male_Orc_Start_01	Te llegó la hora.	
VO_HERO_02g_Male_Orc_Thanks_01	Has demostrado una amabilidad enorme.	
VO_HERO_02g_Male_Orc_Threaten_01	Me criaron humanos, pero no soy ningún necio.	
VO_HERO_02g_Male_Orc_Well_Played_01	Tu fuerza es admirable.	
VO_HERO_02g_Male_Orc_Wow_01	Un espectáculo asombroso.	
VO_HERO_02h_Male_Orc_Attack_01	¡Tiembla de miedo!	
VO_HERO_02h_Male_Orc_Greetings_01	Los espíritus están inquietos.	
VO_HERO_02h_Male_Orc_MIRROR_GREETINGS_01	Y yo también.	
VO_HERO_02h_Male_Orc_MIRROR_START_01	¡Nuestro clan nunca ha flaqueado!	
VO_HERO_02h_Male_Orc_Oops_01	Un grave error.	
VO_HERO_02h_Male_Orc_Picked_01	Defenderé el Valle a toda costa.	
VO_HERO_02h_Male_Orc_Start_01	¡Enfréntate al poder de los Lobo Gélido!	
VO_HERO_02h_Male_Orc_Thanks_01	Los Lobo Gélido te agradecen.	
VO_HERO_02h_Male_Orc_Threaten_01	La tierra se apoderará de ti.	
VO_HERO_02h_Male_Orc_Well_Played_01	Puedo ver tu valor.	
VO_HERO_02h_Male_Orc_Wow_01	¡Benditos ancestros!	
VO_HERO_02i_Male_Orc_Attack_01	¡Poder de la Horda!	
VO_HERO_02i_Male_Orc_Greetings_01	Throm-ka.	
VO_HERO_02i_Male_Orc_MIRROR_GREETINGS_01	Lok-regar ogull.	
VO_HERO_02i_Male_Orc_MIRROR_START_01	No si es MI aliada…	
VO_HERO_02i_Male_Orc_Oops_01	¿Un error de cálculo?	
VO_HERO_02i_Male_Orc_Picked_01	Hoy cabalgamos hacia la victoria.	
VO_HERO_02i_Male_Orc_Start_01	¡La tierra misma es mi aliada!	
VO_HERO_02i_Male_Orc_Thanks_01	El jefe de guerra te sonríe.	
VO_HERO_02i_Male_Orc_Threaten_01	Soy la furia de la Horda.	
VO_HERO_02i_Male_Orc_Well_Played_01	Luchas con determinación.	
VO_HERO_02i_Male_Orc_Wow_01	¡Por los espíritus!	
VO_HERO_02j_Male_Orc_Attack_01	¡Lok-Narash!	
VO_HERO_02j_Male_Orc_Greetings_01	Fuerza y honor.	
VO_HERO_02j_Male_Orc_MIRROR_GREETINGS_01	Siempre nos guiarán.	
VO_HERO_02j_Male_Orc_MIRROR_START_01	Un propósito noble.	
VO_HERO_02j_Male_Orc_Oops_01	Mmm… un error.	
VO_HERO_02j_Male_Orc_Picked_01	He encontrado a mi pueblo.	
VO_HERO_02j_Male_Orc_Start_01	¡Liberaré a la Horda!	
VO_HERO_02j_Male_Orc_Thanks_01	Estoy agradecido.	
VO_HERO_02j_Male_Orc_Threaten_01	¿Te enfrentarías al poder de la Horda?	
VO_HERO_02j_Male_Orc_Well_Played_01	Eres un oponente digno.	
VO_HERO_02j_Male_Orc_Wow_01	¡Por los elementos!	
VO_HERO_02k_Male_Orc_Attack_01	¡Esto termina ahora!	
VO_HERO_02k_Male_Orc_Greetings_01	Gloria a la Horda.	
VO_HERO_02k_Male_Orc_MIRROR_GREETINGS_01	Y que siempre sea noble.	
VO_HERO_02k_Male_Orc_MIRROR_START_01	¡No le temo! ¡La domino!	
VO_HERO_02k_Male_Orc_Oops_01	Qué lástima…	
VO_HERO_02k_Male_Orc_Picked_01	Con el tiempo, toda tormenta acaba.	
VO_HERO_02k_Male_Orc_Start_01	¡Teme a la tormenta que se avecina!	
VO_HERO_02k_Male_Orc_Thanks_01	Que te bendigan los ancestros.	
VO_HERO_02k_Male_Orc_Threaten_01	¡Las tormentas devorarán a mis enemigos!	
VO_HERO_02k_Male_Orc_Well_Played_01	Luchas bien, camarada.	
VO_HERO_02k_Male_Orc_Wow_01	¡Qué vista tan espléndida!	
VO_HERO_03_Female_BloodElf_Emote_01	Yo escribo mi propio destino.	
VO_HERO_03_Female_BloodElf_Emote_02	¡Quédate en las sombras!	
VO_HERO_03_Female_BloodElf_Emote_03	A mí nadie se me escapa.	
VO_HERO_03_Female_BloodElf_Emote_04	¿Qué afilaste más, tu mente o tus cuchillas?	
VO_HERO_03_Female_BloodElf_Emote_05	¿Quién? ¿Yo? ¿Sospechosa?	
VO_HERO_03_Female_BloodElf_Emote_06	Lo siento, estoy hecha una pícara.	
VO_HERO_03_Female_BloodElf_Emote_07	Nada para ver aquí...	
VO_HERO_03_Female_BloodElf_Emote_08	¿Quieres agrandar tu combo?	
VO_HERO_03_Female_BloodElf_Emote_09	Sin rastros.	
VO_HERO_03_Female_BloodElf_Emote_10	Mi lealtad es cosa mía.	
VO_HERO_03_Female_BloodElf_Emote_11	Si fuera tú, no me metería conmigo.	
VO_HERO_03_Female_BloodElf_Emote_12	Siempre saco lo mejor de ti.	
VO_HERO_03_HAPPY_NEW_YEAR_06	¡Feliz año nuevo!	
VO_HERO_03a_Attack_15	¡La justicia es MÍA!	
VO_HERO_03a_CONCEDE_06	Has jugado muy bien. Me rindo.	
VO_HERO_03a_ERROR_FULL_MINIONS_25	¡Tengo demasiados esbirros!	
VO_HERO_03a_ERROR_GENERIC_30	No puedo hacer eso.	
VO_HERO_03a_ERROR_HAND_FULL_24	¡Mi mano está llena!	
VO_HERO_03a_ERROR_I_ATTACKED_22	Ya he atacado.	
VO_HERO_03a_ERROR_JUST_PLAYED_23	Ese esbirro necesita un turno de descanso.	
VO_HERO_03a_ERROR_MINION_ATTACKED_21	Ese esbirro ya atacó.	
VO_HERO_03a_ERROR_NEED_MANA_20	No tengo suficiente maná.	
VO_HERO_03a_ERROR_NEED_WEAPON_19	Necesito un arma.	
VO_HERO_03a_ERROR_PLAY_27	No puedo hacer esa jugada.	
VO_HERO_03a_ERROR_STEALTH_26	No puedo hacer objetivo en esbirros en Sigilo.	
VO_HERO_03a_ERROR_TARGET_28	Ese objetivo no es válido.	
VO_HERO_03a_ERROR_TAUNT_29	Hay un esbirro con Provocación en el camino.	
VO_Hero_03a_Female_NightElf_Start_Illidan_01	Encontré mi presa.	
VO_HERO_03a_FIRE_FESTIVAL	Feliz festival del Solsticio de Verano.	
VO_HERO_03a_GREETINGS_03	Saludos.	
VO_HERO_03a_GREETINGS_RESPONSE	Qué agradable sorpresa. ¡Hola!	
VO_HERO_03a_HALLOWS_END	Feliz Halloween.	
VO_HERO_03a_HAPPY_HOLIDAYS_52	¡Feliz festín del Festival de Invierno!	
VO_HERO_03a_HAPPY_NEW_YEAR_53	¡Feliz año nuevo!	
VO_HERO_03a_HAPPY_NEW_YEAR_LUNAR_16	¡Feliz año nuevo!	
VO_HERO_03a_LOW_CARDS_17	Casi no me quedan cartas.	
VO_HERO_03a_MIRROR_GREETINGS_04	Qué agradable sorpresa. ¡Hola!	
VO_HERO_03a_MIRROR_START_02	¡Soy la mano de hierro de la justicia!	
VO_HERO_03a_NO_CARDS_18	¡No me quedan cartas!	
VO_HERO_03a_NOBLEGARDEN	¡Feliz Jardín Noble! ¿Dónde están los huevos?	
VO_HERO_03a_OOPS_08	Solo un error táctico.	
VO_HERO_03a_PICKED_11	¡Este es el momento!	
VO_HERO_03a_PIRATE_DAY	¡Arr, camarada!	
VO_HERO_03a_SORRY_10	Lo siento.	
VO_HERO_03a_START_01	¡Nadie escapa a mi furia!	
VO_HERO_03a_THANKS_09	Gracias.	
VO_HERO_03a_THINK1_12	Mmm...	
VO_HERO_03a_THINK2_13	Me pregunto...	
VO_HERO_03a_THINK3_14	Déjame pensar...	
VO_HERO_03a_THREATEN_05	¡Despiertas mi cólera!	
VO_HERO_03a_TIMER_16	¡Rápido!	
VO_HERO_03a_WELL_PLAYED_07	Buena jugada.	
VO_HERO_03a_WOW_35	Alucinante.	
VO_HERO_03d_Female_BloodElf_Greetings_01	¿Vienes a conversar?	
VO_HERO_03d_Female_BloodElf_MIRROR_GREETINGS_01	Me conoces muy bien.	
VO_HERO_03d_Female_BloodElf_MIRROR_START_01	Yo también.	
VO_HERO_03d_Female_BloodElf_Thanks_01	Te lo agradezco.	
VO_HERO_03d_Female_BloodElf_Wow_01	¡Encantador!	
VO_HERO_03e_Female_BloodElf_Attack_01	¡Ja!	
VO_HERO_03e_Female_BloodElf_Greetings_01	¡Hola!	
VO_HERO_03e_Female_BloodElf_IntroGarrosh_01	¡Esto será divertido!	
VO_HERO_03e_Female_BloodElf_MIRROR_GREETINGS_01	Ese es un rostro familiar.	
VO_HERO_03e_Female_BloodElf_MIRROR_START_01	Se necesitan dos para bailar, ¿no?	
VO_HERO_03e_Female_BloodElf_Oops_01	¿Un error?	
VO_HERO_03e_Female_BloodElf_Start_01	¿Me concedes esta pieza?	
VO_HERO_03e_Female_BloodElf_Thanks_01	Gracias, de verdad.	
VO_HERO_03e_Female_BloodElf_Threaten_01	Hasta las flores tienen espinas.	
VO_HERO_03e_Female_BloodElf_Well_Played_01	Bien hecho.	
VO_HERO_03e_Female_BloodElf_Wow_01	Interesante.	
VO_HERO_03f_Female_BloodElf_Attack_01	¡El frío y filoso acero!	
VO_HERO_03f_Female_BloodElf_Greetings_01	Es un buen día para pelear.	
VO_HERO_03f_Female_BloodElf_MIRROR_GREETINGS_01	¡Pues claro!	
VO_HERO_03f_Female_BloodElf_MIRROR_START_01	Imposible olvidarlas.	
VO_HERO_03f_Female_BloodElf_Oops_01	¡Ups!	
VO_HERO_03f_Female_BloodElf_Start_01	¡Recuerda mis cuchillas!	
VO_HERO_03f_Female_BloodElf_Thanks_01	Estoy en deuda.	
VO_HERO_03f_Female_BloodElf_Threaten_01	Esto será fácil y rápido.	
VO_HERO_03f_Female_BloodElf_Well_Played_01	Tienes algo de talento...	
VO_HERO_03f_Female_BloodElf_Wow_01	¡Es... hermoso!	
VO_HERO_03g_Female_BloodElf_Picked_01	No te arrepentirás.	
VO_HERO_04_HAPPY_NEW_YEAR_15	¡Feliz año nuevo, adalid!	
VO_HERO_04b_Male_Human_START_Illidan_01	Al parecer nuestro poder es parejo.	
VO_HERO_04b_Male_Human_START_Jaina_01	Lo siento, Jaina.	
VO_HERO_04b_Male_Human_START_Sylvanas_01	Hay un camino oscuro por delante, Brisaveloz.	
VO_HERO_04b_Male_Human_START_Uther_01	¡Lucharé con fuerza, como me enseñaste!	
VO_HERO_04e_Male_Human_Attack_01	¡Por Lordaeron!	
VO_HERO_04e_Male_Human_Greetings_01	Te saludo.	
VO_HERO_04e_Male_Human_MIRROR_GREETINGS_01	Que la Luz te bendiga.	
VO_HERO_04e_Male_Human_MIRROR_START_01	Pero no tanto como yo.	
VO_HERO_04e_Male_Human_Oops_01	Un error...	
VO_HERO_04e_Male_Human_PICKED_01	¡Por el legado de Lothar!	
VO_HERO_04e_Male_Human_Start_01	¡Llevaré honor a la Mano de Plata!	
VO_HERO_04e_Male_Human_Thanks_01	Te doy las gracias.	
VO_HERO_04e_Male_Human_Threaten_01	Tu vida ha llegado a su fin.	
VO_HERO_04e_Male_Human_Well_Played_01	Eres impresionante.	
VO_HERO_04e_Male_Human_Wow_01	¡Maravilloso!	
VO_HERO_04f_Male_Human_Attack_01	¡Silencio, escoria!	
VO_HERO_04f_Male_Human_Greetings_01	¡Hoy lucho con mucho orgullo!	
VO_HERO_04f_Male_Human_MIRROR_GREETINGS_01	¡Oponentes indignos, no los escucho!	
VO_HERO_04f_Male_Human_MIRROR_START_01	¡JA, JA! ¡JA!	
VO_HERO_04f_Male_Human_Oops_01	¿Un error? ¡Qué horror!	
VO_HERO_04f_Male_Human_Picked_01	¡JA, JA! ¡JA!	
VO_HERO_04f_Male_Human_Start_01	¡JAJAJAJAJAAA!	
VO_HERO_04f_Male_Human_Thanks_01	Te agradezco, no lo merezco.	
VO_HERO_04f_Male_Human_Threaten_01	No saldrás con vida, hoy es mi día…	
VO_HERO_04f_Male_Human_Well_Played_01	¡Buena jugada! Tan bien pensada.	
VO_HERO_04f_Male_Human_Wow_01	¡Fascinante, qué galante!	
VO_HERO_04g_Male_Human_Attack_01	¡Debes obedecer!	
VO_HERO_04g_Male_Human_Greetings_01	Explícate ahora.	
VO_HERO_04g_Male_Human_MIRROR_GREETINGS_01	Me tomará un tiempo…	
VO_HERO_04g_Male_Human_MIRROR_START_01	¡Objeción!	
VO_HERO_04g_Male_Human_Oops_01	Detesto los errores.	
VO_HERO_04g_Male_Human_Start_01	¡Yo impondré orden!	
VO_HERO_04g_Male_Human_Thanks_01	Te has ganado mi gratitud.	
VO_HERO_04g_Male_Human_Threaten_01	Quienes huyen de la Luz vivirán por siempre en la oscuridad.	
VO_HERO_04g_Male_Human_Well_Played_01	Bien hecho.	
VO_HERO_04g_Male_Human_Wow_01	¡Espectacular!	
VO_HERO_04h_Male_Human_Attack_01	¡Por el valor!	
VO_HERO_04h_Male_Human_Greetings_01	Ve con honor, colega.	
VO_HERO_04h_Male_Human_MIRROR_GREETINGS_01	El honor es el único camino.	
VO_HERO_04h_Male_Human_MIRROR_START_01	Es la única forma de avanzar.	
VO_HERO_04h_Male_Human_Oops_01	¡Qué ridículo!	
VO_HERO_04h_Male_Human_Picked_01	¡Con honor!	
VO_HERO_04h_Male_Human_Start_01	¡La justicia decidirá!	
VO_HERO_04h_Male_Human_Thanks_01	Estoy muy agradecido.	
VO_HERO_04h_Male_Human_Threaten_01	Lucho por causas justas. ¿Puedes decir lo mismo?	
VO_HERO_04h_Male_Human_Well_Played_01	Luchaste con dignidad.	
VO_HERO_04h_Male_Human_Wow_01	¡Glorioso!	
VO_HERO_05_FACTION_CRY_24	¡Por la Horda!	
VO_HERO_05_FIDGET_09	El tiempo vuela.	
VO_HERO_05_HAPPY_NEW_YEAR_15	¡Feliz año nuevo!	
VO_HERO_05_INDEED_05	Sin dudas.	
VO_HERO_05_SALUTE_07	Impresionante.	
VO_HERO_05b_Female_Undead_Concede_01	Ya he soportado demasiado...	
VO_HERO_05b_Female_Undead_ERROR_FULL_MINIONS_02	Ya tengo demasiados esbirros.	
VO_HERO_05b_Female_Undead_ERROR_GENERIC_02	No puedo hacer eso. 	
VO_HERO_05b_Female_Undead_ERROR_HAND_FULL_01	¡Mi mano está llena!	
VO_HERO_05b_Female_Undead_ERROR_I_ATTACKED_01	Ya ataqué.	
VO_HERO_05b_Female_Undead_ERROR_MINION_ATTACKED_01	Ese esbirro ya atacó.	
VO_HERO_05b_Female_Undead_ERROR_NEED_MANA_01	Necesito maná.	
VO_HERO_05b_Female_Undead_ERROR_NEED_WEAPON_01	Necesito un arma.	
VO_HERO_05b_Female_Undead_ERROR_PLAY_01	No puedo hacer esa jugada.	
VO_HERO_05b_Female_Undead_ERROR_STEALTH_01	Ese esbirro es sigiloso.	
VO_HERO_05b_Female_Undead_ERROR_SUMMON_SICKNESS_01	Ese esbirro aún no puede luchar.	
VO_HERO_05b_Female_Undead_ERROR_TARGET_01	Necesito un objetivo.	
VO_HERO_05b_Female_Undead_ERROR_TAUNT_01	Hay un esbirro con Provocación en el camino.	
VO_HERO_05b_Female_Undead_FIRE_FESTIVAL_01	¡Que arda!	
VO_HERO_05b_Female_Undead_Greetings_01	Saludos. Espero que no me hagas perder el tiempo.	
VO_HERO_05b_Female_Undead_HAPPY_HALLOWEEN_01	¡Halloween! Una noche venerada.	
VO_HERO_05b_Female_Undead_HAPPY_HOLIDAYS_01	Feliz festividad.	
VO_HERO_05b_Female_Undead_HAPPY_NEW_YEAR_01	Feliz año nuevo.	
VO_HERO_05b_Female_Undead_HAPPY_NEW_YEAR_LUNAR_01	Feliz año nuevo.	
VO_HERO_05b_Female_Undead_HAPPY_NOBLEGARDEN_01	Feliz Jardín Noble.	
VO_HERO_05b_Female_Undead_LowCards_01	Tengo pocas cartas.	
VO_HERO_05b_Female_Undead_MIRROR_GREETINGS_01	... ¿Cuántas hermanas Brisaveloz somos? Ya perdí la cuenta.	
VO_HERO_05b_Female_Undead_MIRROR_START_01	Victoria para... MÍ.	
VO_HERO_05b_Female_Undead_NoCards_01	¡No me quedan cartas!	
VO_HERO_05b_Female_Undead_Oops_02	Un error.	
VO_HERO_05b_Female_Undead_Picked_01	Que mi puntería sea infalible...	
VO_HERO_05b_Female_Undead_PIRATE_DAY_02	Arr, ratas de santina... o como sea.	
VO_HERO_05b_Female_Undead_Sorry_01	Lo siento.	
VO_HERO_05b_Female_Undead_Start_01	¡Victoria para los Renegados!	
VO_HERO_05b_Female_Undead_Thanks_02	Te doy las gracias.	
VO_HERO_05b_Female_Undead_Thinking_02	La venganza está cerca...	
VO_HERO_05b_Female_Undead_Thinking_03	...que no quede nadie con vida...	
VO_HERO_05b_Female_Undead_Thinking_04	La victoria está a mi alcance...	
VO_HERO_05b_Female_Undead_Threaten_02	Tú también sufrirás.	
VO_HERO_05b_Female_Undead_Time_01	¡No tengo tiempo para juegos!	
VO_HERO_05b_Female_Undead_Well_Played_01	Buena jugada.	
VO_HERO_05b_Female_Undead_WOW_01	¡Muy astuto!	
VO_HERO_05e_Male_OrcOgre_Attack_01	Mi presa se acerca.	
VO_HERO_05e_Male_OrcOgre_Greetings_01	Nuestros caminos se cruzan.	
VO_HERO_05e_Male_OrcOgre_MIRROR_GREETINGS_01	Pero, ¿a dónde llevan?	
VO_HERO_05e_Male_OrcOgre_MIRROR_START_01	Naturalmente.	
VO_HERO_05e_Male_OrcOgre_Oops_01	Todos erramos a veces.	
VO_HERO_05e_Male_OrcOgre_Picked_01	Encontraremos la manera de avanzar.	
VO_HERO_05e_Male_OrcOgre_Start_01	¡Actúo por instinto!	
VO_HERO_05e_Male_OrcOgre_Thanks_01	Te lo agradezco.	
VO_HERO_05e_Male_OrcOgre_Threaten_01	Tus restos alimentarán a las bestias...	
VO_HERO_05e_Male_OrcOgre_Well_Played_01	Cazas bien.	
VO_HERO_05e_Male_OrcOgre_Wow_01	¡Espectacular!	
VO_HERO_05f_Male_OrcOgre_Attack_01	¡Je, justo en la cara!	
VO_HERO_05f_Male_OrcOgre_Greetings_01	¡Lok'tar ogar!	
VO_HERO_05f_Male_OrcOgre_MIRROR_GREETINGS_01	¡Sí, victoria o muerte!	
VO_HERO_05f_Male_OrcOgre_MIRROR_START_01	¡Llama a todo lo que es salvaje y libre!	
VO_HERO_05f_Male_OrcOgre_Oops_01	Fue un error.	
VO_HERO_05f_Male_OrcOgre_Picked_01	Dame un desafío y lo superaré.	
VO_HERO_05f_Male_OrcOgre_Start_01	Oigo el rugido de la naturaleza.	
VO_HERO_05f_Male_OrcOgre_Thanks_01	Acepta mi humilde agradecimiento.	
VO_HERO_05f_Male_OrcOgre_Threaten_01	Te cazaré.	
VO_HERO_05f_Male_OrcOgre_Well_Played_01	Siempre das en el blanco.	
VO_HERO_05f_Male_OrcOgre_Wow_01	¡Increíble!	
VO_HERO_05g_Male_OrcOgre_Attack_01	¡Por los Mok'nathal!	
VO_HERO_05g_Male_OrcOgre_Greetings_01	Mi vista está fija en ti.	
VO_HERO_05g_Male_OrcOgre_MIRROR_GREETINGS_01	Disfruta la vista.	
VO_HERO_05g_Male_OrcOgre_MIRROR_START_01	¡O diente y cola!	
VO_HERO_05g_Male_OrcOgre_Oops_01	Un error desafortunado.	
VO_HERO_05g_Male_OrcOgre_Picked_01	Luchar está en nuestra naturaleza.	
VO_HERO_05g_Male_OrcOgre_Start_01	¡Por la garra y el colmillo!	
VO_HERO_05g_Male_OrcOgre_Thanks_01	La naturaleza te agradece.	
VO_HERO_05g_Male_OrcOgre_Threaten_01	Te daré un final apropiado.	
VO_HERO_05g_Male_OrcOgre_Well_Played_01	Tus acciones hablan bien de ti.	
VO_HERO_05g_Male_OrcOgre_Wow_01	¡Impresionante!	
VO_HERO_06_HAPPY_NEW_YEAR_15	¡Feliz año nuevo!	
VO_Hero_06_Male_NightElf_Start_Illidan_01	Debes afrontar las consecuencias de tus acciones.	
VO_HERO_06e_Male_NightElf_Attack_01	¡Enemigos de la naturaleza, teman!	
VO_HERO_06e_Male_NightElf_Greetings_01	Te escucho.	
VO_HERO_06e_Male_NightElf_MIRROR_GREETINGS_01	Eres bueno en eso.	
VO_HERO_06e_Male_NightElf_MIRROR_START_01	¡Solo puede ayudar a uno de nosotros!	
VO_HERO_06e_Male_NightElf_Oops_01	Un pequeño error.	
VO_HERO_06e_Male_NightElf_Picked_01	Yo protejo la naturaleza.	
VO_HERO_06e_Male_NightElf_Start_01	Cenarius me guía a la victoria.	
VO_HERO_06e_Male_NightElf_Thanks_01	No sé cómo agradecerte.	
VO_HERO_06e_Male_NightElf_Threaten_01	Nadie es más veloz que los vientos de guerra.	
VO_HERO_06e_Male_NightElf_Well_Played_01	Enorgullécete de tus habilidades.	
VO_HERO_06e_Male_NightElf_Wow_01	¡Por Elune!	
VO_Hero_06e_Male_Tauren_Attack_01	¡La naturaleza resiste!	
VO_Hero_06e_Male_Tauren_Concede_01	Me rindo ante ti.	
VO_Hero_06e_Male_Tauren_ERROR_FULL_MINIONS_01	Tengo demasiados esbirros.	
VO_Hero_06e_Male_Tauren_ERROR_GENERIC_01	No puedo.	
VO_Hero_06e_Male_Tauren_ERROR_GENERIC_02	Imposible.	
VO_Hero_06e_Male_Tauren_ERROR_HAND_FULL_01	¡Mi mano está llena!	
VO_Hero_06e_Male_Tauren_ERROR_I_ATTACKED_01	No puedo volver a atacar.	
VO_Hero_06e_Male_Tauren_ERROR_MINION_ATTACKED_01	Ese esbirro ya atacó.	
VO_Hero_06e_Male_Tauren_ERROR_NEED_MANA_01	No tengo suficiente maná.	
VO_Hero_06e_Male_Tauren_ERROR_NEED_WEAPON_01	¡Necesito un arma!	
VO_Hero_06e_Male_Tauren_ERROR_PLAY_01	No está en mi poder.	
VO_Hero_06e_Male_Tauren_ERROR_STEALTH_01	Ese esbirro se oculta de mí.	
VO_Hero_06e_Male_Tauren_ERROR_SUMMON_SICKNESS_01	Aún no está listo.	
VO_Hero_06e_Male_Tauren_ERROR_TARGET_01	Está fuera de mi alcance.	
VO_Hero_06e_Male_Tauren_ERROR_TAUNT_01	Un enemigo me está provocando.	
VO_Hero_06e_Male_Tauren_FIRE_FESTIVAL_01	El fuego es una fuente de renovación y cambio para el bosque... ¡y para nosotros!	
VO_Hero_06e_Male_Tauren_Greetings_01	Que los vientos te guíen.	
VO_Hero_06e_Male_Tauren_HAPPY_HALLOWEEN_01	¡Cuidado! Los espíritus rondan nuestros pasillos este Halloween...	
VO_Hero_06e_Male_Tauren_HAPPY_HOLIDAYS_01	¡Es momento de que todo sea festivo y brillante!	
VO_Hero_06e_Male_Tauren_HAPPY_NEW_YEAR_01	¡Feliz año nuevo!	
VO_Hero_06e_Male_Tauren_HAPPY_NEW_YEAR_LUNAR_01	¡Feliz año nuevo!	
VO_Hero_06e_Male_Tauren_HAPPY_NOBLEGARDEN_01	Que la naturaleza bendiga a tu Jardín Noble este año.	
VO_Hero_06e_Male_Tauren_LowCards_01	Me quedan pocas cartas.	
VO_Hero_06e_Male_Tauren_MIRROR_GREETINGS_01	¡Y a ti también!	
VO_Hero_06e_Male_Tauren_MIRROR_START_01	Es cierto. Estamos equilibrados.	
VO_Hero_06e_Male_Tauren_NoCards_01	¡No me quedan cartas!	
VO_Hero_06e_Male_Tauren_Oops_01	¿Un error?	
VO_Hero_06e_Male_Tauren_Picked_01	¡Sirvo a mi tierra!	
VO_Hero_06e_Male_Tauren_PIRATE_DAY_01	¡Hamuul Doblón de Runa a su servicio, piratas!	
VO_Hero_06e_Male_Tauren_Sorry_01	Lo siento.	
VO_Hero_06e_Male_Tauren_Start_01	La naturaleza siempre busca el equilibrio.	
VO_Hero_06e_Male_Tauren_Start_Malfurion_01	Me agrada verte, Shan'do.	
VO_Hero_06e_Male_Tauren_Thanks_01	Te lo agradezco.	
VO_Hero_06e_Male_Tauren_Thinking_01	Mmm...	
VO_Hero_06e_Male_Tauren_Thinking_02	Interesante...	
VO_Hero_06e_Male_Tauren_Thinking_03	Déjame pensar...	
VO_Hero_06e_Male_Tauren_Threaten_02	¡Aprende a templar tu fuerza con sabiduría!	
VO_Hero_06e_Male_Tauren_Time_01	¡El tiempo vuela!	
VO_Hero_06e_Male_Tauren_TRIGGER_FORCE_OF_NATURE_01	Aprendí de los mejores...	
VO_Hero_06e_Male_Tauren_TRIGGER_GIFT_OF_THE_WILD_01	¡Sean fuertes, amigos!	
VO_Hero_06e_Male_Tauren_TRIGGER_LUNAR_VISIONS_01	Comulga con la naturaleza...	
VO_Hero_06e_Male_Tauren_TRIGGER_MOONGLADE_PORTAL_01	¡La sabiduría de Claro de la Luna!	
VO_Hero_06e_Male_Tauren_TRIGGER_MULCH_01	Todo regresa a la tierra…	
VO_Hero_06e_Male_Tauren_TRIGGER_WISPERING_WOODS_01	El bosque me habla...	
VO_Hero_06e_Male_Tauren_Well_Played_01	Bien hecho.	
VO_Hero_06e_Male_Tauren_WOW_01	¡Increíble!	
VO_HERO_06g_Male_NightElf_Attack_01	Anu'dorini Talah!	
VO_HERO_06g_Male_NightElf_Greetings_01	Ishnu'alah.	
VO_HERO_06g_Male_NightElf_MIRROR_GREETINGS_01	Elune-Adore.	
VO_HERO_06g_Male_NightElf_MIRROR_START_01	Siempre lo siento en mi interior.	
VO_HERO_06g_Male_NightElf_Oops_01	Un error inocente.	
VO_HERO_06g_Male_NightElf_Picked_01	Si la necesidad es extrema, cuenten conmigo	
VO_HERO_06g_Male_NightElf_Start_01	¡Siente el poder del mundo salvaje!	
VO_HERO_06g_Male_NightElf_Thanks_01	Shaha lor'ma.	
VO_HERO_06g_Male_NightElf_Threaten_01	Todo lo que florece puede marchitarse.	
VO_HERO_06g_Male_NightElf_Well_Played_01	Muy sabio de tu parte.	
VO_HERO_06g_Male_NightElf_Wow_01	¡Magnífico!	
VO_HERO_07_HAPPY_NEW_YEAR_15	¡Feliz año nuevo!	
VO_Hero_07d_Male_OldGod_Attack_02	<Estertor de ataque>	
VO_Hero_07d_Male_OldGod_Concede_01	Vuelvo… al… sueño…	
VO_Hero_07d_Male_OldGod_Death_02	Es el fin…	
VO_Hero_07d_Male_OldGod_ERROR_FULL_MINIONS_02	Hay demasiados.	
VO_Hero_07d_Male_OldGod_ERROR_GENERIC_04	No puede hacerse.	
VO_Hero_07d_Male_OldGod_ERROR_HAND_FULL_01	Mi mano está llena.	
VO_Hero_07d_Male_OldGod_ERROR_I_ATTACKED_01	No puedo atacar.	
VO_Hero_07d_Male_OldGod_ERROR_MINION_ATTACKED_01	Ese esbirro está agotado.	
VO_Hero_07d_Male_OldGod_ERROR_NEED_MANA_02	No tengo suficiente maná.	
VO_Hero_07d_Male_OldGod_ERROR_NEED_WEAPON_01	Necesito un arma.	
VO_Hero_07d_Male_OldGod_ERROR_PLAY_01	No puedo hacer esa jugada.	
VO_Hero_07d_Male_OldGod_ERROR_STEALTH_01	Ese esbirro tiene sigilo.	
VO_Hero_07d_Male_OldGod_ERROR_STEALTH_02	No puedo ver lo que está oculto.	
VO_Hero_07d_Male_OldGod_ERROR_SUMMON_SICKNESS_02	Dale tiempo para que se prepare.	
VO_Hero_07d_Male_OldGod_ERROR_TARGET_01	Necesito un objetivo.	
VO_Hero_07d_Male_OldGod_ERROR_TAUNT_01	Debo atacar al esbirro con provocación.	
VO_Hero_07d_Male_OldGod_FIRE_FESTIVAL_01	El fuego consume, pero las llamas purifican.	
VO_Hero_07d_Male_OldGod_Greetings_01	Bienvenido, mi devoto elegido.	
VO_Hero_07d_Male_OldGod_HAPPY_BIRTHDAY_01	Las velas bailan en un pastel glaseado. ¡Pide un deseo!	
VO_Hero_07d_Male_OldGod_HAPPY_BIRTHDAY_02	Feliz cumpleaños. A… ti.	
VO_Hero_07d_Male_OldGod_HAPPY_HALLOWEEN_01	En Halloween, el velo cae…	
VO_Hero_07d_Male_OldGod_HAPPY_HOLIDAYS_01	Ha llegado tu festividad.	
VO_Hero_07d_Male_OldGod_HAPPY_NEW_YEAR_01	Otro año, el amanecer del fin.	
VO_Hero_07d_Male_OldGod_HAPPY_NEW_YEAR_LUNAR_01	Otro año, el amanecer del fin.	
VO_Hero_07d_Male_OldGod_HAPPY_NOBLEGARDEN_01	Montones de huevos ocultos en las profundidades…	
VO_Hero_07d_Male_OldGod_LowCards_01	El fin de mi mazo está cerca…	
VO_Hero_07d_Male_OldGod_MIRROR_GREETINGS_01	Soñamos juntos. Pero solo uno despertará.	
VO_Hero_07d_Male_OldGod_MIRROR_START_01	Y la ciudad durmiente despertará.	
VO_Hero_07d_Male_OldGod_NoCards_01	¡Mi mazo está acabado!	
VO_Hero_07d_Male_OldGod_Oops_02	Con un susurro, llega el caos.	
VO_Hero_07d_Male_OldGod_Picked_01	Puedo salvarte de lo que se avecina.	
VO_Hero_07d_Male_OldGod_PIRATE_DAY_01	Yo… jo… jo….	
VO_Hero_07d_Male_OldGod_Sorry_01	Expiaré esa equivocación.	
VO_Hero_07d_Male_OldGod_Start_01	¡Todos los ojos se abrirán!	
VO_Hero_07d_Male_OldGod_START_ARTHAS_01	Tu futuro se revela, príncipe. Tu corona abrirá el camino.	
VO_Hero_07d_Male_OldGod_START_AZSHARA_01	Vanidad. Pura vanidad.	
VO_Hero_07d_Male_OldGod_START_DEATHWING_01	Rompemundos. Oíste mi llamado en las profundidades.	
VO_Hero_07d_Male_OldGod_START_DRUID_01	Siento tus raíces en la profundidad, despertando a la pesadilla.	
VO_Hero_07d_Male_OldGod_START_GARROSH_01	Nuestros dones no son tus armas, jefe de guerra.	
VO_Hero_07d_Male_OldGod_START_LADYPRESTOR_01	Te veo como lo que realmente eres.	
VO_Hero_07d_Male_OldGod_START_LADYVASHJ_01	Los dones que he otorgado a tu pueblo, a tu reina...	
VO_Hero_07d_Male_OldGod_START_LAZUL_01	Llevo mucho tiempo susurrándote…	
VO_Hero_07d_Male_OldGod_START_MORGL_01	Acompáñame en las profundidades, pequeño.	
VO_Hero_07d_Male_OldGod_START_NEMSY_01	Tú también has oído el llamado de las profundidades.	
VO_Hero_07d_Male_OldGod_START_SYLVANAS_01	Veo las maquinaciones de tu corazón oscuro.	
VO_Hero_07d_Male_OldGod_START_THUNDERKING_01	Sirviente de los titanes, ha llegado tu hora.	
VO_Hero_07d_Male_OldGod_Thanks_01	Gracias.	
VO_Hero_07d_Male_OldGod_Thinking_01	Mmm…	
VO_Hero_07d_Male_OldGod_Thinking_02	… verdades infinitas…	
VO_Hero_07d_Male_OldGod_Thinking_04	… el velo se desvanece…	
VO_Hero_07d_Male_OldGod_Threaten_02	Sueña conmigo…	
VO_Hero_07d_Male_OldGod_Time_01	¡La hora se aproxima!	
VO_Hero_07d_Male_OldGod_TRIGGER_BANEOFDOOM_01	Su fin es solo el principio.	
VO_Hero_07d_Male_OldGod_TRIGGER_DECKOFCHAOS_01	El futuro es la historia reescrita.	
VO_Hero_07d_Male_OldGod_TRIGGER_DISCARD_01	A las profundidades...	
VO_Hero_07d_Male_OldGod_TRIGGER_DRAINLIFE_01	Tu sufrimiento es mi fuerza.	
VO_Hero_07d_Male_OldGod_TRIGGER_HELLFIRE_01	Todo es ruinas.	
VO_Hero_07d_Male_OldGod_TRIGGER_HEROPOWER_01	Sacrificio…	
VO_Hero_07d_Male_OldGod_TRIGGER_HEROPOWER_02	Más…	
VO_Hero_07d_Male_OldGod_TRIGGER_HEROPOWER_03	Me alimento…	
VO_Hero_07d_Male_OldGod_TRIGGER_NZOTH_01	Soy multitudes.	
VO_Hero_07d_Male_OldGod_TRIGGER_OPPONENT_SHADOWFORM_01	Sí. Acepta las sombras.	
VO_Hero_07d_Male_OldGod_TRIGGER_PLOTTWIST_01	Nada es lo que parece.	
VO_Hero_07d_Male_OldGod_TRIGGER_SHADOWFLAME_01	Se entregan voluntariamente a mí.	
VO_Hero_07d_Male_OldGod_TRIGGER_SOULFRAGMENT_01	Mis ojos se abren.	
VO_Hero_07d_Male_OldGod_TRIGGER_TWISTEDKNOWLEDGE_01	Conozco lo que nadie conoce. Veo lo invisible.	
VO_Hero_07d_Male_OldGod_TRIGGER_TWISTINGNETHER_01	El vacío consume.	
VO_Hero_07d_Male_OldGod_Well_Played_01	¡Glorioso y terrible!	
VO_Hero_07d_Male_OldGod_WOW_01	¡Las multitudes gritan!	
VO_HERO_08_Female_Human_START_Arthas_01	No tengo nada de qué preocuparme, ¿no, Arthas?	
VO_HERO_08_HAPPY_NEW_YEAR_15	¡Feliz año nuevo!	
VO_HERO_08b_HAPPY_NEW_YEAR_53	¡Feliz año nuevo!	
VO_Hero_08e_Male_Lich_Concede_01	La victoria es tuya.	
VO_Hero_08e_Male_Lich_ERROR_FULL_MINIONS_01	¡Mi culto no acepta más reclutas!	
VO_Hero_08e_Male_Lich_ERROR_GENERIC_01	¡No!	
VO_Hero_08e_Male_Lich_ERROR_HAND_FULL_01	¡Demasiadas cartas!	
VO_Hero_08e_Male_Lich_ERROR_I_ATTACKED_01	Ya ataqué.	
VO_Hero_08e_Male_Lich_ERROR_MINION_ATTACKED_01	No puede volver a atacar.	
VO_Hero_08e_Male_Lich_ERROR_NEED_MANA_01	No tengo suficiente maná.	
VO_Hero_08e_Male_Lich_ERROR_NEED_WEAPON_02	Necesito un arma… 	
VO_Hero_08e_Male_Lich_ERROR_PLAY_01	Está más allá de mí.	
VO_Hero_08e_Male_Lich_ERROR_STEALTH_01	Ese se oculta de mi mirada.	
VO_Hero_08e_Male_Lich_ERROR_SUMMON_SICKNESS_01	Aún no está listo.	
VO_Hero_08e_Male_Lich_ERROR_TARGET_01	No puedo hacer objetivo en eso.	
VO_Hero_08e_Male_Lich_ERROR_TAUNT_02	Necesito atacar al que me está provocando.	
VO_Hero_08e_Male_Lich_FIRE_FESTIVAL_01	¿Por qué todos juegan con fuego? ¿No pueden PARAR?	
VO_Hero_08e_Male_Lich_Greetings_01	Saludos desde la fría oscuridad.	
VO_Hero_08e_Male_Lich_HAPPY_HALLOWEEN_01	¡Tantos disfraces de Halloween! ¡No reconozco a nadie!	
VO_Hero_08e_Male_Lich_HAPPY_HOLIDAYS_01	Me encanta el invierno. ¡El frío, la nieve, los regalos robados!	
VO_Hero_08e_Male_Lich_HAPPY_NEW_YEAR_01	¡Feliz año nuevo!	
VO_Hero_08e_Male_Lich_HAPPY_NEW_YEAR_LUNAR_01	¡Feliz año nuevo!	
VO_Hero_08e_Male_Lich_HAPPY_NOBLEGARDEN_01	¡¿Quién se robó mi filacteria y dejó un huevo en su lugar?! ¿Fuiste TÚ?	
VO_Hero_08e_Male_Lich_LowCards_01	Tengo pocas cartas.	
VO_Hero_08e_Male_Lich_MIRROR_GREETINGS_01	¡Ah, mi lugar favorito!	
VO_Hero_08e_Male_Lich_MIRROR_START_01	Muy tarde.	
VO_Hero_08e_Male_Lich_NoCards_01	¡Ya no tengo cartas!	
VO_Hero_08e_Male_Lich_Oops_01	¿Una distracción?	
VO_Hero_08e_Male_Lich_Picked_01	¡Obedece el llamado!	
VO_Hero_08e_Male_Lich_PIRATE_DAY_01	Arr, con esta cara, no necesito una bandera pirata.	
VO_Hero_08e_Male_Lich_Sorry_01	Lo siento muchísimo.	
VO_Hero_08e_Male_Lich_Start_01	Tu curiosidad será tu fin.	
VO_Hero_08e_Male_Lich_Start_Arthas_01	Tienes un futuro prometedor.	
VO_Hero_08e_Male_Lich_Start_Jaina_01	Sigues del lado equivocado, Jaina.	
VO_Hero_08e_Male_Lich_Start_Sylvanas_01	Conque sigues luchando…	
VO_Hero_08e_Male_Lich_Thanks_01	Gracias.	
VO_Hero_08e_Male_Lich_Thinking_01	Mmm...	
VO_Hero_08e_Male_Lich_Thinking_02	¿Ah?	
VO_Hero_08e_Male_Lich_Thinking_04	Todo a su tiempo.	
VO_Hero_08e_Male_Lich_Threaten_01	¡Te espera un abismo de oscuridad!	
VO_Hero_08e_Male_Lich_Time_01	¡El tiempo está en mi contra!	
VO_Hero_08e_Male_Lich_TRIGGER_Blizzard_01	¡Te congelaré la sangre de las venas!	
VO_Hero_08e_Male_Lich_TRIGGER_Cone_of_Cold_01	¡Tu alma ahora está ligada a mí!	
VO_Hero_08e_Male_Lich_TRIGGER_Deep_Freeze_01	No olvides lo que ibas a decir…	
VO_Hero_08e_Male_Lich_TRIGGER_Evocation_01	He estudiado durante tantos años…	
VO_Hero_08e_Male_Lich_TRIGGER_Font_of_Power_01	¡Levántense, guerreros de los baldíos helados!	
VO_Hero_08e_Male_Lich_TRIGGER_Frost_Nova_01	Intenta ser paciente…	
VO_Hero_08e_Male_Lich_TRIGGER_Frostbolt_01	¡Ruega por piedad!	
VO_Hero_08e_Male_Lich_TRIGGER_Icicle_01	¡Tu magia vergonzosa no es un desafío para mí!	
VO_Hero_08e_Male_Lich_TRIGGER_Snap_Freeze_01	<Carcajada maniática>	
VO_Hero_08e_Male_Lich_Well_Played_01	Bien hecho, metiche.	
VO_Hero_08e_Male_Lich_WOW_01	¡Poder innegable!	
VO_HERO_08f_Female_Human_Attack_01	¡A ver si con esto aprendes!	
VO_HERO_08f_Female_Human_Greetings_01	¡Me alegra verte!	
VO_HERO_08f_Female_Human_MIRROR_GREETINGS_01	Parece que siempre nos encontramos.	
VO_HERO_08f_Female_Human_MIRROR_START_01	¿Y vas a especializarte en escarcha o arcano?	
VO_HERO_08f_Female_Human_Oops_01	Solo una equivocación menor.	
VO_HERO_08f_Female_Human_Picked_01	Estoy lista para aprender.	
VO_HERO_08f_Female_Human_Start_01	¡Lo único que siempre quise fue estudiar!	
VO_HERO_08f_Female_Human_Thanks_01	Gracias por tu ayuda.	
VO_HERO_08f_Female_Human_Threaten_01	Algún día seré una gran maga. Ya verás.	
VO_HERO_08f_Female_Human_Well_Played_01	Debes destacarte en tu clase.	
VO_HERO_08f_Female_Human_Wow_01	¡Qué emocionante!	
VO_HERO_08g_Female_Human_Attack_01	¡Por el Kirin Tor!	
VO_HERO_08g_Female_Human_Greetings_01	¿Qué buscas?	
VO_HERO_08g_Female_Human_MIRROR_GREETINGS_01	Justicia, paz, más criaturas para Polimorfia…	
VO_HERO_08g_Female_Human_MIRROR_START_01	El mejor que existe.	
VO_HERO_08g_Female_Human_Oops_01	¿Eso fue intencional?	
VO_HERO_08g_Female_Human_Picked_01	He estudiado muchos años para dominar las artes arcanas.	
VO_HERO_08g_Female_Human_Start_01	¡El conocimiento es poder!	
VO_HERO_08g_Female_Human_Thanks_01	Tienes mi más sincera gratitud.	
VO_HERO_08g_Female_Human_Threaten_01	¡No toleraré la insurrección!	
VO_HERO_08g_Female_Human_Well_Played_01	Nunca había visto a nadie como tú.	
VO_HERO_08g_Female_Human_Wow_01	¡Qué encantador!	
VO_HERO_08h_Female_Human_Attack_01	¡Ríndete de una vez!	
VO_HERO_08h_Female_Human_Greetings_01	¡Estoy aquí para ayudar!	
VO_HERO_08h_Female_Human_MIRROR_GREETINGS_01	Ay… ¡qué amable de tu parte!	
VO_HERO_08h_Female_Human_MIRROR_START_01	¡Qué curioso, yo también!	
VO_HERO_08h_Female_Human_Oops_01	¡Upsi!	
VO_HERO_08h_Female_Human_Picked_01	Repasemos lo elemental.	
VO_HERO_08h_Female_Human_Start_01	Tengo un buen presentimiento esta vez.	
VO_HERO_08h_Female_Human_Thanks_01	¡Ah, gracias!	
VO_HERO_08h_Female_Human_Threaten_01	¡Odio recurrir a la violencia!	
VO_HERO_08h_Female_Human_Well_Played_01	Tu valentía no conoce límites.	
VO_HERO_08h_Female_Human_Wow_01	¡Qué hermoso!	
VO_HERO_08i_Female_Human_Attack_01	¡Me haces perder el tiempo!	
VO_HERO_08i_Female_Human_Greetings_01	Cuidado en quién confías.	
VO_HERO_08i_Female_Human_MIRROR_GREETINGS_01	Siento que puedo confiar en ti.	
VO_HERO_08i_Female_Human_MIRROR_START_01	Tampoco es la pregunta.	
VO_HERO_08i_Female_Human_Oops_01	Eso fue un descuido serio.	
VO_HERO_08i_Female_Human_Picked_01	Siempre recordaré Theramore.	
VO_HERO_08i_Female_Human_Start_01	¡La paz no siempre es la respuesta!	
VO_HERO_08i_Female_Human_Thanks_01	Estoy muy agradecida.	
VO_HERO_08i_Female_Human_Threaten_01	Aquí va a hacer mucho frío.	
VO_HERO_08i_Female_Human_Well_Played_01	Nunca dejes de lado tu pasión.	
VO_HERO_08i_Female_Human_Wow_01	¡Espectacular!	
VO_HERO_08j_Female_Human_Attack_01	¡Es necesario!	
VO_HERO_08j_Female_Human_Greetings_01	Todos tenemos nuestros fantasmas.	
VO_HERO_08j_Female_Human_MIRROR_GREETINGS_01	Algunos más que otros.	
VO_HERO_08j_Female_Human_MIRROR_START_01	Tal vez nunca lo fue.	
VO_HERO_08j_Female_Human_Oops_01	¿Un descuido?	
VO_HERO_08j_Female_Human_Picked_01	Cuidado con la hija del mar.	
VO_HERO_08j_Female_Human_Start_01	Ya no es hora de soñar.	
VO_HERO_08j_Female_Human_Thanks_01	Me alegra contar con tu ayuda.	
VO_HERO_08j_Female_Human_Threaten_01	Una sola chispa puede incendiar el mundo.	
VO_HERO_08j_Female_Human_Well_Played_01	Tienes tanto poder… Debes aprender a controlarlo.	
VO_HERO_08j_Female_Human_Wow_01	¡Increíble!	
VO_HERO_08k_Female_Human_Attack_01	¡Cuestiona todo!	
VO_HERO_08k_Female_Human_Greetings_01	Mis más cordiales saludos.	
VO_HERO_08k_Female_Human_MIRROR_GREETINGS_01	¡¿Los Reflejos exactos pueden hablar?!	
VO_HERO_08k_Female_Human_MIRROR_START_01	Creo que tu intuición es correcta.	
VO_HERO_08k_Female_Human_Oops_01	¿Qué fue eso?	
VO_HERO_08k_Female_Human_Picked_01	Mi poder traerá la paz, de una forma u otra.	
VO_HERO_08k_Female_Human_Start_01	Mi hechicería prevalecerá.	
VO_HERO_08k_Female_Human_Thanks_01	Muchísimas gracias.	
VO_HERO_08k_Female_Human_Threaten_01	Ya me cansaste.	
VO_HERO_08k_Female_Human_Well_Played_01	Me tienes hechizada.	
VO_HERO_08k_Female_Human_Wow_01	¡Este es un momento mágico!	
VO_HERO_09_HAPPY_NEW_YEAR_15	¡Feliz año nuevo!	
VO_HERO_09_Male_Human_Emote_01	¡La Luz siempre triunfa!	
VO_HERO_09_Male_Human_Emote_02	Rezaré por ti.	
VO_HERO_09_Male_Human_Emote_03	Los verdaderos sacerdotes usan armaduras de placas.	
VO_HERO_09_Male_Human_Emote_04	¡Necesito sanación!	
VO_HERO_09_Male_Human_Emote_05	¡Que se haga la luz!	
VO_HERO_09_Male_Human_Emote_06	¡Yo quisiera ya ser un rey!	
VO_HERO_09_Male_Human_Emote_07	No siempre juego limpio. Bueno… casi siempre.	
VO_HERO_09_Male_Human_Emote_08	¡Por la Alianza!	
VO_HERO_09_Male_Human_Emote_09	¡Ventormenta resistirá!	
VO_HERO_09_Male_Human_Emote_10	Siempre vale la pena luchar por una causa justa.	
VO_HERO_09_Male_Human_Emote_11	La nobleza de un rey se mide por las cartas que juega.	
VO_HERO_09_Male_Human_Emote_12	Nunca pierdas la esperanza.	
VO_HERO_09a_Attack_15	¡Por Elune!	
VO_HERO_09a_CONCEDE_06	No hay nada más que hacer. Tú ganas.	
VO_HERO_09a_ERROR_FULL_MINIONS_25	¡Tengo demasiados esbirros!	
VO_HERO_09a_ERROR_GENERIC_30	No puedo hacer eso.	
VO_HERO_09a_ERROR_HAND_FULL_24	¡Mi mano está llena!	
VO_HERO_09a_ERROR_I_ATTACKED_22	Ya he atacado.	
VO_HERO_09a_ERROR_JUST_PLAYED_23	Ese esbirro necesita un turno de descanso.	
VO_HERO_09a_ERROR_MINION_ATTACKED_21	Ese esbirro ya atacó.	
VO_HERO_09a_ERROR_NEED_MANA_20	No tengo suficiente maná.	
VO_HERO_09a_ERROR_NEED_WEAPON_19	Necesito un arma.	
VO_HERO_09a_ERROR_PLAY_27	No puedo hacer esa jugada.	
VO_HERO_09a_ERROR_STEALTH_26	No puedo hacer objetivo en esbirros en Sigilo.	
VO_HERO_09a_ERROR_TARGET_28	Ese objetivo no es válido.	
VO_HERO_09a_ERROR_TAUNT_29	Hay un esbirro con Provocación en el camino.	
VO_Hero_09a_Female_NightElf_Start_Illidan_01	La fuerza bruta no sustituye el verdadero poder.	
VO_HERO_09a_FIRE_FESTIVAL	Feliz festival del Solsticio de Verano.	
VO_HERO_09a_GREETINGS_03	Bendiciones.	
VO_HERO_09a_GREETINGS_RESPONSE	Lo mismo para ti.	
VO_HERO_09a_HALLOWS_END	Feliz Halloween.	
VO_HERO_09a_HAPPY_HOLIDAYS_52	¡Feliz festín del Festival de Invierno!	
VO_HERO_09a_HAPPY_NEW_YEAR_01	¡Feliz año nuevo!	
VO_HERO_09a_HAPPY_NEW_YEAR_LUNAR_53	¡Feliz año nuevo!	
VO_HERO_09a_LOW_CARDS_17	Casi no me quedan cartas.	
VO_HERO_09a_MIRROR_GREETINGS_04	Lo mismo para ti.	
VO_HERO_09a_MIRROR_START_02	La diosa es mi escudo.	
VO_HERO_09a_NO_CARDS_18	¡No me quedan cartas!	
VO_HERO_09a_NOBLEGARDEN	Feliz Jardín Noble.	
VO_HERO_09a_OOPS_08	Un error.	
VO_HERO_09a_PICKED_11	¡La diosa llama!	
VO_HERO_09a_PIRATE_DAY	Palabra de poder: ¡Arrr!	
VO_HERO_09a_SORRY_10	Perdóname.	
VO_HERO_09a_START_01	Elune, dame fuerzas.	
VO_HERO_09a_START_MALFURION	Mi querido Malfurion.	
VO_HERO_09a_THANKS_09	Gracias.	
VO_HERO_09a_THINK1_12	Mmm...	
VO_HERO_09a_THINK2_13	Me pregunto...	
VO_HERO_09a_THINK3_14	Cuál será la voluntad de Elune...	
VO_HERO_09a_THREATEN_05	¡Te arrepentirás!	
VO_HERO_09a_TIMER_16	¡Date prisa!	
VO_HERO_09a_WELL_PLAYED_07	Buena jugada.	
VO_HERO_09a_WOW_10	¡Brillante!	
VO_HERO_09b_Female_Troll_Concede_01	Tú ganas. Era tu destino.	
VO_HERO_09b_Female_Troll_ERROR_FULL_MINIONS_02	¡Mi tablero ya está lleno!	
VO_HERO_09b_Female_Troll_ERROR_GENERIC_02	Eso es imposible.	
VO_HERO_09b_Female_Troll_ERROR_HAND_FULL_01	¡Mi mano está llena!	
VO_HERO_09b_Female_Troll_ERROR_I_ATTACKED_01	Ya ataqué.	
VO_HERO_09b_Female_Troll_ERROR_MINION_ATTACKED_01	Ese esbirro ya atacó.	
VO_HERO_09b_Female_Troll_ERROR_NEED_MANA_02	¡Necesito maná!	
VO_HERO_09b_Female_Troll_ERROR_NEED_WEAPON_01	Necesito un arma.	
VO_HERO_09b_Female_Troll_ERROR_PLAY_01	No puedo hacer esa jugada.	
VO_HERO_09b_Female_Troll_ERROR_STEALTH_01	Ahhh, ese sí que es sigiloso.	
VO_HERO_09b_Female_Troll_ERROR_SUMMON_SICKNESS_01	Oh, ese necesita un turno de preparación.	
VO_HERO_09b_Female_Troll_ERROR_TARGET_01	Necesito un objetivo.	
VO_HERO_09b_Female_Troll_ERROR_TAUNT_01	Debo lidiar con ese esbirro que tiene Provocación.	
VO_HERO_09b_Female_Troll_FIRE_FESTIVAL_01	¡El Festival de Fuego ha llegado!	
VO_HERO_09b_Female_Troll_Greetings_01	¡Te doy la bienvenida! ¿Quieres conocer tu fortuna?	
VO_HERO_09b_Female_Troll_HAPPY_HALLOWEEN_01	Ahhh, Halloween.	
VO_HERO_09b_Female_Troll_HAPPY_HOLIDAYS_01	Feliz festividad.	
VO_HERO_09b_Female_Troll_HAPPY_NEW_YEAR_01	Comienza un año nuevo...	
VO_HERO_09b_Female_Troll_HAPPY_NEW_YEAR_LUNAR_01	Comienza un año nuevo...	
VO_HERO_09b_Female_Troll_HAPPY_NOBLEGARDEN_01	¡Feliz Jardín Noble! 	
VO_HERO_09b_Female_Troll_LowCards_02	Tengo pocas cartas.	
VO_HERO_09b_Female_Troll_MIRROR_GREETINGS_02	Sabía que dirías eso.	
VO_HERO_09b_Female_Troll_MIRROR_START_01	Entonces ya sabes cómo termina...	
VO_HERO_09b_Female_Troll_NoCards_02	¡No me quedan cartas!	
VO_HERO_09b_Female_Troll_Oops_01	Ups, esa será una historia digna de contar.	
VO_HERO_09b_Female_Troll_Picked_02	¿Qué tal si causamos problemas, mm?	
VO_HERO_09b_Female_Troll_PIRATE_DAY_01	¡Yo, jo, jo! 	
VO_HERO_09b_Female_Troll_Sorry_01	Lo siento.	
VO_HERO_09b_Female_Troll_Start_02	He predicho este encuentro...	
VO_HERO_09b_Female_Troll_Thanks_01	Gracias.	
VO_HERO_09b_Female_Troll_Thinking_06	Mmmm...	
VO_HERO_09b_Female_Troll_Thinking_11	¿Qué dicen las cartas?	
VO_HERO_09b_Female_Troll_Thinking_12	¿...qué debo hacer...?	
VO_HERO_09b_Female_Troll_Threaten_03	¡Tu destino está sellado!	
VO_HERO_09b_Female_Troll_Time_02	El fin está cerca.	
VO_HERO_09b_Female_Troll_Well_Played_01	¡Buena jugada!	
VO_HERO_09b_Female_Troll_WOW_01	¡Por los dioses antiguos!	
VO_HERO_09d_Male_Human_Greetings_01	Buenos días.	
VO_HERO_09d_Male_Human_MIRROR_GREETINGS_01	¡Igualmente para ti, extraño conocido!	
VO_HERO_09d_Male_Human_MIRROR_START_01	Siempre lo he pensado.	
VO_HERO_09d_Male_Human_Oops_01	Olvidémoslo.	
VO_HERO_09d_Male_Human_Thanks_01	Gracias, de verdad.	
VO_HERO_09d_Male_Human_Well_Played_01	La Luz te guía.	
VO_HERO_09d_Male_Human_Wow_01	¡Qué maravilla!	
VO_HERO_09e_Male_Human_Attack_01	¡Por Ventormenta!	
VO_HERO_09e_Male_Human_Greetings_01	Saludos.	
VO_HERO_09e_Male_Human_MIRROR_GREETINGS_01	¡Ey, ese no es el saludo secreto!	
VO_HERO_09e_Male_Human_MIRROR_START_01	¡No estás solo!	
VO_HERO_09e_Male_Human_Oops_01	¿Cómo pasó eso?	
VO_HERO_09e_Male_Human_Start_01	Protegeré a la Alianza.	
VO_HERO_09e_Male_Human_Thanks_01	Te lo agradezco.	
VO_HERO_09e_Male_Human_Threaten_01	No me provoques...	
VO_HERO_09e_Male_Human_Well_Played_01	¡Qué bien peleas!	
VO_HERO_09e_Male_Human_Wow_01	Impresionante, de verdad.	
VO_HERO_09f_Male_Human_Attack_01	¡Ríndete!	
VO_HERO_09f_Male_Human_Greetings_01	Te saludo.	
VO_HERO_09f_Male_Human_MIRROR_GREETINGS_01	Me gusta tu estilo.	
VO_HERO_09f_Male_Human_MIRROR_START_01	Qué buena estrategia...	
VO_HERO_09f_Male_Human_Oops_01	Hay que pensar mejor la próxima vez.	
VO_HERO_09f_Male_Human_Start_01	¡La sabiduría traerá la victoria!	
VO_HERO_09f_Male_Human_Thanks_01	Tienes mi agradecimiento.	
VO_HERO_09f_Male_Human_Threaten_01	El ingenio también es un arma.	
VO_HERO_09f_Male_Human_Well_Played_01	Qué ingeniosa jugada.	
VO_HERO_09f_Male_Human_Wow_01	Increíble.	
VO_HERO_09h_Female_Draenei_Attack_01	¡Atrás!	
VO_HERO_09h_Female_Draenei_Greetings_01	¡Te doy la bienvenida!	
VO_HERO_09h_Female_Draenei_MIRROR_GREETINGS_01	Gracias por invitarme.	
VO_HERO_09h_Female_Draenei_MIRROR_START_01	Es MI momento.	
VO_HERO_09h_Female_Draenei_Oops_01	De los errores se aprende.	
VO_HERO_09h_Female_Draenei_Picked_01	No descansaré hasta que el naaru vuelva a ser uno.	
VO_HERO_09h_Female_Draenei_Start_01	Este es mi momento.	
VO_HERO_09h_Female_Draenei_Thanks_01	Te lo agradezco mucho.	
VO_HERO_09h_Female_Draenei_Threaten_01	No me detendrás en mi misión.	
VO_HERO_09h_Female_Draenei_Well_Played_01	¡Qué habilidad!	
VO_HERO_09h_Female_Draenei_Wow_01	¡Estoy asombrada!	
VO_HERO_09i_Female_Draenei_Attack_01	¡Que la Luz me guíe!	
VO_HERO_09i_Female_Draenei_Greetings_01	¡Archenon poros!	
VO_HERO_09i_Female_Draenei_MIRROR_GREETINGS_01	Sí, para ti y tu familia.	
VO_HERO_09i_Female_Draenei_MIRROR_START_01	Y pondré fin a la oscuridad.	
VO_HERO_09i_Female_Draenei_Oops_01	¡Debemos aprender de nuestros errores!	
VO_HERO_09i_Female_Draenei_Picked_01	No descansaré hasta que el naaru vuelva a ser uno.	
VO_HERO_09i_Female_Draenei_Start_01	Iluminaré el camino.	
VO_HERO_09i_Female_Draenei_Thanks_01	Te lo agradezco.	
VO_HERO_09i_Female_Draenei_Threaten_01	¡Te enfrentarás a mi ira!	
VO_HERO_09i_Female_Draenei_Well_Played_01	Estoy… impresionada.	
VO_HERO_09i_Female_Draenei_Wow_01	¡Fascinante!	
VO_HERO_09j_Female_Draenei_Attack_01	¡Krypta voros!	
VO_HERO_09j_Female_Draenei_Greetings_01	Será una pelea digna.	
VO_HERO_09j_Female_Draenei_MIRROR_GREETINGS_01	Opino lo mismo.	
VO_HERO_09j_Female_Draenei_MIRROR_START_01	Ese juramento. Es mi deber cumplirlo.	
VO_HERO_09j_Female_Draenei_Oops_01	Solo un error. No es el fin.	
VO_HERO_09j_Female_Draenei_Picked_01	¡Estamos muy cerca del final para rendirnos!	
VO_HERO_09j_Female_Draenei_Start_01	Por la Luz. ¡Por mi hija!	
VO_HERO_09j_Female_Draenei_Thanks_01	Qué generosidad.	
VO_HERO_09j_Female_Draenei_Threaten_01	¡Arrepiéntete!	
VO_HERO_09j_Female_Draenei_Well_Played_01	¡Una batalla legendaria!	
VO_HERO_09j_Female_Draenei_Wow_01	Vivimos en tiempos realmente fascinantes.	
VO_HERO_09k_Female_Draenei_Attack_01	<Esfuerzo de ataque>	
VO_HERO_09k_Female_Draenei_BRB_01	Volveré.	
VO_HERO_09k_Female_Draenei_CELEBRATE_01	¡Te deseo felicidad en esta ocasión!	
VO_HERO_09k_Female_Draenei_CHEER_01	¡Oh, gloria, gloria!	
VO_HERO_09k_Female_Draenei_Concede_01	Esta batalla… es tuya…	
VO_HERO_09k_Female_Draenei_CONGRATULATIONS_01	Felicitaciones.	
VO_HERO_09k_Female_Draenei_CRY_01	<Llanto>	
VO_HERO_09k_Female_Draenei_CRY_02	Es… demasiado…	
VO_HERO_09k_Female_Draenei_DAY_OF_THE_DEAD_01	Un día para recordar… a los que perdimos.	
VO_HERO_09k_Female_Draenei_Death_01	<Muerte>	
VO_HERO_09k_Female_Draenei_END_OF_SEASON_01	La temporada llega a su fin.	
VO_HERO_09k_Female_Draenei_ERROR_FULL_MINIONS_01	No hay lugar.	
VO_HERO_09k_Female_Draenei_ERROR_GENERIC_01	Eso es imposible.	
VO_HERO_09k_Female_Draenei_ERROR_GENERIC_02	Eso no se puede hacer.	
VO_HERO_09k_Female_Draenei_ERROR_HAND_FULL_01	¡Mi mano está llena!	
VO_HERO_09k_Female_Draenei_ERROR_I_ATTACKED_01	Ya ataqué.	
VO_HERO_09k_Female_Draenei_ERROR_MINION_ATTACKED_01	Ese esbirro ya atacó.	
VO_HERO_09k_Female_Draenei_ERROR_NEED_MANA_01	Necesito más maná.	
VO_HERO_09k_Female_Draenei_ERROR_NEED_MANA_02	Necesito más poder para eso.	
VO_HERO_09k_Female_Draenei_ERROR_NEED_WEAPON_01	Necesito un arma.	
VO_HERO_09k_Female_Draenei_ERROR_PLAY_01	No puedo hacer esa jugada.	
VO_HERO_09k_Female_Draenei_ERROR_STEALTH_01	Ese esbirro tiene sigilo.	
VO_HERO_09k_Female_Draenei_ERROR_STEALTH_02	¡No puedo ver a ese!	
VO_HERO_09k_Female_Draenei_ERROR_SUMMON_SICKNESS_01	Ese esbirro no está listo.	
VO_HERO_09k_Female_Draenei_ERROR_SUMMON_SICKNESS_02	Ese esbirro necesita tiempo para prepararse.	
VO_HERO_09k_Female_Draenei_ERROR_TARGET_01	Necesito un objetivo.	
VO_HERO_09k_Female_Draenei_ERROR_TAUNT_01	Hay un esbirro con Provocación bloqueándome.	
VO_HERO_09k_Female_Draenei_ERROR_TAUNT_02	Debo atacar al esbirro con Provocación.	
VO_HERO_09k_Female_Draenei_FACTION_CRY_01	¡Por la Alianza!	
VO_HERO_09k_Female_Draenei_FIDGET_01	Tal vez me lime las pezuñas mientras espero.	
VO_HERO_09k_Female_Draenei_FIRE_FESTIVAL_01	¡Celebremos la pureza de la llama!	
VO_HERO_09k_Female_Draenei_GG_01	¡Una jugada magistral!	
VO_HERO_09k_Female_Draenei_Greetings_01	Saludos para ti.	
VO_HERO_09k_Female_Draenei_HAPPY_BIRTHDAY_01	¡Feliz cumpleaños!	
VO_HERO_09k_Female_Draenei_HAPPY_BREWFEST_01	Un día entero para festejar la bebida. Qué bien.	
VO_HERO_09k_Female_Draenei_HAPPY_EVENT_01	¡Es época de celebración!	
VO_HERO_09k_Female_Draenei_HAPPY_HALLOWEEN_01	¿Halloween? ¡Qué costumbre tan extraña y oscura!	
VO_HERO_09k_Female_Draenei_HAPPY_HOLIDAYS_01	¡Feliz festividad!	
VO_HERO_09k_Female_Draenei_HAPPY_NEW_YEAR_01	¡Feliz año nuevo!	
VO_HERO_09k_Female_Draenei_HAPPY_NEW_YEAR_LUNAR_01	¡Feliz año nuevo!	
VO_HERO_09k_Female_Draenei_HAPPY_NOBLEGARDEN_01	Perseguimos conejos, ¿no? Y… ¿huevos? Qué confuso.	
VO_HERO_09k_Female_Draenei_HUNGRY_01	No todos los que vagan están perdidos, pero muchos están hambrientos…	
VO_HERO_09k_Female_Draenei_INDEED_01	Eso dicen.	
VO_HERO_09k_Female_Draenei_KIDS_WEEK_01	Daría TODO por mi hija…	
VO_HERO_09k_Female_Draenei_KISS_01	<Sonido de beso>	
VO_HERO_09k_Female_Draenei_KISS_02	¡Mua!	
VO_HERO_09k_Female_Draenei_LAUGH_01	<Risa>	
VO_HERO_09k_Female_Draenei_LowCards_01	Se me acaban las cartas.	
VO_HERO_09k_Female_Draenei_MIRROR_GREETINGS_01	Lo mismo digo.	
VO_HERO_09k_Female_Draenei_MIRROR_START_01	No te daré la oportunidad.	
VO_HERO_09k_Female_Draenei_NICE_CARD_BACK_01	¡Tu dorso es encantador!	
VO_HERO_09k_Female_Draenei_NoCards_01	¡No me quedan cartas!	
VO_HERO_09k_Female_Draenei_Oops_01	Nadie quería que pasara eso.	
VO_HERO_09k_Female_Draenei_PARTY_01	¡Festejemos como si este planeta fuera el último!	
VO_HERO_09k_Female_Draenei_Picked_01	¡La Luz guiará nuestros pasos!	
VO_HERO_09k_Female_Draenei_PIRATE_DAY_01	No entiendo esto del "Día de los Piratas". ¿Arr?	
VO_HERO_09k_Female_Draenei_SALUTE_01	Te saludo.	
VO_HERO_09k_Female_Draenei_Sorry_01	Ah, sí… perdón.	
VO_HERO_09k_Female_Draenei_Start_01	No flaquearé.	
VO_HERO_09k_Female_Draenei_Start_Cariel_01	Lamento que hayamos llegado a esto, amiga.	
VO_HERO_09k_Female_Draenei_Start_Horde_01	¡Un mercenario de la Horda!	
VO_HERO_09k_Female_Draenei_Start_Kazakus_01	La luz del naaru no es para ti.	
VO_HERO_09k_Female_Draenei_Start_Kurtrus_01	No dejes que la ira te defina, Kurtrus.	
VO_HERO_09k_Female_Draenei_START_OF_SEASON_01	¡Comienza la temporada! Ojalá traiga felicidad.	
VO_HERO_09k_Female_Draenei_Start_Scabbs_01	Como siempre, directo al grano.	
VO_HERO_09k_Female_Draenei_Start_Tavish_01	La búsqueda continúa, Tavish.	
VO_HERO_09k_Female_Draenei_Thanks_01	¡Gracias!	
VO_HERO_09k_Female_Draenei_Thinking_01	Mmmm…	
VO_HERO_09k_Female_Draenei_Thinking_02	Guía mi mano…	
VO_HERO_09k_Female_Draenei_Thinking_03	Debo perseverar…	
VO_HERO_09k_Female_Draenei_Thinking_04	Sí, ¿pero cómo…?	
VO_HERO_09k_Female_Draenei_Threaten_01	NO pienso retroceder.	
VO_HERO_09k_Female_Draenei_Time_01	¡No hay tiempo…!	
VO_HERO_09k_Female_Draenei_TRIGGER_AGAINST_ALL_ODDS_01	¡Qué imparcial!	
VO_HERO_09k_Female_Draenei_TRIGGER_AGAINST_ALL_ODDS_02	¡Todos conmigo!	
VO_HERO_09k_Female_Draenei_TRIGGER_CIRCLE_OF_HEALING_01	¡Acérquense a mí!	
VO_HERO_09k_Female_Draenei_TRIGGER_CONDEMN_LEVEL_1_01	¡No se acerquen!	
VO_HERO_09k_Female_Draenei_TRIGGER_CONDEMN_LEVEL_2_01	¡Atrás!	
VO_HERO_09k_Female_Draenei_TRIGGER_CONDEMN_LEVEL_3_01	¡Los condeno a todos!	
VO_HERO_09k_Female_Draenei_TRIGGER_DESPERATE_PRAYER_01	Esta batalla apenas ha comenzado.	
VO_HERO_09k_Female_Draenei_TRIGGER_HOLY_NOVA_01	¡Nadie puede esconderse de la Luz!	
VO_HERO_09k_Female_Draenei_TRIGGER_HYSTERIA_01	¡Un desenfreno!	
VO_HERO_09k_Female_Draenei_TRIGGER_IDOL_OF_YSHAARJ_01	El mundo alberga muchos terrores.	
VO_HERO_09k_Female_Draenei_TRIGGER_MIND_CONTROL_01	Préstame esto.	
VO_HERO_09k_Female_Draenei_TRIGGER_MOUNT_01	¡Jaja, arriba! ¡Esa es mi chica!	
VO_HERO_09k_Female_Draenei_TRIGGER_PALM_READING_01	¿Por qué no me lees las pezuñas?	
VO_HERO_09k_Female_Draenei_TRIGGER_POWER_WORD_SHIELD_01	¡Que la Luz te acompañe!	
VO_HERO_09k_Female_Draenei_TRIGGER_SHADOW_WORD_DEATH_01	¡Fuera!	
VO_HERO_09k_Female_Draenei_TRIGGER_SHADOW_WORD_PAIN_01	Ese era una molestia.	
VO_HERO_09k_Female_Draenei_TRIGGER_SILENCE_01	Shhhh…	
VO_HERO_09k_Female_Draenei_VALENTINES_01	Solo somos carne y hueso. El amor... El amor es eterno.	
VO_HERO_09k_Female_Draenei_WELCOME_01	¡Te doy la bienvenida!	
VO_HERO_09k_Female_Draenei_Well_Played_02	Una jugada magnífica.	
VO_HERO_09k_Female_Draenei_WOW_02	¡Por todas las estrellas!	
VO_Hero_10_Male_NightElf_Attack_01	La venganza es mía.	
VO_Hero_10_Male_NightElf_Concede_01	Me rindo… por ahora.	
VO_Hero_10_Male_NightElf_ERROR_FULL_MINIONS_01	Ya controlo demasiados.	
VO_Hero_10_Male_NightElf_ERROR_GENERIC_03	No es posible.	
VO_Hero_10_Male_NightElf_ERROR_HAND_FULL_01	¡Mi mano está llena!	
VO_Hero_10_Male_NightElf_ERROR_I_ATTACKED_01	¡Ya ataqué!	
VO_Hero_10_Male_NightElf_ERROR_MINION_ATTACKED_01	No puede volver a atacar.	
VO_Hero_10_Male_NightElf_ERROR_NEED_MANA_01	Tengo muy poco maná.	
VO_Hero_10_Male_NightElf_ERROR_NEED_WEAPON_01	Necesito un arma.	
VO_Hero_10_Male_NightElf_ERROR_PLAY_01	No puedo…	
VO_Hero_10_Male_NightElf_ERROR_STEALTH_01	Ese esbirro acecha en sigilo.	
VO_Hero_10_Male_NightElf_ERROR_SUMMON_SICKNESS_01	Ese NO está preparado.	
VO_Hero_10_Male_NightElf_ERROR_TARGET_01	Está fuera de mi alcance.	
VO_Hero_10_Male_NightElf_ERROR_TAUNT_01	¡Otro que me provoca! ¡A MÍ!	
VO_Hero_10_Male_NightElf_FIRE_FESTIVAL_01	¡Nuestros fuegos arderán con más intensidad que la Legión misma!	
VO_Hero_10_Male_NightElf_Greetings_01	El mal se acerca.	
VO_Hero_10_Male_NightElf_HAPPY_HALLOWEEN_01	La oscuridad nos rodea… ¡Es Halloween!	
VO_Hero_10_Male_NightElf_HAPPY_HOLIDAYS_01	No hay festividad para los traidores.	
VO_Hero_10_Male_NightElf_HAPPY_NEW_YEAR_01	¡Feliz año nuevo!	
VO_Hero_10_Male_NightElf_HAPPY_NEW_YEAR_LUNAR_01	¡Feliz año nuevo!	
VO_Hero_10_Male_NightElf_HAPPY_NOBLEGARDEN_01	Buscar huevos es una buena práctica para cazar demonios.	
VO_Hero_10_Male_NightElf_LowCards_01	No me quedan muchas cartas…	
VO_Hero_10_Male_NightElf_MIRROR_GREETINGS_01	Ya lo creo. TÚ estás aquí. 	
VO_Hero_10_Male_NightElf_MIRROR_START_01	¿Te atreves a hablarme?	
VO_Hero_10_Male_NightElf_NoCards_01	¡No me quedan cartas!	
VO_Hero_10_Male_NightElf_Oops_01	¿Un error?	
VO_Hero_10_Male_NightElf_Picked_01	Estuve encerrado en la oscuridad.	
VO_Hero_10_Male_NightElf_PIRATE_DAY_01	¡Todos a bordo del SS Traidor para navegar los mares de la deslealtad!	
VO_Hero_10_Male_NightElf_Sorry_01	Lo siento.	
VO_Hero_10_Male_NightElf_Start_01	¡Esto termina ahora!	
VO_Hero_10_Male_NightElf_Start_Aranna_01	No tendré piedad esta vez.	
VO_Hero_10_Male_NightElf_Start_Arthas_01	Soy mejor que tú, ahora y siempre, Arthas.	
VO_Hero_10_Male_NightElf_Start_Maiev_01	No puedes cazar a un cazador de demonios.	
VO_Hero_10_Male_NightElf_Start_Malfurion_01	Aún tenemos cuentas que saldar, hermano.	
VO_Hero_10_Male_NightElf_Start_Mecha_Jaraxxus_01	¿Volviste por más, demonio?	
VO_Hero_10_Male_NightElf_Start_Tyrande_01	Te demostraré mi valía.	
VO_Hero_10_Male_NightElf_Start_Vashj_01	Pongamos a prueba nuestra fuerza.	
VO_Hero_10_Male_NightElf_Thanks_01	Te lo agradezco.	
VO_Hero_10_Male_NightElf_Thinking_01	Mmm…	
VO_Hero_10_Male_NightElf_Thinking_02	Tanta lucha…	
VO_Hero_10_Male_NightElf_Thinking_03	¿Demonios? Demonios.	
VO_Hero_10_Male_NightElf_Thinking_04	Pierdo la paciencia.	
VO_Hero_10_Male_NightElf_Threaten_01	¡No estás preparado!	
VO_Hero_10_Male_NightElf_Time_01	El tiempo se acaba.	
VO_Hero_10_Male_NightElf_TRIGGER_Command_the_Illidari_01	¡Sirve a tu amo!	
VO_Hero_10_Male_NightElf_TRIGGER_Inner_Demon_01	Todos tenemos nuestros demonios.	
VO_Hero_10_Male_NightElf_TRIGGER_Mana_Burn_01	Redúcete a cenizas…	
VO_Hero_10_Male_NightElf_TRIGGER_Metamorphosis_01	¡Ahora estoy completo!	
VO_Hero_10_Male_NightElf_TRIGGER_Skull_of_Guldan_01	Ay, pobre brujo…	
VO_Hero_10_Male_NightElf_TRIGGER_Spectral_Sight_01	Ya veo…	
VO_Hero_10_Male_NightElf_Well_Played_01	Tienes un poder formidable.	
VO_Hero_10_Male_NightElf_WOW_01	¿Cómo es posible?	
VO_HERO_10c_Male_NightElf_Attack_01	¡Juego de niños!	
VO_HERO_10c_Male_NightElf_Greetings_01	Terminaré mi cacería.	
VO_HERO_10c_Male_NightElf_MIRROR_GREETINGS_01	Termina el trabajo.	
VO_HERO_10c_Male_NightElf_MIRROR_START_01	Nuestra furia no se desvanece con el tiempo.	
VO_HERO_10c_Male_NightElf_Oops_01	¿Movimiento equivocado?	
VO_HERO_10c_Male_NightElf_Picked_01	Hasta los demonios me temerán.	
VO_HERO_10c_Male_NightElf_Start_01	La furia de la Legión no se compara con la mía.	
VO_HERO_10c_Male_NightElf_Thanks_01	Solo agradezco cuando corresponde.	
VO_HERO_10c_Male_NightElf_Threaten_01	¡Lamentarás haberte acercado a mí!	
VO_HERO_10c_Male_NightElf_Well_Played_01	Al fin un enemigo interesante.	
VO_HERO_10c_Male_NightElf_Wow_01	¡Qué poder más delicioso!	
VO_HERO_10d_Male_NightElf_Attack_01	¡Me estoy impacientando!	
VO_HERO_10d_Male_NightElf_Greetings_01	¿Quién se atreve a hablarme?	
VO_HERO_10d_Male_NightElf_MIRROR_GREETINGS_01	Bueno… tú, en realidad.	
VO_HERO_10d_Male_NightElf_MIRROR_START_01	Arde eternamente en mi alma.	
VO_HERO_10d_Male_NightElf_Oops_01	¿Eso era lo correcto?	
VO_HERO_10d_Male_NightElf_Picked_01	Veamos cómo termina esto.	
VO_HERO_10d_Male_NightElf_Start_01	¡Siente el odio de 10000 años!	
VO_HERO_10d_Male_NightElf_Thanks_01	Algún día te corresponderé este gesto.	
VO_HERO_10d_Male_NightElf_Threaten_01	Soy mejor que tú, ahora y siempre.	
VO_HERO_10d_Male_NightElf_Well_Played_01	Tu destreza es innegable.	
VO_HERO_10d_Male_NightElf_Wow_01	¡Cuánto esplendor!	
VO_HERO_10e_Male_NightElf_Attack_01	<Estertor de ataque>	
VO_HERO_10e_Male_NightElf_Attack_02	<Estertor de ataque>	
VO_HERO_10e_Male_NightElf_Greetings_01	Saludos.	
VO_HERO_10e_Male_NightElf_MIRROR_GREETINGS_01	Ahórrate las cordialidades.	
VO_HERO_10e_Male_NightElf_MIRROR_START_01	… Y termina… con Anetheron.	
VO_HERO_10e_Male_NightElf_Oops_01	Ups.	
VO_HERO_10e_Male_NightElf_Picked_01	Solo tengo un propósito.	
VO_HERO_10e_Male_NightElf_Start_01	Mi misión comienza…	
VO_HERO_10e_Male_NightElf_Thanks_01	Gracias.	
VO_HERO_10e_Male_NightElf_Threaten_01	Tiembla ante mí.	
VO_HERO_10e_Male_NightElf_Well_Played_01	Buena jugada.	
VO_HERO_10e_Male_NightElf_Wow_01	Guau.	
VO_HERO_10f_Male_NightElf_Attack_01	¡Ataque rápido!	
VO_HERO_10f_Male_NightElf_Greetings_01	Te veo.	
VO_HERO_10f_Male_NightElf_MIRROR_GREETINGS_01	Es una forma de decir.	
VO_HERO_10f_Male_NightElf_MIRROR_START_01	No lo haría ni en sueños.	
VO_HERO_10f_Male_NightElf_Oops_01	Qué inoportuno.	
VO_HERO_10f_Male_NightElf_Picked_01	Mi dolor me impulsa.	
VO_HERO_10f_Male_NightElf_Start_01	No te interpongas en mi camino.	
VO_HERO_10f_Male_NightElf_Thanks_01	Estoy agradecido.	
VO_HERO_10f_Male_NightElf_Threaten_01	Apártate y no te muevas.	
VO_HERO_10f_Male_NightElf_Well_Played_01	Nuestra batalla quedará en la historia.	
VO_HERO_10f_Male_NightElf_Wow_01	¡No puedo creerlo!	
VO_HERO_10g_Male_NightElf_Attack_01	¡Por fin!	
VO_HERO_10g_Male_NightElf_Attack_02	¡Por fin!	
VO_HERO_10g_Male_NightElf_Greetings_01	Hola, por fin.	
VO_HERO_10g_Male_NightElf_MIRROR_GREETINGS_01	Je.	
VO_HERO_10g_Male_NightElf_MIRROR_START_01	Ni de cerca.	
VO_HERO_10g_Male_NightElf_Oops_01	Qué imprudencia.	
VO_HERO_10g_Male_NightElf_Picked_01	Es un buen día para vengarse.	
VO_HERO_10g_Male_NightElf_Start_01	¡¿Esta es mi forma final?!	
VO_HERO_10g_Male_NightElf_Thanks_01	No muestro mi gratitud con palabras sino con actos.	
VO_HERO_10g_Male_NightElf_Threaten_01	Te encontraré.	
VO_HERO_10g_Male_NightElf_Well_Played_01	Que este sea el fin.	
VO_HERO_10g_Male_NightElf_Wow_01	Fenomenal.	
VO_HERO_10i_Male_NightElf_Attack_01	¡Ya te tengo!	
VO_HERO_10i_Male_NightElf_Attack_02	<Esfuerzo de ataque>	
VO_HERO_10i_Male_NightElf_BRB_01	Estoy AFK. Ahí flagelando a Kil'jaeden.	
VO_HERO_10i_Male_NightElf_CELEBRATE_01	¡A celebrar!	
VO_HERO_10i_Male_NightElf_CHEER_01	¡Sí!	
VO_HERO_10i_Male_NightElf_Concede_01	¡No, espera!	
VO_HERO_10i_Male_NightElf_CONGRATULATIONS_01	Felicitaciones.	
VO_HERO_10i_Male_NightElf_CRY_01	<Llanto>	
VO_HERO_10i_Male_NightElf_DAY_OF_THE_DEAD_01	Este día, recordaré a los que hemos perdido.	
VO_HERO_10i_Male_NightElf_Death_01	<Estertor de muerte>	
VO_HERO_10i_Male_NightElf_END_OF_SEASON_01	La mecha de esta temporada se acorta.	
VO_HERO_10i_Male_NightElf_ERROR_FULL_MINIONS_01	Mi tablero está lleno.	
VO_HERO_10i_Male_NightElf_ERROR_GENERIC_01	No.	
VO_HERO_10i_Male_NightElf_ERROR_GENERIC_02	No lo creo.	
VO_HERO_10i_Male_NightElf_ERROR_HAND_FULL_01	¡Mi mano está demasiado llena!	
VO_HERO_10i_Male_NightElf_ERROR_I_ATTACKED_01	Todavía no.	
VO_HERO_10i_Male_NightElf_ERROR_MINION_ATTACKED_01	Ese esbirro ya atacó.	
VO_HERO_10i_Male_NightElf_ERROR_NEED_MANA_01	No tengo suficiente maná.	
VO_HERO_10i_Male_NightElf_ERROR_NEED_WEAPON_01	¡Necesito un arma!	
VO_HERO_10i_Male_NightElf_ERROR_PLAY_01	Imposible.	
VO_HERO_10i_Male_NightElf_ERROR_STEALTH_01	Ese esbirro tiene Sigilo.	
VO_HERO_10i_Male_NightElf_ERROR_SUMMON_SICKNESS_01	Ese esbirro necesita un turno de descanso.	
VO_HERO_10i_Male_NightElf_ERROR_TARGET_01	No puedo hacer objetivo en eso.	
VO_HERO_10i_Male_NightElf_ERROR_TAUNT_01	¿Ves a ese esbirro con Provocación?	
VO_HERO_10i_Male_NightElf_FACTION_CRY_01	¡Por la Alianza!	
VO_HERO_10i_Male_NightElf_FACTION_CRY_02	¡Por los Illidari!	
VO_HERO_10i_Male_NightElf_FIDGET_01	No dudaré de mi misión.	
VO_HERO_10i_Male_NightElf_FIRE_FESTIVAL_01	Disfruta de este día, pero no me agrada el fuego.	
VO_HERO_10i_Male_NightElf_GG_01	Buena partida.	
VO_HERO_10i_Male_NightElf_Greetings_01	¿Eres amigo o enemigo?	
VO_HERO_10i_Male_NightElf_HAPPY_BIRTHDAY_01	Tu cumpleaños me recuerda que estamos un año más cerca de la muerte.	
VO_HERO_10i_Male_NightElf_HAPPY_BREWFEST_01	Feliz Fiesta de la Cerveza.	
VO_HERO_10i_Male_NightElf_HAPPY_EVENT_01	Este es un muy buen día.	
VO_HERO_10i_Male_NightElf_HAPPY_HALLOWEEN_01	Es Halloween. Cuidado con los demonios traicioneros.	
VO_HERO_10i_Male_NightElf_HAPPY_HOLIDAYS_01	Feliz Festín del Festival de Invierno. ¿Me compraste una guja de guerra nueva?	
VO_HERO_10i_Male_NightElf_HAPPY_NEW_YEAR_01	¡Feliz año nuevo!	
VO_HERO_10i_Male_NightElf_HAPPY_NEW_YEAR_LUNAR_01	¡Feliz año nuevo!	
VO_HERO_10i_Male_NightElf_HAPPY_NOBLEGARDEN_01	¿Jardín Noble? Persigo demonios, no huevos.	
VO_HERO_10i_Male_NightElf_HUNGRY_01	Tengo hambre de venganza… y dulces.	
VO_HERO_10i_Male_NightElf_INDEED_01	Sin dudas.	
VO_HERO_10i_Male_NightElf_KIDS_WEEK_01	Los niños merecen cuidado y protección.	
VO_HERO_10i_Male_NightElf_KISS_01	<Sonido de beso>	
VO_HERO_10i_Male_NightElf_LAUGH_01	<Risa>	
VO_HERO_10i_Male_NightElf_LowCards_01	Me quedan pocas cartas.	
VO_HERO_10i_Male_NightElf_MIRROR_GREETINGS_01	Todo enemigo de Anetheron es mi amigo.	
VO_HERO_10i_Male_NightElf_MIRROR_START_01	¡Bebe!	
VO_HERO_10i_Male_NightElf_NICE_CARD_BACK_01	Bonito dorso de carta. Los míos se chamuscaron con fuego vil.	
VO_HERO_10i_Male_NightElf_NoCards_01	¡No me quedan cartas!	
VO_HERO_10i_Male_NightElf_Oops_01	¡No, no, no!	
VO_HERO_10i_Male_NightElf_PARTY_01	¡Es hora de hacer bullicio!	
VO_HERO_10i_Male_NightElf_Picked_01	Acompáñame en mi cacería de venganza.	
VO_HERO_10i_Male_NightElf_PIRATE_DAY_01	Hoy los demonios caminarán por la plancha.	
VO_HERO_10i_Male_NightElf_SALUTE_01	Te has ganado mi respeto.	
VO_HERO_10i_Male_NightElf_Sorry_01	Te compadezco.	
VO_HERO_10i_Male_NightElf_Start_01	Debo saciar mi sed de venganza.	
VO_HERO_10i_Male_NightElf_Start_Illidan_01	No puedo descansar hasta que Anetheron caiga.	
VO_HERO_10i_Male_NightElf_Start_MECHAJARAXXUS_01	Disfruta de tu último aliento inútil, demonio.	
VO_HERO_10i_Male_NightElf_START_OF_SEASON_01	Empieza una nueva temporada, la cacería continúa.	
VO_HERO_10i_Male_NightElf_Start_Tamsin_01	Primero, debes pasar sobre mí.	
VO_HERO_10i_Male_NightElf_Thanks_01	Te lo agradezco.	
VO_HERO_10i_Male_NightElf_Thinking_01	Mmm…	
VO_HERO_10i_Male_NightElf_Thinking_02	La respuesta está aquí.	
VO_HERO_10i_Male_NightElf_Thinking_03	Mi cacería continúa.	
VO_HERO_10i_Male_NightElf_Thinking_04	¿Qué haría Illidan?	
VO_HERO_10i_Male_NightElf_Threaten_01	Al menos sin ojos no tengo que verte la cara.	
VO_HERO_10i_Male_NightElf_Threaten_02	Te pondré en mi lista.	
VO_HERO_10i_Male_NightElf_Time_01	Las sombras crecen.	
VO_HERO_10i_Male_NightElf_TRIGGER_AFIGHTOFFURY_01	Quédate a mi lado. Salva Ventormenta.	
VO_HERO_10i_Male_NightElf_TRIGGER_AFIGHTOFFURY_ALT_01	Este es el día de tu muerte, Anetheron.	
VO_HERO_10i_Male_NightElf_TRIGGER_CHAOSNOVA_01	¡Caos total!	
VO_HERO_10i_Male_NightElf_TRIGGER_COORDINATEDSTRIKE_01	¡Sígueme y pelea!	
VO_HERO_10i_Male_NightElf_TRIGGER_FEASTOFSOULS_01	La guerra tiene mucho que enseñarnos.	
VO_HERO_10i_Male_NightElf_TRIGGER_FURY_01	<Rugido de furia>	
VO_HERO_10i_Male_NightElf_TRIGGER_INNERDEMON_01	¡Cueste lo que cueste!	
VO_HERO_10i_Male_NightElf_TRIGGER_METAMORPHOSIS_01	¡No tengo nada más que este poder!	
VO_HERO_10i_Male_NightElf_TRIGGER_SKULLOFGULDAN_01	Brujos… son todos iguales.	
VO_HERO_10i_Male_NightElf_TRIGGER_SPECTRALSIGHT_01	Nunca dejaré de buscar.	
VO_HERO_10i_Male_NightElf_VALENTINES_01	Que las estrellas te guíen, mi amor. Cuida de nuestros hijos.	
VO_HERO_10i_Male_NightElf_WELCOME_01	¡Te doy la bienvenida!	
VO_HERO_10i_Male_NightElf_Well_Played_01	Eres un adversario digno.	
VO_HERO_10i_Male_NightElf_WOW_01	Lo veo pero no lo creo.	
VO_HERO_11_HAPPY_NEW_YEAR_20	¡Feliz año nuevo!	
VO_HERO_12_HAPPY_NEW_YEAR_20	¡Feliz año nuevo!	
VO_HERO_13_HAPPY_NEW_YEAR_20	¡Feliz año nuevo!	
VO_HERO_14_HAPPY_NEW_YEAR_20	¡Feliz año nuevo!	
VO_HERO_15_HAPPY_NEW_YEAR_24	<¡Feliz año nuevo!>	
VO_HERO_16_Female_Dryad_Concede_01	No puedo ganar siempre.	
VO_HERO_16_Female_Dryad_ERROR_01	No tengo ningún arma.	
VO_HERO_16_Female_Dryad_ERROR_02	¡Necesito más maná!	
VO_HERO_16_Female_Dryad_ERROR_03	¡Ese esbirro no puede volver a atacar!	
VO_HERO_16_Female_Dryad_ERROR_04	Ya ataqué.	
VO_HERO_16_Female_Dryad_ERROR_05	Ese esbirro no puede atacar todavía.	
VO_HERO_16_Female_Dryad_ERROR_06	¡Mi mano está rebosante!	
VO_HERO_16_Female_Dryad_ERROR_07	¡Tengo demasiados esbirros!	
VO_HERO_16_Female_Dryad_ERROR_08	Ese esbirro cobarde está escondiéndose.	
VO_HERO_16_Female_Dryad_ERROR_09	No puedo hacer eso.	
VO_HERO_16_Female_Dryad_ERROR_10	Eso no es posible.	
VO_HERO_16_Female_Dryad_ERROR_11	¡Primero debo atacar al esbirro con Provocación!	
VO_HERO_16_Female_Dryad_ERROR_12	Eso no va a pasar.	
VO_HERO_16_Female_Dryad_FIRE_FESTIVAL_01	¡Me encanta el festival de fuego!	
VO_HERO_16_Female_Dryad_Greetings_01	¡Que la naturaleza te bendiga!	
VO_HERO_16_Female_Dryad_GREETINGS_RESPONSE	Y a ti también.	
VO_HERO_16_Female_Dryad_HAPPY_HALLOWEEN_01	¡Feliz Halloween!	
VO_HERO_16_Female_Dryad_HAPPY_HOLIDAYS_01	¡Feliz festín del Festival de Invierno!	
VO_HERO_16_Female_Dryad_HAPPY_NEW_YEAR_01	¡Celebremos el año nuevo!	
VO_HERO_16_Female_Dryad_HAPPY_NEW_YEAR_LUNAR_01	¡Celebremos el año nuevo!	
VO_HERO_16_Female_Dryad_HAPPY_NOBLEGARDEN_01	¡Feliz Jardín Noble!	
VO_HERO_16_Female_Dryad_LowCards_01	¡Me estoy quedando sin cartas!	
VO_HERO_16_Female_Dryad_MALFURION_START_01	Ishnu'alah, archidruida.	
VO_HERO_16_Female_Dryad_MIRROR_GREETINGS_01	¡Y a ti también!	
VO_HERO_16_Female_Dryad_MIRROR_START_01	¡Por las tierras salvajes!	
VO_HERO_16_Female_Dryad_NoCards_01	¡Ya no me quedan cartas!	
VO_HERO_16_Female_Dryad_Oops_02	Un error de cálculo salvaje.	
VO_HERO_16_Female_Dryad_PIRATE_DAY_01	¡Arr! ¡Soy una pirata!	
VO_HERO_16_Female_Dryad_Sorry_01	Tengo que disculparme por eso.	
VO_HERO_16_Female_Dryad_Start_01	El bosque contraataca.	
VO_HERO_16_Female_Dryad_Thanks_01	Agradezco tu esfuerzo.	
VO_HERO_16_Female_Dryad_Thinking_01	Veamos...	
VO_HERO_16_Female_Dryad_Thinking_02	¿Y si trato de...?	
VO_HERO_16_Female_Dryad_Thinking_03	¿Qué tal si...?	
VO_HERO_16_Female_Dryad_Threaten_01	¡Sufre como las tierras salvajes!	
VO_HERO_16_Female_Dryad_Time_01	El tiempo se acaba.	
VO_HERO_16_Female_Dryad_Well_Played_01	Buena jugada.	
VO_HERO_16_Female_Dryad_WOW_01	¡Eso fue salvaje!	
VO_HERO_17_Female_Treant_CONCEDE	Un árbol cae para que crezca una semilla...	
VO_HERO_17_Female_Treant_ERROR_FULL_MINIONS	El tablero está un poco lleno.	
VO_HERO_17_Female_Treant_ERROR_GENERIC	Lo siento, cariño, no puedo.	
VO_HERO_17_Female_Treant_ERROR_HAND_FULL	No puedo con todas.	
VO_HERO_17_Female_Treant_ERROR_I_ATTACKED	Déjame descansar, criaturita.	
VO_HERO_17_Female_Treant_ERROR_JUST_PLAYED	Necesita un descanso.	
VO_HERO_17_Female_Treant_ERROR_MINION_ATTACKED	Parece que le falta descanso.	
VO_HERO_17_Female_Treant_ERROR_NEED_MANA	Parece que no tengo más maná.	
VO_HERO_17_Female_Treant_ERROR_NEED_WEAPON	No estoy armada, criaturita.	
VO_HERO_17_Female_Treant_ERROR_PLAY	No, no, no. No podemos hacer eso.	
VO_HERO_17_Female_Treant_ERROR_STEALTH	No lo veo bien.	
VO_HERO_17_Female_Treant_ERROR_TARGET	¿Cómo puedo hacer eso?	
VO_HERO_17_Female_Treant_ERROR_TAUNT	Ese rufián está en el camino.	
VO_HERO_17_Female_Treant_FIRE_FESTIVAL	¡Por favor, apaga esos fuegos artificiales del Solsticio de Verano!	
VO_HERO_17_Female_Treant_GREETINGS	Hola, cariño.	
VO_HERO_17_Female_Treant_GREETINGS_RESPONSE	¿Cariño? Jojojo, ¡hola!	VO_HERO_17_Female_Treant_MIRROR_GREETINGS_01.wav
VO_HERO_17_Female_Treant_HALLOWS_END	Ya estoy muy vieja para Halloween.	
VO_HERO_17_Female_Treant_HAPPY_NEW_YEAR_20	Otro año que se va.	
VO_HERO_17_Female_Treant_LOW_CARDS	Mmm, ¿a dónde se fueron todas mis cartas?	
VO_HERO_17_Female_Treant_LUNAR_NEW_YEAR	Otro año que se va.	
VO_HERO_17_Female_Treant_MIRROR_START	¡Hoy yo seré la maestra!	
VO_HERO_17_Female_Treant_NO_CARDS	Parece que he perdido todas mis cartas.	
VO_HERO_17_Female_Treant_NOBLEGARDEN	¡Que tengas un grato Jardín Noble!	
VO_HERO_17_Female_Treant_OOPS	Parece que todavía estoy un poco dormida.	
VO_HERO_17_Female_Treant_PICKED	Deja que te cuente una historia.	
VO_HERO_17_Female_Treant_PIRATE_DAY	¿Un pirata? ¡Eso parece divertido!	
VO_HERO_17_Female_Treant_SORRY	Lo siento, cariño.	
VO_HERO_17_Female_Treant_START	¿Vienes por una lección?	
VO_HERO_17_Female_Treant_START_MALFURION	¡Malfurion! Cuánto has crecido.	
VO_HERO_17_Female_Treant_THANKS	Gracias, cariño.	
VO_HERO_17_Female_Treant_THINK1	Mmmmm.	
VO_HERO_17_Female_Treant_THINK2	Ahhh, sí.	
VO_HERO_17_Female_Treant_THINK3	¿En qué estaba pensando?	
VO_HERO_17_Female_Treant_THREATEN	No deberías despertar a los árboles, criaturita.	
VO_HERO_17_Female_Treant_TIMER	¡Rápido, rápido!	
VO_HERO_17_Female_Treant_WELL_PLAYED	Qué impresionante.	
VO_HERO_17_Female_Treant_WINTERVEIL_GREETINGS	¡Feliz festín del Festival de Invierno!	
VO_HERO_17_Female_Treant_WOW	¡Encantador!	
VO_HERO_18_Female_Gnome_Concede_01	¡Impresionante! Esta vez ganaste.	
VO_HERO_18_Female_Gnome_ERROR_01	¿No necesito un arma?	
VO_HERO_18_Female_Gnome_ERROR_03	No tengo suficiente maná.	
VO_HERO_18_Female_Gnome_ERROR_04	Ya atacó.	
VO_HERO_18_Female_Gnome_ERROR_06	No puedo atacar dos veces.	
VO_HERO_18_Female_Gnome_ERROR_07	¡Shhh! todavía sigue durmiendo.	
VO_HERO_18_Female_Gnome_ERROR_08	¡Uoo! ¡Demasiadas cartas!	
VO_HERO_18_Female_Gnome_ERROR_10	¡Solo se permiten siete esbirros!	
VO_HERO_18_Female_Gnome_ERROR_12	¡Se oculta con el Sigilo!	
VO_HERO_18_Female_Gnome_ERROR_14	Mmm. No puedo hacerlo.	
VO_HERO_18_Female_Gnome_ERROR_15	No puedo hacer objetivo en eso.	
VO_HERO_18_Female_Gnome_ERROR_17	Hay alguien con Provocación en el camino.	
VO_HERO_18_Female_Gnome_ERROR_19	¡Eso no está permitido!	
VO_HERO_18_Female_Gnome_FIRE_FESTIVAL_01	¡Los fuegos artificiales del Solsticio de Verano son lo máximo!	
VO_HERO_18_Female_Gnome_Greetings_01	Holis, ¿cómo estás?	
VO_HERO_18_Female_Gnome_GREETINGS_RESPONSE	Je, je. ¡Holis!	
VO_HERO_18_Female_Gnome_HAPPY_HALLOWEEN_01	¡¿Halloween?! Qué miedo....	
VO_HERO_18_Female_Gnome_HAPPY_HOLIDAYS_01	¡Feliz festín del Festival de Invierno!	
VO_HERO_18_Female_Gnome_HAPPY_NEW_YEAR_01	¡Feliz año nuevo!	
VO_HERO_18_Female_Gnome_HAPPY_NEW_YEAR_LUNAR_16	¡Feliz año nuevo!	
VO_HERO_18_Female_Gnome_LowCards_01	¡Me quedan pocas cartas!	
VO_HERO_18_Female_Gnome_MIRROR_START_01	¡Sí! ¡Esto será increíble!	
VO_HERO_18_Female_Gnome_NOBLEGARDEN	¡Me encanta Jardín Noble!	
VO_HERO_18_Female_Gnome_NoCards_01	¡No me quedan cartas!	
VO_HERO_18_Female_Gnome_Oops_02	¡Upsi!	
VO_HERO_18_Female_Gnome_PIRATE_DAY_01	Arr, ¡soy una pirata! ¡ARRR!	
VO_HERO_18_Female_Gnome_Sorry_01	Ooh, lo siento.	
VO_HERO_18_Female_Gnome_Start_01	¡Vamos a divertirnos!	
VO_HERO_18_Female_Gnome_Thanks_02	¡Ooh, gracias!	
VO_HERO_18_Female_Gnome_Thinking_01	Mmmmm...	
VO_HERO_18_Female_Gnome_Thinking_03	Mmm... taram taram dam...	
VO_HERO_18_Female_Gnome_Thinking_04	Me pregunto si...	
VO_HERO_18_Female_Gnome_Threaten_01	Serías una marioneta preciosa.	
VO_HERO_18_Female_Gnome_Time_01	¡Tengo que apurarme!	
VO_HERO_18_Female_Gnome_Well_Played_01	¡Guau, qué buena jugada!	
VO_HERO_18_Female_Gnome_WOW_01	¡Eso fue GENIAL!	
VO_ICC08_LichKing_Male_Human_YoungArthas_02	Odio tener que acabar conmigo mismo.	
VO_INNKEEPER_Male_Dwarf_HERONAME_ANNHYLDE_01	¡Annhylde!	
VO_INNKEEPER_Male_Dwarf_HERONAME_DEATHWING_01	¡Alamuerte!	
VO_INNKEEPER_Male_Dwarf_HERONAME_ELISE_02	¡Elisa!	
VO_Innkeeper_Male_Dwarf_HERONAME_ILLIDAN_01	¡Illidan!	
VO_Innkeeper_Male_Dwarf_HERONAME_KELTHUZAD_01	¡Kel'Thuzad!	
VO_INNKEEPER_Male_Dwarf_HERONAME_LAZUL_01	¡Lazul!	
VO_INNKEEPER_Male_Dwarf_HERONAME_LAZUL_02	¡Lazul!	
VO_INNKEEPER_Male_Dwarf_HERONAME_MECHAJAR_03	¡Meca-Jaraxxus!	
VO_INNKEEPER_Male_Dwarf_HERONAME_NZOTH_02	¡N'Zoth!	
VO_INNKEEPER_Male_Dwarf_HERONAME_NZOTH_03	¡N'Zoth!	
VO_INNKEEPER_Male_Dwarf_HERONAME_RASTAKHAN_01	¡Rastakhan!	
VO_INNKEEPER_Male_Dwarf_HERONAME_RASTAKHAN_02	¡Rastakhan!	
VO_INNKEEPER_Male_Dwarf_Heroname_ThunderKing_01	¡El Rey del Trueno!	
VO_INNKEEPER_Male_Naga_HERONAME_VASHJ_01	¡Lady Vashj!	
VO_MechaJar_Male_Demon_Concede_01	Tú ganas... ¡PERO TU MUNDO SIGUE TENIENDO LOS DÍAS CONTADOS!	
VO_MechaJar_Male_Demon_ERROR_FULL_MINIONS_01	MI TABLERO ESTÁ LLENO.	
VO_MechaJar_Male_Demon_ERROR_GENERIC_01	ESO ES IMPOSIBLE.	
VO_MechaJar_Male_Demon_ERROR_HAND_FULL_01	MI MANO ESTÁ LLENA.	
VO_MechaJar_Male_Demon_ERROR_I_ATTACKED_01	YA ATAQUÉ.	
VO_MechaJar_Male_Demon_ERROR_MINION_ATTACKED_01	ESE ESBIRRO YA ATACÓ.	
VO_MechaJar_Male_Demon_ERROR_NEED_MANA_01	NECESITO MANÁ.	
VO_MechaJar_Male_Demon_ERROR_NEED_WEAPON_01	NO TENGO ARMA.	
VO_MechaJar_Male_Demon_ERROR_PLAY_01	NO PUEDO JUGAR ESA CARTA.	
VO_MechaJar_Male_Demon_ERROR_STEALTH_01	ESE ESBIRRO PATÉTICO ESTÁ ESCONDIÉNDOSE.	
VO_MechaJar_Male_Demon_ERROR_SUMMON_SICKNESS_01	ESE ESBIRRO NECESITA UN TURNO DE DESCANSO.	
VO_MechaJar_Male_Demon_ERROR_TARGET_01	NO PUEDO HACER OBJETIVO EN ESO.	
VO_MechaJar_Male_Demon_ERROR_TAUNT_01	HAY UN ESBIRRO CON PROVOCACIÓN EN EL CAMINO.	
VO_MechaJar_Male_Demon_FIRE_FESTIVAL_01	Feliz Festival de Fuego. TODOS PERECERÁN EN LAS LLAMAS.	
VO_MechaJar_Male_Demon_Greetings_02	Te doy la bienvenida. ¡AL OLVIDO!	
VO_MechaJar_Male_Demon_HAPPY_HALLOWEEN_01	Es Halloween. SERÁ TU ÚLTIMO ESCALOFRÍO.	
VO_MechaJar_Male_Demon_HAPPY_HOLIDAYS_01	¡Disfruta del festín del Festival de Invierno! ¡MIENTRAS PUEDAS!	
VO_MechaJar_Male_Demon_HAPPY_NEW_YEAR_01	Feliz año nuevo. SERÁ EL ÚLTIMO.	
VO_MechaJar_Male_Demon_HAPPY_NEW_YEAR_LUNAR_01	¡Feliz año nuevo!	
VO_MechaJar_Male_Demon_HAPPY_NOBLEGARDEN_01	AHORA COMENZARÁN LAS FESTIVIDADES DE JARDÍN NOBLE.	
VO_MechaJar_Male_Demon_LowCards_01	MI MAZO ESTÁ POR LLEGAR A SU FINAL.	
VO_MechaJar_Male_Demon_MIRROR_GREETINGS_03	Tú solamente adoptaste el olvido. ¡YO NACÍ EN ÉL!	
VO_MechaJar_Male_Demon_MIRROR_START_01	¡IGUALMENTE, TONTO!	
VO_MechaJar_Male_Demon_NoCards_01	MIS CARTAS ESTÁN AGOTADAS.	
VO_MechaJar_Male_Demon_Oops_02	¡ERROR! ¡ERROR!	
VO_MechaJar_Male_Demon_Picked_01	JARAXXUS EN LÍNEA.	
VO_MechaJar_Male_Demon_PIRATE_DAY_01	Yo ho REPETIR yo ho ¡VIDA PIRATA INICIADA!	
VO_MechaJar_Male_Demon_Sorry_01	Lo… ¡SIENTO!	
VO_MechaJar_Male_Demon_Start_02	¡Te enfrentas a MECA-JARAXXUS!	
VO_MechaJar_Male_Demon_Thanks_01	GRACIAS.	
VO_MechaJar_Male_Demon_Thinking_01	Mmm.	
VO_MechaJar_Male_Demon_Thinking_02	Debo... destruir...	
VO_MechaJar_Male_Demon_Thinking_05	Computando...	
VO_MechaJar_Male_Demon_Threaten_04	¡TU ARROGANCIA SERÁ TU PERDICIÓN!	
VO_MechaJar_Male_Demon_Time_01	SE ACABA EL TIEMPO.	
VO_MechaJar_Male_Demon_TRIGGER_DOOM_01	¡DÍA DEL K-BUM!	
VO_MechaJar_Male_Demon_TRIGGER_RENOUCEDARKNESS_01	¡OSCURIDAD ELIMINADA!	
VO_MechaJar_Male_Demon_Well_Played_01	¡BUENA JUGADA!	
VO_MechaJar_Male_Demon_WOW_01	IMPRESIONANTE.	
VO_Story_Hero_Rexxar_Male_Orc-Ogre_Story_Rexxar_Attack_01	No quiero hacer esto… Pero lo haré.	
VO_Story_Hero_Rexxar_Male_Orc-Ogre_Story_Rexxar_Greetings_01	Saludos.	
VO_TBA01_4__Concede	*Rugido*	
VO_TBA01_4__Error_Full_Minions	*Rugido*	
VO_TBA01_4__Error_Generic	*Rugido*	
VO_TBA01_4__Error_Hand_Full	*Rugido*	
VO_TBA01_4__Error_I_Attacked	*Rugido*	
VO_TBA01_4__Error_Just_Played	*Rugido*	
VO_TBA01_4__Error_Minion_Attacked	*Rugido*	
VO_TBA01_4__Error_Need_Mana	*Rugido*	
VO_TBA01_4__Error_Need_Weapon	*Rugido*	
VO_TBA01_4__Error_Play	*Rugido*	
VO_TBA01_4__Error_Stealth	*Rugido*	
VO_TBA01_4__Good_Game	*Rugido*	
VO_TBA01_4__Greetings	¡Que comiencen los juegos!	
VO_TBA01_4__Low_Cards	*Rugido*	
VO_TBA01_4__No_Cards	*Rugido*	
VO_TBA01_4__Oops	*Risa siniestra*	
VO_TBA01_4__Sorry	*Risa amenazante*	
VO_TBA01_4__Start	¡Yo soy el amo aquí!	
VO_TBA01_4__Thanks	*Risa maligna*	
VO_TBA01_4__Threaten	¡Contempla el verdadero poder de NEFARIAN!	
VO_TBA01_4__Timer	*Rugido*	
VO_TBA01_4__Well_Played	*Risa malévola*	
VO_TRLA_204h_Male_Troll_Concede_03	Tú ganas... ¡pero yo nunca olvido! ¡Nunca perdono!	
VO_TRLA_204h_Male_Troll_Greetings_01	¡Ah! ¡Miren quién está aquí!	
VO_TRLA_204h_Male_Troll_LowCards_01	Necesitaré más cartas...	
VO_TRLA_204h_Male_Troll_Mirror_Greetings_01	Tú mismo. Deberías revisarte el ojo.	
VO_TRLA_204h_Male_Troll_NoCards_01	¡Ya no tengo cartas!	
VO_TRLA_204h_Male_Troll_Oops_01	Eso fue un error.	
VO_TRLA_204h_Male_Troll_Thanks_01	Muy amable de tu parte.	
VO_TRLA_204h_Male_Troll_Thinking_03	Mmm... 	
VO_TRLA_204h_Male_Troll_Thinking_09	¿Qué haré contigo? 	
VO_TRLA_204h_Male_Troll_Thinking_10	Esto dolerá… 	
VO_TRLA_204h_Male_Troll_Threaten_01	Te haré... ¡una pregunta INCISIVA!	
VO_TRLA_204h_Male_Troll_Time_01	¡Debo apresurarme!	
VO_TRLA_204h_Male_Troll_Well_Played_02	Eso estuvo bien.	
VO_TRLA_204h_Male_Troll_WOW_01	¡Por el loa de mi pueblo!	
VO_ULDA_Brann_Male_Dwarf_Attack_02	¡Eres historia!	
VO_ULDA_Brann_Male_Dwarf_Concede_01	¡Los demás me vengarán!	
VO_ULDA_Brann_Male_Dwarf_Death_02	Estaba… tan cerca…	
VO_ULDA_Brann_Male_Dwarf_ERROR_FULL_MINIONS_02	Tengo demasiados esbirros.	
VO_ULDA_Brann_Male_Dwarf_ERROR_GENERIC_03	No puedo hacer eso.	
VO_ULDA_Brann_Male_Dwarf_ERROR_HAND_FULL_01	¡Mi mano está llena!	
VO_ULDA_Brann_Male_Dwarf_ERROR_I_ATTACKED_01	Ya ataqué.	
VO_ULDA_Brann_Male_Dwarf_ERROR_MINION_ATTACKED_01	Ese esbirro ya atacó.	
VO_ULDA_Brann_Male_Dwarf_ERROR_NEED_MANA_02	Necesitaré más maná para eso. 	
VO_ULDA_Brann_Male_Dwarf_ERROR_NEED_WEAPON_01	Necesito un arma.	
VO_ULDA_Brann_Male_Dwarf_ERROR_PLAY_01	No puedo hacer esa jugada.	
VO_ULDA_Brann_Male_Dwarf_ERROR_STEALTH_01	Ese esbirro tiene sigilo.	
VO_ULDA_Brann_Male_Dwarf_ERROR_SUMMON_SICKNESS_01	Ese esbirro necesita tiempo para prepararse.	
VO_ULDA_Brann_Male_Dwarf_ERROR_TARGET_02	¡Dame un objetivo!	
VO_ULDA_Brann_Male_Dwarf_ERROR_TAUNT_01	Hay un esbirro con Provocación en el camino.	
VO_ULDA_Brann_Male_Dwarf_Greetings_01	¡Ey, hola!	
VO_ULDA_Brann_Male_Dwarf_HAPPY_BIRTHDAY_01	¡Feliz cumpleaños!	
VO_ULDA_Brann_Male_Dwarf_HAPPY_BREWFEST_01	¡Ah, la Fiesta de la Cerveza! ¡La festividad más espumosa!	
VO_ULDA_Brann_Male_Dwarf_HAPPY_HALLOWEEN_01	Ten cuidado... ¡Es Halloween!	
VO_ULDA_Brann_Male_Dwarf_HAPPY_HOLIDAYS_01	¡Feliz festividad!	
VO_ULDA_Brann_Male_Dwarf_HAPPY_NEW_YEAR_01	¡Feliz año nuevo!	
VO_ULDA_Brann_Male_Dwarf_HAPPY_NEW_YEAR_LUNAR_01	¡Feliz año nuevo!	
VO_ULDA_Brann_Male_Dwarf_HAPPY_NOBLEGARDEN_01	Estos huevos de Jardín Noble no pueden ocultarse de mí.	
VO_ULDA_Brann_Male_Dwarf_LowCards_01	Necesito encontrar algunas cartas.	
VO_ULDA_Brann_Male_Dwarf_MIRROR_GREETINGS_01	Lo mismo digo, colega.	
VO_ULDA_Brann_Male_Dwarf_MIRROR_START_01	¡Alguien ha duplicado mi grito de batalla!	
VO_ULDA_Brann_Male_Dwarf_NoCards_01	¡Ya no tengo cartas!	
VO_ULDA_Brann_Male_Dwarf_Oops_02	Nadie necesita enterarse de ese pequeño desliz.	
VO_ULDA_Brann_Male_Dwarf_Picked_01	Este lugar tiene las respuestas. ¡Puedo sentirlo!	
VO_ULDA_Brann_Male_Dwarf_PIRATE_DAY_01	¡¡Ah del barco, marineros!! Je. Bueno. ¿Qué tal?	
VO_ULDA_Brann_Male_Dwarf_Sorry_01	Ajj… Lo siento.	
VO_ULDA_Brann_Male_Dwarf_Start_01	Ahora no podrás escapar.	
VO_ULDA_Brann_Male_Dwarf_Thanks_02	¡Muchas gracias por eso!	
VO_ULDA_Brann_Male_Dwarf_Thinking_01	Mmm...	
VO_ULDA_Brann_Male_Dwarf_Thinking_02	…Quizá sea una trampa…	
VO_ULDA_Brann_Male_Dwarf_Thinking_03	…Piensa, Brann, piensa…	
VO_ULDA_Brann_Male_Dwarf_Thinking_04	…Si esta jugada sale bien…	
VO_ULDA_Brann_Male_Dwarf_Thinking_05	…Ya está aquí… Te busca a ti…	
VO_ULDA_Brann_Male_Dwarf_Thinking_06	…La Liga de Expedicionarios…	
VO_ULDA_Brann_Male_Dwarf_Threaten_02	¡No podrás detenerme!	
VO_ULDA_Brann_Male_Dwarf_Time_01	El tiempo no se detiene.	
VO_ULDA_Brann_Male_Dwarf_Well_Played_01	¡Así se hace!	
VO_ULDA_Brann_Male_Dwarf_WOW_01	¡Por las barbas de diamante de Magni!	
VO_ULDA_Elise_Female_NightElf_Concede_02	Sería sabio… ¡retirarse!	
VO_ULDA_Elise_Female_NightElf_Death_02	Así no...	
VO_ULDA_Elise_Female_NightElf_ERROR_FULL_MINIONS_01	No tengo espacio para más esbirros.	
VO_ULDA_Elise_Female_NightElf_ERROR_GENERIC_01	Absolutamente imposible.	
VO_ULDA_Elise_Female_NightElf_ERROR_HAND_FULL_01	¡No puedo sujetar más cartas!	
VO_ULDA_Elise_Female_NightElf_ERROR_I_ATTACKED_01	Ya ataqué.	
VO_ULDA_Elise_Female_NightElf_ERROR_MINION_ATTACKED_01	Ese esbirro está agotado. 	
VO_ULDA_Elise_Female_NightElf_ERROR_NEED_MANA_01	No tengo suficiente maná.	
VO_ULDA_Elise_Female_NightElf_ERROR_NEED_WEAPON_01	Ten la amabilidad de equipar un arma.	
VO_ULDA_Elise_Female_NightElf_ERROR_PLAY_01	No lo creo.	
VO_ULDA_Elise_Female_NightElf_ERROR_STEALTH_01	Aún está en sigilo.	
VO_ULDA_Elise_Female_NightElf_ERROR_SUMMON_SICKNESS_01	Necesita una siestecita.	
VO_ULDA_Elise_Female_NightElf_ERROR_TARGET_01	Eso está fuera de mi alcance.	
VO_ULDA_Elise_Female_NightElf_ERROR_TAUNT_01	Hay algo con Provocación en el camino.	
VO_ULDA_Elise_Female_NightElf_Greetings_01	¡Soy Elisa Buscaestelar, y no te saldrás con la tuya!	
VO_ULDA_Elise_Female_NightElf_HAPPY_BIRTHDAY_01	Que tengas un día inolvidable.	
VO_ULDA_Elise_Female_NightElf_HAPPY_HALLOWEEN_01	¡Los orígenes de Halloween son aterradores!	
VO_ULDA_Elise_Female_NightElf_HAPPY_HOLIDAYS_01	¿Te has portado bien con el Gran Padre Invierno?	
VO_ULDA_Elise_Female_NightElf_HAPPY_NEW_YEAR_01	¡Feliz año nuevo!	
VO_ULDA_Elise_Female_NightElf_HAPPY_NEW_YEAR_LUNAR_01	¡Feliz año nuevo!	
VO_ULDA_Elise_Female_NightElf_HAPPY_NOBLEGARDEN_01	Ah, ¡me encanta el Jardín Noble!	
VO_ULDA_Elise_Female_NightElf_LowCards_01	Tengo pocas cartas.	
VO_ULDA_Elise_Female_NightElf_MIRROR_GREETINGS_01	¿En serio? No creo que puedas sorprenderme. 	
VO_ULDA_Elise_Female_NightElf_MIRROR_START_01	Al parecer, soy mi propia peor enemiga.	
VO_ULDA_Elise_Female_NightElf_NoCards_01	¡Ya no tengo más cartas!	
VO_ULDA_Elise_Female_NightElf_Oops_01	Un error.	
VO_ULDA_Elise_Female_NightElf_Picked_01	Hora de entrar en acción.	
VO_ULDA_Elise_Female_NightElf_PIRATE_DAY_01	¡Capitana BuscaestelaRRRR a su servicio, camarada!	
VO_ULDA_Elise_Female_NightElf_Sorry_01	Mis disculpas.	
VO_ULDA_Elise_Female_NightElf_Start_02	¡La Liga de Expedicionarios no fracasará!	
VO_ULDA_Elise_Female_NightElf_Thanks_02	¡Estoy sumamente agradecida!	
VO_ULDA_Elise_Female_NightElf_Thinking_01	No puedo fallar…	
VO_ULDA_Elise_Female_NightElf_Thinking_02	Hay mucho en juego…	
VO_ULDA_Elise_Female_NightElf_Thinking_03	Mmm…	
VO_ULDA_Elise_Female_NightElf_Thinking_04	Qué curioso...	
VO_ULDA_Elise_Female_NightElf_Threaten_01	Te lo advierto. He estudiado para esta pelea.	
VO_ULDA_Elise_Female_NightElf_Time_01	El tiempo se acaba. 	
VO_ULDA_Elise_Female_NightElf_Well_Played_01	La historia nunca olvidará esta batalla.	
VO_ULDA_Elise_Female_NightElf_WOW_01	Increíble.	
VO_ULDA_Finley_Male_Murloc_Concede_01	Muy bien, la victoria es tuya.	
VO_ULDA_Finley_Male_Murloc_ERROR_FULL_MINIONS_01	No hay espacio suficiente.	
VO_ULDA_Finley_Male_Murloc_ERROR_GENERIC_04	Eso sería descortés.	
VO_ULDA_Finley_Male_Murloc_ERROR_HAND_FULL_02	Demasiadas cartas… ¡oh! Oh, rayos.	
VO_ULDA_Finley_Male_Murloc_ERROR_I_ATTACKED_02	Es de buenos competidores atacar solo una vez por turno.	
VO_ULDA_Finley_Male_Murloc_ERROR_MINION_ATTACKED_01	Ese esbirro ya atacó.	
VO_ULDA_Finley_Male_Murloc_ERROR_NEED_MANA_02	Necesitaré más maná para eso. 	
VO_ULDA_Finley_Male_Murloc_ERROR_NEED_WEAPON_02	Necesitaré un arma para eso.	
VO_ULDA_Finley_Male_Murloc_ERROR_PLAY_01	No puedo jugar eso.	
VO_ULDA_Finley_Male_Murloc_ERROR_STEALTH_01	Ese esbirro tiene sigilo.	
VO_ULDA_Finley_Male_Murloc_ERROR_SUMMON_SICKNESS_01	Dale a ese esbirro un momento para prepararse.	
VO_ULDA_Finley_Male_Murloc_ERROR_TARGET_02	Se necesita un objetivo.	
VO_ULDA_Finley_Male_Murloc_ERROR_TAUNT_02	Ese esbirro con Provocación es una verdadera molestia.	
VO_ULDA_Finley_Male_Murloc_Greetings_01	¡Oh, vaya! Buen día.	
VO_ULDA_Finley_Male_Murloc_HAPPY_BIRTHDAY_01	¡Feliz cumpleaños!	
VO_ULDA_Finley_Male_Murloc_HAPPY_BREWFEST_01	¿Fiesta de la Cerveza? Beberé hasta ver peces de colores.	
VO_ULDA_Finley_Male_Murloc_HAPPY_HALLOWEEN_01	Halloween... ¡Oh! Una festividad aterradora.	
VO_ULDA_Finley_Male_Murloc_HAPPY_HOLIDAYS_01	¡Feliz festividad!	
VO_ULDA_Finley_Male_Murloc_HAPPY_NEW_YEAR_01	¡Feliz año nuevo!	
VO_ULDA_Finley_Male_Murloc_HAPPY_NEW_YEAR_LUNAR_01	¡Feliz año nuevo!	
VO_ULDA_Finley_Male_Murloc_HAPPY_NOBLEGARDEN_01	Tomémonos un momento para reflexionar sobre los orígenes paganos de Jardín Noble.	
VO_ULDA_Finley_Male_Murloc_LowCards_01	Tengo poquísimas cartas. 	
VO_ULDA_Finley_Male_Murloc_MIRROR_GREETINGS_01	Sir Aletardo supongo. 	
VO_ULDA_Finley_Male_Murloc_MIRROR_START_01	¡Santa ciencia! ¡Un murlocgänger! 	
VO_ULDA_Finley_Male_Murloc_NoCards_01	¡Me estoy quedando seco!	
VO_ULDA_Finley_Male_Murloc_Oops_01	Ay, no. Qué equivocación.	
VO_ULDA_Finley_Male_Murloc_Picked_02	¡Un día espléndido para una aventura! Eh, a pesar de las plagas.	
VO_ULDA_Finley_Male_Murloc_PIRATE_DAY_01	Ah, ¿hay que hacer como pirata? ¿Arrr?	
VO_ULDA_Finley_Male_Murloc_Sorry_01	Ay, lo siento mucho. 	
VO_ULDA_Finley_Male_Murloc_Start_01	¡A un lado, escoria! Es hora de salvar el mundo. 	
VO_ULDA_Finley_Male_Murloc_Thanks_01	¡Muchísimas gracias!	
VO_ULDA_Finley_Male_Murloc_Thinking_01	Mmm....	
VO_ULDA_Finley_Male_Murloc_Thinking_02	…y ahora…	
VO_ULDA_Finley_Male_Murloc_Thinking_03	…qué embrollo…	
VO_ULDA_Finley_Male_Murloc_Thinking_04	…ya lo creo…	
VO_ULDA_Finley_Male_Murloc_Thinking_05	…esto sí que está difícil…	
VO_ULDA_Finley_Male_Murloc_Threaten_03	Muy bien. Fuera guantes.	
VO_ULDA_Finley_Male_Murloc_Time_01	La hora del té terminó. 	
VO_ULDA_Finley_Male_Murloc_Well_Played_01	Muy buen espectáculo.	
VO_ULDA_Finley_Male_Murloc_WOW_01	¡Santas croquetas!	
VO_ULDA_Reno_Male_Human_Attack_01	<Estertor de ataque>	
VO_ULDA_Reno_Male_Human_Concede_01	¡Nunca te rindas! Es mejor huir.	
VO_ULDA_Reno_Male_Human_Death_01	<Muerte>	
VO_ULDA_Reno_Male_Human_ERROR_FULL_MINIONS_01	No hay suficiente lugar.	
VO_ULDA_Reno_Male_Human_ERROR_GENERIC_02	Si pudiera... lo haría.	
VO_ULDA_Reno_Male_Human_ERROR_HAND_FULL_02	¡¿Qué voy a hacer con todas estas cartas?!	
VO_ULDA_Reno_Male_Human_ERROR_I_ATTACKED_02	¡Tengo que recuperar el aliento!	
VO_ULDA_Reno_Male_Human_ERROR_MINION_ATTACKED_01	Ese esbirro ya atacó.	
VO_ULDA_Reno_Male_Human_ERROR_NEED_MANA_01	¡Necesito maná!	
VO_ULDA_Reno_Male_Human_ERROR_NEED_WEAPON_01	Necesito un arma.	
VO_ULDA_Reno_Male_Human_ERROR_PLAY_01	No puedo hacer esa jugada. 	
VO_ULDA_Reno_Male_Human_ERROR_STEALTH_02	Ese esbirro se oculta. Qué escurridizo.	
VO_ULDA_Reno_Male_Human_ERROR_SUMMON_SICKNESS_01	Ese esbirro necesita un turno para prepararse.	
VO_ULDA_Reno_Male_Human_ERROR_TARGET_01	¡Necesito un objetivo!	
VO_ULDA_Reno_Male_Human_ERROR_TAUNT_01	Hay un esbirro con Provocación en el camino.	
VO_ULDA_Reno_Male_Human_Greetings_01	¡Me quito el sombrero!	
VO_ULDA_Reno_Male_Human_HAPPY_BIRTHDAY_02	¡Ey! ¡Es tu cumpleaños! Pide un deseo: ¡nada de dobles!	
VO_ULDA_Reno_Male_Human_HAPPY_BREWFEST_01	¡Fiesta de la Cerveza! Mi tipo de festividad. 	
VO_ULDA_Reno_Male_Human_HAPPY_HALLOWEEN_01	Halloween me da escalofríos.	
VO_ULDA_Reno_Male_Human_HAPPY_HOLIDAYS_01	¡Feliz festividad!	
VO_ULDA_Reno_Male_Human_HAPPY_NEW_YEAR_01	¡Feliz año nuevo!	
VO_ULDA_Reno_Male_Human_HAPPY_NEW_YEAR_LUNAR_01	¡Feliz año nuevo!	
VO_ULDA_Reno_Male_Human_HAPPY_NOBLEGARDEN_01	Es Jardín Noble. ¡Dame esa canasta!	
VO_ULDA_Reno_Male_Human_KISS_01	<Sonido de beso>	
VO_ULDA_Reno_Male_Human_LowCards_01	Creo que mis cartas empiezan a escasear...	
VO_ULDA_Reno_Male_Human_MIRROR_GREETINGS_01	...Ese es MI sombrero.	
VO_ULDA_Reno_Male_Human_MIRROR_START_01	Una de dos no está mal.	
VO_ULDA_Reno_Male_Human_NoCards_01	¡No tengo más!	
VO_ULDA_Reno_Male_Human_Oops_02	Nadie vio eso. Espero.	
VO_ULDA_Reno_Male_Human_Picked_02	Dame mi sombrero, Aletardo. ¡Allá voy!	
VO_ULDA_Reno_Male_Human_PIRATE_DAY_01	Sí, soy el CAPITÁN JACKSON para ti, mequetrefe. Jo, jo, qué bien.	
VO_ULDA_Reno_Male_Human_Sorry_01	Debería disculparme por eso.	
VO_ULDA_Reno_Male_Human_Start_01	¡Vamos a ser ricos! ¡Y a salvar el mundo!	
VO_ULDA_Reno_Male_Human_Thanks_01	Ah. Gracias.	
VO_ULDA_Reno_Male_Human_Thinking_01	Mmm....	
VO_ULDA_Reno_Male_Human_Thinking_02	Esto no se ve bien…	
VO_ULDA_Reno_Male_Human_Thinking_03	Es tan alocado que... tal vez funcione...	
VO_ULDA_Reno_Male_Human_Thinking_04	Has estado en aprietos peores, Reno…	
VO_ULDA_Reno_Male_Human_Threaten_02	Podemos hacer esto por las buenas... o a MI manera.	
VO_ULDA_Reno_Male_Human_Time_01	Tengo que apresurarme...	
VO_ULDA_Reno_Male_Human_Well_Played_01	¡Una maniobra brillante!	
VO_ULDA_Reno_Male_Human_WOW_01	¡Santa madre de múrlocs!	
VO_YOD_009_Male_Human_Concede_01	Agh. Tú ganas.	
VO_YOD_009_Male_Human_ERROR_FULL_MINIONS_02	Ya tengo demasiados esbirros.	
VO_YOD_009_Male_Human_Greetings_01	¡Jaja, seré rico!	
VO_YOD_009_Male_Human_LowCards_01	Se me terminan los hechizos.	
VO_YOD_009_Male_Human_MIRROR_GREETINGS_01	Je, ¡NOSOTROS seremos ricos!	
VO_YOD_009_Male_Human_MIRROR_START_01	¡Ey! ¡Esta tumba es mía! ¡Yo la vi primero!	
VO_YOD_009_Male_Human_NoCards_01	¡No me quedan cartas!	
VO_YOD_009_Male_Human_Oops_01	Ja. Eh, estaba todo planeado.	
VO_YOD_009_Male_Human_Picked_01	Lancemos algunos hechizos.	
VO_YOD_009_Male_Human_Sorry_01	¡Lo siento!	
VO_YOD_009_Male_Human_Start_01	¿Alguna tumba para saquear?	
VO_YOD_009_Male_Human_Thanks_01	¡Gracias! Debo admitir que soy increíble.	
VO_YOD_009_Male_Human_Thinking_01	Mmmm...	
VO_YOD_009_Male_Human_Thinking_03	Si tan solo pudiera… lanzar ese hechizo…	
VO_YOD_009_Male_Human_Thinking_04	Algo que nos vuelva ricos…	
VO_YOD_009_Male_Human_Threaten_01	¡No me hagas usar mi hechizo secreto!	
VO_YOD_009_Male_Human_Time_01	¡Pensé que tenía más tiempo!	
VO_YOD_009_Male_Human_Well_Played_01	Parece que tú también tienes ases bajo la manga.	
VO_YOD_009_Male_Human_WOW_01	¡Increíble! ¡Como yo!	
