TAG	TEXT	COMMENT
ChromaggusBoss_Death_1	¡Rrraaaaaarrr!	
ChromaggusBoss_EmoteResponse_1	*Rugido*	
ChromaggusBoss_Start_1	¡Rrrraaarr!	
LOE_07_MINE_CART_EMOTES	Clonk	
OnyxiaBoss_Death_1	¡Rrraaaaaarrr!	
OnyxiaBoss_EmoteResponse_1	*Rugido*	
OnyxiaBoss_Start_1	¡Rrrraaarr!	
VO_Aran_Male_Shade_AranCrackle_01	Pff. En mi época, Chisporroteo siempre infligía seis de daño.	
VO_Aran_Male_Shade_AranDeath_02	Otra vez no...	
VO_Aran_Male_Shade_AranEmoteResponse_01	¡Fuera! ¡Fuera!	
VO_Aran_Male_Shade_AranHeroPower_01	¡Ardan, vándalos!	
VO_Aran_Male_Shade_AranMedivhSkin_01	¿Medivh? No, no... ¡No estaba molestando a los invitados!	
VO_Aran_Male_Shade_AranOpen_01	¡A ver si aprendes modales!	
VO_Aran_Male_Shade_AranSpell_03	¡Regresa a la fría oscuridad!	
VO_Aran_Male_Shade_AranSpell_04	El maestro es poderoso, ¡pero yo también tengo mis trucos bajo la manga!	
VO_Aran_Male_Shade_AranTrons_02	¡NO! ¡NO! ¡Odio el ruido! ¡Todos esos "holas"!	
VO_Aran_Male_Shade_AranTurn1_01	¡Nada de música fuerte en mi torre!	
VO_Aran_Male_Shade_AranTurn5_01	¡No soy un simple bufón! ¡Soy Nielas Aran!	
VO_Barnes_Male_Human_FinalNazraTurn5_02	¡Socorro! ¡Nos quedamos sin bananas! ¡Mukla está destruyendo toda la despensa!	
VO_Barnes_Male_Human_JulianneTurn5_01	¿Qué es una fiesta sin una obra? ¿Y qué es una obra sin público?	
VO_Barnes_Male_Human_JulianneWin_01	¡Ha finalizado un acto! ¡Restan dos!	
VO_Barnes_Male_Human_Wing2Intro_02	¡Bienvenido al teatro! Soy Barnes, el director de escena. Los portales para salvar a Medivh están en el piso de arriba, pero primero, ¡tenemos un espectáculo que no te puedes perder!	
VO_Barnes_Male_Human_WolfBigMinion_01	¡Oh, abuelita, pero qué esbirros tan grandes tienes!	
VO_Barnes_Male_Human_WolfClaws_01	¡No te preocupes! ¡Esas garras enormes son de utilería!	
VO_Barnes_Male_Human_WolfTurn5_01	¡Me encanta involucrar al público! ¡Corre, invitado, corre!	
VO_Barnes_Male_Human_WolfTurn9_01	¡Jaja! ¡Qué gran espectáculo! ¡Mejor que ese ogro que perseguimos la semana pasada!	
VO_Barnes_Male_Human_WolfWin_01	¡Ajá! ¡El gran final espera!	
VO_BigBadWolf_Male_Worgen_WolfBigMinion_01	¡Para aplastarte mejor!	
VO_BigBadWolf_Male_Worgen_WolfDeath_01	¿Cazado? No...	
VO_BigBadWolf_Male_Worgen_WolfDireWolfAlpha_01	*Gruñido*	
VO_BigBadWolf_Male_Worgen_WolfDireWolfAlpha_02	*Quejido*	
VO_BigBadWolf_Male_Worgen_WolfEmoteResponse_01	Mmmm...\nDelicioso...	
VO_BigBadWolf_Male_Worgen_WolfOpen_01	¡Huye, pequeña! ¡Corre!	
VO_BigBadWolf_Male_Worgen_WolfScarletCrusader_01	Oh, capita roja, ¿a dónde vas?	
VO_BigBadWolf_Male_Worgen_WolfTurn1_01	Mira a tus esbirros. ¿Ves cómo se acobardan ante mi presencia?	
VO_BlackKing_Male_ChessPiece_ChessEmoteGreetings_01	Siempre.	
VO_BlackKing_Male_ChessPiece_ChessEmoteOops_01	¿O será una trampa?	
VO_BlackKing_Male_ChessPiece_ChessEmoteSorry_01	Fue un sacrificio necesario.	
VO_BlackKing_Male_ChessPiece_ChessEmoteThanks	Cuando quieras.	
VO_BlackKing_Male_ChessPiece_ChessEmoteThanks_01	Cuando quieras.	
VO_BlackKing_Male_ChessPiece_ChessEmoteThreaten_01	Veo una gran jugada en 3 movimientos.	
VO_BlackKing_Male_ChessPiece_ChessEmoteWellPlayed_01	Todavía no.	
VO_BlackKing_Male_ChessPiece_ChessEmoteWow_01	Naturalmente.	
VO_BlackKing_Male_ChessPiece_ChessOpen_01	¡Nadie pasará!	
VO_BOSS_AYA_Female_Pandaren_BC_0_Jade_Golem_02	¿Más gólems? ¡Súper!	
VO_BOSS_AYA_Female_Pandaren_BC_0_Jade_Golem_03	¡Jeje! ¡Adelante, mi ejército!	
VO_BOSS_AYA_Female_Pandaren_BC_0_Jade_Golem_04	¡Otro! ¡OTRO!	
VO_BOSS_AYA_Female_Pandaren_BC_2_1st_Turn_Start_01	Sí, claro... ¡Quiero Gadgetzan para MÍ!	
VO_BOSS_AYA_Female_Pandaren_BC_2_2nd_Turn_Start_01	¡Gadgetzan le pertenece al Loto de jade, y el Loto me pertenece a mí!	
VO_BOSS_AYA_Female_Pandaren_BC_2_Arms_Dealing1_01	Más armas. ¡Qué original!	
VO_BOSS_AYA_Female_Pandaren_BC_2_Fill1_01	Ooooh, ¡esto te va a encantar!	
VO_BOSS_AYA_Female_Pandaren_BC_2_Fill2_01	Nahhh, me gusta este lugar. Creo que me quedaré.	
VO_BOSS_AYA_Female_Pandaren_BC_2_Goons_Win_01	¡Nonononono! ¡Esto APEEESTA!	
VO_BOSS_AYA_Female_Pandaren_BC_2_Goons_Winning_02	¡Tal vez deberías CALLARTE!	
VO_BOSS_AYA_Female_Pandaren_BC_2_Jade_Win_01	¡El Loto de jade vuelve a ganar! ¡Soy la mejor!	
VO_BOSS_AYA_Female_Pandaren_BC_2_Lotus_Winning_01	*je je* ¡Sigue jugando, sigue jugando!	
VO_BOSS_AYA_Female_Pandaren_BC_3_1st_Turn_Start_01	¡Gadgetzan es LO MÁXIMO! ¡La quiero toda para mí!	
VO_BOSS_AYA_Female_Pandaren_BC_3_1st_Turn_Start_02	Jejeje, con gusto....	
VO_BOSS_AYA_Female_Pandaren_BC_3_2nd_Turn_Start_01	Ay, ustedes los Kabal son taaaan aburridos....	
VO_BOSS_AYA_Female_Pandaren_BC_3_Fill1_01	Qué día tan bonito, ¿no crees, Kazzy?	
VO_BOSS_AYA_Female_Pandaren_BC_3_Fill2_01	Ay, por favor, Kazzy, relájate un poco. Diviértete.	
VO_BOSS_AYA_Female_Pandaren_BC_3_Jade_Golem3_01	¡Jejejeje!	
VO_BOSS_AYA_Female_Pandaren_BC_3_Kabal_Winning_01	Pero solo porque eres tan aburrido.	
VO_BOSS_AYA_Female_Pandaren_BC_3_Kabal_Wins_01	¡Esto no puede estar pasando! NO NO NO NO Y NO!	
VO_BOSS_AYA_Female_Pandaren_BC_3_Lotus_Winning_01	Oh, ¿qué pasa, Kazzy? No te ves nada bien.	
VO_BOSS_AYA_Female_Pandaren_BC_3_Lotus_Wins_01	Bueno, eso fue divertido. Gracias por jugar, Kazzy	
VO_BOSS_AYA_Female_Pandaren_BC_3_Potion1_02	Bla bla pociones bla bla... ¡VEN AQUÍ A PELEAR!	
VO_BOSS_AYA_Female_Pandaren_BC_3_Potion3_01	¡Puaj! Esto es asqueroso.	
VO_BOSS_AYA_Female_Pandaren_Concede_01	Oh, eso no fue divertido.	
VO_BOSS_AYA_Female_Pandaren_Greetings_01	¡Holis!	
VO_BOSS_AYA_Female_Pandaren_Oops_01	¡Upsi!	
VO_BOSS_AYA_Female_Pandaren_START_01	¡Preparen a los gólems!	
VO_BOSS_AYA_Female_Pandaren_Thanks_02	¡Gracias!	
VO_BOSS_AYA_Female_Pandaren_Threaten_02	Mm, supongo que ahora vas a tener que morir.	
VO_BOSS_AYA_Female_Pandaren_Well_Played_01	¡Eso fue genial!	
VO_BOSS_AYA_Female_Pandaren_Wow_02	¡Guau!	
VO_BOSS_CHO_Male_Ogre_BC_1_1st_Turn_Start_01	¡LOS MATONES MALOSOS LAS HACEN PELIGROSAS!	
VO_BOSS_CHO_Male_Ogre_BC_1_Fill2_01	¡A ELLOS, MUCHACHOS!	
VO_BOSS_CHO_Male_Ogre_BC_2_Fill1_01	¡ESA CHICA TIENE MIRADA LOCA!	
VO_BOSS_CHO_Male_Ogre_Concede_01	¡SÍ! ¡EY! NO, ES TUYA.	
VO_BOSS_CHO_Male_Ogre_Oops_02	¡ERROR COMETIDO!	
VO_BOSS_CHO_Male_Ogre_Thanks_01	GRACIAS.	
VO_BOSS_HAN_Male_Ogre_BC_0_Arms_Dealing_01	Ey, mira lo que encontré en la calle, je je…	
VO_BOSS_HAN_Male_Ogre_BC_0_Arms_Dealing_02	¡Reúnan a los Matones!	
VO_BOSS_HAN_Male_Ogre_BC_0_Arms_Dealing_03	¡Pónganle un traje a ese matón y sáquenlo de aquí!	
VO_BOSS_HAN_Male_Ogre_BC_0_Arms_Dealing_04	Los Matones malosos se reúnen.	
VO_BOSS_HAN_Male_Ogre_BC_1_1st_Turn_Start_01	Estas son calles peligrosas, Kazakus.	
VO_BOSS_HAN_Male_Ogre_BC_1_2nd_Turn_Start_01	¡Gadgetzan le pertenece a los Matones!	
VO_BOSS_HAN_Male_Ogre_BC_1_2nd_Turn_Start_02	Sí, todo muy bonito. Pero Gadgetzan le pertenece a los Matones.	
VO_BOSS_HAN_Male_Ogre_BC_1_Fill1_01	¡Empaca tus pociones y lárgate!	
VO_BOSS_HAN_Male_Ogre_BC_1_Fill2_01	Ey, Cho, reúne a los Matones. Este trol necesita una lección.	test
VO_BOSS_HAN_Male_Ogre_BC_1_Goons_Win_01	Lo siento, Kazakus. Negocios son negocios.	
VO_BOSS_HAN_Male_Ogre_BC_1_Goons_Winning_01	Oh, parece que tuviste un accidente, Kazakus...	
VO_BOSS_HAN_Male_Ogre_BC_1_Kabal_Win_02	Esto... no ha... terminado... Kazakus.	
VO_BOSS_HAN_Male_Ogre_BC_1_Kabal_Winning_02	Je. Nada mal, anciano.	
VO_BOSS_HAN_Male_Ogre_BC_1_Potion1_01	¿Sabes? Nunca me gustaron las pociones.	
VO_BOSS_HAN_Male_Ogre_BC_1_Potion2_01	¡Oye! ¡Cuidado con dónde tiras eso!	
VO_BOSS_HAN_Male_Ogre_BC_2_1st_Turn_Start_01	Gadgetzan nos pertenece. ¡Lárgate, niñita!	
VO_BOSS_HAN_Male_Ogre_BC_2_1st_Turn_Start_04	¿Sí? Pues los Matones malosos tenemos una opinión al respecto.	
VO_BOSS_HAN_Male_Ogre_BC_2_Fill1_01	No me gusta esa mirada, Aya...	
VO_BOSS_HAN_Male_Ogre_BC_2_Goons_Win_01	Tómate un descanso, Aya. Jeje. Te hará bien.	
VO_BOSS_HAN_Male_Ogre_BC_2_Goons_Winning_01	Tal vez te convendría reconsiderar tu postura.	
VO_BOSS_HAN_Male_Ogre_BC_2_Jade_Golem2_01	Ya me estoy cansando de estos muchachitos de jade.	
VO_BOSS_HAN_Male_Ogre_BC_2_Lotus_Win_01	*Gah* Gadgetzan será nuestra....	
VO_BOSS_HAN_Male_Ogre_BC_2_Lotus_Winning_01	¡Que alguien saque a esta niñita de aquí!	
VO_BOSS_HAN_Male_Ogre_Concede_01	¿Sabes que todo esto es tu culpa?	
VO_BOSS_HAN_Male_Ogre_Greetings_01	Ey, bienvenido a Gadgetzan.	
VO_BOSS_HAN_Male_Ogre_INTRO_PACK_OPEN_7	Jojooo... ¿Quién es ese muchachote tan apuesto?	
VO_BOSS_HAN_Male_Ogre_Oops_01	Eso no está bien.	
VO_BOSS_HAN_Male_Ogre_START_01	¡Ahora estás en nuestro territorio!	
VO_BOSS_HAN_Male_Ogre_Thanks_01	Nos has prestado un gran servicio.	test
VO_BOSS_HAN_Male_Ogre_Threaten_01	No deberías negarte.	
VO_BOSS_HAN_Male_Ogre_Well_Played_02	Debo decir que estoy impresionado.	
VO_BOSS_HAN_Male_Ogre_WOW_01	Nada mal.	
VO_BOSS_KAZAKUS_Male_Troll_BC_0_Potion_01	Ahhh, qué refrescante....	
VO_BOSS_KAZAKUS_Male_Troll_BC_0_Potion_02	¡Toma esto!	
VO_BOSS_KAZAKUS_Male_Troll_BC_0_Potion_04	Bebe hasta la última gota....	
VO_BOSS_KAZAKUS_Male_Troll_BC_0_Potion_05	¿A qué sabe?	
VO_BOSS_KAZAKUS_Male_Troll_BC_1_1st_Turn_Start_01	¡Gadgetzan será mía, Han'Cho!	
VO_BOSS_KAZAKUS_Male_Troll_BC_1_2nd_Turn_Start_01	¡Los Kabal están por todos lados! ¡Gadgetzan nos obedece!	
VO_BOSS_KAZAKUS_Male_Troll_BC_1_Arms_Dealing1_01	Mmm, típica cobardía de los Matones. ¡YA DEJEN DE OCULTARSE EN LA MANO! 	
VO_BOSS_KAZAKUS_Male_Troll_BC_1_Fill1_01	¡Mis Kabal controlan un poder ilimitado!	
VO_BOSS_KAZAKUS_Male_Troll_BC_1_Goons_Win_01	¡Volveré... más poderoso que nunca!	
VO_BOSS_KAZAKUS_Male_Troll_BC_1_Goons_Winning_01	Sufrirás, Han'Cho....	
VO_BOSS_KAZAKUS_Male_Troll_BC_1_Kabal_Win_01	Oh. Claro que sí.	
VO_BOSS_KAZAKUS_Male_Troll_BC_1_Kabal_Winning_01	Tu destino se acerca, Han'Cho.	
VO_BOSS_KAZAKUS_Male_Troll_BC_3_1st_Turn_Start_01	Jejeje. Tendrás que eliminarme para quedártela....	
VO_BOSS_KAZAKUS_Male_Troll_BC_3_Fill1_01	¡NO ME LLAMES ASÍ, NIÑA ARROGANTE!	
VO_BOSS_KAZAKUS_Male_Troll_BC_3_Fill2_01	¡Arrodíllate ante el poder de los Kabal!	
VO_BOSS_KAZAKUS_Male_Troll_BC_3_Jade_Golem2_01	¡Niña insolente! ¿Cómo te atreves a burlarte del líder más poderoso de Gadgetzan?	
VO_BOSS_KAZAKUS_Male_Troll_BC_3_Jade_Golem3_01	¡Niña insolente! ¡Ya estoy harto de este jueguito con los gólems!	
VO_BOSS_KAZAKUS_Male_Troll_BC_3_Kabal_Winning_01	Jeje, te ves un poco cansada, niña.	
VO_BOSS_KAZAKUS_Male_Troll_BC_3_Kabal_Winning_02	¡¿Qué?! ¡Niña insolente! ¡Seré tu PERDICIÓN!	test
VO_BOSS_KAZAKUS_Male_Troll_BC_3_Kabal_Wins_01	¡Jaja! ¡Otro enemigo cae ante el poder de los Kabal!	
VO_BOSS_KAZAKUS_Male_Troll_BC_3_Lotus_Winning_01	¡Mocosa presumida!	
VO_BOSS_KAZAKUS_Male_Troll_BC_3_Lotus_Wins_01	Niña tonta. Esto no ha terminadooo....	
VO_BOSS_KAZAKUS_Male_Troll_BC_3_Potion1_01	Siente la furia de las pociones de los Kabal.	
VO_BOSS_KAZAKUS_Male_Troll_Concede_01	Estas calles... son... mías...	
VO_BOSS_KAZAKUS_Male_Troll_Greetings_02	¡Hola, tontos!	test
VO_BOSS_KAZAKUS_Male_Troll_Mirror_Start_01	Parece que tienes algún talento.	
VO_BOSS_KAZAKUS_Male_Troll_Oops_01	Un error de cálculo.	
VO_BOSS_KAZAKUS_Male_Troll_START_01	El maná llama.	
VO_BOSS_KAZAKUS_Male_Troll_Thanks_01	Te lo agradezco mucho, peón.	
VO_BOSS_KAZAKUS_Male_Troll_Threaten_01	¡YO CONTROLO GADGETZAN!	
VO_BOSS_KAZAKUS_Male_Troll_Well_Played_02	Tienes mucho potencial...	
VO_BOSS_KAZAKUS_Male_Troll_Wow_01	¡Cuánto poder!	
VO_BRANN_MITHRIL_ALT_02	Fascinante. Estas runas de mitril contienen códigos de protección. ¡Deben ser de la época de los titanes!	
VO_BRANN_WIN_07_ALT_07	¡Excelente! ¡La cabeza del báculo está en el siguiente cuarto!	
VO_BRM_027h_Death_63	¡No! ¡NO! ¡NOOOOOOOOOOOO!	
VO_BRMA01_1_CARD_05	Uoo, vamos. Démosles una cálida bienvenida.	
VO_BRMA01_1_DEATH_09	¡Uoo! Jaja ¿Uh? ¿Qué...eh? ¡Oh! No me gusta nada, ¡pero igual está sucediendo!	
VO_BRMA01_1_ETC_06	¡Es hora de un poco de entretenimiento EN VIVO! ¡Denle la bienvenida a Elite Tauren Chieftain!	
VO_BRMA01_1_HERO_POWER_04	¡Jajajaja! ¡Todos al montón!	
VO_BRMA01_1_RESPONSE_03	¡Jajajaja! Oh, *hic* Perdón.	
VO_BRMA01_1_START_01	Bienvenido al Tragapenas.	
VO_BRMA01_1_SUCCUBUS_08	Nagmara. Creo que nuestro "colega" necesita un "trago".	
VO_BRMA01_1_TURN1_02	¡Oigan! Jaja. Miren todos. Tenemos una "visita".	
VO_BRMA01_1_WARGOLEM_07	¡Ojojo! Ahora sí que estás en problemas. ¡Falange! ¡Qué no se escape!	
VO_BRMA02_1_ALAKIR_34	A este Señor elemental le encanta aplastar insectos... ¡Al'Akir!	
VO_BRMA02_1_ALEXSTRAZA_32	Protectora, Reina dragón, luchadora de la Arena Hierro Negro... ¡Aaaalexstraza!	
VO_BRMA02_1_BEAST_22	Su comida favorita son los gnomos, pero hoy hará una excepción. Es... ¡La Bestia!	
VO_BRMA02_1_BOOM_28	Espero que los de la primera fila hayan traído gafas protectoras, porque el próximo oponente es, ¡el Dr. Bum!	
VO_BRMA02_1_CAIRNE_20	Él está criando a su hijo para que siga sus huellas. ¡Quiero oírlos gritar por CAIRNE PEZUÑA DE SANGRE!	
VO_BRMA02_1_CHO_07	Es hora del cuento de las buenas noches con el Pandaren más tierno: ¡el Eremita Cho!	
VO_BRMA02_1_DEATH_38	¡Hjt! ¿Eh? ¡Uoo! *Estertor de muerte*	
VO_BRMA02_1_DEATHWING_35	¡OOOOOoh! ¡Damas y enanos! El único, el inigualable... ¡ALAMUERTE!	
VO_BRMA02_1_ETC_18	Y ahora, el tauren, el mito, la leyenda... ¡Elite Tauren Chieftain!	
VO_BRMA02_1_FEUGEN_15	¡Fuerte ese aplauso! Eeees... ¡Feugen!	
VO_BRMA02_1_FOEREAPER_29	Está mecánicamente calibrado para la destrucción máxima. ¡Es el Siegaenemigos 4000!	
VO_BRMA02_1_GEDDON_13	Ooh, ¡la Arena está caliente! Denle la bienvenida al Barón Geddon.	
VO_BRMA02_1_GELBIN_21	Directamente desde Nueva Ciudad Manitas, démosle la bienvenida al líder de los gnomos: ¡Gelbin Mekkatorque!	
VO_BRMA02_1_GRUUL_31	¡No es por nada que lo llaman Asesino de Dragones! ¡Reciban con un gran aplauso a GRUUL!	
VO_BRMA02_1_HERO_POWER_05	¡El público está impaciente! ¡Jaja!	
VO_BRMA02_1_HOGGER_27	Y ahora recibamos al Gnoll nivel 11 que llegó a convertirse en una leyenda viviente: ¡Hogger!	
VO_BRMA02_1_ILLIDAN_23	¿Quién necesita ojos cuando tiene gujas de guerra dobles? Él seguro que no. ¡Es Illidan Tempestira!	
VO_BRMA02_1_LEVIATHAN_12	Recién renovado y listo para destrozar. Eeees... ¡el Leviatán de llamas!	
VO_BRMA02_1_LOATHEB_16	Tápense la nariz, cúbranse la boca y alienten a la mayor masa en descomposición: ¡Loatheb!	
VO_BRMA02_1_MAEXXNA_24	¡Es la araña gigante! ¿Cómo se pronunciaba su nombre? ¡Maexxna!	
VO_BRMA02_1_MILLHOUSE_09	¡Ay, por favor! ¿Quién dejó entrar a ese en la Arena?	
VO_BRMA02_1_MOGOR_25	Su vocabulario es limitado. Su ira: infinita. ¡Es Mogor el ogro!	
VO_BRMA02_1_MUKLA_10	Y a continuación, el barón de las bananas: con ustedes, ¡el Rey Mukla!	
VO_BRMA02_1_NOZDORMU_36	Damas y... ups. ¡Se acabó el tiempo!	
VO_BRMA02_1_ONYXIA_33	Directamente desde el Marjal Revolcafango y el castillo de Ventormenta. ¡Prepárense para Onyxia!	
VO_BRMA02_1_PAGLE_08	Y ahora, recién llegado de su viaje de pesca: ¡el maestro pescador Nat Pagle!	
VO_BRMA02_1_RESPONSE_04	¡Nadie se enfrenta a todas estas leyendas y vive para contarlo!	
VO_BRMA02_1_SNEED_30	Nuestro próximo contendiente se esconde tras los controles de una vieja trituradora. ¿Quién podrá ser?	
VO_BRMA02_1_STALAGG_14	¿Podrá Stalagg sobrevivir en la Arena? ¡Llegó la hora de averiguarlo!	
VO_BRMA02_1_START_01	¡Un nuevo rival!	
VO_BRMA02_1_SYLVANAS_19	Ella arde en odio infernal solo por ustedes. Denle la bienvenida a... ¡Sylvanas Brisaveloz!	
VO_BRMA02_1_THALNOS_06	Recibamos con un gran aplauso al esqueleto del vestido: ¡el Mago sangrientooo... Thalnos!	
VO_BRMA02_1_THAURISSAN_37	Todos al son de "Viva el rey". Es... ¡el emperador Thaurissan!	
VO_BRMA02_1_TINKMASTER_11	Un fuerte aplauso para el único, el inigualable, el gran inventor Maestro manitas Sobrechispa.	
VO_BRMA02_1_TOSHLEY_26	Es el gnomo errante que en su casa está faltante. ¡Denle una cálida bienvenida a Toshley!	
VO_BRMA02_1_TURN1_02	¡Damas y enanos! ¡Hoy tenemos un espectáculo muy especial para ustedes!	
VO_BRMA02_1_TURN1_PT2_03	¡Las más grandes leyendas de Azeroth contra un aventurero solitario!	
VO_BRMA02_1_VOLJIN_17	¡Silencio, por favor! Tenemos un invitado muy especial, ¡el mismísimo Jefe de Guerra Vol'jin!	
VO_BRMA03_1_CARD_04	¡Por el poder de Ragnaros! ¡Yo tengo el poder!	
VO_BRMA03_1_DEATH_09	¡Aaaaaaaaaah!	
VO_BRMA03_1_HERO_POWER_06	¡Muere!	
VO_BRMA03_1_MOIRA_DEATH_05	¡NO! ¡¡¡MOIRA!!! ¡¡¡ME LAS PAGARÁS!!!	
VO_BRMA03_1_RESPONSE_03	¡Cierra la boca antes de que te la cierre yo!	
VO_BRMA03_1_START_01	¡Los enanos Hierro Negro nunca caerán!	
VO_BRMA03_1_TURN1_02	¡Ey! ¡Deja a mi esposa!	
VO_BRMA03_1_VS_RAG_07	¡No! ¿Ragnaros? ¡NO DE NUEVO!	
VO_BRMA04_1_CARD_04	Jurafuegos, ¡a rodar!	
VO_BRMA04_1_DEATH_06	¡Rrrrrrrrrrrr!	
VO_BRMA04_1_HERO_POWER_05	¡Magma!	
VO_BRMA04_1_RESPONSE_03	La piedra mata a todo.	
VO_BRMA04_1_START_01	Hay una piedra en tu camino.	
VO_BRMA04_1_TURN1_02	A rodar.	
VO_BRMA05_1_CARD_05	Tic tac, mortal.	
VO_BRMA05_1_DEATH_04	Una última ofrenda...	
VO_BRMA05_1_HERO_POWER_06	¡Arde!	
VO_BRMA05_1_RESPONSE_03	¡Armagedón!	
VO_BRMA05_1_START_01	¡ARDERÁS!	
VO_BRMA05_1_TURN1_02	¡Ragnaros te consumirá!	
VO_BRMA06_1_DEATH_04	¡Me rindo! ¡Me rindo!	
VO_BRMA06_1_RESPONSE_03	¿Crees que has ganado? Quizá sea hora de otra lección... ¡de DOLOR!	
VO_BRMA06_1_START_01	¡Nadie puede vencer a la llama viva!	
VO_BRMA06_1_SUMMON_RAG_05	¡Contempla a Ragnaros! ¡Quien ya era antiguo cuando el mundo era joven!	
VO_BRMA06_1_TURN1_02_ALT	¡Que no escapen!	
VO_BRMA06_3_INTRO_01	¡DEMASIADO PRONTO! ¡ME HAS DESPERTADO DEMASIADO PRONTO, EXECUTUS!	
VO_BRMA06_3_RESPONSE_03	¡¿QUÉ SIGNIFICA ESTA INTRUSIÓN?!	
VO_BRMA06_3_TURN1_02	¡INSECTOS MORTALES! ¿SE ATREVEN A ENTRAR EN MIS DOMINIOS?	
VO_BRMA07_1_CARD_04	¡Hora de aplastar!	
VO_BRMA07_1_DEATH_06	¡Rrrnoooooo!	
VO_BRMA07_1_HERO_POWER_05	¡Yo aplastar! ¡Tú morir!	
VO_BRMA07_1_RESPONSE_03	¡Raaar! ¡Yo machacar!	
VO_BRMA07_1_START_01	Te machacaré.	
VO_BRMA07_1_TURN1_02	¿Machacar o aplastar? ¡QUÉ DECISIÓN DIFÍCIL!	
VO_BRMA08_1_CARD_05	¡Protegeré la Cumbre!	
VO_BRMA08_1_DEATH_06	Rrr. ¡Aaaaaaaaaah!	
VO_BRMA08_1_RESPONSE_04	¿¿¿POR QUÉ??? Dime por qué. Por favor, si me agradabas.	
VO_BRMA08_1_START_01	¿Qué haces tú aquí?	
VO_BRMA08_1_TURN1_03	¡Lord Nefarious! ¡Creí que este mortal se había encargado de Ragnaros por nosotros!	
VO_BRMA08_1_TURN1_ALT_02	¿Has venido a ayudarme a destruir a los mortales de este mundo?	
VO_BRMA09_1_CARD_05	¡La Cumbre es NUESTRA!	
VO_BRMA09_1_DEATH_11	¡Gaaahhhhh!	
VO_BRMA09_1_HERO_POWER1_06	¡Abran las puertas!	
VO_BRMA09_1_HERO_POWER2_07	¡Maten al de la retaguardia!	
VO_BRMA09_1_HERO_POWER3_08	¡Concéntrense en el héroe, tontos!	
VO_BRMA09_1_HERO_POWER4_09	¡Juntos somos IMPARABLES!	
VO_BRMA09_1_RESPONSE_04	Ja, ja, ja, ja.	
VO_BRMA09_1_START_01	¡Somos la VERDADERA Horda!	
VO_BRMA09_1_TURN1_03	¡Estás escalando la montaña equivocada!	
VO_BRMA09_1_TURN1_ALT_02	¡Nadie se interpondrá en nuestro camino! ¡MUERE!	
VO_BRMA10_1_DEATH_08	¡Rrrrrrrrrrr!	
VO_BRMA10_1_EGG_DEATH_1_05	¡Idiotas! ¡Estos huevos son más valiosos de lo que creen!	
VO_BRMA10_1_EGG_DEATH_2_06	¡No, otro no! ¡Rodarán sus cabezas por esta infamia!	
VO_BRMA10_1_EGG_DEATH_3_07	¡Pagarás por esto!	
VO_BRMA10_1_HERO_POWER_04	¡Aléjate de esos huevos!	
VO_BRMA10_1_RESPONSE_03	¡Te haré tortilla!	
VO_BRMA10_1_START_01	Contemplen... ¡los huevos corrompidos de nuestros nuevos vuelos!	
VO_BRMA10_1_TURN1_02	¡Estos huevos serán su perdición!	
VO_BRMA11_1_ALEXSTRAZA_07	¡AYÚDAME, PROTECTORA! ¡AYUDA!	
VO_BRMA11_1_CARD_04	¡LA FURIA DE ROCA NEGRA FLUYE POR MIS VENAS!	
VO_BRMA11_1_DEATH_ALT_08	Al fin. La agonía termina.	
VO_BRMA11_1_HERO_POWER_05	¡AAAAH! ¡DESTRUCCIÓN!	
VO_BRMA11_1_KILL_PLAYER_06	Discúlpame…he fallado.	
VO_BRMA11_1_RESPONSE_03	¡Debiste huir cuando tenías la oportunidad, mortal!	
VO_BRMA11_1_START_01	¡Huye! Antes de que pierda el control...	
VO_BRMA11_1_TURN1_02	Es demasiado tarde… ¡La corrupción de Nefarian se ha apoderado de mí!	
VO_BRMA13_1_DEATH_ALT_23	¡No! ¡NO! ¡Regresarééé!	
VO_BRMA13_1_DEATHWING_19	¿P-Papi?	
VO_BRMA13_1_HP_DRUID_14	Yo soy el amo de lo Salvaje, druida.	
VO_BRMA13_1_HP_GENERIC_18	¡Tu magia es mía!	
VO_BRMA13_1_HP_HUNTER_12	¡El cazador se convierte en presa!	
VO_BRMA13_1_HP_MAGE_11	Deberías tener más cuidado cuando juegas con magia, maga.	
VO_BRMA13_1_HP_PALADIN_07	¿La Luz te ha abandonado, paladín?	
VO_BRMA13_1_HP_PRIEST_08	Ahora la Luz me sirve a mí, sacerdote.	
VO_BRMA13_1_HP_ROGUE_15	¡Pícara! ¡Deja de esconderte y atrévete a enfrentarme!	
VO_BRMA13_1_HP_SHAMAN_13	Ahora los elementos me obedecen a MÍ, chamán.	
VO_BRMA13_1_HP_WARLOCK_10	¡Estás jugando con magia que no comprendes, brujo!	
VO_BRMA13_1_HP_WARRIOR_09	¡Tu fuerza es tu debilidad, guerrero!	
VO_BRMA13_1_RESPONSE_05	¡Yo soy el amo aquí!	
VO_BRMA13_1_START_01	Bienvenido a mi sagrario personal, héroe.	
VO_BRMA13_1_TURN1_PT1_02	¡Contempla el verdadero poder de NEFARIAN!	
VO_BRMA13_1_TURN1_PT2_03	¡Maná infinito! ¡Armadura de dragontina!	
VO_BRMA14_1_CARD_09	Redirigiendo exceso de energía.	
VO_BRMA14_1_DEATH_08	Sistemas defensivos eliminados. Apagando.	
VO_BRMA14_1_HP1_03	Unidad Electrón activada.	
VO_BRMA14_1_HP2_04	Unidad Toxitrón activada.	
VO_BRMA14_1_HP3_05	Unidad Arcanotrón activada.	
VO_BRMA14_1_HP4_06	Unidad Magmatrón activada.	
VO_BRMA14_1_HP5_07	Unidad defensiva en línea.	
VO_BRMA14_1_RESPONSE1_10	Bip. Bup. Bip.	
VO_BRMA14_1_RESPONSE2_11	Conexión en curso.	
VO_BRMA14_1_RESPONSE3_12	Conexión exitosa. Descargando actualizaciones de sistema operativo.	
VO_BRMA14_1_RESPONSE4_13	Actualización instalada. ¡Hola! ¡Hola! ¡Hola!	
VO_BRMA14_1_RESPONSE5_14	¡Hola! ¡Hola! ¡Hola!	
VO_BRMA14_1_START_01	Intrusos detectados.	
VO_BRMA14_1_TURN1_02	Iniciar matriz de defensa primaria.	
VO_BRMA15_1_CARD_05	¡Mis fallas serán tu fin!	
VO_BRMA15_1_DEATH_04	¡Aaaaaaaahhhhh!	
VO_BRMA15_1_HERO_POWER_06	Mezclar, batir... ¡Aplicar calor!	
VO_BRMA15_1_RESPONSE_03	¡Nada se desperdicia!	
VO_BRMA15_1_START_01	¡No habrá interrupciones!	
VO_BRMA15_1_TURN1_02	¡No haré esperar a mi amo! ¡No puedo fallar de nuevo!	
VO_BRMA16_1_CARD_04	¡No puedes esconderte!	
VO_BRMA16_1_DEATH_06	¡Rrrraaaaaaaa!	
VO_BRMA16_1_GONG1_10	¡AAH! ¡ESE SONIDO!	
VO_BRMA16_1_GONG2_11	¡NOO! ¡TAN CERCA!	
VO_BRMA16_1_GONG3_12	¡MIS OÍDOS!	
VO_BRMA16_1_HERO_POWER_05	¡Tus torpes pasos y tu peste te delatan!	
VO_BRMA16_1_RESPONSE_03	Sí, sigue hablando. Estoy acercándome.	
VO_BRMA16_1_START_01	Oigo como late tu corazón	
VO_BRMA16_1_TRIGGER1_07	Ah. ¡Te oigo!	
VO_BRMA16_1_TRIGGER2_08	Oigo pasos.	
VO_BRMA16_1_TRIGGER3_09	Oigo tus latidos... ¡No podrás escapar!	
VO_BRMA16_1_TURN1_02	La muerte aguarda en la oscuridad.	
VO_BRMA17_1_CARD_86	Espero que sepan nadar... ¡EN LAVA ARDIENTE!	
VO_BRMA17_1_DEATH_97	¡Aaaaaaaaaaah!	
VO_BRMA17_1_DEATH_HEROIC_98	¡NOOOOOOOOOO!	
VO_BRMA17_1_DEATHWING_88	¿PAPI?	
VO_BRMA17_1_HERO_POWER_87	¡Mi llama de las sombras reanima sus huesos!	
VO_BRMA17_1_NEF_AIR1_89	¡Mírame lanzar fuego desde las alturas! Uno de daño es solo el comienzo.	
VO_BRMA17_1_NEF_AIR2_90	¡Dos bolas de fuego! ¡Te las lanzo desde arriba!	
VO_BRMA17_1_NEF_AIR3_91	Esta vez solo te lanzaré una bola de fuego, ¡porque estoy preparándome para un turno glorioso!	
VO_BRMA17_1_NEF_AIR4_92	¡Jo Jo! ¡Tres bolas de fuego! ¡Toma! ¡Desde las alturas!	
VO_BRMA17_1_NEF_AIR5_93	¡Desde ahora solo lanzaré una bola de fuego!	
VO_BRMA17_1_NEF_AIR6_94	¡Caíste! ¡CUATRO bolas de fuego! ¡Ajajaja!	
VO_BRMA17_1_NEF_AIR7_95	Esta vez no dispararé ninguna bola de fuego... Pero prepárate.	
VO_BRMA17_1_NEF_AIR8_96	¡VEINTE BOLAS DE FUEGO! ¡AJAJAJAJAA!	
VO_BRMA17_1_RESPONSE_85	Mentes mortales... tan manipulables.	
VO_BRMA17_1_RESURRECT1_82	¡La destrucción llegará desde las alturas!	
VO_BRMA17_1_RESURRECT2_83	Ya que estoy aquí arriba, tengo una sorpresa para ti allá abajo.	
VO_BRMA17_1_RESURRECT3_84	¡Observa a mi mejor creación! ¡Levántate, hermana! ¡Levántate, Onyxia!	
VO_BRMA17_1_START_78	¡Has llegado al grandioso final!	
VO_BRMA17_1_TRANSFORM1_80	He tratado de ser un buen anfitrión, ¡pero tú NO TE QUIERES MORIR!	
VO_BRMA17_1_TRANSFORM2_81	Es hora de abandonar todas las cortesías ¡y concentrarme en MATARTE!	
VO_BRMA17_1_TURN1_79	Mi mejor creación te espera, mortal.	
VO_COOP02_00	¡Los ayudaré a librarse de la Maldición de la carne!	
VO_COOP02_02	¡Derroten al Maestro de palancas Mecazod juntos para ganar!	
VO_COOP02_ABILITY_05	¡Aumentar revoluciones!	
VO_COOP02_ABILITY_06	¡La imprenta ha muerto, Eremita Cho!	
VO_COOP03_01	¡Yo soy el amo aquí!	
VO_COOP03_02	No... ¡NO! ¡Te destruiré!	
VO_COOP03_03	Mentes mortales... tan manipulables.	
VO_COOP03_04	He tratado de ser un buen anfitrión, ¡pero tú NO TE QUIERES MORIR!	
VO_COOP03_05	Es hora de abandonar todas las cortesías, ¡y concentrarme en MATARTE!	
VO_COOP03_06	¡Ahora la Luz me sirve a MÍ, sacerdote!	
VO_COOP03_07	¡Ahora los elementos me obedecen a MÍ, chamán!	
VO_COOP03_08	Jajajaaa... ¡Contempla el verdadero poder de Nefarian!	
VO_COOP03_09	Jajaja... ¡Has llegado al grandioso final!	
VO_Crone_Female_Troll_CroneDeath_02	¡No! Me vengaré, ¡me vengaré!	
VO_Crone_Female_Troll_CroneEmoteResponse_02	¡Ah jajajajaja!	
VO_Crone_Female_Troll_CroneFlyingMonkeys_01	¡Tráiganme a esa chica!	
VO_Crone_Female_Troll_CroneHeroPower_02	¡Jejejejeje!	
VO_Crone_Female_Troll_CroneOpen_01	¡Ja jajajaja! ¡Vuelen, mis preciosuras!	
VO_Curator_Male_ArcaneGolem_CuratorArcaneGolem_01	Qué curioso. El parecido es fascinante.	
VO_Curator_Male_ArcaneGolem_CuratorBeasts_01	Este Curator es alérgico a las bestias.	
VO_Curator_Male_ArcaneGolem_CuratorDemons_01	No hay lugar para los demonios en la Sala de las Fieras.	
VO_Curator_Male_ArcaneGolem_CuratorDragons_01	Estoy cansado de los excrementos de dragón.	
VO_Curator_Male_ArcaneGolem_CuratorEmoteResponse_01	No se puede procesar su petición.	
VO_Curator_Male_ArcaneGolem_CuratorHarrison_02	¡Intruso detectado! Harrison Jones no es bienvenido.	
VO_Curator_Male_ArcaneGolem_CuratorMechs_01	Reprogramando a los asistentes.	
VO_Curator_Male_ArcaneGolem_CuratorMedivhSkin_01	Medivh impostor. Esa mirada loca lo delata.	
VO_Curator_Male_ArcaneGolem_CuratorMurlocs_01	¡Libérate, pezcaducho!	
VO_Curator_Male_ArcaneGolem_CuratorPirates_01	Los piratas deberían festejarrrr.	
VO_Curator_Male_ArcaneGolem_CuratorReno_02	¡Intruso detectado! Reno Jackson no es bienvenido.	
VO_Curator_Male_ArcaneGolem_CuratorTurn1_01	Este Curator está equipado para cuidar la Sala de las Fieras.	
VO_Curator_Male_ArcaneGolem_CuratorTurn5_01	Por favor obedezca las reglas de la galería.	
VO_Curator_Male_ArcaneGolem_CuratorTurn9_01	Los invitados deben permanecer dentro de la Sala de las Fieras.	
VO_Curator_Male_ArcaneGolem_IllhoofKilrekResponse_01	A este Curator no le importa. Las invocaciones están prohibidas.	
VO_Curator_Male_ArcaneGolem_IllhoofSenseDemons_01	Muchos demonios detectados.	
VO_Curator_Male_ArcaneGolem_IllhoofTurn1_01	Los rituales de invocación no están permitidos.	
VO_Curator_Male_ArcaneGolem_IllhoofTurn5_01	Los rituales son perjudiciales para los habitantes. El demonio no debe continuar.	
VO_Curator_Male_ArcaneGolem_IllhoofWin_01	Este Curator agradece. La Sala de las Fieras se restaurará.	
VO_Curator_Male_ArcaneGolem_NightbaneCorruption_01	¡No! ¡La Sala de las Fieras no debe corromperse!	
VO_Curator_Male_ArcaneGolem_NightbaneTour_01	El dragón Nocturno. Se lo conocía como Arcanagos hasta que la magia salvaje se apoderó de su mente.	
VO_Curator_Male_ArcaneGolem_NightbaneTour_02	A su izquierda, un busto de Aran. A su derecha, el Farol de poder.	
VO_Curator_Male_ArcaneGolem_NightbaneTurn1_01	Las criaturas que escaparon podrían lastimarse. Deben regresar a la Sala de las Fieras.	
VO_Curator_Male_ArcaneGolem_NightbaneTurn3_01	Hay que salvar a las criaturas. Luego podrá continuar.	
VO_Curator_Male_ArcaneGolem_NightbaneUnstablePortal_01	Los invitados deben ser amables. Este dragón le teme a la magia inestable.	
VO_Curator_Male_ArcaneGolem_NightbaneWin_01	Se necesita más asistencia.	
VO_Curator_Neither_ArcaneGolem_CuratorDeath_04	Apagando	
VO_Curator_Neither_ArcaneGolem_CuratorOpen_01	No toque la exposición.	
VO_ELISE_LOE16_ALT_1_FIRST_HALF_02	Mientras el báculo se carga, Rafaam es invulnerable.	
VO_ELISE_LOE16_ALT_1_SECOND_HALF_03	Cuando termina la invocación, tenemos un instante para contraatacar, ¡pero después debemos lidiar con la criatura invocada!	
VO_ELISE_WEIRD_DECK_05	Te pido mil disculpas por el mazo. Lo armamos el año pasado para un torneo y nunca tuvimos tiempo de cambiarlo.	
VO_EMOTE_HERO_TBKTRAF_KT_DRAWING_BOARD	*suspiro* A dibujar otra vez.	
VO_EMOTE_HERO_TBKTRAF_KT_GLOAT	Ruega por piedad.	
VO_EMOTE_HERO_TBKTRAF_KT_MINIONS_SERVANTS	Lacayos, servidores, soldados de la fría oscuridad...	
VO_FP1_014t_EnterPlay_01	¡Ahora tú dueles!	
VO_FP1_031_Attack_07	Corderos al matadero...	
VO_FP1_031_EnterPlay_06	¡La Plaga te consumirá!	
VO_HRW_DEBUG_01	1	
VO_HRW_DEBUG_02	2	
VO_HRW_DEBUG_03	3	
VO_HRW_DEBUG_04	4	
VO_HRW_DEBUG_05	5	
VO_HRW_TEST_00	¡Los ayudaré a librarse de la Maldición de la carne!	
VO_HRW_TEST_01	¡Buen trabajo! Juntos, han derrotado al jefe.\n\n¡Los dos jugadores ganan!	
VO_HRW_TEST_02	¡Derroten al Maestro de palancas Mecazod juntos para ganar!	
VO_HRW_TEST_ABILITY_00	Dañando a un héroe.	
VO_HRW_TEST_ABILITY_01	Destruyendo al esbirro con mayor ataque.	
VO_HRW_TEST_ABILITY_02	Lanzando tres bombas.	
VO_HRW_TEST_ABILITY_03	Dañando a todos los demás personajes.	
VO_HRW_TEST_ABILITY_04	Obteniendo 2 de Ataque.	
VO_HRW_TEST_ABILITY_05	Infligiendo daño a ambos héroes.	
VO_HRW_TEST_ABILITY_06	Silenciando al Eremita Cho. Permanentemente.	
VO_HRW_TEST_ABILITY_98	Tablero objetivo completo. Vaciando tablero objetivo.	
VO_Illhoof_Male_Demon_IlhoofKilrek_01	Vamos, Kil'rek. ¡Debemos terminar con la invocación!	
VO_Illhoof_Male_Demon_IllhoofDeath_02	¡No! ¡Tan cerca! Sargar...	
VO_Illhoof_Male_Demon_IllhoofEmoteResponse_01	¡Tu esencia alimenta el ritual!	
VO_Illhoof_Male_Demon_IllhoofOpen_01	¡Ah, justo a tiempo!	
VO_Illhoof_Male_Demon_IllhoofSummonImps_01	¡A mí, habitantes de la oscuridad! ¡Reúnanse a mi llamada!	
VO_Illhoof_Male_Demon_IllhoofSummoningPortal_01	¿Un portal sin un ritual? Eso parece mucho más fácil...	
VO_Illhoof_Male_Demon_IllhoofTurn1_01	¡El ritual comienza ahora!	
VO_Illhoof_Male_Demon_IllhoofWounded_01	Vengan, mascotas mías. ¡Debemos terminar el ritual!	
VO_Jaraxxus_Male_Demon_FinalMalchezaarJaraxxus_01	Príncipe tonto. ¡Practica karaoke como Jaraxxus!	
VO_Jaraxxus_Male_Demon_FinalMalchezaarJaraxxus_02	¡Ya está aquí\nte busca a ti\nLa Liga de Expedicionarios!	
VO_Julianne_Female_Human_JulianneDeath_01	¡Rómulo! Bebo esto por ti...	
VO_Julianne_Female_Human_JulianneEmoteResponse_01	¿Os mordéis el pulgar para afrentarnos?	
VO_Julianne_Female_Human_JulianneFeignDeath_03	Y al vencerse, despertaré como de un sueño agradable...	
VO_Julianne_Female_Human_JulianneHeroPower_01	Adelante, gentil noche, ¡devuélveme a mi Rómulo!	
VO_Julianne_Female_Human_JulianneOpen_01	¿Qué demoníaca presencia es esta que veo ante mí?	
VO_KAR03_MOROES_MALE_HUMAN_CHESS_TURN_1	Ah, ya lo recuerdo. Las piezas atacarán automáticamente al final de su turno.	
VO_KAR03_MOROES_MALE_HUMAN_CHESS_TURN_3	Si una pieza está entre dos enemigos, ¡los atacará a los dos!	
VO_KAR03_MOROES_MALE_HUMAN_CHESS_TURN_5	La buena ubicación es la clave del ajedrez. ¡Aproveche los ataques dobles!	
VO_KARA_04_01_Female_Human_CroneHuffer_01	Oh, Bufar. Creo que no nos encontramos en Páramos de Poniente...	
VO_KARA_04_01_Female_Human_CroneLionTigerBear_02	¡Oh! ¡Leones, dragones y osos! ¡Qué miedo!	
VO_KARA_04_01_Female_Human_CroneTurn1_01	Oh, no, ¡no dejes que me lastime!	
VO_KARA_04_01_Female_Human_CroneTurn3_01	¡Vengan, todos de la mano! ¡Juntos somos más fuertes!	
VO_KARA_06_01_Male_Human_JulianneDeadlyPoison_02	Ah, una dosis de veneno.	
VO_KARA_06_01_Male_Human_JulianneTurn1_01	¿Me provocas? Entonces, ¡defiéndete!	
VO_KT_ANTI_CHEESE1_65	¡Esto es Naxxramas heroico! ¡No toleraré tácticas cobardes aquí!	
VO_KT_ANTI_CHEESE2_66	Orador del sino... Te crees muy inteligente.	
VO_KT_ANTI_CHEESE3_67	¿Igualdad? ¡No durante mi guardia!	
VO_KT_ANUB2_43	¡NOOO! Bah... Irrelevante. Jamás derrotarás a la Gran Viuda.	
VO_KT_BARON2_64	¡El Arrabal Militar me ha fallado! Es tan difícil conseguir buenos ayudantes en estos días.	
VO_KT_FAERLINA2_45	Faerlina no es nadie. La Reina Araña te hará desaparecer en un segundo.	
VO_KT_GLUTH2_73	Les pregunté a los zombis si querían comer tu cerebro y dijeron: "No consumo comida chatarra".	
VO_KT_GLUTH2_ALT_74	Obtienes un logro por perder contra Gluth. Estoy casi seguro.	
VO_KT_GLUTH3_75	JAJAJA. ¡NO OBTIENES NINGÚN LOGRO POR PERDER CONTRA GLUTH!	
VO_KT_GLUTH4_76	¡No! ¿Y ahora quién comerá estas sobras de zombis?	
VO_KT_GLUTH5_77	Exterminar es lo que más amo hacer en la vida. No, espera, congelarte la sangre en las venas es mi favorito.	
VO_KT_GLUTH6_78	¡Buen perro! ¡Qué buen perrito!	
VO_KT_GOTHIK2_62	¿Por qué Gothik no vuelve como un Gothik espectral? ¡Por favor!	
VO_KT_GROBBULUS2_71	A dibujar otra vez...	
VO_KT_HEIGAN2_55	Estoy ardiendo de ira. ARDIENDO.	
VO_KT_LOATHEB2_57	Sigues MATANDO A MIS ESBIRROS. ¡Detente! ¡Detente ahora mismo!	
VO_KT_MAEXXNA2_47	Su veneno hará que tu muerte sea *casi* indolora.	
VO_KT_MAEXXNA3_48	¿Gigante de mar? Maexxna, ¡esa no está en mi lista de cartas aprobadas!	
VO_KT_MAEXXNA4_49	¡Imposible! ¡Esto no ha terminado, INSIGNIFICANTE MORTAL!	
VO_KT_MAEXXNA6_51	¿Cómo se llama a un jugador que tiene a su esbirro atrapado en una telaraña? ¡MUERTO!	
VO_KT_NOTH2_53	Pobre Noth. 'Noth'e olvides de él.	
VO_KT_PATCHWERK2_69	¡Mi encarnación de la guerra! Debí usar mejores jugadores para coserlo...	
VO_KT_RAZUVIOUS2_59	¿Quién entrenará a mis Caballeros de la Muerte ahora? Yo no puedo, mi agenda está completa.	
VO_KT_SAPPHIRON2_84	Mira a ese pequeño gnomo. Antes era un intruso... COMO TÚ.	
VO_KT_SAPPHIRON3_85	¡Deja de esconderte tras ese bloque de hielo!	
VO_KT_SAPPHIRON4_ALT_87	Sapphiron, ejecuta el plan: "CONGELAR SANGRE EN LAS VENAS".	
VO_KT_SAPPHIRON5_88	¡Mi dragón! NO ME AGRADAS.	
VO_KT_THADDIUS2_81	¡Intruso! ¡Esta es la gota que rebalsó el vaso!	
VO_LOE_01_DEATH_2	¡Orsis! ¡Venga mi muerte!	
VO_LOE_01_RESPONSE	¡Siente la cólera del sol!	
VO_LOE_01_STAFF	¡Ja! ¡Es mía!	
VO_LOE_01_STAFF_2	¡Arderás! 	
VO_LOE_01_STAFF_2_RENO	Te recomiendo no soltar esa vara. Es muy valiosa.	
VO_LOE_01_START	¡Soy INVENCIBLE!	
VO_LOE_01_WIN	¡Ja, ja! ¡La vara es mía! ¡Cómo me gustaría que Harrison estuviera aquí! 	
VO_LOE_01_WIN_2	¡Toma esa vara!	
VO_LOE_01_WIN_2_ALT_2	¿Es normal que el suelo tiemble tanto?	
VO_LOE_01_WOUNDED	¡Lo tengo arrinconado! ¡Acaba con él!	
VO_LOE_02_DEATH	Noooo, ¡no quiero volver a la lámpara!	
VO_LOE_02_INTRO	¡La vara del sol es MÍA!	
VO_LOE_02_MORE_WISHES	Guau, no puedo creer que haya funcionado.	
VO_LOE_02_PHAERIX_STAFF_RECOVER	¡No puedes comprender los poderes de la vara!	
VO_LOE_02_RESPONSE	¡Poder cósmico fenomenal!	
VO_LOE_02_START	¡Libre al fin! ¡Tu recompensa será una muerte rauda!	
VO_LOE_02_START2	¡Aventurero! Soy Reno Jackson, arqueólogo, explorador y cazador de tesoros de fama mundial. 	
VO_LOE_02_START3	Con el autocontrol de una urraca.	
VO_LOE_02_TURN_10	¡Piénsalo, explorador! La vara del sol. ¡Vale millones!	
VO_LOE_02_TURN_6	¿Ya te conté sobre la vez que me infiltré de incógnito entre los ogros de La Masacre?	
VO_LOE_02_TURN_6_2	¿Y sobre esa vez que me colé en el Lyceum de Roca Negra para conseguir...?	
VO_LOE_02_WIN	¡Adelante, mi valiente! ¡La vara descansa en aquella sala!	
VO_LOE_02_WISH	Es muy amable de su parte concedernos deseos mientras intenta matarnos.	
VO_LOE_03_RESPONSE	¡Apúrate!	
VO_LOE_03_TURN_1	¡El techo colapsa y hay monstruos por todas partes! ¡Apresúrate!	
VO_LOE_03_TURN_10	¡Ya casi llegamos! ¡Veo el sol!	
VO_LOE_03_TURN_2	Vaya, vaya: una poza brillante. ¿Quieres echarle un vistazo?	
VO_LOE_03_TURN_2_2	¡No tienes tiempo para eso!	
VO_LOE_03_TURN_3	Mmm... Veamos... ¿Izquierda o derecha?  	
VO_LOE_03_TURN_3_BOULDER	¡Esa roca es enorme! ¡Muévete!	
VO_LOE_03_TURN_3_WARNING	Oh oh, el estruendo es cada vez más fuerte. ¡Apuesto a que el próximo turno colapsará todo el techo!	
VO_LOE_03_TURN_4	¡Mira, una trampa de púas!	
VO_LOE_03_TURN_4_BAD	¡Oh jo jo jo! Eso no me pareció nada divertido.	
VO_LOE_03_TURN_4_GOOD	¡Ey, bravo! Casi tan bien como yo.	
VO_LOE_03_TURN_4_NEITHER	A ver, te estás arrastrando por las púas... ¿Podrías apurarte?	
VO_LOE_03_TURN_5	Ey, qué linda estatua. Y mira cómo brilla ese rubí...	
VO_LOE_03_TURN_5_4	Oh-oh, no parece muy contento. ¡Creo que quiere su gema de vuelta!	
VO_LOE_03_TURN_6	¡Cuidado! ¡El techo se derrumba!	
VO_LOE_03_TURN_6_2	¡Uoo! ¡Estuvo cerca! Me alegra haber podido ayudarte. No me lo agradezcas.	
VO_LOE_03_TURN_7	Mmm, esto está muy oscuro, pero por aquí saldremos más rápido. ¡Vamos!	
VO_LOE_03_TURN_7_2	En mi mapa solo dice "NO PISAR ESTE LUGAR".	
VO_LOE_03_TURN_8	¡Uf! Cada vez hace más calor. ¡Tenemos que apurarnos!	
VO_LOE_03_TURN_9	Ufff... ¿por qué siempre insectos? ¡Los odio!	
VO_LOE_03_WIN	¡Uff! ¡Lo logramos! Nunca creí que estaría tan feliz de ver este desierto... ¡desierto! Necesito agua.	
VO_LOE_04_RESPONSE	¡Trogg aplasta estúpido!	
VO_LOE_04_SCARVASH_TURN_2	¡Trogg no estúpido! ¡Trogg te deja estúpido a ti!	
VO_LOE_04_START	En Uldaman, ¡SOLO troggs!	
VO_LOE_04_WIN	¡Todavía hay más! Por aquí, ¡métete en el carro minero!	
VO_LOE_07_RESPONSE	¿Te parece que tienes tiempo para eso?	
VO_LOE_07_START	Cuidado, ¡nos están persiguiendo!	
VO_LOE_07_WIN	¡Ja, ja! ¡Carros y bombas! ¿Qué más se puede pedir?	
VO_LOE_08_ANIMATE_STONE	¡Tierra y piedra, despierten!	
VO_LOE_08_LANDSLIDE	¡Te enterraré!	
VO_LOE_08_RESPONSE	Serás polvo.	
VO_LOE_08_START	¿¡Quién osa molestar a los creadores!?	
VO_LOE_08_WIN	¡La cabeza del báculo es nuestra! ¡Solo nos falta una pieza!	
VO_LOE_092_Attack_02	¡Contempla!	
VO_LOE_10_NYAH	¡Mrrrglmrrrgl! ¡Nyah!	
VO_LOE_10_RESPONSE	Mrglmrrglrmrrgl.	
VO_LOE_10_RESPONSE_ALT_read	Medialeta, ¿qué haces aquí?	
VO_LOE_10_START	Mrglmrglmrgl.	
VO_LOE_10_START_2	¿De veras? Es muy irrespetuoso de tu parte. 	
VO_LOE_10_TURN_2_GIANTFIN	¡MRRRGL! ¡MRRRGLMRGL!	
VO_LOE_10_TURN1	¡Mrrrgl! Mrrglrrglmrgl.	
VO_LOE_10_WIN	Una pena... Con una mejor crianza, podría haber sido un ejemplo de civismo.	
VO_LOE_12_NAZJAR_PEARL	Espléndido. La perla de las mareas supera todas mis expectativas.	
VO_LOE_12_NAZJAR_TURN_1	Soy la cuchilla de Azshara. ¿Quién eres tú para desafiarme?	
VO_LOE_12_NAZJAR_TURN_1_FINLEY	Soy Sir Aletardo Mrrgglton. El placer es mío.	
VO_LOE_12_NAZJAR_TURN_3_FINLEY	Elisa, ¿qué me cuentas de los demás?	
VO_LOE_12_NAZJAR_TURN_5	¡Fuerzas de lo profundo, arrasen al enemigo como una marea mortal!	
VO_LOE_12_NAZJAR_TURN_5_FINLEY	Parece un poco demasiado, ¿no?	
VO_LOE_12_NAZJAR_TURN_7_FINLEY	*Sonido de dolor* ¡Mrgggl! ¡MRRGLMRRGL!	
VO_LOE_12_NAZJAR_TURN_7_FINLEY_2	Perdona, explorador, a veces pierdo la cabeza. 	
VO_LOE_12_RESPONSE	¡Yo controlo el poder de la perla!	
VO_LOE_12_START	¡El poder de las mareas te consumirá!	
VO_LOE_12_WIN	¡Bravo! ¡La perla es nuestra! ¡Acompáñame a la Sala de los Expedicionarios para ensamblar el artefacto juntos!	
VO_LOE_13_RESPONSE	RRRROOAARRR	
VO_LOE_13_START_2	¡Grr!	
VO_LOE_13_TURN_1	¡El báculo estaba maldito! Ha invocado al etéreo a pesar de nuestras barreras. ¡Se está robando todo!	
VO_LOE_13_TURN_1_2	Todo no. Solo lo bueno.	
VO_LOE_13_TURN_5	Ohhh. ¿Será el verdadero sello de Arthas? ¡Está en perfectas condiciones!	
VO_LOE_13_TURN_5_2	Reno, Brann, ¡escondan los artefactos!	
VO_LOE_13_TURN_9	¡Está animando un ejército! Elisa, ¡detenlo!	
VO_LOE_13_TURN_9_2	¡Tel'zaxus Nalore! ¡El báculo es demasiado poderoso! Pero puedo aminorar su marcha...	
VO_LOE_13_WIN	Nosotros nos encargamos de las piezas, explorador. ¡Tú ve a buscar a Rafaam!	
VO_LOE_14_RESPONSE	PLAF	
VO_LOE_14_START	¡Oh, la armadura de Lothar! Pasé meses en Roca Negra nadando en popó de dragón para encontrarla.	
VO_LOE_14_TURN_13	Brann, ¡está animando los libros de la biblioteca! Yo me ocuparé de los martillos voladores de la exposición de Lordaeron.	
VO_LOE_14_TURN_5	Ya me encargué de las espadas animadas de la sala del este. Elisa, ¿quién solicita mi asistencia?	
VO_LOE_14_TURN_5_2	¡Ve a ayudar a Reno! Está en el almacén principal, ¡rodeado de robots bum!	
VO_LOE_14_TURN_9	Veo que están todos ocupados. Yo me encargo de este broche hermoso.	
VO_LOE_14_WIN	El museo está bajo control. ¡Ve a buscar a Rafaam y dale su merecido, explorador!	
VO_LOE_15_RESPONSE	¡Qué cartas hermosas!	
VO_LOE_15_SPARE	¡Explorador! Tenemos un mazo de más. ¡Úsalo!	
VO_LOE_16_BOOM_BOT	Nos quedaron un montón de estos. ¡Acábalo!	
VO_LOE_16_CROWN	La magia de un mago loco en forma de corona.	
VO_LOE_16_EYE	Qué gracioso. Todavía lo tenía en el bolsillo. Bueno... te lo presto.	
VO_LOE_16_FIRST_ITEM	Estamos explorando el museo en busca de algo útil. ¡Avísame si necesitas una mano!	
VO_LOE_16_GOBLET	Odio las serpientes.	
VO_LOE_16_GREAVE	Una pieza de la armadura de Lothar quedó intacta después de la pelea.	
VO_LOE_16_LOCKET	Este relicario está embrujado por los fantasmas de Karazhan.	
VO_LOE_16_PIPE	¡Toma! Pero ni una palabra a Brann; ¡le encanta esta pipa!	
VO_LOE_16_RAFAAM_DEATH2	¡NO! ¡Nadie puede derrotarme!	
VO_LOE_16_SHARD	Esto estaba dentro de una caja que decía "NO ABRIR". Así que, sí... ¡Buena suerte!	
VO_LOE_16_SPLINTER	Esto lo encontré en el Núcleo de Magma. El Mayordomo lo usaba para limpiarse los dientes.	
VO_LOE_16_START_2	El báculo se está cargando. ¡Cuidado!	
VO_LOE_16_TEAR	Este es un artefacto sagrado de mi gente. Bebe, ¡rápido!	
VO_LOE_16_TURN_2	El báculo está casi listo. ¡Prepárate!	
VO_LOE_16_TURN_2_2	¡JA, JA, JA! ¡PODER SOBRECOGEDOR!	
VO_LOE_16_TURN_2_3	¡El báculo está sobrecargado! ¡No dejes pasar esta oportunidad!	
VO_LOE_16_TURN_3	¡Soy invencible! ¡Nunca me derrotarás!	
VO_LOE_16_TURN_3_2	El báculo se está cargando de nuevo. En poco tiempo, tendremos otra oportunidad.	
VO_LOE_16_TURN_4	El báculo está casi listo. ¡Abre bien los ojos!	
VO_LOE_16_TURN_5	¡JA, JA, JA! ¡PODER SOBRECOGEDOR!	
VO_LOE_16_TURN_5_2	¡El escudo se disipa! ¡Vamos!	
VO_LOE_16_TURN_6	El escudo se ha activado de nuevo. Ten mucho cuidado.	
VO_LOE_16_VIAL	La etiqueta dice "BÉBEME", pero lo encontramos en Naxxramas, así que nadie se atrevió.	
VO_LOE_ARCHAEDAS_TURN_1_CARTOGRAPHER	Si no estuviera tan ocupado enterrándote en piedra.	
VO_LOE_GIANTFIN_TIDEHUNTER_2	¡No, Aletardo! Aun entonces eras diferente.	
VO_LOE_NAZJAR_TURN_3_CARTOGRAPHER	Reno ha vuelto con la vara del sol, y Brann está en camino.	
VO_LOE_SCARVASH_TURN_6_CARTOGRAPHER	¡Concéntrate, Brann!	
VO_LOE_ZINAAR_TURN_10_CARTOGRAPHER_2	No está a la venta.	
VO_LOE_ZINAAR_TURN_6_CARTOGRAPHER_2	Sí.	
VO_LOE_ZINAAR_TURN_6_CARTOGRAPHER_2_ALT	Sí.	
VO_LOE10_DEAD_MURLOCS	Cuántos muertos... Qué desperdicio.	
VO_LOE10_NYAH_FINLEY	¡Oh, qué ridiculez! No seas tan infantil.	
VO_LOE10_TIDEHUNTER	Cuando Elisa me encontró, yo era un cazamareas. ¿Habría terminado así si no me hubiera ido?	
VO_LOE10_TURN_2_FINLEY	¡Hermanos míos! ¿Tenemos que pelear?	
VO_LOE10_TURN_2_FINLEY_2	Supongo que no había otro desenlace posible.	
VO_LOEA04_BRANN_TURN_1	La última vez que anduve por aquí, Scarvash era un trogg pequeñito. Ahora es más grande, más estúpido y más feo.	
VO_LOEA04_BRANN_TURN_6	Fascinante. Estas runas de mitril contienen códigos de protección. ¡Deben ser de la época de los titanes!	
VO_LOEA07_MINE_ALMOST_DONE	¡Estamos cerca! Me pregunto para qué servirá este botón...	
VO_LOEA07_MINE_ARCHAEDAS	¡POR LAS BARBAS DE MAGNI! ¿ESE ES ARCHAEDAS?	
VO_LOEA07_MINE_BARREL_FORWARD	¡A todo motor!	
VO_LOEA07_MINE_BOOM	¡Bombas saltarinas! ¡Eso les enseñará una lección!	
VO_LOEA07_MINE_BOOMZOOKA	¡BUM! ¡La cargaré para el próximo disparo!	
VO_LOEA07_MINE_DETONATE	¿Quieres detonar el pozo? ¡¿HAS PERDIDO LA CABEZA?!	
VO_LOEA07_MINE_DYNAMITE	¡Ey, ten cuidado con eso! ¡Ya hiciste volar un pedazo del camino!	
VO_LOEA07_MINE_HUNKER_DOWN	¡Abajo!	
VO_LOEA07_MINE_PARROT	¡Vuela, Ginny!	
VO_LOEA07_MINE_RAMMING	¡Ja, ja! ¡Vete de aquí!	
VO_LOEA07_MINE_REPAIRS	¡Un poco de chicle de mollejas y quedará como nuevo!	
VO_LOEA07_MINE_SPIKED_DECOY	¡Eh, estúpidos troggs! ¡Aquí estoy!	
VO_LOEA08_TURN_1_BRANN	Un sirviente de los titanes ancestrales. Las historias que podría contarnos...	
VO_LOEA09_1_RESPONSE	¡La cena será copiosa!	
VO_LOEA09_1_TURN1	¿Te atreves a invadir la ciudad en ruinas?	
VO_LOEA09_FINLEY_DEATH	Me recuperaré en unos minutos. Explorador, ¡encárgate de ese naga!	
VO_LOEA09_HERO_POWER	¡Hora de cenar! ¡El menú de hoy es sopa de múrloc!	
VO_LOEA09_HERO_POWER1	Saludos, explorador. Parece que estoy en aprietos. ¿Le darías una mano a un compañero?	
VO_LOEA09_HERO_POWER2	Mmm, debo admitir que está muy oscuro aquí.	
VO_LOEA09_HERO_POWER3	Por todos los cielos. ¿Está subiendo la temperatura?	
VO_LOEA09_HERO_POWER4	Esto es un poco incómodo, debo decir.	
VO_LOEA09_HERO_POWER5	Mmm... sí, definitivamente hace calor aquí.	
VO_LOEA09_HERO_POWER6	Si alguien pudiera ayudarme, sería espléndido.	
VO_LOEA09_QUOTE1	¡Te doy las gracias! ¡Ya estaba perdiendo las esperanzas!	
VO_LOEA09_UNSTABLE	¡Vuelve al caldero!	
VO_LOEA09_WIN	Te doy las gracias, explorador. ¿Deseas que te guíe hasta la pieza final?	
VO_LOEA10_1_MIDDLEFIN	Medialeta, ¿qué haces aquí?	
VO_LOEA15_1_LOSS_11	Tu mazo es una basura. Es hora de usar el mío.	
VO_LOEA15_1_LOW_HEALTH_10	Quizá no debería haber tomado tu mazo.	
VO_LOEA15_1_MAGMA_RAGER_09	¿Furibundo de magma? ¡¿Por qué demonios usarías esta carta?!	
VO_LOEA15_1_START_07	Me gusta tu mazo. Creo que ME LO QUEDARÉ.	
VO_LOEA15_1_TURN1_08	Ohhh, sí. Esta mano es INCREÍBLE.	
VO_LOEA15_1_WIN_12	Tu mazo es ALUCINANTE. ¡Ja, ja, ja!	
VO_LOEA15_GOLDEN	¿Todas las cartas de este mazo SON DORADAS? ¡Tu colección compite con la mía!	
VO_LOEA16_1_CARD_04	¡He conseguido artefactos de MILES de mundos!	
VO_LOEA16_1_RESPONSE_03	¡Sí! ¡SÍ!	
VO_LOEA16_1_START_01	¡Contempla TODO EL PODER del báculo!	
VO_LOEA16_1_TURN1_02	¡Soy invencible! ¡El poder de los titanes es mío!	
VO_Maiden_Female_Titan_FinalMaidenEmoteResponse_01	No se tolerará tu comportamiento.	
VO_Maiden_Female_Titan_FinalMaidenEyeForAnEye_01	Se ha hecho justicia.	
VO_Maiden_Female_Titan_FinalMaidenHeroPower_01	Expulsa tus pensamientos impuros.	
VO_Maiden_Female_Titan_FinalMaidenHumility_01	¡Sí! ¡Arrodíllate y quizá te perdone la vida!	
VO_Maiden_Female_Titan_FinalMaidenOpen_01	¿Has invocado a una agente de los titanes?	
VO_Maiden_Female_Titan_FinalMaidenTurn5_01	Somos eternos. ¡Tú no estás a la altura!	
VO_Malchezaar_Male_Demon_Brawl_06	No habrás pensado que podías vencer...	
VO_Malchezaar_Male_Demon_EmoteParty_01	¡A Malchezaar también le gusta festejar!	
VO_Malchezaar_Male_Demon_FinalAltOpening_01	¡Tontos!	
VO_Malchezaar_Male_Demon_FinalMalchezaarDeath_01	¡No! ¡No! ¡Otra vez no!	
VO_Malchezaar_Male_Demon_FinalMalchezaarEmoteResponse_01	¡Seré tu fin!	
VO_Malchezaar_Male_Demon_FinalMalchezaarHeroPower_01	¡No solo te enfrentas a Malchezaar, sino a todas las legiones bajo mi mando!	
VO_Malchezaar_Male_Demon_FinalMalchezaarJaraxxus_01	¿Qué? ¡Esa es mi invitación!	
VO_Malchezaar_Male_Demon_FinalMalchezaarMedivhSkin_01	¿Viniste con un disfraz? Mmmm... Yo podría hacer eso...	
VO_Malchezaar_Male_Demon_FinalMalchezaarSacrificialPact_03	¡Jajaja! ¡Eso jamás funcionaría contra un verdadero señor Eredar!	
VO_Malchezaar_Male_Demon_FinalMalchezaarTurn1_01	El mago es poderoso, ¿pero cómo pudiste creer que podrías resistir un poder tan abrumador?	
VO_Malchezaar_Male_Demon_FinalMalchezaarTurn7_01	¡Oigo la música! ¡Los Medivas! ¡Qué fiesta! ¡Esta es mi noche!	
VO_Malchezaar_Male_Demon_FinalThirdSequence_01	¿Me han invocado de regreso a Karazhan? ¡Justo a tiempo para la fiesta!	
VO_Malchezaar_Male_Demon_FinalThirdSequence_04	¡Fuera de mi camino, idiota!	
VO_Malchezaar_Male_Demon_PrologueEmoteResponse_01	¡Tonto!	
VO_Malchezaar_Male_Demon_PrologueHeroPower_01	¡Todas las dimensiones, todas las realidades están abiertas a mí!	
VO_Malchezaar_Male_Demon_PrologueOpen_01	¿Dónde está mi invitación?	
VO_Malchezaar_Male_Demon_PrologueTurn1_04	¡¿No me invitaste?! ¡Pero si soy un príncipe de los Eredar!	
VO_Malchezaar_Male_Demon_PrologueTurn11_02	¿Invitaste a Jaraxxus? ¿Ese debilucho?	
VO_Malchezaar_Male_Demon_PrologueWin_01	¡Tú vienes conmigo!	
VO_Mediva_01_Female_Blood Elf_AranSpell_04	Oooh... ¡brrrr!	
VO_Mediva_01_Female_Blood Elf_ChessEmoteOops_06	¡Oh-oh!	
VO_Mediva_01_Female_Blood Elf_PrologueTurn5_06	¡Medivas!	
VO_Mediva_02_Female_Draenei_JulianneDeadlyPoison_02	¡Qué tragedia!	
VO_Mediva_02_Female_Draenei_PrologueTurn5_05	¿Sí?	
VO_Mediva_03_Male_Night Elf_AranHeroPower_01	¡Arde, baby, arde!	
VO_Mediva_03_Male_Night Elf_CuratorBeasts_04	¡Achís, baby!	
VO_Mediva_03_Male_Night Elf_PrologueTurn5_01	¿Me llamaste?	
VO_Medivas_Multiple_Multiple_CroneLionTigerBear_01	¡Oh, vaya!	
VO_Medivas_Multiple_Multiple_IllhoofWounded_01	Mmm... ¡tengo tanto miedo!	
VO_Medivas_Multiple_Multiple_NetherspiteTurn1_01	¡Rayos!	
VO_Medivh_Male_Human_EmoteGreetings_01	¿Qué haces tú aquí?	
VO_Medivh_Male_Human_EmoteOops_01	¿Ese era tu plan?	
VO_Medivh_Male_Human_EmoteSorry_01	Oh, eso no salió bien...	
VO_Medivh_Male_Human_EmoteThanks_01	Qué amable de tu parte.	
VO_Medivh_Male_Human_EmoteThreaten_01	¡Nunca tuviste una posibilidad!	
VO_Medivh_Male_Human_EmoteWellPlayed_01	Buen intento, demonio.	
VO_Medivh_Male_Human_EmoteWow_01	¡Jaja! ¡Eso fue genial!	
VO_Medivh_Male_Human_FinalMalchezaarTurn5_01	Excelente trabajo, Moroes, ¡ya se está armando la fiesta!	
VO_Medivh_Male_Human_FinalMalchezaarWin_01	¡Bien hecho! Vamos, ¡es hora de festejar!	
VO_Medivh_Male_Human_FinalMedivhMedivhSkin_01	¡Ey, un momento! ¡¿Eres yo?! ¿Del futuro? Dime, ¿qué te pareció esta fiesta? Fue ESPECTACULAR, ¿o no?	
VO_Medivh_Male_Human_FinalThirdSequence_01	¡Ah, un invitado! Por favor, ¿podrías encargarte del demonio? ¡Yo tengo que ocuparme de la fiesta!	
VO_Medivh_Male_Human_FinalThirdSequence_02	¿Te dejó sin cartas? Puedes usar los portales.	
VO_Medivh_Male_Human_FinalThirdSequence_03	Toma, te presto mi báculo. Sirve para controlar los portales. Pero no lo rayes.	
VO_Medivh_Male_Human_PrologueDeath_02	¿Qué? Imposible...	
VO_Medivh_Male_Human_PrologueHeroPower_01	¡Pero esta fiesta no!	
VO_Medivh_Male_Human_PrologueOpen_01	Aj, ¿otra vez tú?	
VO_Medivh_Male_Human_PrologueTurn1_02	¿Después de lo que pasó la última vez? ¡Todavía estamos arreglando el agujero en el techo!	
VO_Medivh_Male_Human_PrologueTurn11_01	¿Ya lo oíste cantar karaoke? ¡Es increíble!	
VO_Medivh_Male_Human_PrologueTurn3_02	Moroes, vigila el tablero de ajedrez. Los verdaderos invitados llegarán pronto.	
VO_Medivh_Male_Human_PrologueTurn9_01	¡Globos! ¡Moroes, olvidamos los globos!	
VO_Medivh_Male_Human_PrologueWin_01	¡Vuelve a tu casa, demonio!	
VO_Medivh_Male_Human_Wing0Intro_01	Hemos animado la vajilla, ensayado la ópera y preparado la Sala de las Fieras. ¡Será una noche inolvidable!	
VO_Medivh_Male_Human_Wing4Win_01	¡Pasa, aventurero! ¡Disfruta la fiesta!	
VO_Mirror_Male_Mirror_MirrorDeath_01	¡Ey! ¡Hiciste trampa! ¡Quiero la revancha!	
VO_Mirror_Male_Mirror_MirrorEmoteResponse_01	¡No, tú!	
VO_Mirror_Male_Mirror_MirrorFirstCard_01	¿Tienes eso en tu mazo?	
VO_Mirror_Male_Mirror_MirrorMedivhSkin_01	¡Oh! ¡Medivh, señor! Se ha puesto muy elegante para... ¿Qué...? ¡Ey! ¡Un momento! ¡Usted no es Medivh!	
VO_Mirror_Male_Mirror_MirrorMirrorImage_01	¡Ey, esa es mi carta favorita! ¿Cuál es la tuya? ¿Furibundo de magma?	
VO_Mirror_Male_Mirror_MirrorOpen_02	¡QUÉ ONDAAAAAA!	
VO_Mirror_Male_Mirror_MirrorTurn1_01	¡Uy, qué feos!	
VO_Mirror_Male_Mirror_MirrorTurn3_01	Espejito, espejito, ¿quién es de todos el más bonito?	
VO_Mirror_Male_Mirror_MirrorTurn3_03	¡Tú no, abuelito!	
VO_Mirror_Male_Mirror_MirrorTurn5_02	¿Nefarius? Más bien Ne-flácido, ¿no?	
VO_Mirror_Male_Mirror_MirrorWellPlayedResponse_01	¡Desearía poder decir lo mismo! ¡BAZINGA!	
VO_Moroes_Male_Human_AranTurn1_01	*Suspiro* Le presento a Aran, el fantasma gruñón.	
VO_Moroes_Male_Human_AranTurn9_04	Los dragones han arrasado con el bufé. ¡Y ahora miran a los múrlocs con cariño!	
VO_Moroes_Male_Human_AranWin_01	¡El portal está en la próxima habitación! ¡Llegamos justo a tiempo!	
VO_Moroes_Male_Human_ChessForfeit_02	Se ha quedado sin piezas. Ha perdido la partida.	
VO_Moroes_Male_Human_ChessTurn1_03	Mire, las piezas atacarán automáticamente al final de su turno.	
VO_Moroes_Male_Human_ChessTurn3_01	Si una pieza está entre dos enemigos, ¡los atacará a los dos!	
VO_Moroes_Male_Human_ChessTurn5_01	La buena ubicación es la clave de la victoria. ¡Aproveche los ataques dobles!	
VO_Moroes_Male_Human_ChessTurn7_01	¡Los demás invitados esperan afuera! Ya casi estamos en la ópera, ¡pero debemos apresurarnos!	
VO_Moroes_Male_Human_ChessTurn7_02	No le quedan muchas piezas. Si las pierde todas, también perderá la partida.	
VO_Moroes_Male_Human_ChessWin_01	¡Excelente! Ahora, ¡a la ópera!	
VO_Moroes_Male_Human_CroneTurn5_02	El Mayordomo Executus está abajo. ¿Quiere que le diga que llegó demasiado temprano?	
VO_Moroes_Male_Human_CroneWin_01	¡Al fin! ¡Vamos a liberar al mago!	
VO_Moroes_Male_Human_CuratorTurn3_01	¡El Curator está confundido! ¡Tendrá que detenerlo antes de que los libere a todos!	
VO_Moroes_Male_Human_CuratorWin_01	Muy bien... un ajuste por aquí y... ¡como nuevo!	
VO_Moroes_Male_Human_EndWing1_01	¡Excelente! ¡La casa de la ópera está subiendo estas escaleras! ¡Seguro que Barnes nos dejará pasar rápido!	
VO_Moroes_Male_Human_FinalAltTurn5_01	Cuántos portales... Me pregunto qué habrá en este...	
VO_Moroes_Male_Human_FinalMaidenTurn1_01	Lo siento, encárguese de esto. Estoy seguro de que encontraré los controles indicados.	
VO_Moroes_Male_Human_FinalMaidenTurn7_03	Oh, ese es el mundo de los tentáculos. Le aseguro que no es lo que buscamos.	
VO_Moroes_Male_Human_FinalNazraTurn7_02	¡Haga retroceder a la orco para que podamos abrir otro portal!	
VO_Moroes_Male_Human_FinalSecondSequence_01	¡Excelente! Ahora veamos si este funciona...	
VO_Moroes_Male_Human_FInalStartSequence_01	Mmmm... Veamos. ¿Será este?	
VO_Moroes_Male_Human_FinalThirdSequence_01	¡Lo logré!	
VO_Moroes_Male_Human_FinalTurn1_02	¡Uy! Portal equivocado. Pelee contra la orco para que yo pueda intentarlo de nuevo.	
VO_Moroes_Male_Human_IllhoofKilrekResponse_01	¿Qué están tratando de invocar?	
VO_Moroes_Male_Human_JulianneTurn5_01	¡Déjanos pasar, Barnes! ¡Tenemos que encontrar a Medivh antes de que se arruine la fiesta!	
VO_Moroes_Male_Human_JulianneTurn9_02	¡Ha llegado Illidan! ¡No estamos preparados!	
VO_Moroes_Male_Human_MedivhSkinResponse_01	¿Un disfraz de Medivh? ¡Vaya, el parecido es fascinante!	
VO_Moroes_Male_Human_MirrorTurn3_01	Mmmmm...	
VO_Moroes_Male_Human_MirrorTurn5_01	Lord Nefarius llegará pronto. Tiemblo con solo pensar en su reacción.	
VO_Moroes_Male_Human_MirrorWin_02	¡Excelente! Las escaleras a la ópera están un poco más adelante.	
VO_Moroes_Male_Human_NetherspiteTurn1_01	Esos rayos fortalecen al dragón. ¡Use esbirros para bloquearlos!	
VO_Moroes_Male_Human_NetherspiteTurn5_01	¡Solo dinos dónde está Medivh!	
VO_Moroes_Male_Human_NetherspiteTurn7_01	¡Necesitamos esos portales! ¡Los invitados están lanzando libros a la reserva de maná!	
VO_Moroes_Male_Human_NetherspiteWin_01	¡Bien hecho! Ahora... si tan solo pudiera recordar cómo funciona esto...	
VO_Moroes_Male_Human_NightbaneTurn3_01	Curator, ¡tenemos que rescatar a Medivh!	
VO_Moroes_Male_Human_NightbaneTurn7_01	Ha llegado la Liga de Expedicionarios. RENO, ¡NO TOQUES LA VAJILLA!	
VO_Moroes_Male_Human_PrologueTurn11_01	*Ejem* Y no incendió la biblioteca...	
VO_Moroes_Male_Human_PrologueTurn5_03	Señor, los Medivas están listos. Barnes está ensayando con ellos.	
VO_Moroes_Male_Human_PrologueTurn7_01	¿Ya vio lo que está pasando afuera, señor? Los jefes de las bandas están armando un escándalo para conseguir una invitación.	
VO_Moroes_Male_Human_PrologueTurn9_02	Señor, los múrlocs les tienen pánico a los globos. ¿Ya olvidó lo que pasó la semana pasada?	
VO_Moroes_Male_Human_PrologueWin_02	Mmm, esto no está bien. Esto no está nada bien.	
VO_Moroes_Male_Human_SilverwareResponse_01	Ooh. Eso era una antigüedad.	
VO_Moroes_Male_Human_SilverwareTurn3_02	¡La vajilla está trabajando en equipo! ¡Estamos rodeados!	
VO_Moroes_Male_Human_SilverwareWin_01	Ah, ¡qué desastre!	
VO_Moroes_Male_Human_Wing1Intro_02	Soy Moroes, administrador de Karazhan, y necesito su ayuda. ¡Medivh ha desaparecido! ¡Necesitaremos los portales de la cima de la torre para salvarlo y para salvar la fiesta!	
VO_Moroes_Male_Human_Wing1Win_01	¡Buen trabajo! A este paso, llegaremos a la cima de la torre a tiempo para salvar la fiesta.	
VO_Moroes_Male_Human_Wing2Win_01	¡Adelante! Al final de esas escaleras, el Curator protege la Sala de las Fieras. Espero que no haya sufrido ningún desperfecto...	
VO_Moroes_Male_Human_Wing3Open_02	El Curator protege la Sala de las Fieras, hogar de las criaturas más exóticas de Azeroth. Más adelante se encuentran los aposentos del maestro, ¡y el portal para salvar a Medivh!	
VO_Moroes_Male_Human_Wing3Win_02	¡Ya casi llegamos a la cima! ¡Tenemos que salvar a Medivh antes de que la fiesta se convierta en una gresca!	
VO_Moroes_Male_Human_Wing4Intro_01	¡Al fin! ¡La cima de la torre! ¡Encuentre el portal correcto y traiga a Medivh de regreso!	
VO_Moroes_Male_Human_Wing4Win_01	Lo logró. No puedo creer que la fiesta haya empezado a tiempo. ¿Podría regresar la próxima semana? Es el cumpleaños de Medivh y... eh, necesito refuerzos.	
VO_Moroes_Male_Human_WolfClaws_03	No creo que eso sea cierto...	
VO_NAX1_01_CARD_02	¡Solo un pequeño bocado!	
VO_NAX1_01_DEATH_05	¿Por qué...? ¡¿Por qué?!	
VO_NAX1_01_EMOTE_04	¡Oh! ¡Habla!	
VO_NAX1_01_HP_03	¡Acérquense, mis bocadillos!	
VO_NAX1_01_START_01	Ah, qué bueno verte por aquí...	
VO_NAX10_01_DEATH_LINE_03	¿Qué le ha sucedido a... Remen...? Aaaahrr...	
VO_NAX10_01_EMOTE1_04	¿Hora de juegar?	
VO_NAX10_01_EMOTE2_05	¡Sí! ¡A juegar! ¡Juegar!	
VO_NAX10_01_HP_02	¿No juegamos más?	
VO_NAX10_01_START_01	¡Remendejo quiere juegar!	
VO_NAX11_01_CARD_03	Lodo.	
VO_NAX11_01_DEATH_05	*ugh uh ahoh gowr grrrlrrlrrlaaahhh*	
VO_NAX11_01_EMOTE_04	No palabras.	
VO_NAX11_01_HP_02	Peste.	
VO_NAX11_01_START_01	Carne.	
VO_NAX12_01_CARD_01	*Rugido*	
VO_NAX12_01_DEATH_01	*Gimotea*	
VO_NAX12_01_EMOTE_01	*Gruñido*	
VO_NAX12_01_EMOTE_02	*Grrr*	
VO_NAX12_01_EMOTE_03	*Grrroooooo*	
VO_NAX12_01_HP_01	*Groooar GULP*	
VO_NAX12_01_START_01	*Refunfuño*	
VO_NAX13_01_DEATH_LINE_03	Gracias...	
VO_NAX13_01_EMOTE_04	¡A matar!	
VO_NAX13_01_HP_02	¡Muere ahora!	
VO_NAX13_01_START_01	¡Debo obedecer!	
VO_NAX14_01_CARD_01	*rrrrrAAAHH*	
VO_NAX14_01_DEATH_01	*Groooarrr...*	
VO_NAX14_01_EMOTE_01	*rrrr ¡Rrahhh!*	
VO_NAX14_01_EMOTE_02	*grraaaaah*	
VO_NAX14_01_EMOTE_03	*grooooaaar*	
VO_NAX14_01_HP_01	*groooarrr*	
VO_NAX14_01_START_01	*GROOOARRR*	
VO_NAX15_01_BIGGLES_32	¡No! ¡Maldito seas, intruso!	
VO_NAX15_01_DEATH_LINE_08	¡Este no es el fin! ¡Aún está el modo heroico!	
VO_NAX15_01_DEATH_LINE2_09	¡NooooOooOOOooo!	
VO_NAX15_01_EMOTE_HELLO_26	¿Siempre saludas a los que quieren matarte?	
VO_NAX15_01_EMOTE_OOPS_29	Sin dudas.	
VO_NAX15_01_EMOTE_SORRY_28	No te preocupes, intruso, todos nos equivocamos.	
VO_NAX15_01_EMOTE_THANKS_27	Ehh... ¿de nada?	
VO_NAX15_01_EMOTE_THREATEN_30	¡Oh, qué miedo!	
VO_NAX15_01_EMOTE_WP_25	Pfff, qué novedad... ¡Soy el maldito Kel'Thuzad!	
VO_NAX15_01_HP_07	¡Te congelaré la sangre de las venas!	
VO_NAX15_01_HP2_05	Ahora tu alma está ligada a mí.	
VO_NAX15_01_HP3_06	No habrá escapatoria.	
VO_NAX15_01_HURRY_31	Mi paciencia se agota.	
VO_NAX15_01_PHASE2_10	¡Insensato! ¡Ya casi has gastado tus poderes!	
VO_NAX15_01_PHASE2_ALT_11	¡No! Tu turno ya ha terminado. Ahora me toca a MÍ.	
VO_NAX15_01_RESPOND_ANDUIN_24	¡Qué ingenuo! ¿No recuerdas lo que le pasó a Uther?	
VO_NAX15_01_RESPOND_GARROSH_15	¿Lo dices en serio? Pues, muerte.	
VO_NAX15_01_RESPOND_GARROSH_ALT_16	¿Puedo elegir? ¡Pues parece que te espera la muerte!	
VO_NAX15_01_RESPOND_GULDAN_22	Alguien aquí se quedará con un alma, y no serás tú...	
VO_NAX15_01_RESPOND_JAINA_23	Por supuesto que no. ¡Tú irrumpiste en MI necrópolis flotante!	
VO_NAX15_01_RESPOND_MALFURION_ALT_21	¿Lo salvaje? Y entonces, ¿qué estás haciendo en Naxxramas?	
VO_NAX15_01_RESPOND_REXXAR_19	Como tú digas.	
VO_NAX15_01_RESPOND_THRALL_17	¿Peleas por un martillo? Bien por ti.	
VO_NAX15_01_RESPOND_UTHER_14	... y yo con esbirros enormes y hechizos devastadores. ¡Buena suerte!	
VO_NAX15_01_RESPOND_VALEERA_18	Sí, cómo no...	
VO_NAX15_01_START_13	Al fin nos conocemos.	
VO_NAX15_01_SUMMON_ADDS_12	¡Sean libres, mis esbirros!	
VO_NAX2_01_CARD_02	¡Mátalos en el nombre del amo!	
VO_NAX2_01_CUSTOM_03	¡Has fracasado!	
VO_NAX2_01_DEATH_LINE_05	¡El amo vengará mi muerte!	
VO_NAX2_01_EMOTE_06	¡Jajajajajaja!	
VO_NAX2_01_HP_04	¡Arrodíllate ante mí, sabandija!	
VO_NAX2_01_START_01	¡Mis acólitos me sirven! ¡No me cuestionan!	
VO_NAX3_01_CARD_01	*grghhghgh*	
VO_NAX3_01_DEATH_01	*siseo*	
VO_NAX3_01_EMOTE_01	*siseo*	
VO_NAX3_01_EMOTE_02	*siseo*	
VO_NAX3_01_EMOTE_03	*siseo*	
VO_NAX3_01_EMOTE_04	*siseo*	
VO_NAX3_01_EMOTE_05	*siseo*	
VO_NAX3_01_HP_01	*siseo*	
VO_NAX3_01_START_01	*escabulléndose*	
VO_NAX4_01_CARD_03	Aprovecha tu último aliento.	
VO_NAX4_01_DEATH_LINE_04	Serviré a mi amo en la muerte.	
VO_NAX4_01_EMOTE_06	¡Muere, intruso!	
VO_NAX4_01_HP_02	¡Levántense, mis soldados! ¡Levántense y luchen una vez más!	
VO_NAX4_01_START_01	Otra alma para la... "colección".	
VO_NAX5_01_CARD_03	¡Te dejaré deMENTE!	
VO_NAX5_01_DEATH_LINE_04	Ni la muerte limpiará las impurezas de mi alma.	
VO_NAX5_01_EMOTE_05	No tengo tiempo para estas tonterías.	
VO_NAX5_01_HP_02	¡Bailen, tontos!	
VO_NAX5_01_START_01	¿Y tú crees que estás a salvo aquí?	
VO_NAX6_01_CARD_03	El fin se acerca.	
VO_NAX6_01_DEATH_LINE_04	*rruuuhhhh*	
VO_NAX6_01_EMOTE_05	Desperdicias tu aliento.	
VO_NAX6_01_HP_02	Ahora me perteneces.	
VO_NAX6_01_START_01	Te veo.	
VO_NAX7_01_CARD_03	¡Deberías haberte quedado en casa!	
VO_NAX7_01_DEATH_LINE_04	Ugh... una muerte honorable.	
VO_NAX7_01_EMOTE_05	¡Ja! ¡Solo estoy entrando en calor!	
VO_NAX7_01_HP_02	¡Yieea!	
VO_NAX7_01_START_01	¡No! ¡No! ¡Mis estudiantes! ¡Devuélvemelos!	
VO_NAX8_01_CARD_02	Mata a mis esbirros si quieres... Sus almas te harán una visita.	
VO_NAX8_01_CUSTOM_03	¡Jajaja! ¡Idiota! ¡Soy el Cosechador de almas!	
VO_NAX8_01_CUSTOM2_04	¡Los muertos regresan!	
VO_NAX8_01_DEATH_LINE_05	¡Es mi fin!	
VO_NAX8_01_EMOTE1_06	Tu estupidez te ha llevado hasta la muerte.	
VO_NAX8_01_EMOTE2_07	¡Qué imprudente! Nunca subestimes los poderes que no conoces.	
VO_NAX8_01_EMOTE3_08	Has intentado invadir el reino del Cosechador con todas tus fuerzas.	
VO_NAX8_01_EMOTE4_09	Ahora solo te queda una salida...	
VO_NAX8_01_EMOTE5_10	... ir al menú de opciones y seleccionar RENDIRSE.	
VO_NAX8_01_START_01	Mis esbirros nunca mueren realmente.	
VO_NAX9_01_CUSTOM_02	Ya basta de parloteo. Que vengan.	
VO_NAX9_01_DEATH_LINE_03	¡No! ¡Necesito más tiempo!	
VO_NAX9_01_EMOTE_04	¿Andas en busca de la muerte?	
VO_NAX9_01_START_01	Pulverizaremos tus huesos.	
VO_NAX9_02_CUSTOM_01	¡Invasor! ¡Huye mientras puedas!	
VO_NAX9_03_CUSTOM_01	Ven, Zeliek, vamos a divertirnos.	
VO_NAX9_04_CUSTOM_01	¡Veamos qué tienes, tonto llorón!	
VO_Nazra_Female_Orc_FinalNazraChogall_02	¿El clan del Martillo Crepuscular? ¿Aquí?	
VO_Nazra_Female_Orc_FinalNazraDeath_01	Por la Horda...	
VO_Nazra_Female_Orc_FinalNazraEmoteResponse_01	¡Nazra te aplastará!	
VO_Nazra_Female_Orc_FinalNazraGrom_01	¡¿Grommash?! ¡Tanto tiempo!	
VO_Nazra_Female_Orc_FinalNazraHeroPower_01	¡Nazra reinará en este mundo patético!	
VO_Nazra_Female_Orc_FInalStartSequence_01	¡Tiembla ante la Horda!	
VO_NEFARIAN_ATRAMEDES_DEATH_76	Has matado a un dragón ciego. Qué vergüenza.	
VO_NEFARIAN_BARON_GEDDON_DEAD_40	Ya estamos cerca. Sí. ¡Sí!	
VO_NEFARIAN_CHROMAGGUS_DEAD_63	En realidad, Chromaggus era mi esbirro más débil. ¿Creíste que eso era todo?	
VO_NEFARIAN_CHROMAGGUS1_59	Le di dos cabezas porque pensé "¡Ey, el doble de mordeduras!"	
VO_NEFARIAN_CHROMAGGUS2_60	¡Le he concedido los poderes de todos los vuelos! ¡Es perfecto!	
VO_NEFARIAN_CHROMAGGUS3_61	Buen trabajo, Chromaggus. Buen chico.	
VO_NEFARIAN_CHROMAGGUS4_62	Oh, no, ¿se te está cansando la mano? ¡Muajaja! Buen perrito.	
VO_NEFARIAN_COREN_DEAD_28	El Tragapenas. Qué entretenido.	
VO_NEFARIAN_DRAKKISATH_DEAD_50	Estoy empezando a impacientarme.	
VO_NEFARIAN_DRAKKISATH_RESPOND_48	Sí, Drakkisath. Aventurero, aún estás del lado equivocado de la montaña.	
VO_NEFARIAN_DRAKKISATH1_49	Mira, mejor ve a jugar al modo clasificado. Esta aventura no es para ti.	
VO_NEFARIAN_GARR_DEAD1_38	Deberías tomar un trozo de Garr y arrojarlo contra la superficie del charco de lava de Ragnaros, a ver cuántas veces rebota. Eso le gustará.	
VO_NEFARIAN_GARR2_35	Oye, cuidado con las piedritas.	
VO_NEFARIAN_GARR3_36	Trata de no explotar. Aún te queda un Señor elemental por derrotar.	
VO_NEFARIAN_GARR4_37	¿Sabes algo? Me gusta verte en acción.	
VO_NEFARIAN_GRIMSTONE_DEAD1_30	¡Sigue así y pronto expulsaremos a Ragnaros de esta montaña!	
VO_NEFARIAN_HEROIC_BLOCK_77	No en el modo heroico.	
VO_NEFARIAN_MALORIAK_DEATH_PT1_72	¡Felicitaciones! ¡Qué logro tan sorprendente!	
VO_NEFARIAN_MALORIAK_DEATH_PT2_73	Creo que te concederé un nuevo título para conmemorar este momento.	
VO_NEFARIAN_MALORIAK_DEATH_PT3_74	Asesino de esbirros estúpidos, incompetentes y decepcionantes. Sí, te queda perfecto.	
VO_NEFARIAN_MALORIAK_TURN2_71	Maloriak, trata de no perder ante este mortal.	
VO_NEFARIAN_NEF_MISSION_66	¡Esto es trampa! ¡No voy a tolerarlo!	
VO_NEFARIAN_NEF2_65	¡No! ¡No! ¡Te destruiré!	
VO_NEFARIAN_OMNOTRON_DEAD_69	Me has ahorrado unas reparaciones muy costosas. Gracias.	
VO_NEFARIAN_OMOKK_DEAD_46	¡Esto no tiene ningún sentido!	
VO_NEFARIAN_OMOKK1_44	¿Qué haces aquí? Ragnaros ha muerto. Deberías estar celebrando con tus amigos.	
VO_NEFARIAN_OMOKK2_45	Estoy confundido. Aquí no hay ningún Ragnaros. Tu misión ha terminado. VETE A CASA.	
VO_NEFARIAN_RAZORGORE_DEAD_55	¡Esos huevos iban a usarse en experimentos gloriosos!	
VO_NEFARIAN_REND_DEAD_53	Mira, mortal. Estás metiéndote con el dragón equivocado.	
VO_NEFARIAN_REND1_52	Hasta este orco se da cuenta de que estás haciendo algo mal.	
VO_NEFARIAN_THAURISSAN_DEAD_32	¡Debiste haber asesinado a esa otra enana! ¡No dejes sobrevivientes!	
VO_NEFARIAN_THAURISSAN_DEAD2_33	Lograste matar a los dos enanos. Impresionante, aventurero.	
VO_NEFARIAN_VAEL_DEAD_57	¡Ja! ¡Has matado a uno de los buenos! ¿Estás triste?	
VO_Netherspite_Male_Dragon_NetherspiteAngryChicken_01	¿Tú otra vez? ¿Por qué estás siempre dentro de mis portales?	
VO_Netherspite_Male_Dragon_NetherspiteDeath_01	Mi obra...	
VO_Netherspite_Male_Dragon_NetherspiteEmoteResponse_01	¿Desafías a un dragón en su laboratorio?	
VO_Netherspite_Male_Dragon_NetherspiteEmpowerment_01	¡Tantos mundos! ¡Tanto que aprender!	
VO_Netherspite_Male_Dragon_NetherspiteOpen_01	¿Quién interrumpe mi investigación?	
VO_Netherspite_Male_Dragon_NetherspiteShadowBreath_01	¡Largo de aquí!	
VO_Netherspite_Male_Dragon_NetherspiteTurn12_01	If 12 murlocs leave the red portal at 4 o’clock, and C’Thun arrives at 5 o’clock...	
VO_Netherspite_Male_Dragon_NetherspiteTurn3_02	¡Mis experimentos! ¡No los toques!	
VO_Netherspite_Male_Dragon_NetherspiteTurn5_01	¡Deja de tocar los portales! ¡Las modulaciones de flujo están calibradas a la perfección!	
VO_Netherspite_Male_Dragon_NetherspiteTurn7_01	Esa fiesta parece divertida. ¿Por qué no vas ahí y dejas mis portales en paz?	
VO_Netherspite_Male_Dragon_NetherspiteUnstablePortal_01	Qué interesante. Mmmm... Desequilibrios fundamentales.	
VO_Netherspite_Male_Dragon_NetherspiteUnstablePortal_02	Qué interesante... Desequilibrios fundamentales...	
VO_Nightbane_Roar	*RUGIDO*	
VO_RAGNAROS_GRIMSTONE_DEAD2_66	¡YO TE EXPULSARÉ A TI, CRÍA ESCAMOSA!	
VO_RAGNAROS_NEF1_71	¡AVENTURERO! ¡PARECE QUE NECESITAS AYUDA!	
VO_RAGNAROS_NEF3_72	¡LA VENGANZA SERÁ MÍA! ¡EL FUEGO TE PURGARÁ!	
VO_RAGNAROS_NEF4_73	¡ENVIARÉ A MIS ESBIRROS PARA DESTRUIRTE, ALANEGRA!	
VO_RAGNAROS_NEF5_74	¡CONVIERTAN A ESTE DRAGÓN ENGREÍDO EN CENIZAS!	
VO_RAGNAROS_NEF6_75	¡UN REGALO DE LAS TIERRAS DE FUEGO!	
VO_RAGNAROS_NEF7_76	¡NO PUEDES EXTINGUIR LAS LLAMAS DEL SEÑOR DEL FUEGO!	
VO_RAGNAROS_NEF8_77	¡ME VENGARÉ, DRAGÓN!	
VO_SilverwareGolem_Male_SilverwareGolem_SilverwareDeath_02	A guardar, a guardar; cada plato en su lugar...	
VO_SilverwareGolem_Male_SilverwareGolem_SilverwareEmoteResponse_01	¿Qué tal una pulida?	
VO_SilverwareGolem_Male_SilverwareGolem_SilverwareForkedLightning_01	¿Te gustan los tenedores? ¡Yo tengo tenedores!	
VO_SilverwareGolem_Male_SilverwareGolem_SilverwareHeroPower_01	¡Preparen la mesa! ¡Preparen el piso!	
VO_SilverwareGolem_Male_SilverwareGolem_SilverwareKnifeJuggler_01	¡Oooh, lanzamiento de cuchillos!	
VO_SilverwareGolem_Male_SilverwareGolem_SilverwareOpen_01	¡Me gusta bailar!	
VO_SilverwareGolem_Male_SilverwareGolem_SilverwarePlateTossing_01	¡Un plato para ti! ¡Un plato para ti! ¡Platos para todos!	
VO_TB_MEDIVA1_001	Arde...	
VO_TB_MEDIVA1_002	¡Cuidado!	
VO_TB_MEDIVA1_003	¡Oh, Tito!	
VO_TB_MEDIVA1_004	¡Salud!	
VO_TB_MEDIVA1_005	¡Bestial!	
VO_TB_MEDIVA1_006	Qué peluditos.	
VO_TB_MEDIVA1_007	¡No! Veneno no.	
VO_TB_MEDIVA1_008	¡Qué brillante!	
VO_TB_MEDIVA1_009	¿Necesitabas algo?	
VO_TB_MEDIVA2_001	¡Qué calor!	
VO_TB_MEDIVA2_002	¡Espeluznante!	
VO_TB_MEDIVA2_003	¡Ooh, qué frío!	
VO_TB_MEDIVA2_004	¡Oh, no! ¡Una trampa!	
VO_TB_MEDIVA2_005	Oh, no, no puedo mirar.	
VO_TB_MEDIVA2_006	Ter...nurita.	
VO_TB_MEDIVA2_007	Me encantan los diablillos.	
VO_TB_MEDIVA2_008	¡Qué brillante!	
VO_TB_MEDIVA2_009	¡Achú! ¡AJ!	
VO_TB_MEDIVA2_010	¿Tú me llamaste?	
VO_TB_MEDIVA3_001	¡Qué calor!	
VO_TB_MEDIVA3_002	¡Congélate, muñeco de nieve!	
VO_TB_MEDIVA3_003	¡Tenebrosa oscuridad!	
VO_TB_MEDIVA3_004	¡Una trampa!	
VO_TB_MEDIVA3_005	¡Eso es lo que yo llamo bestias!	
VO_TB_MEDIVA3_006	¡Este tipo tiene mascotas!	
VO_TB_MEDIVA3_007	Ay, no, qué mala onda.	
VO_TB_MEDIVA3_008	Eso es lo que yo llamo veneno...	
VO_TB_MEDIVA3_009	Y ahora... ¡los Medivas!	
VO_TB_MEDIVA3_010	¡Sííí!	
VO_TIRION_INTRO_03	¿Quién de todos ustedes, nobles caballeros, se alzará con el título de Campeón?
VO_WhiteKing_Male_ChessPiece_ChessDeath_01	Jaque mate...	
VO_WhiteKing_Male_ChessPiece_ChessEmoteGreetings_01	¿Qué tal una partida?	
VO_WhiteKing_Male_ChessPiece_ChessEmoteOops_01	Oh, un error.	
VO_WhiteKing_Male_ChessPiece_ChessEmoteSorry_01	Un giro desafortunado.	
VO_WhiteKing_Male_ChessPiece_ChessEmoteThanks_01	Pero qué amable.	
VO_WhiteKing_Male_ChessPiece_ChessEmoteThinking_01	Torre a A3...	
VO_WhiteKing_Male_ChessPiece_ChessEmoteThinking_02	Caballo a F6...	
VO_WhiteKing_Male_ChessPiece_ChessEmoteThinking_03	Reina a E5... No, no…	
VO_WhiteKing_Male_ChessPiece_ChessEmoteThreaten_01	Jaque mate en 4.	
VO_WhiteKing_Male_ChessPiece_ChessEmoteWellPlayed_01	Jaque mate.	
VO_WhiteKing_Male_ChessPiece_ChessEmoteWow_01	¡Ah, excepcional!	
VO_WhiteKing_Male_ChessPiece_ChessOpen_02	¡En garde!	
VOX_Nightbane_Start_01	¡Rrrraaarr!	
