TAG	TEXT	COMMENT
TUTORIAL_ARCANE_INTELLECT_DESCRIPTION	คุณสามารถมีการ์ดในมือได้สูงสุด 10_ใบ	
TUTORIAL_ARCANE_INTELLECT_HEADLINE	จำนวนการ์ดในมือ	
TUTORIAL_MOBILE_COMPLETE_CONGRATS	คุณชนะอิลลิดันแล้ว! สร้างบัญชีฟรีเพื่อท้าดวลกับคู่แข่งออนไลน์คนใหม่เลยสิ!	
TUTORIAL_MOBILE_CREATE_ACCOUNT	สร้างบัญชี	
TUTORIAL_NO_ENDTURN	อย่าเพิ่ง! คุณยังมีการ์ดที่เล่นได้อีก!	
TUTORIAL_NO_ENDTURN_ATK	อย่าเพิ่ง! คุณยังโจมตีได้อยู่	
TUTORIAL_NO_ENDTURN_HP	อย่าเพิ่ง! ใช้พลังฮีโร่ของคุณก่อน	
TUTORIAL_PROGRESS_LESSON_TITLE	การเดินทางเริ่มต้นขึ้นแล้ว	
TUTORIAL_PROGRESS_SAVED	บันทึกความคืบหน้าแล้ว	
TUTORIAL_PROGRESS_TITLE	ความคืบหน้าของภารกิจ	
TUTORIAL_RAID_LEADER_DESCRIPTION	มินเนี่ยนตัวนี้มีพลังที่จะคงอยู่[b]จนกว่ามันจะตาย	
TUTORIAL_RAID_LEADER_HEADLINE	พลัง	
TUTORIAL_TOOLTIP_DECK_DESCRIPTION	คุณจะจั่วการ์ดหนึ่งใบแบบสุ่ม[b]จากเด็คในแต่ละเทิร์น	
TUTORIAL_TOOLTIP_ENEMYDECK_DESC	ฝ่ายตรงข้ามก็จะจั่วการ์ดหนึ่งใบ[b]ในแต่ละเทิร์น 	
TUTORIAL_TOOLTIP_HISTORY_DESC	นี่คือบันทึกเหตุการณ์[b]ในเกม	
TUTORIAL_TOOLTIP_HISTORY_HEADLINE	ประวัติ	
TUTORIAL_WANTED	ประกาศจับ	
TUTORIAL01_HELP_01	ถ้าพลังชีวิตของคุณหมด คุณจะเป็นฝ่ายแพ้	
TUTORIAL01_HELP_02	การ์ดใบนี้ใช้\nไปเมื่อเทิร์นที่แล้ว	
TUTORIAL01_HELP_03	จัดการโนลล์ตัวนี้ซะ!	
TUTORIAL01_HELP_04	มินเนี่ยนจะต้องรอหนึ่งเทิร์น\nจึงจะโจมตีได้	
TUTORIAL01_HELP_05	โจมตีฮ็อกเกอร์!	
TUTORIAL01_HELP_06	ใช้ทุกอย่างที่มี\nเพื่อจัดการฮ็อกเกอร์!	
TUTORIAL01_HELP_07	เก็บใบนั้นไว้สำหรับศัตรู!	
TUTORIAL01_HELP_08	ไม่ต้องสนใจโนลล์กระจอกตัวนั้น แล้วจัดการฮ็อกเกอร์ซะ	
TUTORIAL01_HELP_09	เมื่อพลังชีวิตของฮ็อกเกอร์หมด คุณจะเป็นฝ่ายชนะ	
TUTORIAL01_HELP_10	โจมตีด้วยมินเนี่ยน[b]ของคุณ!	
TUTORIAL01_HELP_11	คลิกเพื่อโจมตี	
TUTORIAL01_HELP_12	ความเสียหายที่[b]มินเนี่ยนทำได้	
TUTORIAL01_HELP_13	ความเสียหายที่[b]มินเนี่ยนรับได้	
TUTORIAL01_HELP_14	จัดการฮ็อกเกอร์!	
TUTORIAL01_HELP_15	เล่นการ์ดมินเนี่ยนและใช้พวกมันโจมตีใส่ฮ็อกเกอร์\n\nเมื่อสร้างความเสียหายได้มากพอ คุณจะเป็นฝ่ายชนะ!	
TUTORIAL01_HELP_16	เริ่มได้!	
TUTORIAL01_HELP_17	คลิกที่ตัวเขา!	
TUTORIAL01_HELP_17_TOUCH	แตะตัวเขา!	
TUTORIAL01_HELP_18	การ์ดฟรี!	
TUTORIAL02_HELP_01	คุณจะได้รับคริสตัล\nมานาเพิ่มทุกเทิร์น	
TUTORIAL02_HELP_02	การเล่นการ์ดจะต้องจ่ายด้วยมานา	
TUTORIAL02_HELP_03	คุณจะได้รับคริสตัลมานา\nที่ใช้ไปแล้วคืนทุกเทิร์น	
TUTORIAL02_HELP_04	คุณมี {0}_มานา	
TUTORIAL02_HELP_06	จัดการมิลเฮาส์!	
TUTORIAL02_HELP_07	ใช้มานาของคุณในแต่ละเทิร์น\nเพื่อจัดการเจ้าโนมน่ารำคาญนี่!	
TUTORIAL02_STARTING_HAND	การ์ดเริ่มเกม	
TUTORIAL03_HELP_01	กอริลล่าตัวนี้มี[b]ความสามารถยั่วยุ	
TUTORIAL03_HELP_02	ราชาเสด็จแล้ว	
TUTORIAL03_HELP_03	ไม่เข้าใจความสามารถการ์ดงั้นเหรอ? เอาเมาส์ไปชี้ที่การ์ดสิ!	
TUTORIAL03_HELP_03_TOUCH	ไม่เข้าใจความสามารถการ์ดงั้นเหรอ? แตะการ์ดค้างไว้สิ!	
TUTORIAL04_HELP_01	คุณสามารถใช้พลังฮีโร่[b]ของคุณได้เทิร์นละครั้ง	
TUTORIAL04_HELP_02	สาปมันเป็นแกะเลย!	
TUTORIAL04_HELP_03	เก็บใบนั้นไว้ใช้กับปีศาจหนองน้ำ!	
TUTORIAL04_HELP_14	ยินดีต้อนรับสู่ผืนป่า	
TUTORIAL04_HELP_15	ฆ่ามินเนี่ยนของเขา ก่อนที่เขาจะถล่มคุณ!	
TUTORIAL04_HELP_16	จัดการกับมินเนี่ยนด้วยพลังฮีโร่และเวทมนตร์ของคุณ!	
TUTORIAL05_HELP_01	ความทนทานของอาวุธ[b]จะลดลงเมื่อคุณโจมตี	
TUTORIAL05_HELP_02	ผู้ทรยศ	
TUTORIAL05_HELP_03	การต่อสู้ครั้งนี้ไม่ยุติธรรมเอาซะเลย โทษคนออกแบบเกมห่วยๆ แล้วกันนะ	
TUTORIAL05_HELP_04	มินเนี่ยนที่มีความสามารถยั่วยุสามารถปกป้องคุณจากการโจมตีได้!	
TUTORIAL05_WEAPON_DESC	ใช้ฮีโร่ของคุณโจมตีจนกว่า[b]ความทนทานของอาวุธจะหมด	
TUTORIAL05_WEAPON_HEADLINE	อาวุธ	
TUTORIAL06_HELP_01	ลอร์วอล์คเกอร์ โช	
TUTORIAL06_HELP_02	เมื่อมินเนี่ยนต่อสู้กัน *ทั้งคู่* จะได้รับความเสียหาย	
TUTORIAL06_HELP_03	มินเนี่ยนที่ความสามารถ "คำรามสู้ศึก" จะทำบางอย่างเมื่อคุณส่งลงจากมือ	
TUTORIAL06_HELP_04	ฆ่ามินเนี่ยนของฝ่ายตรงข้ามก่อนที่พวกมันจะกลายเป็นตัวปัญหา!	
TUTR_HELPER_Fight_01_AttackHero	โจมตีเร็กซ์ซาร์ด้วย[b]มินเนี่ยน[b]ของ[b]คุณ!	
TUTR_HELPER_Fight_01_AttackHuffer	โจมตีมินเนี่ยนศัตรู!	
TUTR_HELPER_Fight_01_HeroPower	ใช้พลังฮีโร่ของคุณ[b]ใส่[b]มินเนี่ยน[b]ตัวนั้น!	
TUTR_HELPER_Fight_01_HistoryTiles	แถบประวัติ[b]แสดง[b]การ[b]กระทำ[b]ที่ผ่านมา	
TUTR_HELPER_Fight_01_Mana	มานาเพิ่มขึ้นทุกรอบ การเล่น[b]การ์ด[b]ต้อง[b]ใช้[b]มานา	
TUTR_HELPER_Fight_01_Mana_02	คริสตัลมานาจะฟื้นฟู[b]กลับมา[b]ทุกรอบ	
TUTR_HELPER_Fight_01_MinionsDestroyed	มินเนี่ยนสร้างความเสียหาย[b]ให้[b]กัน[b]และ[b]กัน[b]เมื่อ[b]โจมตี	
TUTR_HELPER_Fight_01_PlayCard	ลากมินเนี่ยนใบนี้[b]ลง[b]สนาม[b]เพื่อ[b]เล่น[b]มัน!	
TUTR_HELPER_Fight_01_PlayHuffer	ค่าพลังโจมตีทางซ้าย[b]คือ[b]ความ[b]เสียหาย[b]ที่[b]มินเนี่ยน[b]สร้าง[b]ให้[b]ศัตรู	
TUTR_HELPER_Fight_01_PlayHuffer_02	ค่าพลังชีวิตทางขวา[b]คือ[b]ความ[b]เสียหาย[b]ที่มัน[b]รับได้[b]ก่อน[b]ตาย	
TUTR_HELPER_Fight_01_PlayMinion	วางเคอร์เซอร์เหนือ[b]การ์ด[b]เพื่อ[b]ดู[b]ความ[b]สามารถ[b]ของมัน	
TUTR_HELPER_Fight_01_PlaySpell	ลากเวทมนตร์นี้[b]ไปที่[b]มินเนี่ยน[b]ศัตรู[b]เพื่อ[b]ทำลาย[b]มัน!	
TUTR_HELPER_Fight_01_PlayTaunt	มินเนี่ยนต้องทำลาย[b]ศัตรู[b]ที่มี[b]ยั่วยุ[b]ก่อน	
TUTR_HELPER_Fight_01_PlayWeapon	อาวุธเสียความ[b]ทนทาน[b]เมื่อ[b]ฮีโร่[b]โจมตี	
TUTR_HELPER_Fight_01_SpellIgnoresTaunt	เวทมนตร์[b]ไม่สนใจ[b]ยั่วยุ	
TUTR_HELPER_Fight_01_WinCondition	คุณต้องลดพลังชีวิต[b]ของ[b]คู่ต่อสู้[b]ให้[b]เหลือ 0 เพื่อ[b]ชนะ[b]เกม	
