TAG	TEXT	COMMENT
GAMEPLAY_EMOTE_EX1_323h_CONCEDE	お前の勝ちだ…だがやはりこの世界は滅亡するのだ！	
GAMEPLAY_EMOTE_EX1_323h_ERROR_FULL_MINIONS	ミニオンが多過ぎだ！！	
GAMEPLAY_EMOTE_EX1_323h_ERROR_GENERIC	できん！！	
GAMEPLAY_EMOTE_EX1_323h_ERROR_HAND_FULL	カードが多過ぎだ！！	
GAMEPLAY_EMOTE_EX1_323h_ERROR_I_ATTACKED	我は既に攻撃しておるわ！	
GAMEPLAY_EMOTE_EX1_323h_ERROR_JUST_PLAYED	アレはまだ動けぬわ！	
GAMEPLAY_EMOTE_EX1_323h_ERROR_MINION_ATTACKED	アレは既に攻撃しておるわ！	
GAMEPLAY_EMOTE_EX1_323h_ERROR_NEED_MANA	マナが足りん！	
GAMEPLAY_EMOTE_EX1_323h_ERROR_NEED_WEAPON	我の武器はどこに行った？！	
GAMEPLAY_EMOTE_EX1_323h_ERROR_PLAY	今そのカードは使えんのだ！	
GAMEPLAY_EMOTE_EX1_323h_ERROR_STEALTH	そやつは隠れ身しておる！	
GAMEPLAY_EMOTE_EX1_323h_ERROR_TARGET	そいつには使えん！！	
GAMEPLAY_EMOTE_EX1_323h_ERROR_TAUNT	挑発しているミニオンがおるだろうが！	
GAMEPLAY_EMOTE_EX1_323h_FIRE_FESTIVAL	どんどん火をつけろ！	
GAMEPLAY_EMOTE_EX1_323h_GOOD_GAME	よい勝負であった！	
GAMEPLAY_EMOTE_EX1_323h_GREETINGS	我こそジャラクサス、焦熱の軍団のエレダーロードなり！	
GAMEPLAY_EMOTE_EX1_323h_HALLOWS_END	ハロウェンド…お前もジ・エンドだ！	
GAMEPLAY_EMOTE_EX1_323h_LOW_CARDS	我がデッキ！カードが尽きかけているだと？！	
GAMEPLAY_EMOTE_EX1_323h_LUNAR_NEW_YEAR	最後の新年おめでとう！	
GAMEPLAY_EMOTE_EX1_323h_NO_CARDS	ぬぅぅっ！カードが尽きてしまったか！	
GAMEPLAY_EMOTE_EX1_323h_NOBLEGARDEN	ハッピー・ノーブルガーデン！	
GAMEPLAY_EMOTE_EX1_323h_OOPS	しくじったか！！	
GAMEPLAY_EMOTE_EX1_323h_PIRATE_DAY	我こそジャアァァァァラクサス！	
GAMEPLAY_EMOTE_EX1_323h_SORRY	このジャラクサス…すまん	
GAMEPLAY_EMOTE_EX1_323h_THANKS	礼を言うぞ。	
GAMEPLAY_EMOTE_EX1_323h_THINK1	うぬぬぬ…	
GAMEPLAY_EMOTE_EX1_323h_THINK2	どうするか…	
GAMEPLAY_EMOTE_EX1_323h_THINK3	どうやって滅ぼしてやろうか…	
GAMEPLAY_EMOTE_EX1_323h_THREATEN	滅びよ！！	
GAMEPLAY_EMOTE_EX1_323h_TIMER	時が尽きる！	
GAMEPLAY_EMOTE_EX1_323h_WELL_PLAYED	ふん、見事だ！	
GAMEPLAY_EMOTE_EX1_323h_WINTERVEIL_GREETINGS	冬至祭のメインディッシュはお前の魂だ！	
GAMEPLAY_EMOTE_EX1_323h_WOW_04	信じられん！	
GAMEPLAY_EMOTE_HERO_01_CONCEDE	オレは死を選ぶぞ！	
GAMEPLAY_EMOTE_HERO_01_ERROR_FULL_MINIONS	ミニオンが多過ぎる。	
GAMEPLAY_EMOTE_HERO_01_ERROR_GENERIC	それはできんぞ。	
GAMEPLAY_EMOTE_HERO_01_ERROR_HAND_FULL	手札が多過ぎる！	
GAMEPLAY_EMOTE_HERO_01_ERROR_I_ATTACKED	オレは攻撃した。	
GAMEPLAY_EMOTE_HERO_01_ERROR_JUST_PLAYED	そのミニオンが動けるのは次のターンからだ。	
GAMEPLAY_EMOTE_HERO_01_ERROR_MINION_ATTACKED	そのミニオンは攻撃済みだ。	
GAMEPLAY_EMOTE_HERO_01_ERROR_NEED_MANA	マナが足りん。	
GAMEPLAY_EMOTE_HERO_01_ERROR_NEED_WEAPON	武器が要る。	
GAMEPLAY_EMOTE_HERO_01_ERROR_PLAY	今そのカードは使えん。	
GAMEPLAY_EMOTE_HERO_01_ERROR_STEALTH	隠れ身しているミニオンは攻撃できん。	
GAMEPLAY_EMOTE_HERO_01_ERROR_TARGET	それは対象にできん。	
GAMEPLAY_EMOTE_HERO_01_ERROR_TAUNT	「挑発」を持つミニオンが邪魔だ。	
GAMEPLAY_EMOTE_HERO_01_EVENT_FIRE_FESTIVAL	燃やし尽くせ！！	
GAMEPLAY_EMOTE_HERO_01_EVENT_LUNAR_NEW_YEAR	明けましておめでとう！	
GAMEPLAY_EMOTE_HERO_01_GOOD_GAME	いい勝負だった！	
GAMEPLAY_EMOTE_HERO_01_GREETINGS	ハッ、武運を！	
GAMEPLAY_EMOTE_HERO_01_GREETINGS_RESPONSE	ヘッヘッヘ。武運を！	
GAMEPLAY_EMOTE_HERO_01_HALLOWS_END	ハロウェンドを祝うぞ！	
GAMEPLAY_EMOTE_HERO_01_LOW_CARDS	カードが尽きる！	
GAMEPLAY_EMOTE_HERO_01_MIRROR_START	ガァッハッハッ！かかってこいィッ！	
GAMEPLAY_EMOTE_HERO_01_NO_CARDS	カードが尽きたぞ！	
GAMEPLAY_EMOTE_HERO_01_NOBLEGARDEN	ノーブルガーデンを祝うぞ！	
GAMEPLAY_EMOTE_HERO_01_OOPS	しくじったな。	
GAMEPLAY_EMOTE_HERO_01_PIRATE_DAY	ヤァァイボ、ヨーホ！	
GAMEPLAY_EMOTE_HERO_01_SORRY	悪く思うな。	
GAMEPLAY_EMOTE_HERO_01_START	勝利か、死かだ！	
GAMEPLAY_EMOTE_HERO_01_THANKS	礼を言うぞ。	
GAMEPLAY_EMOTE_HERO_01_THINK1	ヌゥゥ…	
GAMEPLAY_EMOTE_HERO_01_THINK2	どうしたものか…	
GAMEPLAY_EMOTE_HERO_01_THINK3	どいつをやるか…	
GAMEPLAY_EMOTE_HERO_01_THREATEN	叩き潰してやる！	
GAMEPLAY_EMOTE_HERO_01_TIMER	決断せねば！	
GAMEPLAY_EMOTE_HERO_01_WELL_PLAYED	見事だ。	
GAMEPLAY_EMOTE_HERO_01_WINTERVEIL_GREETINGS	冬至祭を祝うぞ！	
GAMEPLAY_EMOTE_HERO_01_WOW	見事だ！	
GAMEPLAY_EMOTE_HERO_01A_CELEBRATE	よーし、いいぞ！	
GAMEPLAY_EMOTE_HERO_01A_CONCEDE	おめぇの勝ちだぁ。	
GAMEPLAY_EMOTE_HERO_01A_ERROR_FULL_MINIONS	ミニオンが多過ぎるな。	
GAMEPLAY_EMOTE_HERO_01A_ERROR_GENERIC	それはできんのだ。	
GAMEPLAY_EMOTE_HERO_01A_ERROR_HAND_FULL	手札が多過ぎるわい！	
GAMEPLAY_EMOTE_HERO_01A_ERROR_I_ATTACKED	わしはもう攻撃したぞ。	
GAMEPLAY_EMOTE_HERO_01A_ERROR_JUST_PLAYED	そのミニオンが動けるのは次のターンからだ。	
GAMEPLAY_EMOTE_HERO_01A_ERROR_MINION_ATTACKED	そのミニオンは攻撃済みだな。	
GAMEPLAY_EMOTE_HERO_01A_ERROR_NEED_MANA	マナが足りん。	
GAMEPLAY_EMOTE_HERO_01A_ERROR_NEED_WEAPON	武器、わしの武器はどこだ。	
GAMEPLAY_EMOTE_HERO_01A_ERROR_PLAY	今そのカードは使えんぞ。	
GAMEPLAY_EMOTE_HERO_01A_ERROR_STEALTH	隠れ身しているミニオンは攻撃できんぞ。	
GAMEPLAY_EMOTE_HERO_01A_ERROR_TARGET	そいつは対象にできんな。	
GAMEPLAY_EMOTE_HERO_01A_ERROR_TAUNT	今攻撃できるのは「挑発」を持つミニオンだけだ。	
GAMEPLAY_EMOTE_HERO_01A_EVENT_LUNAR_NEW_YEAR	新年おめでとう！	
GAMEPLAY_EMOTE_HERO_01A_FIRE_FESTIVAL	真夏の炎祭りを祝おう！	
GAMEPLAY_EMOTE_HERO_01A_GOOD_GAME	よい勝負だったな。	
GAMEPLAY_EMOTE_HERO_01A_GREETINGS	よおぉ。	
GAMEPLAY_EMOTE_HERO_01A_GREETINGS_RESPONSE	おおう。	
GAMEPLAY_EMOTE_HERO_01A_HALLOWS_END	ハッピー・ハロウェンド！	
GAMEPLAY_EMOTE_HERO_01A_LOW_CARDS	ぬぅ、カードが尽きるぞ！	
GAMEPLAY_EMOTE_HERO_01A_MIRROR_START	おう、カズモダンのために！	
GAMEPLAY_EMOTE_HERO_01A_NO_CARDS	くっ、カードが尽きたか！	
GAMEPLAY_EMOTE_HERO_01A_NOBLEGARDEN	ハッピー・ノーブルガーデン！	
GAMEPLAY_EMOTE_HERO_01A_OOPS	ぬぅ…しくじったか。	
GAMEPLAY_EMOTE_HERO_01A_PIRATE_DAY	ヤアァァァ！わしは大海原の王様だぁ！	
GAMEPLAY_EMOTE_HERO_01A_SORRY	わりぃな、アンタ。	
GAMEPLAY_EMOTE_HERO_01A_START	カズモダンのために！	
GAMEPLAY_EMOTE_HERO_01A_THANKS	ありがとうよ！	
GAMEPLAY_EMOTE_HERO_01A_THINK1	うむむむ…	
GAMEPLAY_EMOTE_HERO_01A_THINK2	この手は…いや違うか…	
GAMEPLAY_EMOTE_HERO_01A_THINK3	どの手を打つか…	
GAMEPLAY_EMOTE_HERO_01A_THREATEN	山の怒りを知るがいい！	
GAMEPLAY_EMOTE_HERO_01A_TIMER	もだもだしてらんね！	
GAMEPLAY_EMOTE_HERO_01A_WELL_PLAYED	見事だ。	
GAMEPLAY_EMOTE_HERO_01A_WINTERVEIL_GREETINGS	冬至祭おめでとう！	
GAMEPLAY_EMOTE_HERO_01A_WOW	我が髭に賭けて！	
GAMEPLAY_EMOTE_HERO_02_CONCEDE	これはお主の勝ちだな、友よ。	
GAMEPLAY_EMOTE_HERO_02_ERROR_FULL_MINIONS	ミニオンが多過ぎるな。	
GAMEPLAY_EMOTE_HERO_02_ERROR_GENERIC	それは無理だな。	
GAMEPLAY_EMOTE_HERO_02_ERROR_HAND_FULL	手札が多過ぎる！	
GAMEPLAY_EMOTE_HERO_02_ERROR_I_ATTACKED	私はもう攻撃済みだ。	
GAMEPLAY_EMOTE_HERO_02_ERROR_JUST_PLAYED	そのミニオンが動けるのは次のターンからだな。	
GAMEPLAY_EMOTE_HERO_02_ERROR_MINION_ATTACKED	そのミニオンは攻撃済みだな。	
GAMEPLAY_EMOTE_HERO_02_ERROR_NEED_MANA	マナが足りんな。	
GAMEPLAY_EMOTE_HERO_02_ERROR_NEED_WEAPON	武器が要るな。	
GAMEPLAY_EMOTE_HERO_02_ERROR_PLAY	今そのカードは使えんな。	
GAMEPLAY_EMOTE_HERO_02_ERROR_STEALTH	隠れ身してるミニオンは攻撃できんな。	
GAMEPLAY_EMOTE_HERO_02_ERROR_TARGET	それは対象にできんな。	
GAMEPLAY_EMOTE_HERO_02_ERROR_TAUNT	「挑発」を持つミニオンが、待ち受けている。	
GAMEPLAY_EMOTE_HERO_02_EVENT_FIRE_FESTIVAL	精霊に捧げる祭りだ！	
GAMEPLAY_EMOTE_HERO_02_EVENT_LUNAR_NEW_YEAR	新年おめでとう、友よ！	
GAMEPLAY_EMOTE_HERO_02_GOOD_GAME	よい勝負だった！	
GAMEPLAY_EMOTE_HERO_02_GREETINGS	よろしく、我が友よ！	
GAMEPLAY_EMOTE_HERO_02_GREETINGS_RESPONSE	よろしく頼む。	
GAMEPLAY_EMOTE_HERO_02_HALLOWS_END	ハッピー・ハロウェンド。	
GAMEPLAY_EMOTE_HERO_02_LOW_CARDS	カードが尽きるぞ！	
GAMEPLAY_EMOTE_HERO_02_MIRROR_START	フロストウルフに捧ぐ！	
GAMEPLAY_EMOTE_HERO_02_NO_CARDS	カードが尽きたか！	
GAMEPLAY_EMOTE_HERO_02_NOBLEGARDEN	ハッピー・ノーブルガーデン、友よ！	
GAMEPLAY_EMOTE_HERO_02_OOPS	ぬかったか。	
GAMEPLAY_EMOTE_HERO_02_PIRATE_DAY	よう、相棒。今日は、海賊の日だぜェ。	
GAMEPLAY_EMOTE_HERO_02_SORRY	すまんな。	
GAMEPLAY_EMOTE_HERO_02_START	ドゥームハンマーに捧ぐ！	
GAMEPLAY_EMOTE_HERO_02_THANKS	ありがたい。	
GAMEPLAY_EMOTE_HERO_02_THINK1	ふむぅ…	
GAMEPLAY_EMOTE_HERO_02_THINK2	はてさて…	
GAMEPLAY_EMOTE_HERO_02_THINK3	ふむぅ…どうするか…	
GAMEPLAY_EMOTE_HERO_02_THREATEN	精霊がお主を討つ！	
GAMEPLAY_EMOTE_HERO_02_TIMER	時間がない！	
GAMEPLAY_EMOTE_HERO_02_WELL_PLAYED	お見事。	
GAMEPLAY_EMOTE_HERO_02_WINTERVEIL_GREETINGS	冬至祭を祝おう！	
GAMEPLAY_EMOTE_HERO_02_WOW	見事な一手だ！	
GAMEPLAY_EMOTE_HERO_02A_CELEBRATE	<祝いだ！>	
GAMEPLAY_EMOTE_HERO_02A_CONCEDE	<恐れ入った。>	
GAMEPLAY_EMOTE_HERO_02A_ERROR_FULL_MINIONS	<ミニオンが\n多過ぎる。>	
GAMEPLAY_EMOTE_HERO_02A_ERROR_GENERIC	<それは\nムリだ。>	
GAMEPLAY_EMOTE_HERO_02A_ERROR_HAND_FULL	<手札が\n多過ぎる。>	
GAMEPLAY_EMOTE_HERO_02A_ERROR_I_ATTACKED	<自分はもう\n攻撃した。>	VO_HERO_15_ERROR04_43.wav
GAMEPLAY_EMOTE_HERO_02A_ERROR_JUST_PLAYED	<そいつはまだ\n動けん。>	
GAMEPLAY_EMOTE_HERO_02A_ERROR_MINION_ATTACKED	<そいつは\n攻撃済みだ。>	
GAMEPLAY_EMOTE_HERO_02A_ERROR_NEED_MANA	<マナが\nもっと要る。>	
GAMEPLAY_EMOTE_HERO_02A_ERROR_NEED_WEAPON	<武器が\n要る。>	
GAMEPLAY_EMOTE_HERO_02A_ERROR_PLAY	<そのカードは\n今使えん。>	
GAMEPLAY_EMOTE_HERO_02A_ERROR_STEALTH	<隠れ身してる\nミニオンは\n攻撃できん！>	
GAMEPLAY_EMOTE_HERO_02A_ERROR_TARGET	<それは対象に\nできん。>	
GAMEPLAY_EMOTE_HERO_02A_ERROR_TAUNT	<「挑発」を持つ\nミニオンは\n無視できん。>	
GAMEPLAY_EMOTE_HERO_02A_EVENT_LUNAR_NEW_YEAR	<実りある\n一年を祈る！>	
GAMEPLAY_EMOTE_HERO_02A_FIRE_FESTIVAL	<我が故郷には炎の祭りはないのだ。>	
GAMEPLAY_EMOTE_HERO_02A_GREETINGS	<やあ、友よ>	
GAMEPLAY_EMOTE_HERO_02A_GREETINGS_RESPONSE	<やあ、同志よ。>	
GAMEPLAY_EMOTE_HERO_02A_HALLOWS_END	<不気味なハロウェンドを、\nオタマジャクシたちよ>	
GAMEPLAY_EMOTE_HERO_02A_LOW_CARDS	<カードが\n残り少ない！>	
GAMEPLAY_EMOTE_HERO_02A_MIRROR_START	<若者だと？！\n修行が足りんな。>	
GAMEPLAY_EMOTE_HERO_02A_NO_CARDS	<カードが\n尽きたか！>	
GAMEPLAY_EMOTE_HERO_02A_NOBLEGARDEN	<ハッピー・ノーブルガーデン！>	
GAMEPLAY_EMOTE_HERO_02A_OOPS	<呪いあれ！>	
GAMEPLAY_EMOTE_HERO_02A_PIRATE_DAY	<海賊？！先に\n住んでたのは我々だ！>	
GAMEPLAY_EMOTE_HERO_02A_SORRY	<すまんな、\n若者よ。>	
GAMEPLAY_EMOTE_HERO_02A_START	<修行の時間だ\n若者よ！>	
GAMEPLAY_EMOTE_HERO_02A_THANKS	<心からの\n感謝を。>	
GAMEPLAY_EMOTE_HERO_02A_THINK1	<はてさて…>	VO_HERO_15_Thinking1_13.wav
GAMEPLAY_EMOTE_HERO_02A_THINK2	<何か面白い\n手は…>	
GAMEPLAY_EMOTE_HERO_02A_THINK3	<この手も\nありか…>	
GAMEPLAY_EMOTE_HERO_02A_THREATEN	<大海の智慧に\nヒレ伏せ！>	
GAMEPLAY_EMOTE_HERO_02A_TIMER	<急げ、\n急ぐのだ！>	
GAMEPLAY_EMOTE_HERO_02A_WELL_PLAYED	<見事。>	
GAMEPLAY_EMOTE_HERO_02A_WINTERVEIL_GREETINGS	<冬至祭の\n慶びを！>	
GAMEPLAY_EMOTE_HERO_02A_WOW	<空前絶後！>	
GAMEPLAY_EMOTE_HERO_03_CONCEDE	降参よ。	
GAMEPLAY_EMOTE_HERO_03_ERROR_FULL_MINIONS	ミニオンが多過ぎるわね。	
GAMEPLAY_EMOTE_HERO_03_ERROR_GENERIC	それは無理。	
GAMEPLAY_EMOTE_HERO_03_ERROR_HAND_FULL	手札が多過ぎるわ！	
GAMEPLAY_EMOTE_HERO_03_ERROR_I_ATTACKED	あたしはもう攻撃したわ。	
GAMEPLAY_EMOTE_HERO_03_ERROR_JUST_PLAYED	そのミニオンが動けるのは次のターンからね。	
GAMEPLAY_EMOTE_HERO_03_ERROR_MINION_ATTACKED	そのミニオンは攻撃済みよ。	
GAMEPLAY_EMOTE_HERO_03_ERROR_NEED_MANA	マナが足りないわ。	
GAMEPLAY_EMOTE_HERO_03_ERROR_NEED_WEAPON	武器が要るわね。	
GAMEPLAY_EMOTE_HERO_03_ERROR_PLAY	今そのカードは使えないわね。	
GAMEPLAY_EMOTE_HERO_03_ERROR_STEALTH	隠れ身してるミニオンは攻撃できないわ。	
GAMEPLAY_EMOTE_HERO_03_ERROR_TARGET	それは対象にできないわ。	
GAMEPLAY_EMOTE_HERO_03_ERROR_TAUNT	「挑発」を持つミニオンが邪魔。	
GAMEPLAY_EMOTE_HERO_03_EVENT_LUNAR_NEW_YEAR	新年、おめでとう！	
GAMEPLAY_EMOTE_HERO_03_FIRE_FESTIVAL	真夏のお祝いを。	
GAMEPLAY_EMOTE_HERO_03_GOOD_GAME	いい勝負だったわ！	
GAMEPLAY_EMOTE_HERO_03_GREETINGS	お付き合い願うわ。	
GAMEPLAY_EMOTE_HERO_03_GREETINGS_RESPONSE	行き着くところまで。フフッ…	
GAMEPLAY_EMOTE_HERO_03_HALLOWS_END	ハッピー・ハロウェンド！	
GAMEPLAY_EMOTE_HERO_03_LOW_CARDS	カードが無くなるわ！	
GAMEPLAY_EMOTE_HERO_03_MIRROR_START	よそ見は、禁物よ。	
GAMEPLAY_EMOTE_HERO_03_NO_CARDS	カードが無くなったわ！	
GAMEPLAY_EMOTE_HERO_03_NOBLEGARDEN	ハッピー・ノーブルガーデン！	
GAMEPLAY_EMOTE_HERO_03_OOPS	しくじったわね…	
GAMEPLAY_EMOTE_HERO_03_PIRATE_DAY	ヤアァァァ！！	
GAMEPLAY_EMOTE_HERO_03_SORRY	悪いわね。	
GAMEPLAY_EMOTE_HERO_03_START	背中に気をつけて。	
GAMEPLAY_EMOTE_HERO_03_THANKS	ありがとう。	
GAMEPLAY_EMOTE_HERO_03_THINK1	うぅん…	
GAMEPLAY_EMOTE_HERO_03_THINK2	この手なら…	
GAMEPLAY_EMOTE_HERO_03_THINK3	どの手で行くか…	
GAMEPLAY_EMOTE_HERO_03_THREATEN	あなたの死神よ！	
GAMEPLAY_EMOTE_HERO_03_TIMER	早く決めなきゃ！	
GAMEPLAY_EMOTE_HERO_03_WELL_PLAYED	お見事ね。	
GAMEPLAY_EMOTE_HERO_03_WINTERVEIL_GREETINGS	冬至祭、おめでとう。	
GAMEPLAY_EMOTE_HERO_03_WOW	やるわね。	
GAMEPLAY_EMOTE_HERO_04_CONCEDE	貴公の勝ちだ。	
GAMEPLAY_EMOTE_HERO_04_ERROR_FULL_MINIONS	ミニオンが多過ぎですな。	
GAMEPLAY_EMOTE_HERO_04_ERROR_GENERIC	それは無理ですな。	
GAMEPLAY_EMOTE_HERO_04_ERROR_HAND_FULL	手札が多過ぎますぞ！	
GAMEPLAY_EMOTE_HERO_04_ERROR_I_ATTACKED	ワシはもう攻撃しましたぞ。	
GAMEPLAY_EMOTE_HERO_04_ERROR_JUST_PLAYED	そのミニオンが動けるのは次のターンからですぞ。	
GAMEPLAY_EMOTE_HERO_04_ERROR_MINION_ATTACKED	そのミニオンは攻撃済みですぞ。	
GAMEPLAY_EMOTE_HERO_04_ERROR_NEED_MANA	マナが足りませんな。	
GAMEPLAY_EMOTE_HERO_04_ERROR_NEED_WEAPON	武器が必要ですな。	
GAMEPLAY_EMOTE_HERO_04_ERROR_PLAY	今そのカードは使えませんな。	
GAMEPLAY_EMOTE_HERO_04_ERROR_STEALTH	隠れ身しているミニオンは攻撃できませんぞ。	
GAMEPLAY_EMOTE_HERO_04_ERROR_TARGET	それは対象にできませんぞ。	
GAMEPLAY_EMOTE_HERO_04_ERROR_TAUNT	「挑発」を持つミニオンが邪魔だな。	
GAMEPLAY_EMOTE_HERO_04_EVENT_LUNAR_NEW_YEAR	勇者よ、新年を祝いましょうぞ！	
GAMEPLAY_EMOTE_HERO_04_FIRE_FESTIVAL	真夏の炎祭りを祝いましょうぞ！	
GAMEPLAY_EMOTE_HERO_04_GOOD_GAME	よい勝負でしたな！	
GAMEPLAY_EMOTE_HERO_04_GREETINGS	ご挨拶仕る！	
GAMEPLAY_EMOTE_HERO_04_GREETINGS_RESPONSE	ご丁重なご挨拶、いたみ入る！	
GAMEPLAY_EMOTE_HERO_04_HALLOWS_END	勇者よ、ハロウェンドを祝いましょうぞ！	VO_HERO_04_HAPPY_HALLOWEEN_13.wav
GAMEPLAY_EMOTE_HERO_04_LOW_CARDS	まもなくカードが尽きる！	
GAMEPLAY_EMOTE_HERO_04_MIRROR_START	我、光を導かん。	
GAMEPLAY_EMOTE_HERO_04_NO_CARDS	カードが尽きたか！	
GAMEPLAY_EMOTE_HERO_04_NOBLEGARDEN	ノーブルガーデンを祝いましょうぞ！	VO_HERO_04_HAPPY_NOBLEGARDEN_17.wav
GAMEPLAY_EMOTE_HERO_04_OOPS	しくじりましたな。	
GAMEPLAY_EMOTE_HERO_04_PIRATE_DAY	なんてこった！塩水びたしの荒くれ野郎ども！	VO_HERO_04_PIRATE_DAY_33.wav
GAMEPLAY_EMOTE_HERO_04_SORRY	失礼した。	
GAMEPLAY_EMOTE_HERO_04_START	我、名誉を以て戦う！	
GAMEPLAY_EMOTE_HERO_04_THANKS	感謝いたす。	
GAMEPLAY_EMOTE_HERO_04_THINK1	ふむむむ…	
GAMEPLAY_EMOTE_HERO_04_THINK2	はて…	
GAMEPLAY_EMOTE_HERO_04_THINK3	考える時間をくだされ…	
GAMEPLAY_EMOTE_HERO_04_THREATEN	正義の報復を受けよ！	
GAMEPLAY_EMOTE_HERO_04_TIMER	急がなければ！	
GAMEPLAY_EMOTE_HERO_04_WELL_PLAYED	お見事。	
GAMEPLAY_EMOTE_HERO_04_WINTERVEIL_GREETINGS	勇者よ、冬至祭を祝いましょうぞ！	
GAMEPLAY_EMOTE_HERO_04_WOW	これは仰天した！	
GAMEPLAY_EMOTE_HERO_04A_CELEBRATE	光よ、感謝します！	
GAMEPLAY_EMOTE_HERO_04A_CONCEDE	貴方の勝ちだ。降伏する。	
GAMEPLAY_EMOTE_HERO_04A_ERROR_FULL_MINIONS	これ以上のミニオンは指揮を乱す。	
GAMEPLAY_EMOTE_HERO_04A_ERROR_GENERIC	それはできぬ。	
GAMEPLAY_EMOTE_HERO_04A_ERROR_HAND_FULL	手札が多過ぎる！	
GAMEPLAY_EMOTE_HERO_04A_ERROR_I_ATTACKED	私は既に攻撃を終えた。	
GAMEPLAY_EMOTE_HERO_04A_ERROR_JUST_PLAYED	そのミニオンは次のターンを待たねばならぬ。	
GAMEPLAY_EMOTE_HERO_04A_ERROR_MINION_ATTACKED	そのミニオンは既に攻撃を終えた。	
GAMEPLAY_EMOTE_HERO_04A_ERROR_NEED_MANA	マナが足りないわね。	
GAMEPLAY_EMOTE_HERO_04A_ERROR_NEED_WEAPON	武器が必要だわ。	
GAMEPLAY_EMOTE_HERO_04A_ERROR_PLAY	今その手は打てぬ。	
GAMEPLAY_EMOTE_HERO_04A_ERROR_STEALTH	隠れ身しているミニオンは攻められぬ。	
GAMEPLAY_EMOTE_HERO_04A_ERROR_TARGET	それは対象にできぬ。	
GAMEPLAY_EMOTE_HERO_04A_ERROR_TAUNT	「挑発」を持つミニオンを攻撃せねばならぬ。	
GAMEPLAY_EMOTE_HERO_04A_FIRE_FESTIVAL	炎祭りを祝いましょう。	
GAMEPLAY_EMOTE_HERO_04A_GOOD_GAME	よい勝負でした！	
GAMEPLAY_EMOTE_HERO_04A_GREETINGS	挑む者よ、健闘を。	
GAMEPLAY_EMOTE_HERO_04A_GREETINGS_RESPONSE	ご武運を。	
GAMEPLAY_EMOTE_HERO_04A_HALLOWS_END	ハロウェンドの祝福を。	
GAMEPLAY_EMOTE_HERO_04A_LOW_CARDS	くっ、カードが尽きる！	
GAMEPLAY_EMOTE_HERO_04A_LUNAR_NEW_YEAR	新年の祝福を！	
GAMEPLAY_EMOTE_HERO_04A_MIRROR_START	「聖なる炎」は私の二つ名よ。	
GAMEPLAY_EMOTE_HERO_04A_NO_CARDS	カードが尽きてしまった…！	
GAMEPLAY_EMOTE_HERO_04A_NOBLEGARDEN	ノーブルガーデンの祝福を！	
GAMEPLAY_EMOTE_HERO_04A_OOPS	失策ね、間違いなく。	
GAMEPLAY_EMOTE_HERO_04A_PIRATE_DAY	ヤアァァァ、おめーのお宝を奪ってやるぜ。	
GAMEPLAY_EMOTE_HERO_04A_SORRY	あら、失礼。	
GAMEPLAY_EMOTE_HERO_04A_START	我が刃は、聖なる炎を宿す！	
GAMEPLAY_EMOTE_HERO_04A_THANKS	心からの感謝を。	
GAMEPLAY_EMOTE_HERO_04A_THINK1	うぅん…。	
GAMEPLAY_EMOTE_HERO_04A_THINK2	最善の手は…。	
GAMEPLAY_EMOTE_HERO_04A_THINK3	やはりここは…うぅん…。	
GAMEPLAY_EMOTE_HERO_04A_THREATEN	外道め、報いを受けよ！	
GAMEPLAY_EMOTE_HERO_04A_TIMER	いざ、進軍！	
GAMEPLAY_EMOTE_HERO_04A_WELL_PLAYED	お見事。	
GAMEPLAY_EMOTE_HERO_04A_WINTERVEIL_GREETINGS	冬至祭の祝福を！	
GAMEPLAY_EMOTE_HERO_04A_WOW	感服しました！	
GAMEPLAY_EMOTE_HERO_05_CONCEDE	見事な戦いぶりだった。俺の負けだ。	
GAMEPLAY_EMOTE_HERO_05_ERROR_FULL_MINIONS	ミニオンが多過ぎるか。	
GAMEPLAY_EMOTE_HERO_05_ERROR_GENERIC	それはできん。	
GAMEPLAY_EMOTE_HERO_05_ERROR_HAND_FULL	手札が多過ぎる！	
GAMEPLAY_EMOTE_HERO_05_ERROR_I_ATTACKED	俺は攻撃済みだ。	
GAMEPLAY_EMOTE_HERO_05_ERROR_JUST_PLAYED	そのミニオンが動けるのは次のターンからだ。	
GAMEPLAY_EMOTE_HERO_05_ERROR_MINION_ATTACKED	そのミニオンは攻撃済みだ。	
GAMEPLAY_EMOTE_HERO_05_ERROR_NEED_MANA	マナが足りん。	
GAMEPLAY_EMOTE_HERO_05_ERROR_NEED_WEAPON	武器が要る。	
GAMEPLAY_EMOTE_HERO_05_ERROR_PLAY	今そのカードは使えん。	
GAMEPLAY_EMOTE_HERO_05_ERROR_STEALTH	隠れ身しているミニオンは攻撃できん。	
GAMEPLAY_EMOTE_HERO_05_ERROR_TARGET	それは対象にできん。	
GAMEPLAY_EMOTE_HERO_05_ERROR_TAUNT	「挑発」を持つミニオンが邪魔だ。	
GAMEPLAY_EMOTE_HERO_05_EVENT_LUNAR_NEW_YEAR	新年の祝いを！	
GAMEPLAY_EMOTE_HERO_05_FIRE_FESTIVAL	真夏の祝いを。	
GAMEPLAY_EMOTE_HERO_05_GOOD_GAME	よい狩りだった。	
GAMEPLAY_EMOTE_HERO_05_GREETINGS	敬意を、旅人よ。	
GAMEPLAY_EMOTE_HERO_05_GREETINGS_RESPONSE	幸あれ！	
GAMEPLAY_EMOTE_HERO_05_HALLOWS_END	ハロウェンドの祝いを！	
GAMEPLAY_EMOTE_HERO_05_LOW_CARDS	カードが尽きる！	
GAMEPLAY_EMOTE_HERO_05_MIRROR_START	かかって来い！	
GAMEPLAY_EMOTE_HERO_05_NO_CARDS	カードが尽きたか！	
GAMEPLAY_EMOTE_HERO_05_NOBLEGARDEN	ノーブルガーデンの祝いを。	
GAMEPLAY_EMOTE_HERO_05_OOPS	的外れもいいところだ。	
GAMEPLAY_EMOTE_HERO_05_PIRATE_DAY	野郎ども、獲物を逃がすんじゃねー！	
GAMEPLAY_EMOTE_HERO_05_SORRY	失敬。	
GAMEPLAY_EMOTE_HERO_05_START	狩りの時間だ！	
GAMEPLAY_EMOTE_HERO_05_THANKS	感謝。	
GAMEPLAY_EMOTE_HERO_05_THINK1	むむ…	
GAMEPLAY_EMOTE_HERO_05_THINK2	どう仕掛けるか…	
GAMEPLAY_EMOTE_HERO_05_THINK3	ふむむむ…	
GAMEPLAY_EMOTE_HERO_05_THREATEN	お前を狩る！	
GAMEPLAY_EMOTE_HERO_05_TIMER	好機を逃すぞ！	
GAMEPLAY_EMOTE_HERO_05_WELL_PLAYED	見事だ。	
GAMEPLAY_EMOTE_HERO_05_WINTERVEIL_GREETINGS	冬至祭の祝いを！	
GAMEPLAY_EMOTE_HERO_05_WOW	見事な！	
GAMEPLAY_EMOTE_HERO_05A_CELEBRATE	ははっ！いいわ！最高！	
GAMEPLAY_EMOTE_HERO_05A_CONCEDE	お見事。あたしの負けね。	
GAMEPLAY_EMOTE_HERO_05A_ERROR_FULL_MINIONS	ミニオンが多過ぎるわね。	
GAMEPLAY_EMOTE_HERO_05A_ERROR_GENERIC	それは無理よ。	
GAMEPLAY_EMOTE_HERO_05A_ERROR_HAND_FULL	手札が多過ぎるわ！	
GAMEPLAY_EMOTE_HERO_05A_ERROR_I_ATTACKED	あたしはもう攻撃したわ。	
GAMEPLAY_EMOTE_HERO_05A_ERROR_JUST_PLAYED	そのミニオンが動けるのは次のターンからよ。	
GAMEPLAY_EMOTE_HERO_05A_ERROR_MINION_ATTACKED	そのミニオンは攻撃済みね。	
GAMEPLAY_EMOTE_HERO_05A_ERROR_NEED_MANA	マナが足りないわ。	
GAMEPLAY_EMOTE_HERO_05A_ERROR_NEED_WEAPON	武器が必要よ。	
GAMEPLAY_EMOTE_HERO_05A_ERROR_PLAY	それはできないわよ。	
GAMEPLAY_EMOTE_HERO_05A_ERROR_STEALTH	隠れ身しているミニオンは狙えないわ。	
GAMEPLAY_EMOTE_HERO_05A_ERROR_TARGET	それは標的にできないわ。	
GAMEPLAY_EMOTE_HERO_05A_ERROR_TAUNT	今狙えるのは「挑発」を持つミニオンだけよ。	
GAMEPLAY_EMOTE_HERO_05A_EVENT_FIRE_FESTIVAL	炎の祭りが来たわ。	
GAMEPLAY_EMOTE_HERO_05A_EVENT_HALLOWS_END	ハッピー・ハロウェンド。	
GAMEPLAY_EMOTE_HERO_05A_EVENT_LUNAR_NEW_YEAR	新年おめでとう！	
GAMEPLAY_EMOTE_HERO_05A_EVENT_NOBLEGARDEN	ハッピー・ノーブルガーデン。	
GAMEPLAY_EMOTE_HERO_05A_EVENT_PIRATE_DAY	ヤアァァァ！海に沈めてやる！	
GAMEPLAY_EMOTE_HERO_05A_GOOD_GAME	いい勝負だったわ。	
GAMEPLAY_EMOTE_HERO_05A_GREETINGS	ようこそ、旅人さん。	
GAMEPLAY_EMOTE_HERO_05A_GREETINGS_RESPONSE	ハッ、これはどうも！	
GAMEPLAY_EMOTE_HERO_05A_LOW_CARDS	カードが尽きる…！	
GAMEPLAY_EMOTE_HERO_05A_MIRROR_START	震えるのは、どちらかしらね。	
GAMEPLAY_EMOTE_HERO_05A_NO_CARDS	カードが尽きたわ！	
GAMEPLAY_EMOTE_HERO_05A_OOPS	間違いね。	
GAMEPLAY_EMOTE_HERO_05A_SORRY	悪いわね。	
GAMEPLAY_EMOTE_HERO_05A_START	エルフ族の力の前に、震えるがいいわ！	
GAMEPLAY_EMOTE_HERO_05A_THANKS	どうも。	
GAMEPLAY_EMOTE_HERO_05A_THINK1	う～ん…	
GAMEPLAY_EMOTE_HERO_05A_THINK2	どいつを射る…	
GAMEPLAY_EMOTE_HERO_05A_THINK3	どうする…	
GAMEPLAY_EMOTE_HERO_05A_THREATEN	覚悟はいいわね？！	
GAMEPLAY_EMOTE_HERO_05A_TIMER	今よ。かかれ！	
GAMEPLAY_EMOTE_HERO_05A_WELL_PLAYED	見事ね。	
GAMEPLAY_EMOTE_HERO_05A_WINTERVEIL_GREETING	冬至祭おめでとう。	
GAMEPLAY_EMOTE_HERO_05A_WOW	すごいわ！	
GAMEPLAY_EMOTE_HERO_06_CONCEDE	敗北を認めよう。	
GAMEPLAY_EMOTE_HERO_06_ERROR_FULL_MINIONS	ミニオンが多過ぎるか。	
GAMEPLAY_EMOTE_HERO_06_ERROR_GENERIC	それはできぬ。	
GAMEPLAY_EMOTE_HERO_06_ERROR_HAND_FULL	手札が多過ぎる！	
GAMEPLAY_EMOTE_HERO_06_ERROR_I_ATTACKED	私は攻撃済みだ。	
GAMEPLAY_EMOTE_HERO_06_ERROR_JUST_PLAYED	そのミニオンが動けるのは次のターンからだ。	
GAMEPLAY_EMOTE_HERO_06_ERROR_MINION_ATTACKED	そのミニオンは攻撃済みだ。	
GAMEPLAY_EMOTE_HERO_06_ERROR_NEED_MANA	マナが足りぬか。	
GAMEPLAY_EMOTE_HERO_06_ERROR_NEED_WEAPON	武器が必要だ。	
GAMEPLAY_EMOTE_HERO_06_ERROR_PLAY	今そのカードは使えぬぞ。	
GAMEPLAY_EMOTE_HERO_06_ERROR_STEALTH	隠れ身しているミニオンは攻撃できぬ。	
GAMEPLAY_EMOTE_HERO_06_ERROR_TARGET	それは対象にできぬな。	
GAMEPLAY_EMOTE_HERO_06_ERROR_TAUNT	「挑発」を持つミニオンが邪魔だ。	
GAMEPLAY_EMOTE_HERO_06_EVENT_LUNAR_NEW_YEAR	新年の祝いを！	
GAMEPLAY_EMOTE_HERO_06_FIRE_FESTIVAL	真夏の祝いを！山火事に注意を。	
GAMEPLAY_EMOTE_HERO_06_GOOD_GAME	よい勝負であった。	
GAMEPLAY_EMOTE_HERO_06_GREETINGS	お主に敬意を。	
GAMEPLAY_EMOTE_HERO_06_GREETINGS_RESPONSE	感謝を。	
GAMEPLAY_EMOTE_HERO_06_HALLOWS_END	ハロウェンドの祝いを！	
GAMEPLAY_EMOTE_HERO_06_LOW_CARDS	カードが尽きてしまう！	
GAMEPLAY_EMOTE_HERO_06_MIRROR_START	いたずらに自然に触れてはならぬ！	
GAMEPLAY_EMOTE_HERO_06_NO_CARDS	カードが尽きてしまった！	
GAMEPLAY_EMOTE_HERO_06_NOBLEGARDEN	ノーブルガーデンの祝いを。	
GAMEPLAY_EMOTE_HERO_06_OOPS	油断したか…	
GAMEPLAY_EMOTE_HERO_06_PIRATE_DAY	ヤアァァァァァ！！	
GAMEPLAY_EMOTE_HERO_06_SORRY	申し訳ない。	
GAMEPLAY_EMOTE_HERO_06_START	自然を守らねばならぬ！	
GAMEPLAY_EMOTE_HERO_06_START_TYRANDE	愛しのティランダよ。	
GAMEPLAY_EMOTE_HERO_06_THANKS	感謝つかまつる。	
GAMEPLAY_EMOTE_HERO_06_THINK1	フム…	
GAMEPLAY_EMOTE_HERO_06_THINK2	フム…さて…	
GAMEPLAY_EMOTE_HERO_06_THINK3	どうしたものか…	
GAMEPLAY_EMOTE_HERO_06_THREATEN	自然の怒りを知るがよい！	
GAMEPLAY_EMOTE_HERO_06_TIMER	時は無情！	
GAMEPLAY_EMOTE_HERO_06_WELL_PLAYED	ふむ、見事。	
GAMEPLAY_EMOTE_HERO_06_WINTERVEIL_GREETINGS	冬至祭を祝おう！	
GAMEPLAY_EMOTE_HERO_06_WOW	なんと素晴らしい！	
GAMEPLAY_EMOTE_HERO_07_CONCEDE	今回はお前の勝ちだ…	
GAMEPLAY_EMOTE_HERO_07_ERROR_FULL_MINIONS	ミニオンが多過ぎる。	
GAMEPLAY_EMOTE_HERO_07_ERROR_GENERIC	それはできん。	
GAMEPLAY_EMOTE_HERO_07_ERROR_HAND_FULL	手札が多過ぎる！	
GAMEPLAY_EMOTE_HERO_07_ERROR_I_ATTACKED	我はもう攻撃している。	
GAMEPLAY_EMOTE_HERO_07_ERROR_JUST_PLAYED	そのミニオンが動けるのは次のターンからだ。	
GAMEPLAY_EMOTE_HERO_07_ERROR_MINION_ATTACKED	そのミニオンは攻撃済みだ。	
GAMEPLAY_EMOTE_HERO_07_ERROR_NEED_MANA	マナが足りんな。	
GAMEPLAY_EMOTE_HERO_07_ERROR_NEED_WEAPON	武器が必要だ。	
GAMEPLAY_EMOTE_HERO_07_ERROR_PLAY	今そのカードは使えんな。	
GAMEPLAY_EMOTE_HERO_07_ERROR_STEALTH	隠れ身しているミニオンは攻撃できんな。	
GAMEPLAY_EMOTE_HERO_07_ERROR_TARGET	それは対象にできんな。	
GAMEPLAY_EMOTE_HERO_07_ERROR_TAUNT	「挑発」を持つミニオンが邪魔だ。	
GAMEPLAY_EMOTE_HERO_07_EVENT_LUNAR_NEW_YEAR	新年の祝いを！	
GAMEPLAY_EMOTE_HERO_07_FIRE_FESTIVAL	盛大に燃やすのだ。	
GAMEPLAY_EMOTE_HERO_07_GOOD_GAME	よい勝負であった。	
GAMEPLAY_EMOTE_HERO_07_GREETINGS	御機嫌よう。	
GAMEPLAY_EMOTE_HERO_07_GREETINGS_RESPONSE	そちらも。	
GAMEPLAY_EMOTE_HERO_07_HALLOWS_END	常の世ならぬハロウェンドよ！	
GAMEPLAY_EMOTE_HERO_07_LOW_CARDS	もうすぐカードが尽きるぞ！	
GAMEPLAY_EMOTE_HERO_07_MIRROR_START	我はお前の悪夢となろう！	
GAMEPLAY_EMOTE_HERO_07_NO_CARDS	カードが尽きたか！	
GAMEPLAY_EMOTE_HERO_07_NOBLEGARDEN	ノーブルガーデンの祝いを。	
GAMEPLAY_EMOTE_HERO_07_OOPS	失策であった。	
GAMEPLAY_EMOTE_HERO_07_PIRATE_DAY	「海賊の日」だと？理解できんな。	
GAMEPLAY_EMOTE_HERO_07_SORRY	失敬。	
GAMEPLAY_EMOTE_HERO_07_START	お前の魂は我が物となろう！	
GAMEPLAY_EMOTE_HERO_07_THANKS	感謝する。	
GAMEPLAY_EMOTE_HERO_07_THINK1	ふ～む…	
GAMEPLAY_EMOTE_HERO_07_THINK2	どうする…	
GAMEPLAY_EMOTE_HERO_07_THINK3	どの手を打つべきか…	
GAMEPLAY_EMOTE_HERO_07_THREATEN	お前の魂に苦痛あれ！	
GAMEPLAY_EMOTE_HERO_07_TIMER	時間が尽きるぞ！	
GAMEPLAY_EMOTE_HERO_07_WELL_PLAYED	見事。	
GAMEPLAY_EMOTE_HERO_07_WINTERVEIL_GREETINGS	喜ばしき冬至祭よ…	
GAMEPLAY_EMOTE_HERO_07_WOW	桁外れな。	
GAMEPLAY_EMOTE_HERO_08_CONCEDE	今回は貴方の勝ちね。	
GAMEPLAY_EMOTE_HERO_08_ERROR_FULL_MINIONS	ミニオンが多過ぎるわ。	
GAMEPLAY_EMOTE_HERO_08_ERROR_GENERIC	それはできないわ。	
GAMEPLAY_EMOTE_HERO_08_ERROR_HAND_FULL	手札が多過ぎるわ！	
GAMEPLAY_EMOTE_HERO_08_ERROR_I_ATTACKED	私はもう攻撃したわ。	
GAMEPLAY_EMOTE_HERO_08_ERROR_JUST_PLAYED	そのミニオンは次のターンから動けるわ。	
GAMEPLAY_EMOTE_HERO_08_ERROR_MINION_ATTACKED	そのミニオンは攻撃済みね。	
GAMEPLAY_EMOTE_HERO_08_ERROR_NEED_MANA	マナが足りないわ。	
GAMEPLAY_EMOTE_HERO_08_ERROR_NEED_WEAPON	武器が必要だわ。	
GAMEPLAY_EMOTE_HERO_08_ERROR_PLAY	今そのカードは使えないわ。	
GAMEPLAY_EMOTE_HERO_08_ERROR_STEALTH	隠れ身しているミニオンは攻撃できないわ。	
GAMEPLAY_EMOTE_HERO_08_ERROR_TARGET	それは対象にできないわ。	
GAMEPLAY_EMOTE_HERO_08_ERROR_TAUNT	「挑発」を持つミニオンが邪魔ね。	
GAMEPLAY_EMOTE_HERO_08_EVENT_LUNAR_NEW_YEAR	明けまして、おめでとう！	
GAMEPLAY_EMOTE_HERO_08_FIRE_FESTIVAL	真夏の炎祭りを祝いましょう！	
GAMEPLAY_EMOTE_HERO_08_GOOD_GAME	いい勝負だったわ。	
GAMEPLAY_EMOTE_HERO_08_GREETINGS	ご機嫌いかが。	
GAMEPLAY_EMOTE_HERO_08_GREETINGS_RESPONSE	ご機嫌いかが、旅のお方。	
GAMEPLAY_EMOTE_HERO_08_HALLOWS_END	ハッピー・ハロウェンド！	
GAMEPLAY_EMOTE_HERO_08_LOW_CARDS	もうほとんどカードが無いわ！	
GAMEPLAY_EMOTE_HERO_08_MIRROR_START	それはこっちのセリフよ！	
GAMEPLAY_EMOTE_HERO_08_NO_CARDS	カードが無くなったわ！	
GAMEPLAY_EMOTE_HERO_08_NOBLEGARDEN	ノーブルガーデンを祝いましょう。	
GAMEPLAY_EMOTE_HERO_08_OOPS	おおっと。	
GAMEPLAY_EMOTE_HERO_08_PIRATE_DAY	ヨーホ！	
GAMEPLAY_EMOTE_HERO_08_SORRY	失礼。	
GAMEPLAY_EMOTE_HERO_08_START	貴方が招いたのよ。	
GAMEPLAY_EMOTE_HERO_08_THANKS	感謝を。	
GAMEPLAY_EMOTE_HERO_08_THINK1	ふ～む…	
GAMEPLAY_EMOTE_HERO_08_THINK2	どうかしら…	
GAMEPLAY_EMOTE_HERO_08_THINK3	この手…それとも、この手…	
GAMEPLAY_EMOTE_HERO_08_THREATEN	私の魔法で引き裂かれるがいいわ！	
GAMEPLAY_EMOTE_HERO_08_TIMER	あまり時間がないわ！	
GAMEPLAY_EMOTE_HERO_08_WELL_PLAYED	お見事。	
GAMEPLAY_EMOTE_HERO_08_WINTERVEIL_GREETINGS	冬至祭を祝いましょう！	
GAMEPLAY_EMOTE_HERO_08_WOW	すごいわ。	
GAMEPLAY_EMOTE_HERO_08A_CELEBRATE	うむ、良し！ハハハ！	
GAMEPLAY_EMOTE_HERO_08A_CONCEDE	これも我が罪、我の詰みか。お見事。	
GAMEPLAY_EMOTE_HERO_08A_ERROR_FULL_MINIONS	手駒が多過ぎるか。	
GAMEPLAY_EMOTE_HERO_08A_ERROR_GENERIC	それは不可能だ。	
GAMEPLAY_EMOTE_HERO_08A_ERROR_HAND_FULL	手札が多過ぎたか！	
GAMEPLAY_EMOTE_HERO_08A_ERROR_I_ATTACKED	私自らの一撃、既に為された。	
GAMEPLAY_EMOTE_HERO_08A_ERROR_JUST_PLAYED	その駒が動けるのは次の手番からだ。	
GAMEPLAY_EMOTE_HERO_08A_ERROR_MINION_ATTACKED	その駒は既に動いている。	
GAMEPLAY_EMOTE_HERO_08A_ERROR_NEED_MANA	マナが足りない。	
GAMEPLAY_EMOTE_HERO_08A_ERROR_NEED_WEAPON	武器が必要だ。	
GAMEPLAY_EMOTE_HERO_08A_ERROR_PLAY	今その手は打てない。	
GAMEPLAY_EMOTE_HERO_08A_ERROR_STEALTH	隠れ身している駒は取れない。	
GAMEPLAY_EMOTE_HERO_08A_ERROR_TARGET	それは対象にできない。	
GAMEPLAY_EMOTE_HERO_08A_ERROR_TAUNT	「挑発」を持つ駒を除くのが先決だ。	
GAMEPLAY_EMOTE_HERO_08A_FIRE_FESTIVAL	「真夏の炎祭り」が来たぞ！	
GAMEPLAY_EMOTE_HERO_08A_GOOD_GAME	よい対局だった。	
GAMEPLAY_EMOTE_HERO_08A_GREETINGS	ああ。御機嫌よう。	
GAMEPLAY_EMOTE_HERO_08A_GREETINGS_RESPONSE	そちらも御機嫌よう、ガーディアン。	
GAMEPLAY_EMOTE_HERO_08A_HALLOWS_END	ハロウェンドを祝おう！	
GAMEPLAY_EMOTE_HERO_08A_LOW_CARDS	む、カードが尽きる！	
GAMEPLAY_EMOTE_HERO_08A_LUNAR_NEW_YEAR	新年の慶びを！	
GAMEPLAY_EMOTE_HERO_08A_MIRROR_START	否、既に動いているとも。	
GAMEPLAY_EMOTE_HERO_08A_NO_CARDS	カードが尽きたか！	
GAMEPLAY_EMOTE_HERO_08A_NOBLEGARDEN	ノーブルガーデンを祝おう！	
GAMEPLAY_EMOTE_HERO_08A_OOPS	愚の骨頂。	
GAMEPLAY_EMOTE_HERO_08A_PIRATE_DAY	私はメディヴ、ガァァァァーーディアンだ。	
GAMEPLAY_EMOTE_HERO_08A_SORRY	心からお詫び申し上げる。	
GAMEPLAY_EMOTE_HERO_08A_START	いざ、駒を進めるとしよう。	
GAMEPLAY_EMOTE_HERO_08A_THANKS	感謝する。	
GAMEPLAY_EMOTE_HERO_08A_THINK1	ふむぅ…	
GAMEPLAY_EMOTE_HERO_08A_THINK2	これは面白い…	
GAMEPLAY_EMOTE_HERO_08A_THINK3	あるいは…	
GAMEPLAY_EMOTE_HERO_08A_THREATEN	何物も私を止められぬ。何物も！	
GAMEPLAY_EMOTE_HERO_08A_TIMER	悠長にしている場合ではない！	
GAMEPLAY_EMOTE_HERO_08A_WELL_PLAYED	見事だ。	
GAMEPLAY_EMOTE_HERO_08A_WINTERVEIL_GREETINGS	挑戦者よ、冬至祭の慶びを。	
GAMEPLAY_EMOTE_HERO_08A_WOW	まさに妙手。	
GAMEPLAY_EMOTE_HERO_08B_CONCEDE	お見事。君の勝ちだ。	
GAMEPLAY_EMOTE_HERO_08B_ERROR_FULL_MINIONS	ミニオンが多過ぎるか。	
GAMEPLAY_EMOTE_HERO_08B_ERROR_GENERIC	それはできないな。	
GAMEPLAY_EMOTE_HERO_08B_ERROR_HAND_FULL	手札が多過ぎる！	
GAMEPLAY_EMOTE_HERO_08B_ERROR_I_ATTACKED	もう攻撃したぞ。	
GAMEPLAY_EMOTE_HERO_08B_ERROR_JUST_PLAYED	そのミニオンは次のターンから動ける。	
GAMEPLAY_EMOTE_HERO_08B_ERROR_MINION_ATTACKED	そのミニオンは攻撃済みだな。	
GAMEPLAY_EMOTE_HERO_08B_ERROR_NEED_MANA	マナが足りないな。	
GAMEPLAY_EMOTE_HERO_08B_ERROR_NEED_WEAPON	武器がいるな。	
GAMEPLAY_EMOTE_HERO_08B_ERROR_PLAY	今その手は打てない。	
GAMEPLAY_EMOTE_HERO_08B_ERROR_STEALTH	隠れ身しているミニオンは攻められん。	
GAMEPLAY_EMOTE_HERO_08B_ERROR_TARGET	それは対象にできないな。	
GAMEPLAY_EMOTE_HERO_08B_ERROR_TAUNT	「挑発」を持つミニオンが邪魔だ。	
GAMEPLAY_EMOTE_HERO_08B_FIRE_FESTIVAL	大いなる真夏の楽しみを。	
GAMEPLAY_EMOTE_HERO_08B_GOOD_GAME	はてさて。よい勝負だったな！	
GAMEPLAY_EMOTE_HERO_08B_GREETINGS	よろしく、真理の探究者よ。	
GAMEPLAY_EMOTE_HERO_08B_GREETINGS_RESPONSE	共に求めしものを見出さん。	
GAMEPLAY_EMOTE_HERO_08B_HALLOWS_END	ハロウェンドを祝おう！	
GAMEPLAY_EMOTE_HERO_08B_LOW_CARDS	カードが尽きるか。	
GAMEPLAY_EMOTE_HERO_08B_LUNAR_NEW_YEAR	新年おめでとう！	
GAMEPLAY_EMOTE_HERO_08B_MIRROR_START	我ら、共に多くを学ばん。	
GAMEPLAY_EMOTE_HERO_08B_NO_CARDS	カードが尽きたか！	
GAMEPLAY_EMOTE_HERO_08B_NOBLEGARDEN	ノーブルガーデンを祝おう！	
GAMEPLAY_EMOTE_HERO_08B_OOPS	なんと。やれやれ。	
GAMEPLAY_EMOTE_HERO_08B_PIRATE_DAY	今日は…、海の犯罪者どもを祝う日だと？	
GAMEPLAY_EMOTE_HERO_08B_SORRY	なんともはや。すまないね。	
GAMEPLAY_EMOTE_HERO_08B_START	知は力なり。	
GAMEPLAY_EMOTE_HERO_08B_THANKS	友よ、感謝する。	
GAMEPLAY_EMOTE_HERO_08B_THINK1	う～ん…	
GAMEPLAY_EMOTE_HERO_08B_THINK2	観察し、省察し…	
GAMEPLAY_EMOTE_HERO_08B_THINK3	必ず、打つ手が…	
GAMEPLAY_EMOTE_HERO_08B_THREATEN	猪口才な若造め、教育してくれる！	
GAMEPLAY_EMOTE_HERO_08B_TIMER	こんな時間か！	
GAMEPLAY_EMOTE_HERO_08B_WELL_PLAYED	お見事。	
GAMEPLAY_EMOTE_HERO_08B_WINTERVEIL_GREETINGS	冬至祭を祝おう！	
GAMEPLAY_EMOTE_HERO_08B_WOW	すばらしい。	
GAMEPLAY_EMOTE_HERO_09_CONCEDE	恐れ入りました。	
GAMEPLAY_EMOTE_HERO_09_ERROR_FULL_MINIONS	ミニオンが多過ぎますね。	
GAMEPLAY_EMOTE_HERO_09_ERROR_GENERIC	それはできません。	
GAMEPLAY_EMOTE_HERO_09_ERROR_HAND_FULL	手札が多過ぎます！	
GAMEPLAY_EMOTE_HERO_09_ERROR_I_ATTACKED	僕はもう攻撃しました。	
GAMEPLAY_EMOTE_HERO_09_ERROR_JUST_PLAYED	そのミニオンが動けるのは次のターンからです。	
GAMEPLAY_EMOTE_HERO_09_ERROR_MINION_ATTACKED	そのミニオンは攻撃済みです。	
GAMEPLAY_EMOTE_HERO_09_ERROR_NEED_MANA	マナが足りません。	
GAMEPLAY_EMOTE_HERO_09_ERROR_NEED_WEAPON	武器が必要です。	
GAMEPLAY_EMOTE_HERO_09_ERROR_PLAY	今そのカードは使えません。	
GAMEPLAY_EMOTE_HERO_09_ERROR_STEALTH	隠れ身しているミニオンは攻撃できません。	
GAMEPLAY_EMOTE_HERO_09_ERROR_TARGET	それは対象にはできませんね。	
GAMEPLAY_EMOTE_HERO_09_ERROR_TAUNT	「挑発」を持つミニオンが邪魔です。	
GAMEPLAY_EMOTE_HERO_09_EVENT_LUNAR_NEW_YEAR	明けましておめでとうございます！	
GAMEPLAY_EMOTE_HERO_09_FIRE_FESTIVAL	花火が楽しみです！	
GAMEPLAY_EMOTE_HERO_09_GOOD_GAME	よい勝負でした！	
GAMEPLAY_EMOTE_HERO_09_GREETINGS	よろしく！	
GAMEPLAY_EMOTE_HERO_09_GREETINGS_DISABLED	んむ～～！	
GAMEPLAY_EMOTE_HERO_09_GREETINGS_RESPONSE	よろしく、友よ！	
GAMEPLAY_EMOTE_HERO_09_HALLOWS_END	ハッピー・ハロウェンド！	
GAMEPLAY_EMOTE_HERO_09_LOW_CARDS	もうすぐカードが尽きる！	
GAMEPLAY_EMOTE_HERO_09_MIRROR_START	光は正しき者に微笑む！	
GAMEPLAY_EMOTE_HERO_09_NO_CARDS	カードが尽きてしまった！	
GAMEPLAY_EMOTE_HERO_09_NOBLEGARDEN	ハッピー・ノーブルガーデン！	
GAMEPLAY_EMOTE_HERO_09_OOPS	目論見が外れましたね。	
GAMEPLAY_EMOTE_HERO_09_OOPS_DISABLED	んぐぅ？	
GAMEPLAY_EMOTE_HERO_09_PIRATE_DAY	ヤァァハハハァ、極悪海賊団に入ろうぜ。	
GAMEPLAY_EMOTE_HERO_09_SORRY	失礼しました。	
GAMEPLAY_EMOTE_HERO_09_START	光が勝利をもたらさんことを！	
GAMEPLAY_EMOTE_HERO_09_THANKS	感謝します。	
GAMEPLAY_EMOTE_HERO_09_THANKS_DISABLED	むぐぐ…	
GAMEPLAY_EMOTE_HERO_09_THINK1	ふむ…	
GAMEPLAY_EMOTE_HERO_09_THINK2	何をするべきか…	
GAMEPLAY_EMOTE_HERO_09_THINK3	決断しなくては…	
GAMEPLAY_EMOTE_HERO_09_THREATEN	光の浄化を受けよ！	
GAMEPLAY_EMOTE_HERO_09_THREATEN_DISABLED	んん～～～！	
GAMEPLAY_EMOTE_HERO_09_TIMER	決断しなくては！	
GAMEPLAY_EMOTE_HERO_09_WELL_PLAYED	お見事です。	
GAMEPLAY_EMOTE_HERO_09_WELL_PLAYED_DISABLED	むぐぐ…	
GAMEPLAY_EMOTE_HERO_09_WINTERVEIL_GREETINGS	冬至祭を祝いましょう！	
GAMEPLAY_EMOTE_HERO_09_WOW	わぁっ…	
GAMEPLAY_EMOTE_HERO_09_WOW_DISABLED	んん～～～！	
GAMEPLAY_EMOTE_HERO_TBKTRAF_KT_CONCEDE	この…借りは…返すぞ…	
GAMEPLAY_EMOTE_HERO_TBKTRAF_KT_GREETINGS	ついに我が前に現れたか！	
GAMEPLAY_EMOTE_HERO_TBKTRAF_KT_LOW_CARDS	我がカードが尽きかけている！	
GAMEPLAY_EMOTE_HERO_TBKTRAF_KT_NO_CARDS	おのれ！！！呪われよ、侵入者め！	
GAMEPLAY_EMOTE_HERO_TBKTRAF_KT_OOPS	ハァ…設計図から作り直しか…	
GAMEPLAY_EMOTE_HERO_TBKTRAF_KT_SORRY	おのれ！呪われよ、侵入者め！	
GAMEPLAY_EMOTE_HERO_TBKTRAF_KT_START	我の前まで来るがよい、侵入者よ！	
GAMEPLAY_EMOTE_HERO_TBKTRAF_KT_THANKS	どう…いたしまして？	
GAMEPLAY_EMOTE_HERO_TBKTRAF_KT_THINK1	これはどうだ？ 	
GAMEPLAY_EMOTE_HERO_TBKTRAF_KT_THINK2	よし…よぉし！	
GAMEPLAY_EMOTE_HERO_TBKTRAF_KT_THINK3	どう思う、ビグルスワース君？	
GAMEPLAY_EMOTE_HERO_TBKTRAF_KT_THREATEN	その体に流れる血を凍てつかせてくれよう！	
GAMEPLAY_EMOTE_HERO_TBKTRAF_KT_WELL_PLAYED	ハー、当たり前のことを。我は「あの」ケルスザードなのだぞ！	
GAMEPLAY_EMOTE_HERO_TBKTRAF_RAF_CONCEDE	バカな！我が負けるはずなんてない！	
GAMEPLAY_EMOTE_HERO_TBKTRAF_RAF_GREETINGS	ようこそ、探検家よ。	
GAMEPLAY_EMOTE_HERO_TBKTRAF_RAF_LOW_CARDS	我がカードが尽きかけているとは！	
GAMEPLAY_EMOTE_HERO_TBKTRAF_RAF_NO_CARDS	我が美しき宝が！	
GAMEPLAY_EMOTE_HERO_TBKTRAF_RAF_OOPS	失敗だ！	
GAMEPLAY_EMOTE_HERO_TBKTRAF_RAF_SORRY	哀れだな。	
GAMEPLAY_EMOTE_HERO_TBKTRAF_RAF_START	ラファーム！頂点たる考古学者なり！	
GAMEPLAY_EMOTE_HERO_TBKTRAF_RAF_THANKS	ああ、感謝する。	
GAMEPLAY_EMOTE_HERO_TBKTRAF_RAF_THINK1	うぬぬぬ…	
GAMEPLAY_EMOTE_HERO_TBKTRAF_RAF_THINK2	どれをいただこう…	
GAMEPLAY_EMOTE_HERO_TBKTRAF_RAF_THINK3	まさに垂涎…	
GAMEPLAY_EMOTE_HERO_TBKTRAF_RAF_THREATEN	この圧倒的なパワー！	
GAMEPLAY_EMOTE_HERO_TBKTRAF_RAF_WELL_PLAYED	お見事	
GAMEPLAY_EMOTE_HERO_TBMECHWAR01_CONCEDE	<敗北宣言>	The text is in brackets because the VO files is just Annoy-o-Tron's greeting
GAMEPLAY_EMOTE_HERO_TBMECHWAR01_ERROR_FULL_MINIONS	<エラー！>	The text is in brackets because the VO files is just Annoy-o-Tron's greeting
GAMEPLAY_EMOTE_HERO_TBMECHWAR01_ERROR_HAND_FULL	<エラー！>	The text is in brackets because the VO files is just Annoy-o-Tron's greeting
GAMEPLAY_EMOTE_HERO_TBMECHWAR01_ERROR_I_ATTACKED	<エラー！>	The text is in brackets because the VO files is just Annoy-o-Tron's greeting
GAMEPLAY_EMOTE_HERO_TBMECHWAR01_ERROR_JUST_PLAYED	<エラー！>	The text is in brackets because the VO files is just Annoy-o-Tron's greeting
GAMEPLAY_EMOTE_HERO_TBMECHWAR01_ERROR_MINION_ATTACKED	<エラー！>	The text is in brackets because the VO files is just Annoy-o-Tron's greeting
GAMEPLAY_EMOTE_HERO_TBMECHWAR01_ERROR_NEED_MANA	<エラー！>	The text is in brackets because the VO files is just Annoy-o-Tron's greeting
GAMEPLAY_EMOTE_HERO_TBMECHWAR01_ERROR_NEED_WEAPON	<エラー！>	The text is in brackets because the VO files is just Annoy-o-Tron's greeting
GAMEPLAY_EMOTE_HERO_TBMECHWAR01_ERROR_PLAY	<エラー！>	The text is in brackets because the VO files is just Annoy-o-Tron's greeting
GAMEPLAY_EMOTE_HERO_TBMECHWAR01_ERROR_STEALTH	<エラー！>	The text is in brackets because the VO files is just Annoy-o-Tron's greeting
GAMEPLAY_EMOTE_HERO_TBMECHWAR01_ERROR_TARGET	<エラー！>	The text is in brackets because the VO files is just Annoy-o-Tron's greeting
GAMEPLAY_EMOTE_HERO_TBMECHWAR01_ERROR_TAUNT	<エラー！>	The text is in brackets because the VO files is just Annoy-o-Tron's greeting
GAMEPLAY_EMOTE_HERO_TBMECHWAR01_GREETINGS	<あいさつ>	The text is in brackets because the VO files is just Annoy-o-Tron's greeting
GAMEPLAY_EMOTE_HERO_TBMECHWAR01_LOW_CARDS	<カードが残りわずかです>	The text is in brackets because the VO files is just Annoy-o-Tron's greeting
GAMEPLAY_EMOTE_HERO_TBMECHWAR01_NO_CARDS	<カードが無くなりました>	The text is in brackets because the VO files is just Annoy-o-Tron's greeting
GAMEPLAY_EMOTE_HERO_TBMECHWAR01_OOPS	<エラー>	The text is in brackets because the VO files is just Annoy-o-Tron's greeting
GAMEPLAY_EMOTE_HERO_TBMECHWAR01_SORRY	<謝罪>	The text is in brackets because the VO files is just Annoy-o-Tron's greeting
GAMEPLAY_EMOTE_HERO_TBMECHWAR01_START	<開始>	The text is in brackets because the VO files is just Annoy-o-Tron's greeting
GAMEPLAY_EMOTE_HERO_TBMECHWAR01_THANKS	<感謝>	The text is in brackets because the VO files is just Annoy-o-Tron's greeting
GAMEPLAY_EMOTE_HERO_TBMECHWAR01_THINK1	<処理中…>	The text is in brackets because the VO files is just Annoy-o-Tron's greeting
GAMEPLAY_EMOTE_HERO_TBMECHWAR01_THINK2	<標的を捕捉中…>	The text is in brackets because the VO files is just Annoy-o-Tron's greeting
GAMEPLAY_EMOTE_HERO_TBMECHWAR01_THINK3	<CPUサイクルを無駄遣い中…>	The text is in brackets because the VO files is just Annoy-o-Tron's greeting
GAMEPLAY_EMOTE_HERO_TBMECHWAR01_THREATEN	<威嚇>	The text is in brackets because the VO files is just Annoy-o-Tron's attack
GAMEPLAY_EMOTE_HERO_TBMECHWAR01_TIMER	<持ち時間が残りわずかです>	The text is in brackets because the VO files is just Annoy-o-Tron's greeting
GAMEPLAY_EMOTE_HERO_TBMECHWAR01_WELL_PLAYED	<賞賛>	The text is in brackets because the VO files is just Annoy-o-Tron's greeting
GAMEPLAY_EMOTE_HERO_TBMECHWAR01_WOW	<すごい！>	The text is in brackets because the VO files is just Annoy-o-Tron's greeting
GAMEPLAY_EMOTE_HERO_TBMECHWAR02_CONCEDE	<行の終わり>	The text is in brackets because the VO files is just Boom Bot's greeting
GAMEPLAY_EMOTE_HERO_TBMECHWAR02_ERROR_FULL_MINIONS	<エラー！>	The text is in brackets because the VO files is just Boom Bot's greeting
GAMEPLAY_EMOTE_HERO_TBMECHWAR02_ERROR_HAND_FULL	<エラー！>	The text is in brackets because the VO files is just Boom Bot's greeting
GAMEPLAY_EMOTE_HERO_TBMECHWAR02_ERROR_I_ATTACKED	<エラー！>	The text is in brackets because the VO files is just Boom Bot's greeting
GAMEPLAY_EMOTE_HERO_TBMECHWAR02_ERROR_JUST_PLAYED	<エラー！>	The text is in brackets because the VO files is just Boom Bot's greeting
GAMEPLAY_EMOTE_HERO_TBMECHWAR02_ERROR_MINION_ATTACKED	<エラー！>	The text is in brackets because the VO files is just Boom Bot's greeting
GAMEPLAY_EMOTE_HERO_TBMECHWAR02_ERROR_NEED_MANA	<エラー！>	The text is in brackets because the VO files is just Boom Bot's greeting
GAMEPLAY_EMOTE_HERO_TBMECHWAR02_ERROR_NEED_WEAPON	<エラー！>	The text is in brackets because the VO files is just Boom Bot's greeting
GAMEPLAY_EMOTE_HERO_TBMECHWAR02_ERROR_PLAY	<エラー！>	The text is in brackets because the VO files is just Boom Bot's greeting
GAMEPLAY_EMOTE_HERO_TBMECHWAR02_ERROR_STEALTH	<エラー！>	The text is in brackets because the VO files is just Boom Bot's greeting
GAMEPLAY_EMOTE_HERO_TBMECHWAR02_ERROR_TARGET	<エラー！>	The text is in brackets because the VO files is just Boom Bot's greeting
GAMEPLAY_EMOTE_HERO_TBMECHWAR02_ERROR_TAUNT	<エラー！>	The text is in brackets because the VO files is just Boom Bot's greeting
GAMEPLAY_EMOTE_HERO_TBMECHWAR02_GREETINGS	<あいさつ>	The text is in brackets because the VO files is just Annoy-o-Tron's greeting
GAMEPLAY_EMOTE_HERO_TBMECHWAR02_LOW_CARDS	<カードが残りわずかです>	The text is in brackets because the VO files is just Boom Bot's greeting
GAMEPLAY_EMOTE_HERO_TBMECHWAR02_NO_CARDS	<カードが尽きました！>	The text is in brackets because the VO files is just Boom Bot's greeting
GAMEPLAY_EMOTE_HERO_TBMECHWAR02_OOPS	<エラー！>	The text is in brackets because the VO files is just Boom Bot's greeting
GAMEPLAY_EMOTE_HERO_TBMECHWAR02_SORRY	<失敬>	The text is in brackets because the VO files is just Boom Bot's greeting
GAMEPLAY_EMOTE_HERO_TBMECHWAR02_START	<起動>	The text is in brackets because the VO files is just Boom Bot's greeting
GAMEPLAY_EMOTE_HERO_TBMECHWAR02_THANKS	<ありがとうございます>	The text is in brackets because the VO files is just Boom Bot's greeting
GAMEPLAY_EMOTE_HERO_TBMECHWAR02_THINK1	<処理中…>	The text is in brackets because the VO files is just Boom Bot's greeting
GAMEPLAY_EMOTE_HERO_TBMECHWAR02_THINK2	<標的を捕捉中…>	The text is in brackets because the VO files is just Boom Bot's greeting
GAMEPLAY_EMOTE_HERO_TBMECHWAR02_THINK3	<CPUサイクルを無駄遣い中…>	The text is in brackets because the VO files is just Boom Bot's greeting
GAMEPLAY_EMOTE_HERO_TBMECHWAR02_THREATEN	<威嚇！>	The text is in brackets because the VO files is just Boom Bot's Attack sound
GAMEPLAY_EMOTE_HERO_TBMECHWAR02_TIMER	<持ち時間が残りわずかです>	The text is in brackets because the VO files is just Boom Bot's greeting
GAMEPLAY_EMOTE_HERO_TBMECHWAR02_WELL_PLAYED	<賞賛>	The text is in brackets because the VO files is just Boom Bot's greeting
GAMEPLAY_EMOTE_HERO_TBMECHWAR02_WOW	<見事な！>	The text is in brackets because the VO files is just Annoy-o-Tron's greeting
GAMEPLAY_EMOTE_ICC_481_CONCEDE	お主の勝ちだ、アイスクリームで涼むがいい。	
GAMEPLAY_EMOTE_ICC_481_GREETINGS	死の冷たき抱擁をお主に。	
GAMEPLAY_EMOTE_ICC_481_LOW_CARDS	カードが尽きるぞ！	
GAMEPLAY_EMOTE_ICC_481_NO_CARDS	カードが尽きたか！	
GAMEPLAY_EMOTE_ICC_481_OOPS	墓穴を掘ったな。	
GAMEPLAY_EMOTE_ICC_481_START	我はスコージの凍てつく心臓なり！	
GAMEPLAY_EMOTE_ICC_481_THANKS	ありがとう。	
GAMEPLAY_EMOTE_ICC_481_THINK1	ふむぅ…	
GAMEPLAY_EMOTE_ICC_481_THINK2	精霊たちは何も言わない…	
GAMEPLAY_EMOTE_ICC_481_THINK3	私一人で決めなければ。	
GAMEPLAY_EMOTE_ICC_481_THREATEN	打ち砕いてくれる！	
GAMEPLAY_EMOTE_ICC_481_TIMER	道を選ばねば！	
GAMEPLAY_EMOTE_ICC_481_WELL_PLAYED	お見事。	
GAMEPLAY_EMOTE_ICC_481_WOW	ものすごいな。	
GAMEPLAY_EMOTE_ICC_827_CONCEDE	今日はあなたの勝ちね。	
GAMEPLAY_EMOTE_ICC_827_GREETINGS	どこに隠れてたの？	
GAMEPLAY_EMOTE_ICC_827_LOW_CARDS	カードが無くなるわ！	
GAMEPLAY_EMOTE_ICC_827_NO_CARDS	カードが無くなったわ！	
GAMEPLAY_EMOTE_ICC_827_OOPS	これは悲劇ね。	
GAMEPLAY_EMOTE_ICC_827_START	死の影からは逃れられないわ。	
GAMEPLAY_EMOTE_ICC_827_THANKS	ありがとう。	
GAMEPLAY_EMOTE_ICC_827_THINK1	うぅん…	
GAMEPLAY_EMOTE_ICC_827_THINK2	死の影が伸びていくわ…	
GAMEPLAY_EMOTE_ICC_827_THINK3	時がこぼれ落ちて行くわね…	
GAMEPLAY_EMOTE_ICC_827_THREATEN	あなた、自分の影にも怯えるようになるわ。	
GAMEPLAY_EMOTE_ICC_827_TIMER	早く決めなきゃ！	
GAMEPLAY_EMOTE_ICC_827_WELL_PLAYED	素敵ね。	
GAMEPLAY_EMOTE_ICC_827_WOW	嘘みたい！	
GAMEPLAY_EMOTE_ICC_828_CONCEDE	この狩りはお前のものだ。	
GAMEPLAY_EMOTE_ICC_828_GREETINGS	さあ逃げるがいい、獲物よ！	
GAMEPLAY_EMOTE_ICC_828_LOW_CARDS	カードが尽きる！	
GAMEPLAY_EMOTE_ICC_828_MIRROR_START	走れ！距離を取らせてやる。	
GAMEPLAY_EMOTE_ICC_828_NO_CARDS	カードが尽きたか！	
GAMEPLAY_EMOTE_ICC_828_OOPS	外れたな。	
GAMEPLAY_EMOTE_ICC_828_START	狩りの時間だ！	
GAMEPLAY_EMOTE_ICC_828_THANKS	感謝する。	
GAMEPLAY_EMOTE_ICC_828_THINK1	むむ…	
GAMEPLAY_EMOTE_ICC_828_THINK2	どの足跡を追うか…	
GAMEPLAY_EMOTE_ICC_828_THINK3	どう仕掛けるか…	
GAMEPLAY_EMOTE_ICC_828_THREATEN	お前を狩る…永遠にだ。	
GAMEPLAY_EMOTE_ICC_828_TIMER	ニオイが消えるぞ！	
GAMEPLAY_EMOTE_ICC_828_WELL_PLAYED	見事だ。	
GAMEPLAY_EMOTE_ICC_828_WOW	素晴らしいぞ。	
GAMEPLAY_EMOTE_ICC_829_CONCEDE	貴公の勝利だ…今回はな。	
GAMEPLAY_EMOTE_ICC_829_GREETINGS	もはや、ワシの裁きを受けるのみ。	
GAMEPLAY_EMOTE_ICC_829_LOW_CARDS	まもなくカードが尽きる！	
GAMEPLAY_EMOTE_ICC_829_NO_CARDS	カードが尽きたか！	
GAMEPLAY_EMOTE_ICC_829_OOPS	失望したぞ。	
GAMEPLAY_EMOTE_ICC_829_START	光の正義は無力なり。	
GAMEPLAY_EMOTE_ICC_829_THANKS	感謝いたす。	
GAMEPLAY_EMOTE_ICC_829_THINK1	ふむむむ…	
GAMEPLAY_EMOTE_ICC_829_THINK2	フロストモーンが呼んでおる…	
GAMEPLAY_EMOTE_ICC_829_THINK3	凍てつく玉座が呼んでおる…	
GAMEPLAY_EMOTE_ICC_829_THREATEN	貴様は慈悲を乞うであろうが、ワシは許さんぞ！	
GAMEPLAY_EMOTE_ICC_829_TIMER	終わりが近づいておる！	
GAMEPLAY_EMOTE_ICC_829_WELL_PLAYED	お見事。	
GAMEPLAY_EMOTE_ICC_829_WOW	信じられん！	
GAMEPLAY_EMOTE_ICC_830_CONCEDE	フン、お前の勝利など、何の証明にもなるものか！	
GAMEPLAY_EMOTE_ICC_830_GREETINGS	完全なる闇、それが僕の復讐だ。	
GAMEPLAY_EMOTE_ICC_830_LOW_CARDS	もうすぐカードが尽きる！	
GAMEPLAY_EMOTE_ICC_830_NO_CARDS	カードが尽きてしまった！	
GAMEPLAY_EMOTE_ICC_830_OOPS	人は間違えるものさ。	
GAMEPLAY_EMOTE_ICC_830_START	闇が勝利をもたらす！	
GAMEPLAY_EMOTE_ICC_830_THANKS	感謝します。	
GAMEPLAY_EMOTE_ICC_830_THINK1	ふむ…	
GAMEPLAY_EMOTE_ICC_830_THINK2	闇の声が聞こえる…	
GAMEPLAY_EMOTE_ICC_830_THINK3	影をつかむようだな…	
GAMEPLAY_EMOTE_ICC_830_THREATEN	闇がお前を貪り尽くすぞ！	
GAMEPLAY_EMOTE_ICC_830_TIMER	影が短くなりつつある！	
GAMEPLAY_EMOTE_ICC_830_WELL_PLAYED	お見事。	
GAMEPLAY_EMOTE_ICC_830_WOW	まぐれだ！	
GAMEPLAY_EMOTE_ICC_831_CONCEDE	お前の勝ちだ…今回はな。	
GAMEPLAY_EMOTE_ICC_831_GREETINGS	我を恐れよ。	
GAMEPLAY_EMOTE_ICC_831_LOW_CARDS	もうすぐカードが尽きるぞ！	
GAMEPLAY_EMOTE_ICC_831_NO_CARDS	カードが尽きたか！	
GAMEPLAY_EMOTE_ICC_831_OOPS	今のは何の役にも立たんな。	
GAMEPLAY_EMOTE_ICC_831_START	血と影とを捧げられし、契約の力よ。	
GAMEPLAY_EMOTE_ICC_831_THANKS	ああ、感謝する。	
GAMEPLAY_EMOTE_ICC_831_THINK1	ふ～む…	
GAMEPLAY_EMOTE_ICC_831_THINK2	ますます…渇くぞ…	
GAMEPLAY_EMOTE_ICC_831_THINK3	どの血を吸うべきか…	
GAMEPLAY_EMOTE_ICC_831_THREATEN	お前の苦痛は…レジェンド級となろう！	
GAMEPLAY_EMOTE_ICC_831_TIMER	喰らわねば、今すぐ！	
GAMEPLAY_EMOTE_ICC_831_WELL_PLAYED	上出来だな。	
GAMEPLAY_EMOTE_ICC_831_WOW	地獄の炎にかけて。	
GAMEPLAY_EMOTE_ICC_832_CONCEDE	お主の勝ちだ。これで休める。	
GAMEPLAY_EMOTE_ICC_832_GREETINGS	腐敗の循環を始めよう。	
GAMEPLAY_EMOTE_ICC_832_LOW_CARDS	カードが尽きてしまう！	
GAMEPLAY_EMOTE_ICC_832_NO_CARDS	カードが尽きてしまった！	
GAMEPLAY_EMOTE_ICC_832_OOPS	クモも巣から落ちる、か。	
GAMEPLAY_EMOTE_ICC_832_START	生命の環は終わりだ！	
GAMEPLAY_EMOTE_ICC_832_THANKS	感謝つかまつる。	
GAMEPLAY_EMOTE_ICC_832_THINK1	フム…	
GAMEPLAY_EMOTE_ICC_832_THINK2	絡んだクモの巣のようだ…	
GAMEPLAY_EMOTE_ICC_832_THINK3	考えが病んでいるな…	
GAMEPLAY_EMOTE_ICC_832_THREATEN	萎びて腐るがよい。	
GAMEPLAY_EMOTE_ICC_832_TIMER	死は永遠…私のターンは違う！	
GAMEPLAY_EMOTE_ICC_832_WELL_PLAYED	上々だ。	
GAMEPLAY_EMOTE_ICC_832_WOW	これは魂消た！	
GAMEPLAY_EMOTE_ICC_833_CONCEDE	今回はお前が上手だったわね。	
GAMEPLAY_EMOTE_ICC_833_GREETINGS	震えているわね。怖いのかしら？	
GAMEPLAY_EMOTE_ICC_833_LOW_CARDS	もうほとんどカードが無いわ！	
GAMEPLAY_EMOTE_ICC_833_NO_CARDS	カードが無くなったわ！	
GAMEPLAY_EMOTE_ICC_833_OOPS	致命的な失敗だわ。	
GAMEPLAY_EMOTE_ICC_833_START	力は恐れるに足らず。力に魅入られし者を恐れよ！	
GAMEPLAY_EMOTE_ICC_833_THANKS	感謝を。	
GAMEPLAY_EMOTE_ICC_833_THINK1	ふ～む…	
GAMEPLAY_EMOTE_ICC_833_THINK2	時が溶け落ちてゆくわ…	
GAMEPLAY_EMOTE_ICC_833_THINK3	う～ん、決めなくては…	
GAMEPLAY_EMOTE_ICC_833_THREATEN	女王に首を垂れよ！	
GAMEPLAY_EMOTE_ICC_833_TIMER	時間よ！	
GAMEPLAY_EMOTE_ICC_833_WELL_PLAYED	これはお見事…	
GAMEPLAY_EMOTE_ICC_833_WOW	凍てついた心にも響いたわ！	
GAMEPLAY_EMOTE_ICC_834_CONCEDE	オレは死を選ぶぞ。	
GAMEPLAY_EMOTE_ICC_834_GREETINGS	ヘルスクリームの怒りからは逃れられんぞ。	
GAMEPLAY_EMOTE_ICC_834_LOW_CARDS	カードが尽きる！	
GAMEPLAY_EMOTE_ICC_834_NO_CARDS	カードが尽きたぞ。	
GAMEPLAY_EMOTE_ICC_834_OOPS	失敗だ！	
GAMEPLAY_EMOTE_ICC_834_START	この世界を焼き尽くし、その灰を支配してくれる！	
GAMEPLAY_EMOTE_ICC_834_THANKS	礼を言うぞ。	
GAMEPLAY_EMOTE_ICC_834_THINK1	ヌゥゥ…	
GAMEPLAY_EMOTE_ICC_834_THINK2	時が過ぎる…	
GAMEPLAY_EMOTE_ICC_834_THINK3	どいつをやるか…	
GAMEPLAY_EMOTE_ICC_834_THREATEN	膝をつくのはお前が先だ。	
GAMEPLAY_EMOTE_ICC_834_TIMER	決断せねば！	
GAMEPLAY_EMOTE_ICC_834_WELL_PLAYED	オレの敵に相応しいぞ！	
GAMEPLAY_EMOTE_ICC_834_WOW	見事な！	
VO_AnnoyO_Male_Mech_Attack_01	ハロー！	
VO_AnnoyO_Male_Mech_Concede_02	ハロー…	
VO_AnnoyO_Male_Mech_Death_01	ハ…ロォー…	
VO_AnnoyO_Male_Mech_ERROR_FULL_MINIONS_01	ハロー！	
VO_AnnoyO_Male_Mech_ERROR_GENERIC_04	ハロー。	
VO_AnnoyO_Male_Mech_ERROR_HAND_FULL_02	アー！ハロー！！	
VO_AnnoyO_Male_Mech_ERROR_I_ATTACKED_02	ハ、ハロー！	
VO_AnnoyO_Male_Mech_ERROR_MINION_ATTACKED_01	ハロー！ハロー。	
VO_AnnoyO_Male_Mech_ERROR_NEED_MANA_01	ハロー！ハロー。	
VO_AnnoyO_Male_Mech_ERROR_NEED_WEAPON_01	ハロー。	
VO_AnnoyO_Male_Mech_ERROR_PLAY_01	ハロー！	
VO_AnnoyO_Male_Mech_ERROR_STEALTH_01	ハロォォォォォ…	
VO_AnnoyO_Male_Mech_ERROR_SUMMON_SICKNESS_01	ハロー？ハロー！ハロー。	
VO_AnnoyO_Male_Mech_ERROR_TARGET_01	ハロー。	
VO_AnnoyO_Male_Mech_ERROR_TAUNT_01	ハロー！	
VO_AnnoyO_Male_Mech_FIRE_FESTIVAL_01	ハロー？ハロー！ハロー！	
VO_AnnoyO_Male_Mech_GG_01	ハロー！	
VO_AnnoyO_Male_Mech_Greetings_03	ハロー！ハロー！ハロー！	
VO_AnnoyO_Male_Mech_HAPPY_HALLOWEEN_01	ハロウ！ハロウ！ハロウ！	
VO_AnnoyO_Male_Mech_HAPPY_HOLIDAYS_01	ハロォ、ォォ！	
VO_AnnoyO_Male_Mech_HAPPY_NEW_YEAR_01	ハロー！ハロー！ハロォォォ！	
VO_AnnoyO_Male_Mech_HAPPY_NEW_YEAR_LUNAR_01	ハロー！ハロー！ハロォォォ！	
VO_AnnoyO_Male_Mech_HAPPY_NOBLEGARDEN_01	ハァロォォォ！	
VO_AnnoyO_Male_Mech_LowCards_01	ハロー？！	
VO_AnnoyO_Male_Mech_MIRROR_GREETINGS_02	ハロー！ハロー！ハロー！	
VO_AnnoyO_Male_Mech_MIRROR_START_01	ハロー？ハロー。ハロォォォ！	
VO_AnnoyO_Male_Mech_NoCards_01	ハァロォォォ！	
VO_AnnoyO_Male_Mech_Oops_01	ハロォォォー。	
VO_AnnoyO_Male_Mech_Picked_01	ハロー。ハロー！ハロー！	
VO_AnnoyO_Male_Mech_PIRATE_DAY_02	アホイ！アホイ！アホイ！	
VO_AnnoyO_Male_Mech_Sorry_01	ハロー…	
VO_AnnoyO_Male_Mech_Start_01	ハロー！ハロー！ハロー！	
VO_AnnoyO_Male_Mech_Thanks_01	ハロー！	
VO_AnnoyO_Male_Mech_Thinking_02	ハロー？ハロォォォー！	
VO_AnnoyO_Male_Mech_Thinking_03	ハ…ロォー？	
VO_AnnoyO_Male_Mech_Thinking_07	ハロー。ハロー。ハロー？	
VO_AnnoyO_Male_Mech_Threaten_01	ハロー！	
VO_AnnoyO_Male_Mech_Time_01	ハロー。ハロー！ハロォォォ！	
VO_AnnoyO_Male_Mech_Well_Played_01	ハロォォォー！	
VO_AnnoyO_Male_Mech_WOW_01	ハロォォォ！	
VO_Arthas_Male_Human_Attack_01	邪悪は浄化する！	
VO_Arthas_Male_Human_CONCEDE_01	この一戦、お前の勝ちだ。	
VO_Arthas_Male_Human_ERROR_FULL_MINIONS_01	ミニオンが多過ぎる！	
VO_Arthas_Male_Human_ERROR_GENERIC_01	それは無理だ。	
VO_Arthas_Male_Human_ERROR_HAND_FULL_01	手札が多過ぎる！	
VO_Arthas_Male_Human_ERROR_I_ATTACKED_01	私はもう攻撃したぞ。	
VO_Arthas_Male_Human_ERROR_JUST_PLAYED_01	そのミニオンが動けるのは次のターンからだ。	
VO_Arthas_Male_Human_ERROR_MINION_ATTACKED_01	そのミニオンはもう攻撃済みだ。	
VO_Arthas_Male_Human_ERROR_NEED_MANA_01	マナが足りないな。	
VO_Arthas_Male_Human_ERROR_NEED_WEAPON_01	武器が必要だ。	
VO_Arthas_Male_Human_ERROR_PLAY_01	今そのカードは使えないな。	
VO_Arthas_Male_Human_ERROR_STEALTH_01	隠れ身しているミニオンは攻撃できないな。	
VO_Arthas_Male_Human_ERROR_TARGET_01	それは対象にできないぞ。	
VO_Arthas_Male_Human_ERROR_TAUNT_01	「挑発」を持つミニオンが邪魔だ。	
VO_Arthas_Male_Human_FIRE_FESTIVAL_01	篝火を焚くのだ！	
VO_Arthas_Male_Human_GREETINGS_01	挨拶つかまつる。	
VO_Arthas_Male_Human_GREETINGS_RESPONSE	こちらこそ、挨拶つかまつる。	
VO_Arthas_Male_Human_HAPPY_HALLOWEEN_01	ハロウェンドを祝うぞ！	
VO_Arthas_Male_Human_HAPPY_HOLIDAYS_01	冬至祭を祝うぞ！	
VO_Arthas_Male_Human_HAPPY_NEW_YEAR_01	新年を祝うぞ！	
VO_Arthas_Male_Human_HAPPY_NEW_YEAR_LUNAR_01	旧正月を祝うぞ！	
VO_Arthas_Male_Human_HAPPY_NOBLEGARDEN	ノーブルガーデンを祝うぞ。	
VO_Arthas_Male_Human_LOW_CARDS_01	カードが残り少ない。	
VO_Arthas_Male_Human_MIRROR_GREETINGS_01	こちらこそ、挨拶つかまつる。	
VO_Arthas_Male_Human_MIRROR_START_01	国王たる父の名にかけて！	
VO_Arthas_Male_Human_NO_CARDS_01	もうカードが無い！	
VO_Arthas_Male_Human_OOPS_01	しくじったな。	
VO_Arthas_Male_Human_PIRATE_DAY_01	私はアァァァサスだ！	
VO_Arthas_Male_Human_SORRY_01	陳謝する、友よ。	
VO_Arthas_Male_Human_START_01	ローデロンに勝利を！	
VO_Arthas_Male_Human_THANKS_01	心遣い、痛み入る。	
VO_Arthas_Male_Human_THINK1_01	うぅむ…	
VO_Arthas_Male_Human_THINK2_01	どの道を行くか…	
VO_Arthas_Male_Human_THINK3_01	ウーサーならどうする…	
VO_Arthas_Male_Human_THREATEN_01	お前は救いようがないな！	
VO_Arthas_Male_Human_TIMER_01	今すぐ動かなければ！	
VO_Arthas_Male_Human_WELL_PLAYED_01	見事だ。	
VO_Arthas_Male_Human_WOW_01	これは仰天だな！	
VO_BOT_238_Male_Goblin_Concede_01	これまでか。自爆ッッ！	
VO_BOT_238_Male_Goblin_Greetings_02	ボカンと一発、行ってみようか！	
VO_BOT_238_Male_Goblin_HAPPY_HALLOWEEN_01	ブー！ハハハハ！ハッピー・ハロウェンド。 	
VO_BOT_238_Male_Goblin_LowCards_01	カードがもうすぐなくなるぞ…	
VO_BOT_238_Male_Goblin_NoCards_01	終わった！カード切れだ！	
VO_BOT_238_Male_Goblin_Oops_01	うむ、実験に失敗はつきものだ。	
VO_BOT_238_Male_Goblin_Thanks_01	ありがとう！君は最後に滅ぼそう。	
VO_BOT_238_Male_Goblin_Thinking_01	そう来るなら…	
VO_BOT_238_Male_Goblin_Thinking_02	計画を立てるなら今か…	
VO_BOT_238_Male_Goblin_Thinking_03	ふむむむ…	
VO_BOT_238_Male_Goblin_Threaten_01	ボタンを押させたいのか！	
VO_BOT_238_Male_Goblin_Time_03	おっ、いい導火線だな。	
VO_BOT_238_Male_Goblin_Well_Played_02	君ィ、やるじゃないか。	
VO_BOT_238_Male_Goblin_WOW_01	やるなァ！	
VO_BRM_027h__LUNAR_NEW_YEAR	見よ！初日は赤く燃えている！	
VO_BRM_027h_Attack_15	サルファロンの炎を味わえぇい！	
VO_BRM_027h_Concede_11	貴様の勝ちだ！楽しめたぞ！	
VO_BRM_027h_Emote_Start	恨みはらさでおくべきか、ドラゴンめ！	
VO_BRM_027h_ERROR01_51	武器がいるぞ。	
VO_BRM_027h_ERROR02_52	マナが足りんぞ。	
VO_BRM_027h_ERROR03_53	そいつは既に攻撃しておる。	
VO_BRM_027h_ERROR04_54	我は既に攻撃しておる。	
VO_BRM_027h_ERROR05_55	下等生物は次のターンにならねば動けんのだ。	
VO_BRM_027h_ERROR06_56	カードが多過ぎるぞ。	
VO_BRM_027h_ERROR07_57	ミニオンが多過ぎるな。	
VO_BRM_027h_ERROR08_58	ふん、隠れた虫ケラは狙えんな。	
VO_BRM_027h_ERROR09_59	今そのカードは使えんな。	
VO_BRM_027h_ERROR10_60	そいつには使えん。	
VO_BRM_027h_ERROR11_61	あの挑発しておるミニオンが邪魔だ。	
VO_BRM_027h_ERROR12_62	それはできんな。	
VO_BRM_027h_FIRE_FESTIVAL	フハハ！皆が我を讃えておるわ！	
VO_BRM_027h_GG_16	楽しめたぞ！	
VO_BRM_027h_Greetings_04	炎に浄められよ！	
VO_BRM_027h_GREETINGS_RESPONSE	汚らわしい。消えろ、消えろ、消え失せろ！	
VO_BRM_027h_HALLOWS_END	ハッピー・ハロウェンド！	
VO_BRM_027h_HAPPY_NEW_YEAR_38	見よ！初日は赤く燃えている！	
VO_BRM_027h_LowCards_49	ぬぅ、我がデッキが燃え尽きる。	
VO_BRM_027h_NOBLEGARDEN	卵焼きか、それとも目玉焼きか？	
VO_BRM_027h_NoCards_50	我がデッキが燃え尽きたか。	
VO_BRM_027h_Oops_07	ぐぁっ！しくじった！	
VO_BRM_027h_PIRATE_DAY	野郎ども！奪え！燃やせ！ファイヤアアア！	
VO_BRM_027h_Sorry_10	悪く思うな。	
VO_BRM_027h_Thanks_09	熱い感謝を。	
VO_BRM_027h_Thinking1_12	ふむ…	
VO_BRM_027h_Thinking2_13	さーて…	
VO_BRM_027h_Thinking3_14	どいつから燃やすか…	
VO_BRM_027h_Threaten_08	炎に飲まれてくたばるがいい！	
VO_BRM_027h_Time_48	我の尻に火がついておるとは！	
VO_BRM_027h_Well_Played_06	フンッ！見事だ。	
VO_BRM_027h_Winterveil_Greetings	いいものだな、クリスマスキャンドルの灯火は！	
VO_BRM_027h_WOW_20	アツイな。	
VO_EX1_323h_HAPPY_NEW_YEAR_13	最後の新年おめでとう！	
VO_GIL_504_Female_Orc_Concede_01	お前の勝ちだ。今回はね。	
VO_GIL_504_Female_Orc_Greetings_02	儂の縄張りへようこそいらっしゃい。	
VO_GIL_504_Female_Orc_GREETINGS_RESPONSE	では始めようねェ、お前と儂とで。	
VO_GIL_504_Female_Orc_LowCards_01	カードが残り少ないねェ！	
VO_GIL_504_Female_Orc_NoCards_01	カードが尽きたか！	
VO_GIL_504_Female_Orc_Oops_01	愚か者め。	
VO_GIL_504_Female_Orc_Start_01	夜の森は危険がいっぱいなんだよ。	
VO_GIL_504_Female_Orc_Thanks_01	感謝するよ。	
VO_GIL_504_Female_Orc_Thinking_01	ふぅむ…	
VO_GIL_504_Female_Orc_Thinking_02	厄介だねェ…	
VO_GIL_504_Female_Orc_Thinking_03	薄暗い道だねェ…	
VO_GIL_504_Female_Orc_Threaten_02	呪いがお前を貪りつくすよ！	
VO_GIL_504_Female_Orc_Time_01	決断しなければ！	
VO_GIL_504_Female_Orc_Well_Played_01	なんて見事なんだろう。	
VO_GIL_504_Female_Orc_Wow_01	夜の名において！	
VO_GILA_400h_Male_Human_Concede_01	おめぇにゃ敵うわけねぇや！	
VO_GILA_400h_Male_Human_Death_02	あ、ああー	
VO_GILA_400h_Male_Human_ERROR_FULL_MINIONS_01	もうぎゅうぎゅう詰めでいっぱいだぜ。	
VO_GILA_400h_Male_Human_ERROR_GENERIC_01	できねぇな。	
VO_GILA_400h_Male_Human_ERROR_GENERIC_04	できねぇ相談だぜ。	
VO_GILA_400h_Male_Human_ERROR_HAND_FULL_01	カードが多すぎなんだよ！	
VO_GILA_400h_Male_Human_ERROR_I_ATTACKED_01	オレぁもう攻撃したぜ。	
VO_GILA_400h_Male_Human_ERROR_MINION_ATTACKED_01	そいつぁもう攻撃したぜ。	
VO_GILA_400h_Male_Human_ERROR_NEED_MANA_02	マナが足りねぇぞ！	
VO_GILA_400h_Male_Human_ERROR_NEED_WEAPON_02	武器が必要なんだ！	
VO_GILA_400h_Male_Human_ERROR_STEALTH_01	こそこそ隠れやがって！	
VO_GILA_400h_Male_Human_ERROR_SUMMON_SICKNESS_01	そいつぁまだ動けねぇよ。	
VO_GILA_400h_Male_Human_ERROR_TARGET_01	そいつぁ狙えねぇ。	
VO_GILA_400h_Male_Human_ERROR_TAUNT_01	挑発してるミニオンが邪魔だな。	
VO_GILA_400h_Male_Human_Greetings_01	オレはおめぇがキライだ。オレの犬どもも、おめえを嫌ってる。	
VO_GILA_400h_Male_Human_GREETINGS_RESPONSE	誰もが俺を嫌ってる。	
VO_GILA_400h_Male_Human_LowCards_01	もうカードが無ぇぞ…	
VO_GILA_400h_Male_Human_NoCards_01	カードが無くなっちまった！	
VO_GILA_400h_Male_Human_Oops_01	おいこいつぁひでぇな。	
VO_GILA_400h_Male_Human_Sorry_01	すまなかったな。	
VO_GILA_400h_Male_Human_Start_01	おい犬ども、何を掘り当てやがった？	
VO_GILA_400h_Male_Human_Thanks_01	ありがとよ。	
VO_GILA_400h_Male_Human_Thinking_01	ふむむ…	
VO_GILA_400h_Male_Human_Thinking_03	どうしたもんだろうな…	
VO_GILA_400h_Male_Human_Thinking_04	なあどうする、おい…	
VO_GILA_400h_Male_Human_Threaten_04	死んだふりでもしてるんだな。	
VO_GILA_400h_Male_Human_Time_01	もう時間がねぇぞ。	
VO_GILA_400h_Male_Human_Well_Played_01	見事なもんだな！	
VO_GILA_400h_Male_Human_WOW_01	ワンダフルだぜ！	
VO_GILA_500h3_Female_Human_Concede_01	私には勝ち目がないわ！	
VO_GILA_500h3_Female_Human_ERROR_FULL_MINIONS_01	場所が足りないわ。	
VO_GILA_500h3_Female_Human_ERROR_GENERIC_04	それは許されない！	
VO_GILA_500h3_Female_Human_ERROR_HAND_FULL_02	手札が多過ぎるわ！	
VO_GILA_500h3_Female_Human_ERROR_I_ATTACKED_02	二回も攻撃できない！	
VO_GILA_500h3_Female_Human_ERROR_MINION_ATTACKED_01	それはもう攻撃したわ。	
VO_GILA_500h3_Female_Human_ERROR_NEED_MANA_02	マナが足りないわね。	
VO_GILA_500h3_Female_Human_ERROR_NEED_WEAPON_02	武器が必要になるわね。	
VO_GILA_500h3_Female_Human_ERROR_PLAY_01	ルールを曲げることはできないわ。	
VO_GILA_500h3_Female_Human_ERROR_STEALTH_01	目視できないわ！	
VO_GILA_500h3_Female_Human_ERROR_SUMMON_SICKNESS_01	ミニオンはまだ動けない。	
VO_GILA_500h3_Female_Human_ERROR_TARGET_01	標的にできないわね。	
VO_GILA_500h3_Female_Human_ERROR_TAUNT_01	「挑発」を持つミニオンに邪魔されてる！	
VO_GILA_500h3_Female_Human_Greetings_01	無冠の党からの挨拶です。	
VO_GILA_500h3_Female_Human_GREETINGS_RESPONSE	ご親切にどうも。	
VO_GILA_500h3_Female_Human_LowCards_01	カードが残り少ないわ…	
VO_GILA_500h3_Female_Human_NoCards_01	カードが無くなった！	
VO_GILA_500h3_Female_Human_Oops_02	今のは…うかつだったわ。	
VO_GILA_500h3_Female_Human_Sorry_01	ごめんなさい。	
VO_GILA_500h3_Female_Human_Start_01	足跡を追ってきたわ。	
VO_GILA_500h3_Female_Human_Thanks_01	感謝するわ。	
VO_GILA_500h3_Female_Human_Thinking_02	何か手があるはずだわ…	
VO_GILA_500h3_Female_Human_Thinking_03	考えるのよテス。考えて…	
VO_GILA_500h3_Female_Human_Thinking_05	ああ…う～ん。	
VO_GILA_500h3_Female_Human_Threaten_03	あなたを打ちのめしてみせる！	
VO_GILA_500h3_Female_Human_Time_01	急いで行動しないと。	
VO_GILA_500h3_Female_Human_Well_Played_01	見事な戦術だわ。 	
VO_GILA_500h3_Female_Human_WOW_01	本当に素敵だわ。	
VO_GILA_600h_Male_Worgen_Concede_01	君が一枚上手だった！	
VO_GILA_600h_Male_Worgen_ERROR_FULL_MINIONS_02	こっちの陣地にミニオンが多すぎるな。	
VO_GILA_600h_Male_Worgen_ERROR_GENERIC_01	それは不可能だ。	
VO_GILA_600h_Male_Worgen_ERROR_GENERIC_02	それはできない。	
VO_GILA_600h_Male_Worgen_ERROR_HAND_FULL_01	カードが多過ぎるぞ！	
VO_GILA_600h_Male_Worgen_ERROR_I_ATTACKED_01	私はもう攻撃済みだ。	
VO_GILA_600h_Male_Worgen_ERROR_MINION_ATTACKED_01	そのミニオンはもう攻撃済みだ。	
VO_GILA_600h_Male_Worgen_ERROR_NEED_MANA_01	マナがないんだ。 	
VO_GILA_600h_Male_Worgen_ERROR_NEED_WEAPON_02	武器が必要だ。	
VO_GILA_600h_Male_Worgen_ERROR_STEALTH_01	あのミニオンは目視できないぞ！	
VO_GILA_600h_Male_Worgen_ERROR_SUMMON_SICKNESS_01	まだ出撃準備が整ってない。	
VO_GILA_600h_Male_Worgen_ERROR_TARGET_01	そいつは的にできない。	
VO_GILA_600h_Male_Worgen_ERROR_TAUNT_01	「挑発」ミニオンが邪魔をしている！	
VO_GILA_600h_Male_Worgen_Greetings_01	私の相棒は凶暴なもんでね。	
VO_GILA_600h_Male_Worgen_GREETINGS_RESPONSE	なるほど、いい面構えだ。	
VO_GILA_600h_Male_Worgen_LowCards_01	カードがもう残り少ない。	
VO_GILA_600h_Male_Worgen_NoCards_01	カードが尽きてしまった！	
VO_GILA_600h_Male_Worgen_Oops_01	そいつは手違いだ！	
VO_GILA_600h_Male_Worgen_Sorry_01	ああ…失敬。	
VO_GILA_600h_Male_Worgen_Start_01	配置に着いたぞ。	
VO_GILA_600h_Male_Worgen_Thanks_01	感謝する。	
VO_GILA_600h_Male_Worgen_Thinking_01	うーん…	
VO_GILA_600h_Male_Worgen_Thinking_02	こちらの次の手と言えば…	
VO_GILA_600h_Male_Worgen_Thinking_04	必ず手はあるはずだ…	
VO_GILA_600h_Male_Worgen_Threaten_01	バラバラに吹っ飛ばしてくれるぞ！	
VO_GILA_600h_Male_Worgen_Time_01	急かすんじゃない！	
VO_GILA_600h_Male_Worgen_Well_Played_01	素晴らしい用兵だな。	
VO_GILA_600h_Male_Worgen_WOW_01	そんな信じられない！	
VO_GILA_900h_Female_Gnome_Concede_01	手は尽くしたわ。あんたの勝ち！	
VO_GILA_900h_Female_Gnome_ERROR_FULL_MINIONS_02	これ以上のミニオンは無理よ。	
VO_GILA_900h_Female_Gnome_ERROR_GENERIC_01	それは無理よ。	
VO_GILA_900h_Female_Gnome_ERROR_HAND_FULL_01	カードが多すぎるわ！	
VO_GILA_900h_Female_Gnome_ERROR_I_ATTACKED_02	次の攻撃はまだよ！	
VO_GILA_900h_Female_Gnome_ERROR_MINION_ATTACKED_01	ミニオンは攻撃済み。	
VO_GILA_900h_Female_Gnome_ERROR_NEED_MANA_01	マナが足りないわ。	
VO_GILA_900h_Female_Gnome_ERROR_NEED_WEAPON_01	武器がないわよ。	
VO_GILA_900h_Female_Gnome_ERROR_PLAY_01	流石のあたしでも無理よ。 	
VO_GILA_900h_Female_Gnome_ERROR_STEALTH_01	ターゲットは隠れてる。	
VO_GILA_900h_Female_Gnome_ERROR_SUMMON_SICKNESS_01	そのミニオンはまだ動けないわ。	
VO_GILA_900h_Female_Gnome_ERROR_TARGET_01	対象にできないわ。	
VO_GILA_900h_Female_Gnome_ERROR_TAUNT_01	「挑発」を持つミニオンが邪魔ね！	
VO_GILA_900h_Female_Gnome_GG_01	ホントいい勝負だったわ！	
VO_GILA_900h_Female_Gnome_Greetings_01	あらまあ、またあんたね。	
VO_GILA_900h_Female_Gnome_GREETINGS_RESPONSE	うわ、あたしが時間線をメチャクチャにしちゃったの？	
VO_GILA_900h_Female_Gnome_LowCards_01	残りカードが少ない…	
VO_GILA_900h_Female_Gnome_NoCards_01	カードがもう無い！	
VO_GILA_900h_Female_Gnome_Oops_02	今のは失敗だったと思うわ。	
VO_GILA_900h_Female_Gnome_Sorry_01	あー、ゴメン？	
VO_GILA_900h_Female_Gnome_Start_01	さあ時間切れよ！	
VO_GILA_900h_Female_Gnome_Thanks_01	ありがと。	
VO_GILA_900h_Female_Gnome_Thinking_02	ふ～む…	
VO_GILA_900h_Female_Gnome_Thinking_03	…4次元的に考えなきゃダメね。	
VO_GILA_900h_Female_Gnome_Thinking_05	…歯車は回り続けてる…	
VO_GILA_900h_Female_Gnome_Threaten_01	あんたを時間線から消してやるわ！	
VO_GILA_900h_Female_Gnome_Time_01	このあたしが時間切れなんてあり得ない！	
VO_GILA_900h_Female_Gnome_Well_Played_01	文句なしの結果ね！	
VO_GILA_900h_Female_Gnome_WOW_02	信じられない！	
VO_HERO_01_HAPPY_NEW_YEAR_06	明けまして、おめでとう！	
VO_HERO_02_HAPPY_NEW_YEAR_07	新年おめでとう、友よ！	
VO_HERO_02b_Male_Troll_Concede_01	見事やっさー。してやられたさー！	
VO_HERO_02b_Male_Troll_ERROR_FULL_MINIONS_02	ミニオンが多過ぎる。	
VO_HERO_02b_Male_Troll_ERROR_GENERIC_02	そう、うまくはいかんさー。	
VO_HERO_02b_Male_Troll_ERROR_HAND_FULL_01	手札いっぱい！	
VO_HERO_02b_Male_Troll_ERROR_I_ATTACKED_02	もう攻撃したさー。	
VO_HERO_02b_Male_Troll_ERROR_MINION_ATTACKED_01	そいつは攻撃済みさー。	
VO_HERO_02b_Male_Troll_ERROR_NEED_MANA_01	マナがいる！	
VO_HERO_02b_Male_Troll_ERROR_NEED_WEAPON_01	武器がいる！	
VO_HERO_02b_Male_Troll_ERROR_PLAY_01	それはできん。	
VO_HERO_02b_Male_Troll_ERROR_STEALTH_01	隠れてるんさー。	
VO_HERO_02b_Male_Troll_ERROR_SUMMON_SICKNESS_01	そいつには時間が必要さー。	
VO_HERO_02b_Male_Troll_ERROR_TARGET_01	的が必要さー。	
VO_HERO_02b_Male_Troll_ERROR_TAUNT_02	「挑発」ミニオンを攻撃せんと。	
VO_HERO_02b_Male_Troll_FIRE_FESTIVAL_01	炎の祭りだばーよ！	
VO_HERO_02b_Male_Troll_Greetings_01	ようこそー。控えるがいいさー。	
VO_HERO_02b_Male_Troll_HAPPY_HALLOWEEN_01	ハッハッハッハ。ハロウェンドさー！	
VO_HERO_02b_Male_Troll_HAPPY_HOLIDAYS_01	幸多き祝日を。	
VO_HERO_02b_Male_Troll_HAPPY_NEW_YEAR_01	実り豊かな一年を願うさー。	
VO_HERO_02b_Male_Troll_HAPPY_NEW_YEAR_LUNAR_01	実り豊かな一年を願うさー。	
VO_HERO_02b_Male_Troll_HAPPY_NOBLEGARDEN_01	いい加減しれー。我の帽子に、タマゴは無いさー！	
VO_HERO_02b_Male_Troll_LowCards_01	カードが無くなる！	
VO_HERO_02b_Male_Troll_MIRROR_GREETINGS_01	上等な影武者さー。	
VO_HERO_02b_Male_Troll_MIRROR_START_01	どっちかが屈するさー。	
VO_HERO_02b_Male_Troll_NoCards_01	カードが無ぇ！	
VO_HERO_02b_Male_Troll_Oops_02	こんなこともあるさ。	
VO_HERO_02b_Male_Troll_Picked_01	王とはいいものさー。	
VO_HERO_02b_Male_Troll_PIRATE_DAY_01	王が許せば\nそれは「私掠」ねー。	
VO_HERO_02b_Male_Troll_Sorry_01	失敬。	
VO_HERO_02b_Male_Troll_Start_02	ラスタカン王の御前どー！	
VO_HERO_02b_Male_Troll_Thanks_01	ありがたい。	
VO_HERO_02b_Male_Troll_Thinking_05	ああ…ふ～む…	
VO_HERO_02b_Male_Troll_Thinking_11	我の栄光のため…	
VO_HERO_02b_Male_Troll_Thinking_15	ロアよ、助言を…	
VO_HERO_02b_Male_Troll_Threaten_04	震えあがれ！	
VO_HERO_02b_Male_Troll_Time_01	王を急かさんけー！	
VO_HERO_02b_Male_Troll_Well_Played_01	お見事さー。	
VO_HERO_02b_Male_Troll_WOW_01	本当かー？	
VO_HERO_03_HAPPY_NEW_YEAR_06	新年、おめでとう！	
VO_HERO_03a_Attack_15	正義は「我」にあり！	
VO_HERO_03a_CONCEDE_06	打つ手なし。私の負けだ。	
VO_HERO_03a_ERROR_FULL_MINIONS_25	ミニオンが多過ぎるぞ！	
VO_HERO_03a_ERROR_GENERIC_30	それは無理だ。	
VO_HERO_03a_ERROR_HAND_FULL_24	手札が多過ぎる！	
VO_HERO_03a_ERROR_I_ATTACKED_22	もう攻撃したぞ。	
VO_HERO_03a_ERROR_JUST_PLAYED_23	そのミニオンが動けるのは次のターン。	
VO_HERO_03a_ERROR_MINION_ATTACKED_21	そのミニオンは攻撃済みだ。	
VO_HERO_03a_ERROR_NEED_MANA_20	マナが足りないぞ。	
VO_HERO_03a_ERROR_NEED_WEAPON_19	武器がいるな。	
VO_HERO_03a_ERROR_PLAY_27	その手は使えない。	
VO_HERO_03a_ERROR_STEALTH_26	「隠れ身」しているミニオンは狙えない。	
VO_HERO_03a_ERROR_TARGET_28	そいつは狙えないぞ。	
VO_HERO_03a_ERROR_TAUNT_29	「挑発」を持つミニオンが邪魔だ。	
VO_HERO_03a_FIRE_FESTIVAL	真夏の祭りを祝おう！	
VO_HERO_03a_GREETINGS_03	友よ、幸運を。	
VO_HERO_03a_GREETINGS_RESPONSE	これは驚きね。ごきげんよう！	
VO_HERO_03a_HALLOWS_END	ハッピー・ハロウェンド！	
VO_HERO_03a_HAPPY_HOLIDAYS_52	冬至祭を祝おう！	
VO_HERO_03a_HAPPY_NEW_YEAR_53	新年おめでとう！	
VO_HERO_03a_HAPPY_NEW_YEAR_LUNAR_16	新年おめでとう！	
VO_HERO_03a_LOW_CARDS_17	カードが残り少ない！	
VO_HERO_03a_MIRROR_GREETINGS_04	これは驚きね。ごきげんよう！	
VO_HERO_03a_MIRROR_START_02	私は鉄の正義の手！	
VO_HERO_03a_NO_CARDS_18	もうカードが無いッ！	
VO_HERO_03a_NOBLEGARDEN	ハッピー・ノーブルガーデン！卵はどこ？	
VO_HERO_03a_OOPS_08	戦術ミスか。	
VO_HERO_03a_PICKED_11	時は来た！	
VO_HERO_03a_PIRATE_DAY	ヤアァァァ、兄弟！	
VO_HERO_03a_SORRY_10	失敬。	
VO_HERO_03a_START_01	私の怒りからは逃れられない！	
VO_HERO_03a_THANKS_09	感謝する。	
VO_HERO_03a_THINK1_12	うぬぅ…	
VO_HERO_03a_THINK2_13	どうするか…	
VO_HERO_03a_THINK3_14	考えろ…	
VO_HERO_03a_THREATEN_05	お前は私を怒らせたッ！	
VO_HERO_03a_TIMER_16	早く！	
VO_HERO_03a_WELL_PLAYED_07	見事だ。	
VO_HERO_03a_WOW_35	すごい！	
VO_HERO_04_HAPPY_NEW_YEAR_15	勇者よ、新年を祝いましょうぞ！	
VO_HERO_05_HAPPY_NEW_YEAR_15	新年の祝いを！	
VO_HERO_06_HAPPY_NEW_YEAR_15	新年の祝いを！	
VO_HERO_07_HAPPY_NEW_YEAR_15	新年の祝いを！	
VO_HERO_08_HAPPY_NEW_YEAR_15	明けまして、おめでとう！	
VO_HERO_08b_HAPPY_NEW_YEAR_53	新年おめでとう！	
VO_HERO_09_HAPPY_NEW_YEAR_15	明けましておめでとうございます！	
VO_HERO_09a_Attack_15	エルーンに捧ぐ！	
VO_HERO_09a_CONCEDE_06	終わりですね。貴方の勝ちです。	
VO_HERO_09a_ERROR_FULL_MINIONS_25	ミニオンが多過ぎます。	
VO_HERO_09a_ERROR_GENERIC_30	それはできません。	
VO_HERO_09a_ERROR_HAND_FULL_24	手札が多過ぎます！	
VO_HERO_09a_ERROR_I_ATTACKED_22	もう攻撃しています。	
VO_HERO_09a_ERROR_JUST_PLAYED_23	そのミニオンは次のターンから。	
VO_HERO_09a_ERROR_MINION_ATTACKED_21	そのミニオンは攻撃済み。	
VO_HERO_09a_ERROR_NEED_MANA_20	マナが足りませんね。	
VO_HERO_09a_ERROR_NEED_WEAPON_19	武器が要ります。	
VO_HERO_09a_ERROR_PLAY_27	その手は打てません。	
VO_HERO_09a_ERROR_STEALTH_26	隠れ身しているミニオンは攻められない。	
VO_HERO_09a_ERROR_TARGET_28	それは対象にできません。	
VO_HERO_09a_ERROR_TAUNT_29	「挑発」を持つミニオンが邪魔ね。	
VO_HERO_09a_FIRE_FESTIVAL	真夏の祭りを祝いましょう。	
VO_HERO_09a_GREETINGS_03	貴方に祝福を。	
VO_HERO_09a_GREETINGS_RESPONSE	貴方にも。	
VO_HERO_09a_HALLOWS_END	ハッピー・ハロウェンド！	
VO_HERO_09a_HAPPY_HOLIDAYS_52	冬至祭を祝いましょう！	
VO_HERO_09a_HAPPY_NEW_YEAR_01	新年を祝いましょう！	
VO_HERO_09a_HAPPY_NEW_YEAR_LUNAR_53	新年を祝いましょう！	
VO_HERO_09a_LOW_CARDS_17	カードが無くなります！	
VO_HERO_09a_MIRROR_GREETINGS_04	貴方にも。	
VO_HERO_09a_MIRROR_START_02	我が女神は私の盾に。	
VO_HERO_09a_NO_CARDS_18	カードが無くなった！	
VO_HERO_09a_NOBLEGARDEN	ハッピー・ノーブルガーデン。	
VO_HERO_09a_OOPS_08	しくじった。	
VO_HERO_09a_PICKED_11	我が女神のお召しね！	
VO_HERO_09a_PIRATE_DAY	真言・ヤァァ！	
VO_HERO_09a_SORRY_10	失礼を。	
VO_HERO_09a_START_01	エルーンが力を与え給う。	
VO_HERO_09a_START_MALFURION	我が愛しのマルフュリオン。	
VO_HERO_09a_THANKS_09	感謝。	
VO_HERO_09a_THINK1_12	うぅん…	
VO_HERO_09a_THINK2_13	どうかしら…	
VO_HERO_09a_THINK3_14	エルーンのお望みは、何？	
VO_HERO_09a_THREATEN_05	貴方は後悔しますよ！	
VO_HERO_09a_TIMER_16	急ぎましょう！	
VO_HERO_09a_WELL_PLAYED_07	お見事です。	
VO_HERO_09a_WOW_10	なんて素晴らしい！	
VO_HERO_09b_Female_Troll_Concede_01	あんたが勝つ運命だったのさ。	
VO_HERO_09b_Female_Troll_ERROR_FULL_MINIONS_02	陣地は満員だよ！	
VO_HERO_09b_Female_Troll_ERROR_GENERIC_02	それは無理だね。	
VO_HERO_09b_Female_Troll_ERROR_HAND_FULL_01	手札が多過ぎだ！	
VO_HERO_09b_Female_Troll_ERROR_I_ATTACKED_01	もう攻撃したよ。	
VO_HERO_09b_Female_Troll_ERROR_MINION_ATTACKED_01	そのミニオンは攻撃済みさ。	
VO_HERO_09b_Female_Troll_ERROR_NEED_MANA_02	マナが要るよ！	
VO_HERO_09b_Female_Troll_ERROR_NEED_WEAPON_01	武器が要るね。	
VO_HERO_09b_Female_Troll_ERROR_PLAY_01	それはできないよ。	
VO_HERO_09b_Female_Troll_ERROR_STEALTH_01	ああ、そいつは潜んでるね。	
VO_HERO_09b_Female_Troll_ERROR_SUMMON_SICKNESS_01	ああ、そいつは準備中さ。	
VO_HERO_09b_Female_Troll_ERROR_TARGET_01	的が必要さ。	
VO_HERO_09b_Female_Troll_ERROR_TAUNT_01	挑発してるあのミニオンが先だね。	
VO_HERO_09b_Female_Troll_FIRE_FESTIVAL_01	今宵は炎の祭りさ！	
VO_HERO_09b_Female_Troll_Greetings_01	よく来たね！占い、聞きたいかい？	
VO_HERO_09b_Female_Troll_HAPPY_HALLOWEEN_01	ああー、ハロウェンドだね！	
VO_HERO_09b_Female_Troll_HAPPY_HOLIDAYS_01	めでたい祝日だね。	
VO_HERO_09b_Female_Troll_HAPPY_NEW_YEAR_01	さぁ、新しい年が始まるよ…	
VO_HERO_09b_Female_Troll_HAPPY_NEW_YEAR_LUNAR_01	新しい年が始まるよ…	
VO_HERO_09b_Female_Troll_HAPPY_NOBLEGARDEN_01	ノーブルガーデンの祝いを！ 	
VO_HERO_09b_Female_Troll_LowCards_02	カードが残り少ないね。	
VO_HERO_09b_Female_Troll_MIRROR_GREETINGS_02	そう言うのは知ってたよ。	
VO_HERO_09b_Female_Troll_MIRROR_START_01	なら、終わりも知ってるだろう…	
VO_HERO_09b_Female_Troll_NoCards_02	カードがなくなったよ！	
VO_HERO_09b_Female_Troll_Oops_01	おっと、こいつはいい笑い話だ。	
VO_HERO_09b_Female_Troll_Picked_02	ひと騒動起こそうかね、んん？	
VO_HERO_09b_Female_Troll_PIRATE_DAY_01	ヨー、ホー、ホー！ 	
VO_HERO_09b_Female_Troll_Sorry_01	悪かったね。	
VO_HERO_09b_Female_Troll_Start_02	この出会いは占いに出てたよ…	
VO_HERO_09b_Female_Troll_Thanks_01	ありがとう。	
VO_HERO_09b_Female_Troll_Thinking_06	ふむむ…	
VO_HERO_09b_Female_Troll_Thinking_11	…ささやき…	
VO_HERO_09b_Female_Troll_Thinking_12	…どうしようか…？	
VO_HERO_09b_Female_Troll_Threaten_03	あんたは破滅するよ！	
VO_HERO_09b_Female_Troll_Time_02	終わりが近いよ！	
VO_HERO_09b_Female_Troll_Well_Played_01	これはお見事！	
VO_HERO_09b_Female_Troll_WOW_01	旧神の名にかけて！	
VO_HERO_11_HAPPY_NEW_YEAR_20	新年おめでとう！	
VO_HERO_12_HAPPY_NEW_YEAR_20	新年の慶びを！	
VO_HERO_13_HAPPY_NEW_YEAR_20	新年の祝福を！	
VO_HERO_14_HAPPY_NEW_YEAR_20	新年おめでとう！	
VO_HERO_15_HAPPY_NEW_YEAR_24	<新年の祝いを！>	
VO_HERO_16_Female_Dryad_Concede_01	毎回勝つのは無理。	
VO_HERO_16_Female_Dryad_ERROR_01	武器を持ってない。	
VO_HERO_16_Female_Dryad_ERROR_02	もっとマナがいる！	
VO_HERO_16_Female_Dryad_ERROR_03	そのミニオンはもう攻撃できない！	
VO_HERO_16_Female_Dryad_ERROR_04	もう攻撃した。	
VO_HERO_16_Female_Dryad_ERROR_05	そのミニオンは攻撃できない。	
VO_HERO_16_Female_Dryad_ERROR_06	手札があふれてるわ！	
VO_HERO_16_Female_Dryad_ERROR_07	ミニオンが多過ぎるわ！	
VO_HERO_16_Female_Dryad_ERROR_08	あの弱虫ミニオンは隠れてる。	
VO_HERO_16_Female_Dryad_ERROR_09	それはできない。	
VO_HERO_16_Female_Dryad_ERROR_10	それは無理よ。	
VO_HERO_16_Female_Dryad_ERROR_11	「挑発」を持つミニオンを攻撃しなきゃ！	
VO_HERO_16_Female_Dryad_ERROR_12	それは無理みたい。	
VO_HERO_16_Female_Dryad_FIRE_FESTIVAL_01	炎の祭りは大好き！	
VO_HERO_16_Female_Dryad_Greetings_01	あなたに自然の祝福を。	
VO_HERO_16_Female_Dryad_GREETINGS_RESPONSE	ええ、あなたにもね。	
VO_HERO_16_Female_Dryad_HAPPY_HALLOWEEN_01	ハッピー・ハロウェンド！	
VO_HERO_16_Female_Dryad_HAPPY_HOLIDAYS_01	冬至祭を祝いましょう！	
VO_HERO_16_Female_Dryad_HAPPY_NEW_YEAR_01	一緒に新年を祝いましょう！	
VO_HERO_16_Female_Dryad_HAPPY_NEW_YEAR_LUNAR_01	一緒に新年を祝いましょう！	
VO_HERO_16_Female_Dryad_HAPPY_NOBLEGARDEN_01	ハッピー・ノーブルガーデン！	
VO_HERO_16_Female_Dryad_LowCards_01	カードが無くなってしまう！	
VO_HERO_16_Female_Dryad_MALFURION_START_01	イシュヌ・アラー、大ドルイド。	
VO_HERO_16_Female_Dryad_MIRROR_GREETINGS_01	ええ、あなたにもね！	
VO_HERO_16_Female_Dryad_MIRROR_START_01	始原の大地のために！	
VO_HERO_16_Female_Dryad_NoCards_01	カードが無くなったわ！	
VO_HERO_16_Female_Dryad_Oops_02	計算違いって自然なことよね。	
VO_HERO_16_Female_Dryad_PIRATE_DAY_01	ヤァァ！アタシは海賊だ！	
VO_HERO_16_Female_Dryad_Sorry_01	あなたにお詫びしないと。	
VO_HERO_16_Female_Dryad_Start_01	森が仕返しするわ。	
VO_HERO_16_Female_Dryad_Thanks_01	ご尽力、感謝します。	
VO_HERO_16_Female_Dryad_Thinking_01	えぇと…	
VO_HERO_16_Female_Dryad_Thinking_02	これはどうかしら…	
VO_HERO_16_Female_Dryad_Thinking_03	こうしたら…	
VO_HERO_16_Female_Dryad_Threaten_01	大地の痛みを味わいなさい！	
VO_HERO_16_Female_Dryad_Time_01	もう時間がない。	
VO_HERO_16_Female_Dryad_Well_Played_01	お見事ね。	
VO_HERO_16_Female_Dryad_WOW_01	今のはワイルドね！	
VO_HERO_18_Female_Gnome_Concede_01	やるじゃん！今回はあんたの勝ちね。	
VO_HERO_18_Female_Gnome_ERROR_01	武器ないとダメじゃね？	
VO_HERO_18_Female_Gnome_ERROR_03	マナが足りない！	
VO_HERO_18_Female_Gnome_ERROR_04	そいつもう攻撃した！	
VO_HERO_18_Female_Gnome_ERROR_06	二回攻撃とかムリだから。	
VO_HERO_18_Female_Gnome_ERROR_07	シーッ、よく寝てるから起こさないで。	
VO_HERO_18_Female_Gnome_ERROR_08	うわっ、あたしのカード、多すぎ…？	
VO_HERO_18_Female_Gnome_ERROR_10	ミニオンは7体までだから、ね？	
VO_HERO_18_Female_Gnome_ERROR_12	そいつは隠れ身してるよ！	
VO_HERO_18_Female_Gnome_ERROR_14	それは無理。	
VO_HERO_18_Female_Gnome_ERROR_15	はぁ～、そいつは狙えないから。	
VO_HERO_18_Female_Gnome_ERROR_17	「挑発」持ちが邪魔！	
VO_HERO_18_Female_Gnome_ERROR_19	それはダメだってば！	
VO_HERO_18_Female_Gnome_FIRE_FESTIVAL_01	真夏の祭りの花火はサイコー！	
VO_HERO_18_Female_Gnome_Greetings_01	ヤッホー、元気ぃ！	
VO_HERO_18_Female_Gnome_GREETINGS_RESPONSE	うひゃひゃひゃ、ビョーキー！	
VO_HERO_18_Female_Gnome_HAPPY_HALLOWEEN_01	はっ？！ハロウェンド！うひゃひゃひゃ、こわーい！	
VO_HERO_18_Female_Gnome_HAPPY_HOLIDAYS_01	冬至祭おめー！	
VO_HERO_18_Female_Gnome_HAPPY_NEW_YEAR_01	正月おめー！	
VO_HERO_18_Female_Gnome_HAPPY_NEW_YEAR_LUNAR_16	新年おめでとう！	
VO_HERO_18_Female_Gnome_LowCards_01	やっべ、カードが無くなるわ！	
VO_HERO_18_Female_Gnome_MIRROR_START_01	イェーイ！こいつはすっごいことになる！	
VO_HERO_18_Female_Gnome_NOBLEGARDEN	ノーブルガーデン、サイコー！	
VO_HERO_18_Female_Gnome_NoCards_01	ゲッ！カードがもうない！	
VO_HERO_18_Female_Gnome_Oops_02	おお～っと！	
VO_HERO_18_Female_Gnome_PIRATE_DAY_01	ヤァァ！アタシは海賊だー！ヤアァァァ！	
VO_HERO_18_Female_Gnome_Sorry_01	あうう、ごめーん…	
VO_HERO_18_Female_Gnome_Start_01	面白おかしくやろうか！うひゃひゃひゃ！	
VO_HERO_18_Female_Gnome_Thanks_02	いや～ん、ありがと！	
VO_HERO_18_Female_Gnome_Thinking_01	む～ん…	
VO_HERO_18_Female_Gnome_Thinking_03	フンフンフフーン…	
VO_HERO_18_Female_Gnome_Thinking_04	これはどうだろ…	
VO_HERO_18_Female_Gnome_Threaten_01	キャワイイ操り人形にしてあげる。	
VO_HERO_18_Female_Gnome_Time_01	早くしなきゃ！	
VO_HERO_18_Female_Gnome_Well_Played_01	うおぅ、お見事！	
VO_HERO_18_Female_Gnome_WOW_01	今の、やるじゃん！	
VO_ICC08_LichKing_Male_Human_YoungArthas_02	ミラーマッチは嫌いだ。	
VO_INNKEEPER_Male_Dwarf_HERONAME_LAZUL_01	ラズール！	
VO_INNKEEPER_Male_Dwarf_HERONAME_LAZUL_02	ラズール！	
VO_INNKEEPER_Male_Dwarf_HERONAME_MECHAJAR_03	メカ・ジャラクサス！	
VO_INNKEEPER_Male_Dwarf_HERONAME_RASTAKHAN_01	ラスタカン！	
VO_INNKEEPER_Male_Dwarf_HERONAME_RASTAKHAN_02	ラスタカン！	
VO_MechaJar_Male_Demon_Concede_01	お前の勝ちだ…だが滅亡することは変わらん！	
VO_MechaJar_Male_Demon_ERROR_FULL_MINIONS_01	陣地が満員だ！	
VO_MechaJar_Male_Demon_ERROR_GENERIC_01	それはできん！	
VO_MechaJar_Male_Demon_ERROR_HAND_FULL_01	手札が多過ぎだ！	
VO_MechaJar_Male_Demon_ERROR_I_ATTACKED_01	我は既に攻撃した！	
VO_MechaJar_Male_Demon_ERROR_MINION_ATTACKED_01	そいつは既に攻撃した！	
VO_MechaJar_Male_Demon_ERROR_NEED_MANA_01	マナが足りん！	
VO_MechaJar_Male_Demon_ERROR_NEED_WEAPON_01	武器を持っておらん！	
VO_MechaJar_Male_Demon_ERROR_PLAY_01	今そのカードは使えん！	
VO_MechaJar_Male_Demon_ERROR_STEALTH_01	その惨めなミニオンは隠れておる！	
VO_MechaJar_Male_Demon_ERROR_SUMMON_SICKNESS_01	そのミニオンが動けるのは次のターンからだ！	
VO_MechaJar_Male_Demon_ERROR_TARGET_01	そいつは標的にできん！	
VO_MechaJar_Male_Demon_ERROR_TAUNT_01	「挑発」ミニオンが邪魔だ！	
VO_MechaJar_Male_Demon_FIRE_FESTIVAL_01	炎の祭りを祝おう。炎で全てを焼き尽くせ！	
VO_MechaJar_Male_Demon_Greetings_02	ようこそ…滅びへ！	
VO_MechaJar_Male_Demon_HAPPY_HALLOWEEN_01	このハロウェンドに、お前もジ・エンドだ！	
VO_MechaJar_Male_Demon_HAPPY_HOLIDAYS_01	冬至祭を楽しむがいい。できるうちにな！	
VO_MechaJar_Male_Demon_HAPPY_NEW_YEAR_01	新年おめでとう。お前の最後の年だ！	
VO_MechaJar_Male_Demon_HAPPY_NEW_YEAR_LUNAR_01	旧正月おめでとう！	
VO_MechaJar_Male_Demon_HAPPY_NOBLEGARDEN_01	これよりノーブルガーデンのお楽しみを始動する！	
VO_MechaJar_Male_Demon_LowCards_01	我がデッキが尽きる！	
VO_MechaJar_Male_Demon_MIRROR_GREETINGS_03	所詮お前も滅びゆく存在。我は滅びより生まれた！	
VO_MechaJar_Male_Demon_MIRROR_START_01	我もだ、バカめ！	
VO_MechaJar_Male_Demon_NoCards_01	我のカードが枯渇！	
VO_MechaJar_Male_Demon_Oops_02	エラー！エラー！	
VO_MechaJar_Male_Demon_Picked_01	ジャラクサス、起動開始。	
VO_MechaJar_Male_Demon_PIRATE_DAY_01	ヨーホー、繰り返す、ヨーホー、海賊生活開始！	
VO_MechaJar_Male_Demon_Sorry_01	我は…すまん！	
VO_MechaJar_Male_Demon_Start_02	我こそメカ・ジャラクサス！	
VO_MechaJar_Male_Demon_Thanks_01	感謝する！	
VO_MechaJar_Male_Demon_Thinking_01	うーむ。	
VO_MechaJar_Male_Demon_Thinking_02	破壊…せねば…	
VO_MechaJar_Male_Demon_Thinking_05	演算中…	
VO_MechaJar_Male_Demon_Threaten_04	不遜さ故にお前は滅ぶのだ！	
VO_MechaJar_Male_Demon_Time_01	時が尽きる！	
VO_MechaJar_Male_Demon_TRIGGER_DOOM_01	メカメカ大作戦！	
VO_MechaJar_Male_Demon_TRIGGER_RENOUCEDARKNESS_01	闇を削除！	
VO_MechaJar_Male_Demon_Well_Played_01	ふん、見事だ！	
VO_MechaJar_Male_Demon_WOW_01	素晴らしい！	
VO_TBA01_4__Concede	ウゥゥ～～～ッ！	
VO_TBA01_4__Error_Full_Minions	ウゥゥ～～～ッ！	
VO_TBA01_4__Error_Generic	ウゥゥ～～～ッ！	
VO_TBA01_4__Error_Hand_Full	ウゥゥ～～～ッ！	
VO_TBA01_4__Error_I_Attacked	ウゥゥ～～～ッ！	
VO_TBA01_4__Error_Just_Played	ウゥゥ～～～ッ！	
VO_TBA01_4__Error_Minion_Attacked	ウゥゥ～～～ッ！	
VO_TBA01_4__Error_Need_Mana	ウゥゥ～～～ッ！	
VO_TBA01_4__Error_Need_Weapon	ウゥゥ～～～ッ！	
VO_TBA01_4__Error_Play	ウゥゥ～～～ッ！	
VO_TBA01_4__Error_Stealth	ウゥゥ～～～ッ！	
VO_TBA01_4__Good_Game	ウゥゥ～～～ッ！	
VO_TBA01_4__Greetings	さぁ、ゲームを始めようか！	
VO_TBA01_4__Low_Cards	ウゥゥ～～～ッ！	
VO_TBA01_4__No_Cards	ウゥゥ～～～ッ！	
VO_TBA01_4__Oops	フハハハァ...	
VO_TBA01_4__Sorry	ハハハハ！	
VO_TBA01_4__Start	ここの支配者は私だ！	
VO_TBA01_4__Thanks	フフハハハハ！	
VO_TBA01_4__Threaten	見るがよい。慄くがよい。このネファリアンの真の力！	
VO_TBA01_4__Timer	ウゥゥ～～～ッ！	
VO_TBA01_4__Well_Played	フーハッハッハッハッハッハ！	
VO_TRLA_204h_Male_Troll_Concede_03	やーの勝ち…だが絶対許さん。忘れんぞ！	
VO_TRLA_204h_Male_Troll_Greetings_01	この顔、忘れたかや？	
VO_TRLA_204h_Male_Troll_LowCards_01	もっとカードが要る…	
VO_TRLA_204h_Male_Troll_Mirror_Greetings_01	やーこそ、目、見えてるかや。	
VO_TRLA_204h_Male_Troll_NoCards_01	カードがない！	
VO_TRLA_204h_Male_Troll_Oops_01	おー…間違いさー。	
VO_TRLA_204h_Male_Troll_Thanks_01	恩に着るさー。	
VO_TRLA_204h_Male_Troll_Thinking_03	ふむぅ… 	
VO_TRLA_204h_Male_Troll_Thinking_09	ふーん。どうしてやるばー？フッフッフッフッフ。 	
VO_TRLA_204h_Male_Troll_Thinking_10	ハー。これは痛むさー… 	
VO_TRLA_204h_Male_Troll_Threaten_01	やー…恐れ、斧のけ！	
VO_TRLA_204h_Male_Troll_Time_01	慌てれー！	
VO_TRLA_204h_Male_Troll_Well_Played_02	いー腕さー。	
VO_TRLA_204h_Male_Troll_WOW_01	我達のロアにかけて！	
