TAG	TEXT	COMMENT
PRESENCE_ADVENTURE_MODE_BOH	Wertuje Księgę bohaterów	
PRESENCE_ADVENTURE_MODE_BOT	Myszkuje w laboratorium Doktora Huka	
PRESENCE_ADVENTURE_MODE_BRM_CLASS_CHALLENGE	Wyzwanie klasowe Czarnej Góry	
PRESENCE_ADVENTURE_MODE_BRM_HEROIC	Czarna Góra (Heroiczny)	
PRESENCE_ADVENTURE_MODE_BRM_NORMAL	Czarna Góra	
PRESENCE_ADVENTURE_MODE_BTA	Wchodzi do przygody Przez płomienie spaczenia	
PRESENCE_ADVENTURE_MODE_BTA_HEROIC	Rozpoczyna wyzwanie przygody Przez płomienie spaczenia	
PRESENCE_ADVENTURE_MODE_BTP	Zagłębia się we wspomnienia Illidana!	
PRESENCE_ADVENTURE_MODE_DAL	Planuje napad	
PRESENCE_ADVENTURE_MODE_DRG	Wznosi się nad Smocze Pustkowia	
PRESENCE_ADVENTURE_MODE_GIL	Szykuje się na Potworne łowy	
PRESENCE_ADVENTURE_MODE_ICC_NORMAL	Przebywa w Lodowej Koronie	
PRESENCE_ADVENTURE_MODE_KAR_CLASS_CHALLENGE	Wyzwanie klasowe Karazhanu	
PRESENCE_ADVENTURE_MODE_KAR_HEROIC	Karazhan (Heroiczny)	
PRESENCE_ADVENTURE_MODE_KAR_NORMAL	Karazhan	
PRESENCE_ADVENTURE_MODE_LOE_CLASS_CHALLENGE	Wyzwanie klasowe Ligi Odkrywców	
PRESENCE_ADVENTURE_MODE_LOE_HEROIC	Liga Odkrywców (Heroiczny)	
PRESENCE_ADVENTURE_MODE_LOE_NORMAL	Liga Odkrywców	
PRESENCE_ADVENTURE_MODE_LOOT	Szykuje się na Podziemną wyprawę	
PRESENCE_ADVENTURE_MODE_NAXX_CLASS_CHALLENGE	Wyzwanie klasowe Naxxramas	
PRESENCE_ADVENTURE_MODE_NAXX_HEROIC	Naxxramas (Heroiczny)	
PRESENCE_ADVENTURE_MODE_NAXX_NORMAL	Naxxramas	
PRESENCE_ADVENTURE_MODE_RETURNING_PLAYER_CHALLENGE	Triumfalny powrót do Hearthstone!	
PRESENCE_ADVENTURE_MODE_TRL	Szykuje się do rozróby...	
PRESENCE_ADVENTURE_MODE_ULD	Planuje ekspedycję	
PRESENCE_SCENARIO_BOH_FIGHT_01	Przekonuje arcymaga Antonidasa	
PRESENCE_SCENARIO_BOH_FIGHT_02	Zbywa księcia Kael'thasa	
PRESENCE_SCENARIO_BOH_FIGHT_03	Kłóci się z księciem Arthasem	
PRESENCE_SCENARIO_BOH_FIGHT_04	Uspokaja Grommasza Piekłorycza	
PRESENCE_SCENARIO_BOH_FIGHT_05	Przechytrza Archimonda	
PRESENCE_SCENARIO_BOH_FIGHT_06	Broni Theramore	
PRESENCE_SCENARIO_BOH_FIGHT_07	Pociąga Thralla do odpowiedzialności	
PRESENCE_SCENARIO_BOH_FIGHT_08	Przepędza Słońcobójców	
PRESENCE_SCENARIO_BOH2_FIGHT_01	Wzywa do działania	
PRESENCE_SCENARIO_BOH2_FIGHT_02	Przekonuje wodza	
PRESENCE_SCENARIO_BOH2_FIGHT_03	Zaprzyjaźnia się z Miszą	
PRESENCE_SCENARIO_BOH2_FIGHT_04	Ratuje honor Mogrina	
PRESENCE_SCENARIO_BOH2_FIGHT_05	Prowadzi śledztwo u boku Jainy	
PRESENCE_SCENARIO_BOH2_FIGHT_06	Wyswabadza Baina z niewoli	
PRESENCE_SCENARIO_BOH2_FIGHT_07	Odpiera inwazję Daelina	
PRESENCE_SCENARIO_BOH2_FIGHT_08	Ratuje mok'nathalów	
PRESENCE_SCENARIO_BOH3_FIGHT_01	Spotyka się z Wszechmatką	
PRESENCE_SCENARIO_BOH3_FIGHT_02	Dyskutuje z Rehgarem	
PRESENCE_SCENARIO_BOH3_FIGHT_03	Podbija Północną Grań	
PRESENCE_SCENARIO_BOH3_FIGHT_04	Gasi ogień w Orgrimmarze	
PRESENCE_SCENARIO_BOH3_FIGHT_05	Walczy w mak'gorze	
PRESENCE_SCENARIO_BOH3_FIGHT_06	Atakuje Theramore	
PRESENCE_SCENARIO_BOH3_FIGHT_07	Aktywuje Boski Dzwon	
PRESENCE_SCENARIO_BOH3_FIGHT_08	Broni Orgrimmaru przed oblężeniem	
PRESENCE_SCENARIO_BOH4_FIGHT_01	Robi wrażenie na Arcybiskupie Faolu	
PRESENCE_SCENARIO_BOH4_FIGHT_02	Broni Lordaeronu	
PRESENCE_SCENARIO_BOH4_FIGHT_03	Walczy z Varokiem Zaurzykłem	
PRESENCE_SCENARIO_BOH4_FIGHT_04	Niszczy Mroczny Portal	
PRESENCE_SCENARIO_BOH4_FIGHT_05	Ratuje wieśniaków przed Mistrzem Ostrzy	
PRESENCE_SCENARIO_BOH4_FIGHT_06	Broni Żagiewia	
PRESENCE_SCENARIO_BOH4_FIGHT_07	Zmierza do Stratholmu	
PRESENCE_SCENARIO_BOH4_FIGHT_08	Mierzy się z Arthasem	
PRESENCE_SCENARIO_BOH5_FIGHT_01	Rozczarowuje Variana	
PRESENCE_SCENARIO_BOH5_FIGHT_02	Przekonuje Jainę	
PRESENCE_SCENARIO_BOH5_FIGHT_03	Pertraktuje z Moirą	
PRESENCE_SCENARIO_BOH5_FIGHT_04	Pobiera nauki u Velena	
PRESENCE_SCENARIO_BOH5_FIGHT_05	Wymyka się Nazgrimowi	
PRESENCE_SCENARIO_BOH5_FIGHT_06	Rozwiązuje zagadki Małpiego Króla	
PRESENCE_SCENARIO_BOH5_FIGHT_07	Dzierży Młot Harmonii	
PRESENCE_SCENARIO_BOH5_FIGHT_08	Walczy o Lordaeron	
PRESENCE_SCENARIO_BOTA_CLEAR_BOOM	Trudzi się nad wyzwaniem	
PRESENCE_SCENARIO_BOTA_CLEAR_PUZZLE_1	Trudzi się nad wyzwaniem	
PRESENCE_SCENARIO_BOTA_CLEAR_PUZZLE_2	Trudzi się nad wyzwaniem	
PRESENCE_SCENARIO_BOTA_CLEAR_PUZZLE_3	Trudzi się nad wyzwaniem	
PRESENCE_SCENARIO_BOTA_CLEAR_PUZZLE_4	Trudzi się nad wyzwaniem	
PRESENCE_SCENARIO_BOTA_LETHAL_BOOM	Trudzi się nad wyzwaniem	
PRESENCE_SCENARIO_BOTA_LETHAL_PUZZLE_1	Trudzi się nad wyzwaniem	
PRESENCE_SCENARIO_BOTA_LETHAL_PUZZLE_2	Trudzi się nad wyzwaniem	
PRESENCE_SCENARIO_BOTA_LETHAL_PUZZLE_3	Trudzi się nad wyzwaniem	
PRESENCE_SCENARIO_BOTA_LETHAL_PUZZLE_4	Trudzi się nad wyzwaniem	
PRESENCE_SCENARIO_BOTA_MIRROR_BOOM	Trudzi się nad wyzwaniem	
PRESENCE_SCENARIO_BOTA_MIRROR_PUZZLE_1	Trudzi się nad wyzwaniem	
PRESENCE_SCENARIO_BOTA_MIRROR_PUZZLE_2	Trudzi się nad wyzwaniem	
PRESENCE_SCENARIO_BOTA_MIRROR_PUZZLE_3	Trudzi się nad wyzwaniem	
PRESENCE_SCENARIO_BOTA_MIRROR_PUZZLE_4	Trudzi się nad wyzwaniem	
PRESENCE_SCENARIO_BOTA_SURVIVAL_BOOM	Trudzi się nad wyzwaniem	
PRESENCE_SCENARIO_BOTA_SURVIVAL_PUZZLE_1	Trudzi się nad wyzwaniem	
PRESENCE_SCENARIO_BOTA_SURVIVAL_PUZZLE_2	Trudzi się nad wyzwaniem	
PRESENCE_SCENARIO_BOTA_SURVIVAL_PUZZLE_3	Trudzi się nad wyzwaniem	
PRESENCE_SCENARIO_BOTA_SURVIVAL_PUZZLE_4	Trudzi się nad wyzwaniem	
PRESENCE_SCENARIO_BRM_CLASS_CHALLENGE_DRUID	Wyzwanie druida w Czarnej Górze	
PRESENCE_SCENARIO_BRM_CLASS_CHALLENGE_HUNTER	Wyzwanie łowcy w Czarnej Górze	
PRESENCE_SCENARIO_BRM_CLASS_CHALLENGE_MAGE	Wyzwanie maga w Czarnej Górze	
PRESENCE_SCENARIO_BRM_CLASS_CHALLENGE_PALADIN	Wyzwanie paladyna w Czarnej Górze	
PRESENCE_SCENARIO_BRM_CLASS_CHALLENGE_PRIEST	Wyzwanie kapłana w Czarnej Górze	
PRESENCE_SCENARIO_BRM_CLASS_CHALLENGE_ROGUE	Wyzwanie łotra w Czarnej Górze	
PRESENCE_SCENARIO_BRM_CLASS_CHALLENGE_SHAMAN	Wyzwanie szamana w Czarnej Górze	
PRESENCE_SCENARIO_BRM_CLASS_CHALLENGE_WARLOCK	Wyzwanie czarnoksiężnika w Czarnej Górze	
PRESENCE_SCENARIO_BRM_CLASS_CHALLENGE_WARRIOR	Wyzwanie wojownika w Czarnej Górze	
PRESENCE_SCENARIO_BRM_HEROIC_SCENARIO_ATRAMEDES	Heroiczny Atramedes	
PRESENCE_SCENARIO_BRM_HEROIC_SCENARIO_BARON_GEDDON	Heroiczny Baron Geddon	
PRESENCE_SCENARIO_BRM_HEROIC_SCENARIO_CHROMAGGUS	Heroiczny Chromagus	
PRESENCE_SCENARIO_BRM_HEROIC_SCENARIO_DARK_IRON_ARENA	Heroiczna Arena Czarnorytnych	feel free to shorten long translations since the UI may squeeze text into a tiny (unreadable) font size when text is too long. this string is shown in the Friends List.
PRESENCE_SCENARIO_BRM_HEROIC_SCENARIO_DRAKKISATH	Heroiczny Drakkisat	
PRESENCE_SCENARIO_BRM_HEROIC_SCENARIO_GARR	Heroiczny Garr	
PRESENCE_SCENARIO_BRM_HEROIC_SCENARIO_GRIM_GUZZLER	Heroiczny Ponury Opój	
PRESENCE_SCENARIO_BRM_HEROIC_SCENARIO_MAJORDOMO	Heroiczny Ragnaros Władca Ognia	feel free to shorten long translations to 'Heroic Ragnaros' since the UI may squeeze text into a tiny (unreadable) font size when text is too long. this string is shown in the Friends List.
PRESENCE_SCENARIO_BRM_HEROIC_SCENARIO_MALORIAK	Heroiczny Maloriak	
PRESENCE_SCENARIO_BRM_HEROIC_SCENARIO_NEFARIAN	Heroiczny Lord Victor Nefarius	feel free to shorten long translations to 'Heroic Nefarius' since the UI may squeeze text into a tiny (unreadable) font size when text is too long. this string is shown in the Friends List.
PRESENCE_SCENARIO_BRM_HEROIC_SCENARIO_OMNOTRON	Heroiczny Omnotron	
PRESENCE_SCENARIO_BRM_HEROIC_SCENARIO_OMOKK	Heroiczny Omokk	
PRESENCE_SCENARIO_BRM_HEROIC_SCENARIO_RAZORGORE	Heroiczny Brzytworóg	
PRESENCE_SCENARIO_BRM_HEROIC_SCENARIO_REND_BLACKHAND	Heroiczny Rwij Czarnoręki	
PRESENCE_SCENARIO_BRM_HEROIC_SCENARIO_THAURISSAN	Heroiczny Imperator Thaurissan	feel free to shorten long translations to 'Heroic Thaurissan' since the UI may squeeze text into a tiny (unreadable) font size when text is too long. this string is shown in the Friends List.
PRESENCE_SCENARIO_BRM_HEROIC_SCENARIO_VAELASTRASZ	Heroiczny Vaelastraz	
PRESENCE_SCENARIO_BRM_HEROIC_SCENARIO_ZOMBIE_NEF	Heroiczny Nefarian	
PRESENCE_SCENARIO_BRM_NORMAL_SCENARIO_ATRAMEDES	Walczy z Atramedesem	
PRESENCE_SCENARIO_BRM_NORMAL_SCENARIO_BARON_GEDDON	Walczy z Baronem Geddonem	
PRESENCE_SCENARIO_BRM_NORMAL_SCENARIO_CHROMAGGUS	Walczy z Chromagusem	
PRESENCE_SCENARIO_BRM_NORMAL_SCENARIO_DARK_IRON_ARENA	Walczy na Arenie Czarnorytnych	feel free to shorten long translations since the UI may squeeze text into a tiny (unreadable) font size when text is too long. this string is shown in the Friends List.
PRESENCE_SCENARIO_BRM_NORMAL_SCENARIO_DRAKKISATH	Walczy z Drakkisatem	
PRESENCE_SCENARIO_BRM_NORMAL_SCENARIO_GARR	Walczy z Garrem	
PRESENCE_SCENARIO_BRM_NORMAL_SCENARIO_GRIM_GUZZLER	Walczy pod Ponurym Opojem	
PRESENCE_SCENARIO_BRM_NORMAL_SCENARIO_MAJORDOMO	Walczy z Ragnarosem Władcą Ognia	feel free to shorten long translations to 'Battling Ragnaros' since the UI may squeeze text into a tiny (unreadable) font size when text is too long. this string is shown in the Friends List.
PRESENCE_SCENARIO_BRM_NORMAL_SCENARIO_MALORIAK	Walczy z Maloriakiem	
PRESENCE_SCENARIO_BRM_NORMAL_SCENARIO_NEFARIAN	Walczy z Lordem Victorem Nefariusem	feel free to shorten long translations to 'Battling Nefarius' since the UI may squeeze text into a tiny (unreadable) font size when text is too long. this string is shown in the Friends List.
PRESENCE_SCENARIO_BRM_NORMAL_SCENARIO_OMNOTRON	Walczy z Systemem Omnotron	
PRESENCE_SCENARIO_BRM_NORMAL_SCENARIO_OMOKK	Walczy z Omokkiem	
PRESENCE_SCENARIO_BRM_NORMAL_SCENARIO_RAZORGORE	Walczy z Brzytworogiem	
PRESENCE_SCENARIO_BRM_NORMAL_SCENARIO_REND_BLACKHAND	Walczy z Rwijem Czarnorękim	
PRESENCE_SCENARIO_BRM_NORMAL_SCENARIO_THAURISSAN	Walczy z Imperatorem Thaurissanem	feel free to shorten long translations to 'Battling Thaurissan' since the UI may squeeze text into a tiny (unreadable) font size when text is too long. this string is shown in the Friends List.
PRESENCE_SCENARIO_BRM_NORMAL_SCENARIO_VAELASTRASZ	Walczy z Vaelastrazem	
PRESENCE_SCENARIO_BRM_NORMAL_SCENARIO_ZOMBIE_NEF	Walczy z Nefarianem	
PRESENCE_SCENARIO_BTA_COIN_01_INQUISITOR_DAKREL	Eksploruje Półwysep Piekielnego Ognia	
PRESENCE_SCENARIO_BTA_COIN_02_XUR_GOTH	Eksploruje Półwysep Piekielnego Ognia	
PRESENCE_SCENARIO_BTA_COIN_03_ZIXOR	Eksploruje Półwysep Piekielnego Ognia	
PRESENCE_SCENARIO_BTA_COIN_04_BALTHARAK	Eksploruje Półwysep Piekielnego Ognia	
PRESENCE_SCENARIO_BTA_COIN_05_KANRETHAD_PRIME	Przemierza Moczary Zangarskie	
PRESENCE_SCENARIO_BTA_COIN_06_BURGRAK_CRUELCHAIN	Przemierza Moczary Zangarskie	
PRESENCE_SCENARIO_BTA_COIN_07_FELSTORM_RUN	Przemierza Moczary Zangarskie	
PRESENCE_SCENARIO_BTA_COIN_08_MOTHER_SHAHRAZ	Przemierza Moczary Zangarskie	
PRESENCE_SCENARIO_BTA_COIN_09_SHAL_JA_OUTCAST	Szkoli się w Czarnej Świątyni	
PRESENCE_SCENARIO_BTA_COIN_10_KARNUK_OUTCAST	Szkoli się w Czarnej Świątyni	
PRESENCE_SCENARIO_BTA_COIN_11_JEK_HAZ	Szkoli się w Czarnej Świątyni	
PRESENCE_SCENARIO_BTA_COIN_12_MAGTHERIDON_PRIME	Szkoli się w Czarnej Świątyni	
PRESENCE_SCENARIO_BTA_COIN_13_GOK_AMOK	Walczy o Burzę Otchłani	
PRESENCE_SCENARIO_BTA_COIN_14_FLIKK	Walczy o Burzę Otchłani	
PRESENCE_SCENARIO_BTA_COIN_15_BADUU_CORRUPTED	Walczy o Burzę Otchłani	
PRESENCE_SCENARIO_BTA_COIN_16_MECHA_JARAXXUS	Walczy o Burzę Otchłani	
PRESENCE_SCENARIO_BTA_COIN_17_ILLIDAN_STORMRAGE	Chroni przyszłość Rubieży	
PRESENCE_SCENARIO_BTA_HEROIC_COIN_01_KAZZAK	Wyzywa na pojedynek siłaczy Rubieży	
PRESENCE_SCENARIO_BTA_HEROIC_COIN_02_GRUUL	Wyzywa na pojedynek siłaczy Rubieży	
PRESENCE_SCENARIO_BTA_HEROIC_COIN_03_MAGTHERIDON	Wyzywa na pojedynek siłaczy Rubieży	
PRESENCE_SCENARIO_BTA_HEROIC_COIN_04_SUPREMUS	Wyzywa na pojedynek siłaczy Rubieży	
PRESENCE_SCENARIO_BTA_HEROIC_COIN_05_TERON_GOREFIEND	Wyzywa na pojedynek siłaczy Rubieży	
PRESENCE_SCENARIO_BTA_HEROIC_COIN_06_MOTHER_SHARAZ	Wyzywa na pojedynek siłaczy Rubieży	
PRESENCE_SCENARIO_BTA_HEROIC_COIN_07_LADY_VASHJ	Wyzywa na pojedynek siłaczy Rubieży	
PRESENCE_SCENARIO_BTA_HEROIC_COIN_08_KAELTHAS	Wyzywa na pojedynek siłaczy Rubieży	
PRESENCE_SCENARIO_BTA_HEROIC_COIN_09_ILLIDAN	Wyzywa na pojedynek siłaczy Rubieży	
PRESENCE_SCENARIO_BTP_COIN_01_AZZINOTH	Walczy z Płonącym Legionem!	
PRESENCE_SCENARIO_BTP_COIN_02_XAVIUS	Przechodzi na stronę wroga!	
PRESENCE_SCENARIO_BTP_COIN_03_MANNOROTH	Odstrasza demony!	
PRESENCE_SCENARIO_BTP_COIN_04_CENARIUS	Broni się przed oskarżeniami!	
PRESENCE_SCENARIO_DALA_01_BANK	Napada na Bank Dalaranu	
PRESENCE_SCENARIO_DALA_01_BANK_HEROIC	Napada na Bank Dalaranu	
PRESENCE_SCENARIO_DALA_02_VIOLET_HOLD	Wypuszcza więźniów Purpurowej Twierdzy	
PRESENCE_SCENARIO_DALA_02_VIOLET_HOLD_HEROIC	Wypuszcza więźniów Purpurowej Twierdzy	
PRESENCE_SCENARIO_DALA_03_STREETS	Sieje zamęt na ulicach	
PRESENCE_SCENARIO_DALA_03_STREETS_HEROIC	Sieje zamęt na ulicach	
PRESENCE_SCENARIO_DALA_04_UNDERBELLY	Infiltruje Podbrzusze	
PRESENCE_SCENARIO_DALA_04_UNDERBELLY_HEROIC	Infiltruje Podbrzusze	
PRESENCE_SCENARIO_DALA_05_CITADEL	Zajmuje Purpurową Cytadelę	
PRESENCE_SCENARIO_DALA_05_CITADEL_HEROIC	Zajmuje Purpurową Cytadelę	
PRESENCE_SCENARIO_DALA_TAVERN	Knuje w dalarańskiej karczmie	
PRESENCE_SCENARIO_DALA_TAVERN_HEROIC	Knuje w dalarańskiej karczmie	
PRESENCE_SCENARIO_DRGA_EVIL_CHAPTER_01_COIN_01	Walczy nad Smoczymi Pustkowiami	
PRESENCE_SCENARIO_DRGA_EVIL_CHAPTER_01_COIN_01_HEROIC	Walczy nad Smoczymi Pustkowiami	
PRESENCE_SCENARIO_DRGA_EVIL_CHAPTER_01_COIN_02	Walczy nad Smoczymi Pustkowiami	
PRESENCE_SCENARIO_DRGA_EVIL_CHAPTER_01_COIN_02_HEROIC	Walczy nad Smoczymi Pustkowiami	
PRESENCE_SCENARIO_DRGA_EVIL_CHAPTER_01_COIN_03	Walczy nad Smoczymi Pustkowiami	
PRESENCE_SCENARIO_DRGA_EVIL_CHAPTER_01_COIN_03_HEROIC	Walczy nad Smoczymi Pustkowiami	
PRESENCE_SCENARIO_DRGA_EVIL_CHAPTER_02_COIN_01	Walczy nad Smoczymi Pustkowiami	
PRESENCE_SCENARIO_DRGA_EVIL_CHAPTER_02_COIN_01_HEROIC	Walczy nad Smoczymi Pustkowiami	
PRESENCE_SCENARIO_DRGA_EVIL_CHAPTER_02_COIN_02	Walczy nad Smoczymi Pustkowiami	
PRESENCE_SCENARIO_DRGA_EVIL_CHAPTER_02_COIN_02_HEROIC	Walczy nad Smoczymi Pustkowiami	
PRESENCE_SCENARIO_DRGA_EVIL_CHAPTER_02_COIN_03	Walczy nad Smoczymi Pustkowiami	
PRESENCE_SCENARIO_DRGA_EVIL_CHAPTER_02_COIN_03_HEROIC	Walczy nad Smoczymi Pustkowiami	
PRESENCE_SCENARIO_DRGA_EVIL_CHAPTER_03_COIN_01	Walczy nad Smoczymi Pustkowiami	
PRESENCE_SCENARIO_DRGA_EVIL_CHAPTER_03_COIN_01_HEROIC	Walczy nad Smoczymi Pustkowiami	
PRESENCE_SCENARIO_DRGA_EVIL_CHAPTER_03_COIN_02	Walczy nad Smoczymi Pustkowiami	
PRESENCE_SCENARIO_DRGA_EVIL_CHAPTER_03_COIN_02_HEROIC	Walczy nad Smoczymi Pustkowiami	
PRESENCE_SCENARIO_DRGA_EVIL_CHAPTER_03_COIN_03	Walczy nad Smoczymi Pustkowiami	
PRESENCE_SCENARIO_DRGA_EVIL_CHAPTER_03_COIN_03_HEROIC	Walczy nad Smoczymi Pustkowiami	
PRESENCE_SCENARIO_DRGA_EVIL_CHAPTER_04_COIN_01	Walczy nad Smoczymi Pustkowiami	
PRESENCE_SCENARIO_DRGA_EVIL_CHAPTER_04_COIN_01_HEROIC	Walczy nad Smoczymi Pustkowiami	
PRESENCE_SCENARIO_DRGA_EVIL_CHAPTER_04_COIN_02	Walczy nad Smoczymi Pustkowiami	
PRESENCE_SCENARIO_DRGA_EVIL_CHAPTER_04_COIN_02_HEROIC	Walczy nad Smoczymi Pustkowiami	
PRESENCE_SCENARIO_DRGA_EVIL_CHAPTER_04_COIN_03	Walczy nad Smoczymi Pustkowiami	
PRESENCE_SCENARIO_DRGA_EVIL_CHAPTER_04_COIN_03_HEROIC	Walczy nad Smoczymi Pustkowiami	
PRESENCE_SCENARIO_DRGA_GOOD_CHAPTER_01_COIN_01	Walczy nad Smoczymi Pustkowiami	
PRESENCE_SCENARIO_DRGA_GOOD_CHAPTER_01_COIN_01_HEROIC	Walczy nad Smoczymi Pustkowiami	
PRESENCE_SCENARIO_DRGA_GOOD_CHAPTER_01_COIN_02	Walczy nad Smoczymi Pustkowiami	
PRESENCE_SCENARIO_DRGA_GOOD_CHAPTER_01_COIN_02_HEROIC	Walczy nad Smoczymi Pustkowiami	
PRESENCE_SCENARIO_DRGA_GOOD_CHAPTER_01_COIN_03	Walczy nad Smoczymi Pustkowiami	
PRESENCE_SCENARIO_DRGA_GOOD_CHAPTER_01_COIN_03_HEROIC	Walczy nad Smoczymi Pustkowiami	
PRESENCE_SCENARIO_DRGA_GOOD_CHAPTER_02_COIN_01	Walczy nad Smoczymi Pustkowiami	
PRESENCE_SCENARIO_DRGA_GOOD_CHAPTER_02_COIN_01_HEROIC	Walczy nad Smoczymi Pustkowiami	
PRESENCE_SCENARIO_DRGA_GOOD_CHAPTER_02_COIN_02	Walczy nad Smoczymi Pustkowiami	
PRESENCE_SCENARIO_DRGA_GOOD_CHAPTER_02_COIN_02_HEROIC	Walczy nad Smoczymi Pustkowiami	
PRESENCE_SCENARIO_DRGA_GOOD_CHAPTER_02_COIN_03	Walczy nad Smoczymi Pustkowiami	
PRESENCE_SCENARIO_DRGA_GOOD_CHAPTER_02_COIN_03_HEROIC	Walczy nad Smoczymi Pustkowiami	
PRESENCE_SCENARIO_DRGA_GOOD_CHAPTER_03_COIN_01	Walczy nad Smoczymi Pustkowiami	
PRESENCE_SCENARIO_DRGA_GOOD_CHAPTER_03_COIN_01_HEROIC	Walczy nad Smoczymi Pustkowiami	
PRESENCE_SCENARIO_DRGA_GOOD_CHAPTER_03_COIN_02	Walczy nad Smoczymi Pustkowiami	
PRESENCE_SCENARIO_DRGA_GOOD_CHAPTER_03_COIN_02_HEROIC	Walczy nad Smoczymi Pustkowiami	
PRESENCE_SCENARIO_DRGA_GOOD_CHAPTER_03_COIN_03	Walczy nad Smoczymi Pustkowiami	
PRESENCE_SCENARIO_DRGA_GOOD_CHAPTER_03_COIN_03_HEROIC	Walczy nad Smoczymi Pustkowiami	
PRESENCE_SCENARIO_DRGA_GOOD_CHAPTER_04_COIN_01	Walczy nad Smoczymi Pustkowiami	
PRESENCE_SCENARIO_DRGA_GOOD_CHAPTER_04_COIN_01_HEROIC	Walczy nad Smoczymi Pustkowiami	
PRESENCE_SCENARIO_DRGA_GOOD_CHAPTER_04_COIN_02	Walczy nad Smoczymi Pustkowiami	
PRESENCE_SCENARIO_DRGA_GOOD_CHAPTER_04_COIN_02_HEROIC	Walczy nad Smoczymi Pustkowiami	
PRESENCE_SCENARIO_DRGA_GOOD_CHAPTER_04_COIN_03	Walczy nad Smoczymi Pustkowiami	
PRESENCE_SCENARIO_DRGA_GOOD_CHAPTER_04_COIN_03_HEROIC	Walczy nad Smoczymi Pustkowiami	
PRESENCE_SCENARIO_GIL_BONUS_CHALLENGE	Walczy ze Złagatą	
PRESENCE_SCENARIO_GIL_DUNGEON	Bierze udział w Potwornych łowach	
PRESENCE_SCENARIO_ICC_NORMAL_DEATHWHISPER	Walczy z Morową Panią	
PRESENCE_SCENARIO_ICC_NORMAL_FINALE	Walczy z Królem Liszem	
PRESENCE_SCENARIO_ICC_NORMAL_LANATHEL	Walczy z Lana'thel	
PRESENCE_SCENARIO_ICC_NORMAL_LICHKING	Przegrywa z Królem Liszem	
PRESENCE_SCENARIO_ICC_NORMAL_MARROWGAR	Walczy z Lordem Kościejcem	
PRESENCE_SCENARIO_ICC_NORMAL_PUTRICIDE	Walczy z Przebrzydem	
PRESENCE_SCENARIO_ICC_NORMAL_SAURFANG	Walczy z Zaurzykłem	
PRESENCE_SCENARIO_ICC_NORMAL_SINDRAGOSA	Walczy z Sindragosą	
PRESENCE_SCENARIO_KAR_CLASS_CHALLENGE_DRUID	Wyzwanie druida w Karazhanie	
PRESENCE_SCENARIO_KAR_CLASS_CHALLENGE_HUNTER	Wyzwanie łowcy w Karazhanie	
PRESENCE_SCENARIO_KAR_CLASS_CHALLENGE_MAGE	Wyzwanie maga w Karazhanie	
PRESENCE_SCENARIO_KAR_CLASS_CHALLENGE_PALADIN	Wyzwanie paladyna w Karazhanie	
PRESENCE_SCENARIO_KAR_CLASS_CHALLENGE_PRIEST	Wyzwanie kapłana w Karazhanie	
PRESENCE_SCENARIO_KAR_CLASS_CHALLENGE_ROGUE	Wyzwanie łotra w Karazhanie	
PRESENCE_SCENARIO_KAR_CLASS_CHALLENGE_SHAMAN	Wyzwanie szamana w Karazhanie	
PRESENCE_SCENARIO_KAR_CLASS_CHALLENGE_WARLOCK	Wyzwanie czarnoksiężnika w Karazhanie	
PRESENCE_SCENARIO_KAR_CLASS_CHALLENGE_WARRIOR	Wyzwanie wojownika w Karazhanie	
PRESENCE_SCENARIO_KAR_HEROIC_ARAN	Heroiczne Widmo Arana	
PRESENCE_SCENARIO_KAR_HEROIC_CHESS	Heroiczne Szachy	
PRESENCE_SCENARIO_KAR_HEROIC_CRONE	Heroiczna Jędza	
PRESENCE_SCENARIO_KAR_HEROIC_CURATOR	Heroiczny Kustosz	
PRESENCE_SCENARIO_KAR_HEROIC_ILLHOOF	Heroiczny Podłokopytny	
PRESENCE_SCENARIO_KAR_HEROIC_JULIANNE	Heroiczna Juliana	
PRESENCE_SCENARIO_KAR_HEROIC_MIRROR	Heroiczne Magiczne Zwierciadło	
PRESENCE_SCENARIO_KAR_HEROIC_NETHERSPITE	Heroiczny Otchłarion	
PRESENCE_SCENARIO_KAR_HEROIC_NIGHTBANE	Heroiczny Pożeracz Nocy	
PRESENCE_SCENARIO_KAR_HEROIC_PANTRY	Heroiczny Sztućcowy Golem	
PRESENCE_SCENARIO_KAR_HEROIC_PORTALS	Bohatersko uwalnia Medivha!	
PRESENCE_SCENARIO_KAR_HEROIC_PROLOGUE	Heroiczny Malkezar	
PRESENCE_SCENARIO_KAR_HEROIC_WOLF	Heroiczny Wielki Zły Wilk	
PRESENCE_SCENARIO_KAR_NORMAL_ARAN	Walczy z Widmem Arana	
PRESENCE_SCENARIO_KAR_NORMAL_CHESS	Walczy z Szachami	
PRESENCE_SCENARIO_KAR_NORMAL_CRONE	Walczy z Jędzą	
PRESENCE_SCENARIO_KAR_NORMAL_CURATOR	Walczy z Kustoszem	
PRESENCE_SCENARIO_KAR_NORMAL_ILLHOOF	Walczy z Podłokopytnym	
PRESENCE_SCENARIO_KAR_NORMAL_JULIANNE	Walczy z Julianą	
PRESENCE_SCENARIO_KAR_NORMAL_MIRROR	Walczy z Magicznym Zwierciadłem	
PRESENCE_SCENARIO_KAR_NORMAL_NETHERSPITE	Walczy z Otchłarionem	
PRESENCE_SCENARIO_KAR_NORMAL_NIGHTBANE	Walczy z Pożeraczem Nocy	
PRESENCE_SCENARIO_KAR_NORMAL_PANTRY	Walczy ze Sztućcowym Golemem	
PRESENCE_SCENARIO_KAR_NORMAL_PORTALS	Uwalnia Medivha!	
PRESENCE_SCENARIO_KAR_NORMAL_PROLOGUE	Walczy z Malkezarem	
PRESENCE_SCENARIO_KAR_NORMAL_WOLF	Walczy z Wielkim Złym Wilkiem	
PRESENCE_SCENARIO_LOE_CLASS_CHALLENGE_DRUID	LO: Wyzwanie druida	
PRESENCE_SCENARIO_LOE_CLASS_CHALLENGE_HUNTER	LO: Wyzwanie łowcy	
PRESENCE_SCENARIO_LOE_CLASS_CHALLENGE_MAGE	LO: Wyzwanie maga	
PRESENCE_SCENARIO_LOE_CLASS_CHALLENGE_PALADIN	LO: Wyzwanie paladyna	
PRESENCE_SCENARIO_LOE_CLASS_CHALLENGE_PRIEST	LO: Wyzwanie kapłana	
PRESENCE_SCENARIO_LOE_CLASS_CHALLENGE_ROGUE	LO: Wyzwanie łotra	
PRESENCE_SCENARIO_LOE_CLASS_CHALLENGE_SHAMAN	LO: Wyzwanie szamana	
PRESENCE_SCENARIO_LOE_CLASS_CHALLENGE_WARLOCK	LO: Wyzwanie czarnoksiężnika	
PRESENCE_SCENARIO_LOE_CLASS_CHALLENGE_WARRIOR	LO: Wyzwanie wojownika	
PRESENCE_SCENARIO_LOE_HEROIC_ARCHAEDAS	Heroiczny Archaedas	
PRESENCE_SCENARIO_LOE_HEROIC_GIANTFIN	Heroiczny Wielkopłetw	
PRESENCE_SCENARIO_LOE_HEROIC_LADY_NAZJAR	Heroiczna Lady Naz'jar	
PRESENCE_SCENARIO_LOE_HEROIC_MINE_CART	Heroiczna gonitwa w wózku	
PRESENCE_SCENARIO_LOE_HEROIC_RAFAAM_1	Heroiczny Arcyzłodziej Rafaam	
PRESENCE_SCENARIO_LOE_HEROIC_RAFAAM_2	Heroiczny Wyzwolony Rafaam	
PRESENCE_SCENARIO_LOE_HEROIC_SCARVASH	Heroiczny Wódz Skarwosz	
PRESENCE_SCENARIO_LOE_HEROIC_SKELESAURUS	Heroiczny Szkielezaurus	
PRESENCE_SCENARIO_LOE_HEROIC_SLITHERSPEAR	Heroiczny Lord Ślizgodzid	
PRESENCE_SCENARIO_LOE_HEROIC_STEEL_SENTINEL	Heroiczny Stalowy Wartownik	
PRESENCE_SCENARIO_LOE_HEROIC_SUN_RAIDER_PHAERIX	Heroiczny Słoneczny Grabieżca Faeriks	
PRESENCE_SCENARIO_LOE_HEROIC_TEMPLE_ESCAPE	Heroiczna ucieczka ze świątyni	
PRESENCE_SCENARIO_LOE_HEROIC_ZINAAR	Heroiczny Zinaar	
PRESENCE_SCENARIO_LOE_NORMAL_ARCHAEDAS	Walczy z Archaedasem	
PRESENCE_SCENARIO_LOE_NORMAL_GIANTFIN	Walczy z Wielkopłetwem	
PRESENCE_SCENARIO_LOE_NORMAL_LADY_NAZJAR	Walczy z Lady Naz'jar	
PRESENCE_SCENARIO_LOE_NORMAL_MINE_CART	Gonitwa w wózku	
PRESENCE_SCENARIO_LOE_NORMAL_RAFAAM_1	Walczy z Arcyzłodziejem Rafaamem	
PRESENCE_SCENARIO_LOE_NORMAL_RAFAAM_2	Walczy z Wyzwolonym Rafaamem	
PRESENCE_SCENARIO_LOE_NORMAL_SCARVASH	Walczy z Wodzem Skarwoszem	
PRESENCE_SCENARIO_LOE_NORMAL_SKELESAURUS	Walczy ze Szkielezaurusem Hexem	
PRESENCE_SCENARIO_LOE_NORMAL_SLITHERSPEAR	Walczy z Lordem Ślizgodzidem	
PRESENCE_SCENARIO_LOE_NORMAL_STEEL_SENTINEL	Walczy ze Stalowym Wartownikiem	
PRESENCE_SCENARIO_LOE_NORMAL_SUN_RAIDER_PHAERIX	Walczy z Faeriksem	
PRESENCE_SCENARIO_LOE_NORMAL_TEMPLE_ESCAPE	Ucieczka ze świątyni	
PRESENCE_SCENARIO_LOE_NORMAL_ZINAAR	Walczy z Zinaarem	
PRESENCE_SCENARIO_LOOT_DUNGEON	Bierze udział w Podziemnej wyprawie	
PRESENCE_SCENARIO_NAXX_CLASS_CHALLENGE_DRUID	Wyzwanie druida w Naxxramas	
PRESENCE_SCENARIO_NAXX_CLASS_CHALLENGE_HUNTER	Wyzwanie łowcy w Naxxramas	
PRESENCE_SCENARIO_NAXX_CLASS_CHALLENGE_MAGE	Wyzwanie maga w Naxxramas	
PRESENCE_SCENARIO_NAXX_CLASS_CHALLENGE_PALADIN	Wyzwanie paladyna w Naxxramas	
PRESENCE_SCENARIO_NAXX_CLASS_CHALLENGE_PRIEST	Wyzwanie kapłana w Naxxramas	
PRESENCE_SCENARIO_NAXX_CLASS_CHALLENGE_ROGUE	Wyzwanie łotra w Naxxramas	
PRESENCE_SCENARIO_NAXX_CLASS_CHALLENGE_SHAMAN	Wyzwanie szamana w Naxxramas	
PRESENCE_SCENARIO_NAXX_CLASS_CHALLENGE_WARLOCK	Wyzwanie czarnoksiężnika w Naxxramas	
PRESENCE_SCENARIO_NAXX_CLASS_CHALLENGE_WARRIOR	Wyzwanie wojownika w Naxxramas	
PRESENCE_SCENARIO_NAXX_HEROIC_SCENARIO_ANUBREKHAN	Heroiczny Anub'Rekhan	
PRESENCE_SCENARIO_NAXX_HEROIC_SCENARIO_FAERLINA	Heroiczna Ferlina	feel free to shorten long translations to 'Heroic Faerlina' since the UI may squeeze text into a tiny (unreadable) font size when text is too long. this string is shown in the Friends List.
PRESENCE_SCENARIO_NAXX_HEROIC_SCENARIO_GLUTH	Heroiczny Glut	
PRESENCE_SCENARIO_NAXX_HEROIC_SCENARIO_GOTHIK	Heroiczny Gotyk	feel free to shorten long translations to 'Heroic Gothik' since the UI may squeeze text into a tiny (unreadable) font size when text is too long. this string is shown in the Friends List.
PRESENCE_SCENARIO_NAXX_HEROIC_SCENARIO_GROBBULUS	Heroiczny Grobulus	
PRESENCE_SCENARIO_NAXX_HEROIC_SCENARIO_HEIGAN	Heroiczny Heigan	feel free to shorten long translations to 'Heroic Heigan' since the UI may squeeze text into a tiny (unreadable) font size when text is too long. this string is shown in the Friends List.
PRESENCE_SCENARIO_NAXX_HEROIC_SCENARIO_HORSEMEN	Heroiczni Czterej Jeźdźcy	
PRESENCE_SCENARIO_NAXX_HEROIC_SCENARIO_KELTHUZAD	Heroiczny Kel'Thuzad	
PRESENCE_SCENARIO_NAXX_HEROIC_SCENARIO_LOATHEB	Heroiczny Ohydziarz	
PRESENCE_SCENARIO_NAXX_HEROIC_SCENARIO_MAEXXNA	Heroiczna Maexxna	
PRESENCE_SCENARIO_NAXX_HEROIC_SCENARIO_NOTH	Heroiczny Nicz	feel free to shorten long translations to 'Heroic Noth' since the UI may squeeze text into a tiny (unreadable) font size when text is too long. this string is shown in the Friends List.
PRESENCE_SCENARIO_NAXX_HEROIC_SCENARIO_PATCHWERK	Heroiczny Łacior	
PRESENCE_SCENARIO_NAXX_HEROIC_SCENARIO_RAZUVIOUS	Heroiczny Razuwiusz	feel free to shorten long translations to 'Heroic Razuvious' since the UI may squeeze text into a tiny (unreadable) font size when text is too long. this string is shown in the Friends List.
PRESENCE_SCENARIO_NAXX_HEROIC_SCENARIO_SAPPHIRON	Heroiczny Szafiron	
PRESENCE_SCENARIO_NAXX_HEROIC_SCENARIO_THADDIUS	Heroiczny Thadius	
PRESENCE_SCENARIO_NAXX_NORMAL_SCENARIO_ANUBREKHAN	Walczy z Anub'Rekhanem	
PRESENCE_SCENARIO_NAXX_NORMAL_SCENARIO_FAERLINA	Walczy z Ferliną	feel free to shorten long translations to 'Battling Faerlina' since the UI may squeeze text into a tiny (unreadable) font size when text is too long. this string is shown in the Friends List.
PRESENCE_SCENARIO_NAXX_NORMAL_SCENARIO_GLUTH	Walczy z Glutem	
PRESENCE_SCENARIO_NAXX_NORMAL_SCENARIO_GOTHIK	Walczy z Gotykiem	feel free to shorten long translations to 'Battling Gothik' since the UI may squeeze text into a tiny (unreadable) font size when text is too long. this string is shown in the Friends List.
PRESENCE_SCENARIO_NAXX_NORMAL_SCENARIO_GROBBULUS	Walczy z Grobulusem	
PRESENCE_SCENARIO_NAXX_NORMAL_SCENARIO_HEIGAN	Walczy z Heiganem	feel free to shorten long translations to 'Battling Heigan' since the UI may squeeze text into a tiny (unreadable) font size when text is too long. this is string shown in the Friends List.
PRESENCE_SCENARIO_NAXX_NORMAL_SCENARIO_HORSEMEN	Walczy z Czterema Jeźdźcami	
PRESENCE_SCENARIO_NAXX_NORMAL_SCENARIO_KELTHUZAD	Walczy z Kel'Thuzadem	
PRESENCE_SCENARIO_NAXX_NORMAL_SCENARIO_LOATHEB	Walczy z Ohydziarzem	
PRESENCE_SCENARIO_NAXX_NORMAL_SCENARIO_MAEXXNA	Walczy z Maexxną	
PRESENCE_SCENARIO_NAXX_NORMAL_SCENARIO_NOTH	Walczy z Niczem	feel free to shorten long translations to 'Battling Noth' since the UI may squeeze text into a tiny (unreadable) font size when text is too long. this string is shown in the Friends List.
PRESENCE_SCENARIO_NAXX_NORMAL_SCENARIO_PATCHWERK	Walczy z Łaciorem	
PRESENCE_SCENARIO_NAXX_NORMAL_SCENARIO_RAZUVIOUS	Walczy z Razuwiuszem	feel free to shorten long translations to 'Battling Razuvious' since the UI may squeeze text into a tiny (unreadable) font size when text is too long. this string is shown in the Friends List.
PRESENCE_SCENARIO_NAXX_NORMAL_SCENARIO_SAPPHIRON	Walczy z Szafironem	
PRESENCE_SCENARIO_NAXX_NORMAL_SCENARIO_THADDIUS	Walczy z Thadiusem	
PRESENCE_SCENARIO_RETURNING_PLAYER_CHALLENGE_1	Powraca do gry!	
PRESENCE_SCENARIO_RETURNING_PLAYER_CHALLENGE_2	Powraca do gry!	
PRESENCE_SCENARIO_RETURNING_PLAYER_CHALLENGE_3	Powraca do gry!	
PRESENCE_SCENARIO_TRL_DUNGEON	Rozrabia na Arenie Gurubaszów	
PRESENCE_SCENARIO_ULD_01_CITY	Eksploruje Zaginione Miasto	
PRESENCE_SCENARIO_ULD_01_CITY_HEROIC	Eksploruje Zaginione Miasto	
PRESENCE_SCENARIO_ULD_02_DESERT	Błądzi po pustyni	
PRESENCE_SCENARIO_ULD_02_DESERT_HEROIC	Błądzi po pustyni	
PRESENCE_SCENARIO_ULD_03_TOMB	Przekopuje grobowce	
PRESENCE_SCENARIO_ULD_03_TOMB_HEROIC	Przekopuje grobowce	
PRESENCE_SCENARIO_ULD_04_HALLS	Wędruje po Komnatach	
PRESENCE_SCENARIO_ULD_04_HALLS_HEROIC	Wędruje po Komnatach	
PRESENCE_SCENARIO_ULD_05_SANCTUM	Walczy w Sanktuarium	
PRESENCE_SCENARIO_ULD_05_SANCTUM_HEROIC	Walczy w Sanktuarium	
PRESENCE_SCENARIO_ULD_TAVERN	Robi zakupy na bazarze	
PRESENCE_SCENARIO_ULD_TAVERN_HEROIC	Robi zakupy na bazarze	
PRESENCE_STATUS_ADVENTURE_CHOOSING_MODE	Szuka przygody	
PRESENCE_STATUS_ADVENTURE_SCENARIO_PLAYING_GAME	{0}	{0} replaced with the specific scenario string, via PRESENCE_SCENARIO_NAXX_*
PRESENCE_STATUS_ADVENTURE_SCENARIO_SELECT	{0}	{0} replaced with the adventure mode, via PRESENCE_ADVENTURE_MODE_*, e.g. Naxxramas (Heroic) -- (originally i wanted it to say "Mission Select: Naxxramas Class Challenge" but this got too long for the UI element.)
PRESENCE_STATUS_ARENA_FORGE	Przygotowuje talię na Arenę	
PRESENCE_STATUS_ARENA_GAME	Walczy na Arenie	
PRESENCE_STATUS_ARENA_IDLE	Krząta się po Arenie	
PRESENCE_STATUS_ARENA_PURCHASE	Rozmyśla nad wejściem na Arenę	
PRESENCE_STATUS_ARENA_QUEUE	Wyszukuje przeciwnika na Arenie	
PRESENCE_STATUS_ARENA_REWARD	Odbiera nagrody za Arenę	
PRESENCE_STATUS_BATTLEGROUNDS_GAME	Walczy w Ustawce!	
PRESENCE_STATUS_BATTLEGROUNDS_QUEUE	Szuka przeciwników do Ustawki	
PRESENCE_STATUS_BATTLEGROUNDS_SCREEN	Szuka spiny na Ustawce	
PRESENCE_STATUS_COLLECTION	Przegląda swoją kolekcję	
PRESENCE_STATUS_CRAFTING	Tworzy nowe karty	
PRESENCE_STATUS_DECKEDITOR	Przygotowuje talię	
PRESENCE_STATUS_DUELS_FORGE	Tworzy talię do Starć	
PRESENCE_STATUS_DUELS_GAME	Toczy EPICKIE Starcie	
PRESENCE_STATUS_DUELS_IDLE	Rusza do Starcia	
PRESENCE_STATUS_DUELS_PURCHASE	Rozważa rozpoczęcie serii Starć	
PRESENCE_STATUS_DUELS_QUEUE	Wyszukuje przeciwnika do Starć	
PRESENCE_STATUS_DUELS_REWARD	Odbiera nagrody za Starcia	
PRESENCE_STATUS_FIRESIDE_BRAWL_SCREEN	Chce rozpocząć Bójkę przy kominku	
PRESENCE_STATUS_FRIENDLY_DECKPICKER	Szykuje się do walki	
PRESENCE_STATUS_FRIENDLY_GAME	Walczy ze znajomym	
PRESENCE_STATUS_HUB	Krząta się po głównym menu	
PRESENCE_STATUS_LOGIN	Odpala grę	
PRESENCE_STATUS_PACKOPENING	Otwiera pakiety kart!!!	
PRESENCE_STATUS_PLAY_DECKPICKER	Wchodzi do trybu Pojedynku	
PRESENCE_STATUS_PLAY_GAME	Walczy w trybie Pojedynku	
PRESENCE_STATUS_PLAY_QUEUE	Wyszukuje przeciwnika	
PRESENCE_STATUS_PRACTICE_DECKPICKER	Wchodzi do trybu treningowego	
PRESENCE_STATUS_PRACTICE_GAME	Ćwiczy grę z karczmarzem	
PRESENCE_STATUS_QUESTLOG	Ogląda dziennik zadań	
PRESENCE_STATUS_SPECTATING_GAME_ADVENTURE_BRM_CLASS_CHALLENGE	Ogląda wyzwanie klasowe w Czarnej Górze!	
PRESENCE_STATUS_SPECTATING_GAME_ADVENTURE_BRM_HEROIC	Ogląda Heroiczną Czarną Górę!	
PRESENCE_STATUS_SPECTATING_GAME_ADVENTURE_BRM_NORMAL	Ogląda potyczkę w Czarnej Górze!	
PRESENCE_STATUS_SPECTATING_GAME_ADVENTURE_ICC_NORMAL	Ogląda Mroźny Tron!	
PRESENCE_STATUS_SPECTATING_GAME_ADVENTURE_KAR_CLASS_CHALLENGE	Ogląda wyzwanie klasowe w Karazhanie!	
PRESENCE_STATUS_SPECTATING_GAME_ADVENTURE_KAR_HEROIC	Ogląda Heroiczny Karazhan!	
PRESENCE_STATUS_SPECTATING_GAME_ADVENTURE_KAR_NORMAL	Ogląda Karazhan!	
PRESENCE_STATUS_SPECTATING_GAME_ADVENTURE_LOE_CLASS_CHALLENGE	Ogląda wyzwania klasowe LO!	
PRESENCE_STATUS_SPECTATING_GAME_ADVENTURE_LOE_HEROIC	Ogląda Heroiczną Ligę!	
PRESENCE_STATUS_SPECTATING_GAME_ADVENTURE_LOE_NORMAL	Ogląda Ligę Odkrywców	
PRESENCE_STATUS_SPECTATING_GAME_ADVENTURE_NAXX_CLASS_CHALLENGE	Ogląda wyzwanie klasowe Naxxramas!	
PRESENCE_STATUS_SPECTATING_GAME_ADVENTURE_NAXX_HEROIC	Ogląda Heroiczny Naxxramas!	
PRESENCE_STATUS_SPECTATING_GAME_ADVENTURE_NAXX_NORMAL	Ogląda potyczkę w Naxxramas!	
PRESENCE_STATUS_SPECTATING_GAME_ARENA	Ogląda potyczkę na Arenie	
PRESENCE_STATUS_SPECTATING_GAME_BATTLEGROUNDS	Ogląda Ustawkę	
PRESENCE_STATUS_SPECTATING_GAME_BOH	Podziwia Księgę bohaterów	
PRESENCE_STATUS_SPECTATING_GAME_BOT	Asystuje w laboratorium	
PRESENCE_STATUS_SPECTATING_GAME_BTA	Ogląda przygodę Przez płomienie spaczenia	
PRESENCE_STATUS_SPECTATING_GAME_BTA_HEROIC	Ogląda wyzwanie przygody Przez płomienie spaczenia	
PRESENCE_STATUS_SPECTATING_GAME_BTP	Obserwuje prolog	
PRESENCE_STATUS_SPECTATING_GAME_DAL	Podgląda atak na Dalaran	
PRESENCE_STATUS_SPECTATING_GAME_DAL_HEROIC	Podgląda atak na Dalaran	
PRESENCE_STATUS_SPECTATING_GAME_DRG	Obserwuje Smocze Pustkowia	
PRESENCE_STATUS_SPECTATING_GAME_DRG_HEROIC	Obserwuje Smocze Pustkowia	
PRESENCE_STATUS_SPECTATING_GAME_DUELS	Ogląda Starcie	
PRESENCE_STATUS_SPECTATING_GAME_FRIENDLY	Ogląda towarzyską potyczkę	
PRESENCE_STATUS_SPECTATING_GAME_GIL	Ogląda Potworne łowy	
PRESENCE_STATUS_SPECTATING_GAME_GIL_BONUS_CHALLENGE	Ogląda walkę ze Złagatą	
PRESENCE_STATUS_SPECTATING_GAME_LOOT	Ogląda Podziemną wyprawę	
PRESENCE_STATUS_SPECTATING_GAME_PLAY	Ogląda potyczkę w trybie Pojedynku	
PRESENCE_STATUS_SPECTATING_GAME_PRACTICE	Ogląda grę treningową	
PRESENCE_STATUS_SPECTATING_GAME_RETURNING_PLAYER_CHALLENGE	Ogląda powracającego znajomego!	
PRESENCE_STATUS_SPECTATING_GAME_TAVERN_BRAWL	Ogląda Karczemną bójkę	
PRESENCE_STATUS_SPECTATING_GAME_TRL	Ogląda rozróbę	
PRESENCE_STATUS_SPECTATING_GAME_TUTORIAL	Ogląda samouczek	
PRESENCE_STATUS_SPECTATING_GAME_ULD	Ogląda grobowce	
PRESENCE_STATUS_SPECTATING_GAME_ULD_HEROIC	Ogląda grobowce	
PRESENCE_STATUS_STORE	Przegląda sklep	
PRESENCE_STATUS_TAVERN_BRAWL_DECKEDITOR	Przygotowuje talię do Bójki	
PRESENCE_STATUS_TAVERN_BRAWL_FRIENDLY_GAME	Bójka ze znajomym	
PRESENCE_STATUS_TAVERN_BRAWL_FRIENDLY_WAITING	Szykuje się do Bójki ze znajomym	
PRESENCE_STATUS_TAVERN_BRAWL_GAME	Walczy w Karczemnej bójce	
PRESENCE_STATUS_TAVERN_BRAWL_QUEUE	Wyszukuje przeciwnika do Bójki	
PRESENCE_STATUS_TAVERN_BRAWL_SCREEN	Chce rozpocząć Bójkę	
PRESENCE_STATUS_TUTORIAL_GAME	Walczy z {0}	0 = PRESENCE_TUTORIAL_*
PRESENCE_STATUS_TUTORIAL_PREGAME	Po raz pierwszy uruchamia grę	
PRESENCE_STATUS_VIEWING_JOURNAL	Przegląda dziennik	
PRESENCE_STATUS_WAIT_FOR_OPPONENT_RECONNECT	Czeka na powrót przeciwnika	
PRESENCE_STATUS_WELCOMEQUESTS	Otrzymuje nowe zadanie!	
PRESENCE_TUTORIAL_CHO	Wiedzicielem Czo	
PRESENCE_TUTORIAL_HEMET	Hemetem	
PRESENCE_TUTORIAL_HOGGER	Wyżerem	
PRESENCE_TUTORIAL_ILLIDAN	Illidanem	
PRESENCE_TUTORIAL_MILLHOUSE	Mełkiem Gromiłło	
PRESENCE_TUTORIAL_MUKLA	Królem Muklą	
