TAG	TEXT	COMMENT
GAMEPLAY_EMOTE_EX1_323h_CONCEDE	Tú ganas... PERO TU MUNDO ESTÁ CONDENADO.	
GAMEPLAY_EMOTE_EX1_323h_ERROR_FULL_MINIONS	¡¡DEMASIADOS ESBIRROS!!	
GAMEPLAY_EMOTE_EX1_323h_ERROR_GENERIC	¡NO PUEDO HACER ESO!	
GAMEPLAY_EMOTE_EX1_323h_ERROR_HAND_FULL	¡¡DEMASIADAS CARTAS!!	
GAMEPLAY_EMOTE_EX1_323h_ERROR_I_ATTACKED	¡YA HE ATACADO!	
GAMEPLAY_EMOTE_EX1_323h_ERROR_JUST_PLAYED	¡ACABA DE LLEGAR!	
GAMEPLAY_EMOTE_EX1_323h_ERROR_MINION_ATTACKED	¡ESA COSA YA HA ATACADO!	
GAMEPLAY_EMOTE_EX1_323h_ERROR_NEED_MANA	¡NO HAY MANÁ SUFICIENTE!	
GAMEPLAY_EMOTE_EX1_323h_ERROR_NEED_WEAPON	¡¿DÓNDE ESTÁ MI ARMA?!	
GAMEPLAY_EMOTE_EX1_323h_ERROR_PLAY	¡NO PUEDO JUGAR ESO!	
GAMEPLAY_EMOTE_EX1_323h_ERROR_STEALTH	¡ESTÁ EN SIGILO!	
GAMEPLAY_EMOTE_EX1_323h_ERROR_TARGET	¡NO ES VÁLIDO!	
GAMEPLAY_EMOTE_EX1_323h_ERROR_TAUNT	¡EL ESBIRRO CON PROVOCAR SE INTERPONE!	
GAMEPLAY_EMOTE_EX1_323h_GOOD_GAME	¡BUENA PARTIDA!	
GAMEPLAY_EMOTE_EX1_323h_GREETINGS	Soy Jaraxxus, señor eredar de la Legión Ardiente.	
GAMEPLAY_EMOTE_EX1_323h_LOW_CARDS	¡Mi mazo! ¡SE QUEDA SIN CARTAS!	
GAMEPLAY_EMOTE_EX1_323h_LUNAR_NEW_YEAR	Soy Jaraxxus, señor eredar de la Legión Ardiente.	
GAMEPLAY_EMOTE_EX1_323h_NO_CARDS	¡NOOO! ¡NO ME QUEDAN CARTAS!	
GAMEPLAY_EMOTE_EX1_323h_OOPS	¡ERROR!	
GAMEPLAY_EMOTE_EX1_323h_SORRY	Jaraxxus... lo siente.	
GAMEPLAY_EMOTE_EX1_323h_THANKS	GRACIAS.	
GAMEPLAY_EMOTE_EX1_323h_THINK1	Mmm...	
GAMEPLAY_EMOTE_EX1_323h_THINK2	Me pregunto...	
GAMEPLAY_EMOTE_EX1_323h_THINK3	¿Cómo te destruiré...?	
GAMEPLAY_EMOTE_EX1_323h_THREATEN	¡AL OLVIDO!	
GAMEPLAY_EMOTE_EX1_323h_TIMER	EL TIEMPO SE AGOTA.	
GAMEPLAY_EMOTE_EX1_323h_WELL_PLAYED	¡BIEN JUGADO!	
GAMEPLAY_EMOTE_EX1_323h_WINTERVEIL_GREETINGS	ESTE FESTIVAL DE INVIERNO... ¡FESTÍN CON TU ALMA!	
GAMEPLAY_EMOTE_EX1_323h_WOW_04	¡INCREÍBLE!	
GAMEPLAY_EMOTE_HERO_01_CONCEDE	¡Elijo la muerte!	
GAMEPLAY_EMOTE_HERO_01_ERROR_FULL_MINIONS	Tengo demasiados esbirros.	
GAMEPLAY_EMOTE_HERO_01_ERROR_GENERIC	No puedo hacer eso.	
GAMEPLAY_EMOTE_HERO_01_ERROR_HAND_FULL	¡Mi mano está llena!	
GAMEPLAY_EMOTE_HERO_01_ERROR_I_ATTACKED	Ya he atacado.	
GAMEPLAY_EMOTE_HERO_01_ERROR_JUST_PLAYED	El esbirro necesita un turno para prepararse.	
GAMEPLAY_EMOTE_HERO_01_ERROR_MINION_ATTACKED	Ese esbirro ya ha atacado.	
GAMEPLAY_EMOTE_HERO_01_ERROR_NEED_MANA	No tengo suficiente maná.	
GAMEPLAY_EMOTE_HERO_01_ERROR_NEED_WEAPON	Necesito un arma.	
GAMEPLAY_EMOTE_HERO_01_ERROR_PLAY	No puedo jugar eso.	
GAMEPLAY_EMOTE_HERO_01_ERROR_STEALTH	No puedo seleccionar a esbirros en sigilo.	
GAMEPLAY_EMOTE_HERO_01_ERROR_TARGET	No es un objetivo válido.	
GAMEPLAY_EMOTE_HERO_01_ERROR_TAUNT	Se interpone un esbirro con Provocar.	
GAMEPLAY_EMOTE_HERO_01_EVENT_LUNAR_NEW_YEAR	Soy Jaraxxus, señor eredar de la Legión Ardiente.	
GAMEPLAY_EMOTE_HERO_01_GOOD_GAME	¡Buena partida!	
GAMEPLAY_EMOTE_HERO_01_GREETINGS	Saludos.	
GAMEPLAY_EMOTE_HERO_01_LOW_CARDS	¡Casi no me quedan cartas!	
GAMEPLAY_EMOTE_HERO_01_MIRROR_START	¡Ja, ja, ja! ¡Ponme a prueba!	
GAMEPLAY_EMOTE_HERO_01_NO_CARDS	¡No me quedan cartas!	
GAMEPLAY_EMOTE_HERO_01_OOPS	Ha sido un error.	
GAMEPLAY_EMOTE_HERO_01_SORRY	Siento lo ocurrido.	
GAMEPLAY_EMOTE_HERO_01_START	¡Victoria o muerte!	
GAMEPLAY_EMOTE_HERO_01_THANKS	Gracias.	
GAMEPLAY_EMOTE_HERO_01_THINK1	Mmm...	
GAMEPLAY_EMOTE_HERO_01_THINK2	Mmm... Me pregunto...	
GAMEPLAY_EMOTE_HERO_01_THINK3	¿Y ahora qué...?	
GAMEPLAY_EMOTE_HERO_01_THREATEN	¡Te aplastaré!	
GAMEPLAY_EMOTE_HERO_01_TIMER	¡Debo elegir!	
GAMEPLAY_EMOTE_HERO_01_WELL_PLAYED	Bien jugado.	
GAMEPLAY_EMOTE_HERO_01_WINTERVEIL_GREETINGS	¡Feliz festín del Festival de Invierno!	
GAMEPLAY_EMOTE_HERO_01_WOW	¡Impresionante!	
GAMEPLAY_EMOTE_HERO_01A_CONCEDE	Tú ganas.	
GAMEPLAY_EMOTE_HERO_01A_ERROR_FULL_MINIONS	Tengo demasiados esbirros.	
GAMEPLAY_EMOTE_HERO_01A_ERROR_GENERIC	No puedo hacer eso.	
GAMEPLAY_EMOTE_HERO_01A_ERROR_HAND_FULL	¡Mi mano está llena!	
GAMEPLAY_EMOTE_HERO_01A_ERROR_I_ATTACKED	Ya he atacado.	
GAMEPLAY_EMOTE_HERO_01A_ERROR_JUST_PLAYED	El esbirro necesita un turno para prepararse.	
GAMEPLAY_EMOTE_HERO_01A_ERROR_MINION_ATTACKED	Ese esbirro ya ha atacado.	
GAMEPLAY_EMOTE_HERO_01A_ERROR_NEED_MANA	No tengo suficiente maná.	
GAMEPLAY_EMOTE_HERO_01A_ERROR_NEED_WEAPON	Necesito un arma.	
GAMEPLAY_EMOTE_HERO_01A_ERROR_PLAY	No puedo jugar eso.	
GAMEPLAY_EMOTE_HERO_01A_ERROR_STEALTH	No puedo seleccionar a esbirros en sigilo.	
GAMEPLAY_EMOTE_HERO_01A_ERROR_TARGET	No es un objetivo válido.	
GAMEPLAY_EMOTE_HERO_01A_ERROR_TAUNT	Debo atacar al esbirro con Provocar.	
GAMEPLAY_EMOTE_HERO_01A_EVENT_LUNAR_NEW_YEAR	Saludos.	
GAMEPLAY_EMOTE_HERO_01A_GOOD_GAME	Buena partida.	
GAMEPLAY_EMOTE_HERO_01A_GREETINGS	Hola.	
GAMEPLAY_EMOTE_HERO_01A_LOW_CARDS	¡Casi no me quedan cartas!	
GAMEPLAY_EMOTE_HERO_01A_MIRROR_START	¡Sí, por Khaz Modan!	
GAMEPLAY_EMOTE_HERO_01A_NO_CARDS	¡No me quedan cartas!	
GAMEPLAY_EMOTE_HERO_01A_OOPS	Eso no ha salido bien.	
GAMEPLAY_EMOTE_HERO_01A_SORRY	Lo siento mucho.	
GAMEPLAY_EMOTE_HERO_01A_START	¡Por Khaz Modan!	
GAMEPLAY_EMOTE_HERO_01A_THANKS	¡Gracias!	
GAMEPLAY_EMOTE_HERO_01A_THINK1	Mmm...	
GAMEPLAY_EMOTE_HERO_01A_THINK2	Igual juego esta.... No, no...	
GAMEPLAY_EMOTE_HERO_01A_THINK3	No sé cuál elegir...	
GAMEPLAY_EMOTE_HERO_01A_THREATEN	¡Siente la furia de la montaña!	
GAMEPLAY_EMOTE_HERO_01A_TIMER	¡Debo darme prisa!	
GAMEPLAY_EMOTE_HERO_01A_WELL_PLAYED	Bien jugado.	
GAMEPLAY_EMOTE_HERO_01A_WINTERVEIL_GREETINGS	¡Feliz Festival de Invierno!	
GAMEPLAY_EMOTE_HERO_01A_WOW	¡Por mis barbas!	
GAMEPLAY_EMOTE_HERO_02_CONCEDE	Esta partida es tuya.	
GAMEPLAY_EMOTE_HERO_02_ERROR_FULL_MINIONS	Tengo demasiados esbirros.	
GAMEPLAY_EMOTE_HERO_02_ERROR_GENERIC	No puedo hacer eso.	
GAMEPLAY_EMOTE_HERO_02_ERROR_HAND_FULL	¡Mi mano está llena!	
GAMEPLAY_EMOTE_HERO_02_ERROR_I_ATTACKED	Ya he atacado.	
GAMEPLAY_EMOTE_HERO_02_ERROR_JUST_PLAYED	El esbirro necesita un turno para prepararse.	
GAMEPLAY_EMOTE_HERO_02_ERROR_MINION_ATTACKED	Ese esbirro ya ha atacado.	
GAMEPLAY_EMOTE_HERO_02_ERROR_NEED_MANA	No tengo suficiente maná.	
GAMEPLAY_EMOTE_HERO_02_ERROR_NEED_WEAPON	Necesito un arma.	
GAMEPLAY_EMOTE_HERO_02_ERROR_PLAY	No puedo jugar eso.	
GAMEPLAY_EMOTE_HERO_02_ERROR_STEALTH	No puedo seleccionar a esbirros en sigilo.	
GAMEPLAY_EMOTE_HERO_02_ERROR_TARGET	No es un objetivo válido.	
GAMEPLAY_EMOTE_HERO_02_ERROR_TAUNT	Se interpone un esbirro con Provocar.	
GAMEPLAY_EMOTE_HERO_02_EVENT_LUNAR_NEW_YEAR	Lok'tar, camarada.	
GAMEPLAY_EMOTE_HERO_02_GOOD_GAME	¡Buena partida!	
GAMEPLAY_EMOTE_HERO_02_GREETINGS	Lok'tar, camarada.	
GAMEPLAY_EMOTE_HERO_02_LOW_CARDS	¡Casi no me quedan cartas!	
GAMEPLAY_EMOTE_HERO_02_MIRROR_START	¡Por los Lobo Gélido!	
GAMEPLAY_EMOTE_HERO_02_NO_CARDS	¡No me quedan cartas!	
GAMEPLAY_EMOTE_HERO_02_OOPS	¡Eso ha sido un error!	
GAMEPLAY_EMOTE_HERO_02_SORRY	Siento lo ocurrido.	
GAMEPLAY_EMOTE_HERO_02_START	¡Por Martillo Maldito!	
GAMEPLAY_EMOTE_HERO_02_THANKS	Te lo agradezco.	
GAMEPLAY_EMOTE_HERO_02_THINK1	Mmm...	
GAMEPLAY_EMOTE_HERO_02_THINK2	Me pregunto...	
GAMEPLAY_EMOTE_HERO_02_THINK3	Qué hacer...	
GAMEPLAY_EMOTE_HERO_02_THREATEN	¡Los elementos te destruirán!	
GAMEPLAY_EMOTE_HERO_02_TIMER	¡Queda poco tiempo!	
GAMEPLAY_EMOTE_HERO_02_WELL_PLAYED	Bien jugado.	
GAMEPLAY_EMOTE_HERO_02_WINTERVEIL_GREETINGS	¡Feliz festín del Festival de Invierno!	
GAMEPLAY_EMOTE_HERO_02_WOW	¡Increíble!	
GAMEPLAY_EMOTE_HERO_02A_CONCEDE	<Me han vencido.>	
GAMEPLAY_EMOTE_HERO_02A_ERROR_FULL_MINIONS	<Tengo demasiados\nesbirros.>	
GAMEPLAY_EMOTE_HERO_02A_ERROR_GENERIC	<Imposible.>	
GAMEPLAY_EMOTE_HERO_02A_ERROR_HAND_FULL	<¡Mi mano\nestá llena!>	
GAMEPLAY_EMOTE_HERO_02A_ERROR_I_ATTACKED	<Ya he atacado.>	VO_HERO_15_ERROR04_43.wav
GAMEPLAY_EMOTE_HERO_02A_ERROR_JUST_PLAYED	<El esbirro necesita\nun turno para prepararse.>	
GAMEPLAY_EMOTE_HERO_02A_ERROR_MINION_ATTACKED	<Ese esbirro\nya ha atacado.>	
GAMEPLAY_EMOTE_HERO_02A_ERROR_NEED_MANA	<No tengo\nsuficiente maná.>	
GAMEPLAY_EMOTE_HERO_02A_ERROR_NEED_WEAPON	<Necesito un arma.>	
GAMEPLAY_EMOTE_HERO_02A_ERROR_PLAY	<No puedo jugar eso.>	
GAMEPLAY_EMOTE_HERO_02A_ERROR_STEALTH	<No puedo seleccionar\na esbirros en sigilo.>	
GAMEPLAY_EMOTE_HERO_02A_ERROR_TARGET	<No es un\nobjetivo válido.>	
GAMEPLAY_EMOTE_HERO_02A_ERROR_TAUNT	<Debo atacar al esbirro\ncon Provocar.>	
GAMEPLAY_EMOTE_HERO_02A_EVENT_LUNAR_NEW_YEAR	<¡Próspero\nAño Nuevo!>	
GAMEPLAY_EMOTE_HERO_02A_GREETINGS	<Hola, camarada.>	
GAMEPLAY_EMOTE_HERO_02A_LOW_CARDS	<¡Me estoy quedando\nsin cartas!>	
GAMEPLAY_EMOTE_HERO_02A_MIRROR_START	<¡¿Joven?! Tienes tanto\nque aprender...>	
GAMEPLAY_EMOTE_HERO_02A_NO_CARDS	<¡No me quedan cartas!>	
GAMEPLAY_EMOTE_HERO_02A_OOPS	<¡Maldición!>	
GAMEPLAY_EMOTE_HERO_02A_SORRY	<Lo siento, joven.>	
GAMEPLAY_EMOTE_HERO_02A_START	<¡Te voy a dar\nuna lección, joven!>	
GAMEPLAY_EMOTE_HERO_02A_THANKS	<Te lo agradezco.>	
GAMEPLAY_EMOTE_HERO_02A_THINK1	<Tal vez...>	VO_HERO_15_Thinking1_13.wav
GAMEPLAY_EMOTE_HERO_02A_THINK2	<Eso sería\ninteresante...>	
GAMEPLAY_EMOTE_HERO_02A_THINK3	<Una posibilidad\nsería...>	
GAMEPLAY_EMOTE_HERO_02A_THREATEN	<¡Enfréntate a la sabiduría\nde los mares!>	
GAMEPLAY_EMOTE_HERO_02A_TIMER	<Rápido, ¡rápido!>	
GAMEPLAY_EMOTE_HERO_02A_WELL_PLAYED	<Bien hecho.>	
GAMEPLAY_EMOTE_HERO_02A_WINTERVEIL_GREETINGS	<Feliz Festival\nde Invierno.>	
GAMEPLAY_EMOTE_HERO_02A_WOW	<¡Inconcebible!>	
GAMEPLAY_EMOTE_HERO_03_CONCEDE	Me rindo.	
GAMEPLAY_EMOTE_HERO_03_ERROR_FULL_MINIONS	Tengo demasiados esbirros.	
GAMEPLAY_EMOTE_HERO_03_ERROR_GENERIC	No puedo hacer eso.	
GAMEPLAY_EMOTE_HERO_03_ERROR_HAND_FULL	¡Tengo la mano llena!	
GAMEPLAY_EMOTE_HERO_03_ERROR_I_ATTACKED	Ya he atacado.	
GAMEPLAY_EMOTE_HERO_03_ERROR_JUST_PLAYED	El esbirro necesita un turno para prepararse.	
GAMEPLAY_EMOTE_HERO_03_ERROR_MINION_ATTACKED	Ese esbirro ya ha atacado.	
GAMEPLAY_EMOTE_HERO_03_ERROR_NEED_MANA	No tengo suficiente maná.	
GAMEPLAY_EMOTE_HERO_03_ERROR_NEED_WEAPON	Necesito un arma.	
GAMEPLAY_EMOTE_HERO_03_ERROR_PLAY	No puedo jugar eso.	
GAMEPLAY_EMOTE_HERO_03_ERROR_STEALTH	No puedo seleccionar a esbirros en sigilo.	
GAMEPLAY_EMOTE_HERO_03_ERROR_TARGET	No es un objetivo válido.	
GAMEPLAY_EMOTE_HERO_03_ERROR_TAUNT	Se interpone un esbirro con Provocar.	
GAMEPLAY_EMOTE_HERO_03_EVENT_LUNAR_NEW_YEAR	El placer es mío.	
GAMEPLAY_EMOTE_HERO_03_GOOD_GAME	¡Buena partida!	
GAMEPLAY_EMOTE_HERO_03_GREETINGS	El placer es mío.	
GAMEPLAY_EMOTE_HERO_03_LOW_CARDS	¡Casi no me quedan cartas!	
GAMEPLAY_EMOTE_HERO_03_MIRROR_START	Siempre lo hago.	
GAMEPLAY_EMOTE_HERO_03_NO_CARDS	¡No me quedan cartas!	
GAMEPLAY_EMOTE_HERO_03_OOPS	Nadie es perfecto.	
GAMEPLAY_EMOTE_HERO_03_SORRY	Lo siento.	
GAMEPLAY_EMOTE_HERO_03_START	Vigila tu espalda.	
GAMEPLAY_EMOTE_HERO_03_THANKS	Gracias.	
GAMEPLAY_EMOTE_HERO_03_THINK1	Mmm...	
GAMEPLAY_EMOTE_HERO_03_THINK2	Me pregunto...	
GAMEPLAY_EMOTE_HERO_03_THINK3	Cuántas posibilidades...	
GAMEPLAY_EMOTE_HERO_03_THREATEN	¡Yo te daré muerte!	
GAMEPLAY_EMOTE_HERO_03_TIMER	¡Debo elegir rápido!	
GAMEPLAY_EMOTE_HERO_03_WELL_PLAYED	Bien jugado.	
GAMEPLAY_EMOTE_HERO_03_WINTERVEIL_GREETINGS	Feliz festín del Festival de Invierno.	
GAMEPLAY_EMOTE_HERO_03_WOW	Increíble.	
GAMEPLAY_EMOTE_HERO_04_CONCEDE	La victoria es tuya.	
GAMEPLAY_EMOTE_HERO_04_ERROR_FULL_MINIONS	Tengo demasiados esbirros.	
GAMEPLAY_EMOTE_HERO_04_ERROR_GENERIC	No puedo hacer eso.	
GAMEPLAY_EMOTE_HERO_04_ERROR_HAND_FULL	¡Mi mano está llena!	
GAMEPLAY_EMOTE_HERO_04_ERROR_I_ATTACKED	Ya he atacado.	
GAMEPLAY_EMOTE_HERO_04_ERROR_JUST_PLAYED	El esbirro necesita un turno para prepararse.	
GAMEPLAY_EMOTE_HERO_04_ERROR_MINION_ATTACKED	Ese esbirro ya ha atacado.	
GAMEPLAY_EMOTE_HERO_04_ERROR_NEED_MANA	No tengo suficiente maná.	
GAMEPLAY_EMOTE_HERO_04_ERROR_NEED_WEAPON	Necesito un arma.	
GAMEPLAY_EMOTE_HERO_04_ERROR_PLAY	No puedo jugar eso.	
GAMEPLAY_EMOTE_HERO_04_ERROR_STEALTH	No puedo seleccionar a esbirros en sigilo.	
GAMEPLAY_EMOTE_HERO_04_ERROR_TARGET	No es un objetivo válido.	
GAMEPLAY_EMOTE_HERO_04_ERROR_TAUNT	Se interpone un esbirro con Provocar.	
GAMEPLAY_EMOTE_HERO_04_EVENT_LUNAR_NEW_YEAR	Te saludo.	
GAMEPLAY_EMOTE_HERO_04_GOOD_GAME	¡Buena partida!	
GAMEPLAY_EMOTE_HERO_04_GREETINGS	Te saludo.	
GAMEPLAY_EMOTE_HERO_04_LOW_CARDS	¡Casi no me quedan cartas!	
GAMEPLAY_EMOTE_HERO_04_MIRROR_START	¡Yo lucharé por la Luz!	
GAMEPLAY_EMOTE_HERO_04_NO_CARDS	¡Me he quedado sin cartas!	
GAMEPLAY_EMOTE_HERO_04_OOPS	Ha sido un error.	
GAMEPLAY_EMOTE_HERO_04_SORRY	Lo siento.	
GAMEPLAY_EMOTE_HERO_04_START	Lucharé con honor.	
GAMEPLAY_EMOTE_HERO_04_THANKS	Gracias.	
GAMEPLAY_EMOTE_HERO_04_THINK1	Mmm...	
GAMEPLAY_EMOTE_HERO_04_THINK2	Me pregunto...	
GAMEPLAY_EMOTE_HERO_04_THINK3	Déjame pensar...	
GAMEPLAY_EMOTE_HERO_04_THREATEN	¡La justicia exige castigo!	
GAMEPLAY_EMOTE_HERO_04_TIMER	¡Debo apresurarme!	
GAMEPLAY_EMOTE_HERO_04_WELL_PLAYED	Bien jugado.	
GAMEPLAY_EMOTE_HERO_04_WINTERVEIL_GREETINGS	¡Feliz festín del Festival de Invierno!	
GAMEPLAY_EMOTE_HERO_04_WOW	¡Por la Luz Sagrada!	
GAMEPLAY_EMOTE_HERO_04A_CONCEDE	Tú ganas. Me rindo.	
GAMEPLAY_EMOTE_HERO_04A_ERROR_FULL_MINIONS	Tengo demasiados esbirros.	
GAMEPLAY_EMOTE_HERO_04A_ERROR_GENERIC	No puedo hacer eso.	
GAMEPLAY_EMOTE_HERO_04A_ERROR_HAND_FULL	¡Mi mano está llena!	
GAMEPLAY_EMOTE_HERO_04A_ERROR_I_ATTACKED	Ya he atacado.	
GAMEPLAY_EMOTE_HERO_04A_ERROR_JUST_PLAYED	Ese esbirro necesita un turno para prepararse.	
GAMEPLAY_EMOTE_HERO_04A_ERROR_MINION_ATTACKED	Ese esbirro ya ha atacado.	
GAMEPLAY_EMOTE_HERO_04A_ERROR_NEED_MANA	No tengo suficiente maná.	
GAMEPLAY_EMOTE_HERO_04A_ERROR_NEED_WEAPON	Necesito un arma.	
GAMEPLAY_EMOTE_HERO_04A_ERROR_PLAY	No puedo jugar eso.	
GAMEPLAY_EMOTE_HERO_04A_ERROR_STEALTH	No puedo seleccionar a esbirros en sigilo.	
GAMEPLAY_EMOTE_HERO_04A_ERROR_TARGET	No es un objetivo válido.	
GAMEPLAY_EMOTE_HERO_04A_ERROR_TAUNT	Debo atacar al esbirro con Provocar.	
GAMEPLAY_EMOTE_HERO_04A_GOOD_GAME	Buena partida.	
GAMEPLAY_EMOTE_HERO_04A_GREETINGS	Hola, contrincante.	
GAMEPLAY_EMOTE_HERO_04A_LOW_CARDS	¡Casi no me quedan cartas!	
GAMEPLAY_EMOTE_HERO_04A_LUNAR_NEW_YEAR	Saludos, contrincante.	
GAMEPLAY_EMOTE_HERO_04A_MIRROR_START	Fuego sagrado es mi segundo nombre.	
GAMEPLAY_EMOTE_HERO_04A_NO_CARDS	¡No me quedan cartas!	
GAMEPLAY_EMOTE_HERO_04A_OOPS	Un error, puro y duro.	
GAMEPLAY_EMOTE_HERO_04A_SORRY	Lo siento.	
GAMEPLAY_EMOTE_HERO_04A_START	¡El fuego sagrado guía mi martillo!	
GAMEPLAY_EMOTE_HERO_04A_THANKS	Gracias, de corazón.	
GAMEPLAY_EMOTE_HERO_04A_THINK1	Mmm...	
GAMEPLAY_EMOTE_HERO_04A_THINK2	Decisiones, decisiones...	
GAMEPLAY_EMOTE_HERO_04A_THINK3	¿Debería...? Mmm...	
GAMEPLAY_EMOTE_HERO_04A_THREATEN	¡Me las pagarás, canalla!	
GAMEPLAY_EMOTE_HERO_04A_TIMER	¡El tiempo apremia!	
GAMEPLAY_EMOTE_HERO_04A_WELL_PLAYED	Bien jugado.	
GAMEPLAY_EMOTE_HERO_04A_WINTERVEIL_GREETINGS	¡Feliz festín del Festival de Invierno!	
GAMEPLAY_EMOTE_HERO_04A_WOW	¡Es increíble!	
GAMEPLAY_EMOTE_HERO_05_CONCEDE	Has luchado bien; me rindo.	
GAMEPLAY_EMOTE_HERO_05_ERROR_FULL_MINIONS	Tengo demasiados esbirros.	
GAMEPLAY_EMOTE_HERO_05_ERROR_GENERIC	No puedo hacer eso.	
GAMEPLAY_EMOTE_HERO_05_ERROR_HAND_FULL	¡Mi mano está llena!	
GAMEPLAY_EMOTE_HERO_05_ERROR_I_ATTACKED	Ya he atacado.	
GAMEPLAY_EMOTE_HERO_05_ERROR_JUST_PLAYED	El esbirro necesita un turno para prepararse.	
GAMEPLAY_EMOTE_HERO_05_ERROR_MINION_ATTACKED	Ese esbirro ya ha atacado.	
GAMEPLAY_EMOTE_HERO_05_ERROR_NEED_MANA	No tengo suficiente maná.	
GAMEPLAY_EMOTE_HERO_05_ERROR_NEED_WEAPON	Necesito un arma.	
GAMEPLAY_EMOTE_HERO_05_ERROR_PLAY	No puedo jugar eso.	
GAMEPLAY_EMOTE_HERO_05_ERROR_STEALTH	No puedo seleccionar a esbirros en sigilo.	
GAMEPLAY_EMOTE_HERO_05_ERROR_TARGET	No es un objetivo válido.	
GAMEPLAY_EMOTE_HERO_05_ERROR_TAUNT	Se interpone un esbirro con Provocar.	
GAMEPLAY_EMOTE_HERO_05_EVENT_LUNAR_NEW_YEAR	Saludos, viajero.	
GAMEPLAY_EMOTE_HERO_05_GOOD_GAME	¡Buena partida!	
GAMEPLAY_EMOTE_HERO_05_GREETINGS	Saludos, viajero.	
GAMEPLAY_EMOTE_HERO_05_LOW_CARDS	Apenas me quedan cartas.	
GAMEPLAY_EMOTE_HERO_05_MIRROR_START	¡Estoy preparado!	
GAMEPLAY_EMOTE_HERO_05_NO_CARDS	¡No me quedan cartas!	
GAMEPLAY_EMOTE_HERO_05_OOPS	Eso no ha salido como pensaba.	
GAMEPLAY_EMOTE_HERO_05_SORRY	Lo siento.	
GAMEPLAY_EMOTE_HERO_05_START	¡Que comience la caza!	
GAMEPLAY_EMOTE_HERO_05_THANKS	Gracias.	
GAMEPLAY_EMOTE_HERO_05_THINK1	Mmm...	
GAMEPLAY_EMOTE_HERO_05_THINK2	Me pregunto...	
GAMEPLAY_EMOTE_HERO_05_THINK3	Mmm...	
GAMEPLAY_EMOTE_HERO_05_THREATEN	¡Yo te daré caza!	
GAMEPLAY_EMOTE_HERO_05_TIMER	¡El tiempo vuela!	
GAMEPLAY_EMOTE_HERO_05_WELL_PLAYED	Bien jugado.	
GAMEPLAY_EMOTE_HERO_05_WINTERVEIL_GREETINGS	¡Feliz festín del Festival de Invierno!	
GAMEPLAY_EMOTE_HERO_05_WOW	¡Brillante!	
GAMEPLAY_EMOTE_HERO_05A_CONCEDE	¡Qué habilidad! Me rindo.	
GAMEPLAY_EMOTE_HERO_05A_ERROR_FULL_MINIONS	Tengo demasiados esbirros.	
GAMEPLAY_EMOTE_HERO_05A_ERROR_GENERIC	No puedo hacer eso.	
GAMEPLAY_EMOTE_HERO_05A_ERROR_HAND_FULL	¡Mi mano está llena!	
GAMEPLAY_EMOTE_HERO_05A_ERROR_I_ATTACKED	Ya he atacado.	
GAMEPLAY_EMOTE_HERO_05A_ERROR_JUST_PLAYED	Ese esbirro necesita un turno para prepararse.	
GAMEPLAY_EMOTE_HERO_05A_ERROR_MINION_ATTACKED	Ese esbirro ya ha atacado.	
GAMEPLAY_EMOTE_HERO_05A_ERROR_NEED_MANA	No tengo suficiente maná.	
GAMEPLAY_EMOTE_HERO_05A_ERROR_NEED_WEAPON	Necesito un arma.	
GAMEPLAY_EMOTE_HERO_05A_ERROR_PLAY	No puedo jugar eso.	
GAMEPLAY_EMOTE_HERO_05A_ERROR_STEALTH	No puedo seleccionar a esbirros en sigilo.	
GAMEPLAY_EMOTE_HERO_05A_ERROR_TARGET	No es un objetivo válido.	
GAMEPLAY_EMOTE_HERO_05A_ERROR_TAUNT	Debo atacar al esbirro con Provocar.	
GAMEPLAY_EMOTE_HERO_05A_EVENT_LUNAR_NEW_YEAR	Saludos, viajero.	
GAMEPLAY_EMOTE_HERO_05A_GOOD_GAME	Buena partida.	
GAMEPLAY_EMOTE_HERO_05A_GREETINGS	Hola, contrincante.	
GAMEPLAY_EMOTE_HERO_05A_LOW_CARDS	¡Casi no me quedan cartas!	
GAMEPLAY_EMOTE_HERO_05A_MIRROR_START	Yo nunca tiemblo.	
GAMEPLAY_EMOTE_HERO_05A_NO_CARDS	¡No me quedan cartas!	
GAMEPLAY_EMOTE_HERO_05A_OOPS	Ha sido un error.	
GAMEPLAY_EMOTE_HERO_05A_SORRY	Lo lamento.	
GAMEPLAY_EMOTE_HERO_05A_START	¡Tiembla ante el poder de los elfos!	
GAMEPLAY_EMOTE_HERO_05A_THANKS	Gracias.	
GAMEPLAY_EMOTE_HERO_05A_THINK1	Mmm...	
GAMEPLAY_EMOTE_HERO_05A_THINK2	¿A quién disparo?	
GAMEPLAY_EMOTE_HERO_05A_THINK3	¿Qué hago ahora?	
GAMEPLAY_EMOTE_HERO_05A_THREATEN	¡Mi venganza será definitiva!	
GAMEPLAY_EMOTE_HERO_05A_TIMER	¡Debo actuar!	
GAMEPLAY_EMOTE_HERO_05A_WELL_PLAYED	Bien jugado.	
GAMEPLAY_EMOTE_HERO_05A_WINTERVEIL_GREETING	Feliz Festival de Invierno.	
GAMEPLAY_EMOTE_HERO_05A_WOW	¡Increíble!	
GAMEPLAY_EMOTE_HERO_06_CONCEDE	Admito la derrota.	
GAMEPLAY_EMOTE_HERO_06_ERROR_FULL_MINIONS	Tengo demasiados esbirros.	
GAMEPLAY_EMOTE_HERO_06_ERROR_GENERIC	No puedo hacer eso.	
GAMEPLAY_EMOTE_HERO_06_ERROR_HAND_FULL	¡Mi mano está llena!	
GAMEPLAY_EMOTE_HERO_06_ERROR_I_ATTACKED	Ya he atacado.	
GAMEPLAY_EMOTE_HERO_06_ERROR_JUST_PLAYED	El esbirro necesita un turno para prepararse.	
GAMEPLAY_EMOTE_HERO_06_ERROR_MINION_ATTACKED	Ese esbirro ya ha atacado.	
GAMEPLAY_EMOTE_HERO_06_ERROR_NEED_MANA	No tengo suficiente maná.	
GAMEPLAY_EMOTE_HERO_06_ERROR_NEED_WEAPON	Necesito un arma.	
GAMEPLAY_EMOTE_HERO_06_ERROR_PLAY	No puedo jugar eso.	
GAMEPLAY_EMOTE_HERO_06_ERROR_STEALTH	No puedo seleccionar a esbirros en sigilo.	
GAMEPLAY_EMOTE_HERO_06_ERROR_TARGET	No es un objetivo válido.	
GAMEPLAY_EMOTE_HERO_06_ERROR_TAUNT	Se interpone un esbirro con Provocar.	
GAMEPLAY_EMOTE_HERO_06_EVENT_LUNAR_NEW_YEAR	Saludos.	
GAMEPLAY_EMOTE_HERO_06_GOOD_GAME	¡Buena partida!	
GAMEPLAY_EMOTE_HERO_06_GREETINGS	Saludos.	
GAMEPLAY_EMOTE_HERO_06_LOW_CARDS	¡Casi no me quedan cartas!	
GAMEPLAY_EMOTE_HERO_06_MIRROR_START	¡Hay que proteger la naturaleza!	
GAMEPLAY_EMOTE_HERO_06_NO_CARDS	¡No me quedan cartas!	
GAMEPLAY_EMOTE_HERO_06_OOPS	Un error natural...	
GAMEPLAY_EMOTE_HERO_06_SORRY	Lo siento mucho.	
GAMEPLAY_EMOTE_HERO_06_START	Protegeré los bosques.	
GAMEPLAY_EMOTE_HERO_06_START_TYRANDE	Mi querida Tyrande.	
GAMEPLAY_EMOTE_HERO_06_THANKS	Te lo agradezco.	
GAMEPLAY_EMOTE_HERO_06_THINK1	Mmm...	
GAMEPLAY_EMOTE_HERO_06_THINK2	Mmm... Me pregunto...	
GAMEPLAY_EMOTE_HERO_06_THINK3	Qué hacer...	
GAMEPLAY_EMOTE_HERO_06_THREATEN	¡La Naturaleza te destruirá!	
GAMEPLAY_EMOTE_HERO_06_TIMER	¡El tiempo no espera!	
GAMEPLAY_EMOTE_HERO_06_WELL_PLAYED	Has jugado bien.	
GAMEPLAY_EMOTE_HERO_06_WINTERVEIL_GREETINGS	Feliz festín del Festival de Invierno.	
GAMEPLAY_EMOTE_HERO_06_WOW	¡Espectacular!	
GAMEPLAY_EMOTE_HERO_07_CONCEDE	Esta vez ganas tú...	
GAMEPLAY_EMOTE_HERO_07_ERROR_FULL_MINIONS	Tengo demasiados esbirros.	
GAMEPLAY_EMOTE_HERO_07_ERROR_GENERIC	No puedo hacer eso.	
GAMEPLAY_EMOTE_HERO_07_ERROR_HAND_FULL	¡Mi mano está llena!	
GAMEPLAY_EMOTE_HERO_07_ERROR_I_ATTACKED	Ya he atacado.	
GAMEPLAY_EMOTE_HERO_07_ERROR_JUST_PLAYED	El esbirro necesita un turno para prepararse.	
GAMEPLAY_EMOTE_HERO_07_ERROR_MINION_ATTACKED	Ese esbirro ya ha atacado.	
GAMEPLAY_EMOTE_HERO_07_ERROR_NEED_MANA	No tengo suficiente maná.	
GAMEPLAY_EMOTE_HERO_07_ERROR_NEED_WEAPON	Necesito un arma.	
GAMEPLAY_EMOTE_HERO_07_ERROR_PLAY	No puedo jugar eso.	
GAMEPLAY_EMOTE_HERO_07_ERROR_STEALTH	No puedo seleccionar a esbirros en sigilo.	
GAMEPLAY_EMOTE_HERO_07_ERROR_TARGET	No es un objetivo válido.	
GAMEPLAY_EMOTE_HERO_07_ERROR_TAUNT	Se interpone un esbirro con Provocar.	
GAMEPLAY_EMOTE_HERO_07_EVENT_LUNAR_NEW_YEAR	Te saludo.	
GAMEPLAY_EMOTE_HERO_07_GOOD_GAME	¡Buena partida!	
GAMEPLAY_EMOTE_HERO_07_GREETINGS	Te saludo.	
GAMEPLAY_EMOTE_HERO_07_LOW_CARDS	Me quedan pocas cartas.	
GAMEPLAY_EMOTE_HERO_07_MIRROR_START	¡Soy tu pesadilla!	
GAMEPLAY_EMOTE_HERO_07_NO_CARDS	¡No me quedan cartas!	
GAMEPLAY_EMOTE_HERO_07_OOPS	Ha sido un error.	
GAMEPLAY_EMOTE_HERO_07_SORRY	Lo siento.	
GAMEPLAY_EMOTE_HERO_07_START	¡Tu alma será mía!	
GAMEPLAY_EMOTE_HERO_07_THANKS	Gracias.	
GAMEPLAY_EMOTE_HERO_07_THINK1	Mmm...	
GAMEPLAY_EMOTE_HERO_07_THINK2	Me pregunto...	
GAMEPLAY_EMOTE_HERO_07_THINK3	Tantas posibilidades...	
GAMEPLAY_EMOTE_HERO_07_THREATEN	¡Tu alma sufrirá!	
GAMEPLAY_EMOTE_HERO_07_TIMER	¡Me queda poco tiempo!	
GAMEPLAY_EMOTE_HERO_07_WELL_PLAYED	Bien jugado.	
GAMEPLAY_EMOTE_HERO_07_WINTERVEIL_GREETINGS	Feliz festín del Festival de Invierno...	
GAMEPLAY_EMOTE_HERO_07_WOW	¡Extraordinario!	
GAMEPLAY_EMOTE_HERO_08_CONCEDE	Esta vez ganas tú...	
GAMEPLAY_EMOTE_HERO_08_ERROR_FULL_MINIONS	Tengo demasiados esbirros.	
GAMEPLAY_EMOTE_HERO_08_ERROR_GENERIC	No puedo hacer eso.	
GAMEPLAY_EMOTE_HERO_08_ERROR_HAND_FULL	¡Mi mano está llena!	
GAMEPLAY_EMOTE_HERO_08_ERROR_I_ATTACKED	Ya he atacado.	
GAMEPLAY_EMOTE_HERO_08_ERROR_JUST_PLAYED	El esbirro necesita un turno para prepararse.	
GAMEPLAY_EMOTE_HERO_08_ERROR_MINION_ATTACKED	Ese esbirro ya ha atacado.	
GAMEPLAY_EMOTE_HERO_08_ERROR_NEED_MANA	No tengo suficiente maná.	
GAMEPLAY_EMOTE_HERO_08_ERROR_NEED_WEAPON	Necesito un arma.	
GAMEPLAY_EMOTE_HERO_08_ERROR_PLAY	No puedo jugar eso.	
GAMEPLAY_EMOTE_HERO_08_ERROR_STEALTH	No puedo seleccionar a esbirros en sigilo.	
GAMEPLAY_EMOTE_HERO_08_ERROR_TARGET	No es un objetivo válido.	
GAMEPLAY_EMOTE_HERO_08_ERROR_TAUNT	Se interpone un esbirro con Provocar.	
GAMEPLAY_EMOTE_HERO_08_EVENT_LUNAR_NEW_YEAR	¡Hola!	
GAMEPLAY_EMOTE_HERO_08_GOOD_GAME	¡Buena partida!	
GAMEPLAY_EMOTE_HERO_08_GREETINGS	¡Hola!	
GAMEPLAY_EMOTE_HERO_08_LOW_CARDS	¡Casi no me quedan cartas!	
GAMEPLAY_EMOTE_HERO_08_MIRROR_START	Oh, prepárate.	
GAMEPLAY_EMOTE_HERO_08_NO_CARDS	¡No me quedan cartas!	
GAMEPLAY_EMOTE_HERO_08_OOPS	¡Uy!	
GAMEPLAY_EMOTE_HERO_08_SORRY	Lo siento.	
GAMEPLAY_EMOTE_HERO_08_START	Tú lo has querido.	
GAMEPLAY_EMOTE_HERO_08_THANKS	Gracias.	
GAMEPLAY_EMOTE_HERO_08_THINK1	Mmm...	
GAMEPLAY_EMOTE_HERO_08_THINK2	Me pregunto...	
GAMEPLAY_EMOTE_HERO_08_THINK3	Qué hacer, qué hacer...	
GAMEPLAY_EMOTE_HERO_08_THREATEN	¡Mi magia te hará pedazos!	
GAMEPLAY_EMOTE_HERO_08_TIMER	Se me acaba el tiempo...	
GAMEPLAY_EMOTE_HERO_08_WELL_PLAYED	Bien jugado.	
GAMEPLAY_EMOTE_HERO_08_WINTERVEIL_GREETINGS	¡Feliz festín del Festival de Invierno!	
GAMEPLAY_EMOTE_HERO_08_WOW	¡Increíble!	
GAMEPLAY_EMOTE_HERO_08A_CONCEDE	Jaque mate. Bien hecho.	
GAMEPLAY_EMOTE_HERO_08A_ERROR_FULL_MINIONS	¡Tengo demasiados esbirros!	
GAMEPLAY_EMOTE_HERO_08A_ERROR_GENERIC	No puedo hacer eso.	
GAMEPLAY_EMOTE_HERO_08A_ERROR_HAND_FULL	¡Mi mano está llena!	
GAMEPLAY_EMOTE_HERO_08A_ERROR_I_ATTACKED	Ya he atacado.	
GAMEPLAY_EMOTE_HERO_08A_ERROR_JUST_PLAYED	Ese esbirro necesita un turno para prepararse.	
GAMEPLAY_EMOTE_HERO_08A_ERROR_MINION_ATTACKED	Ese esbirro ya ha atacado.	
GAMEPLAY_EMOTE_HERO_08A_ERROR_NEED_MANA	No tengo suficiente maná.	
GAMEPLAY_EMOTE_HERO_08A_ERROR_NEED_WEAPON	Necesito un arma.	
GAMEPLAY_EMOTE_HERO_08A_ERROR_PLAY	No puedo jugar eso.	
GAMEPLAY_EMOTE_HERO_08A_ERROR_STEALTH	No puedo seleccionar a esbirros en sigilo.	
GAMEPLAY_EMOTE_HERO_08A_ERROR_TARGET	No es un objetivo válido.	
GAMEPLAY_EMOTE_HERO_08A_ERROR_TAUNT	Debo atacar al esbirro con Provocar.	
GAMEPLAY_EMOTE_HERO_08A_GOOD_GAME	Buena partida.	
GAMEPLAY_EMOTE_HERO_08A_GREETINGS	Ah, un placer.	
GAMEPLAY_EMOTE_HERO_08A_LOW_CARDS	¡Casi no me quedan cartas!	
GAMEPLAY_EMOTE_HERO_08A_LUNAR_NEW_YEAR	Ah, un placer.	
GAMEPLAY_EMOTE_HERO_08A_MIRROR_START	Ya ha empezado.	
GAMEPLAY_EMOTE_HERO_08A_NO_CARDS	¡No me quedan cartas!	
GAMEPLAY_EMOTE_HERO_08A_OOPS	Ha sido un error.	
GAMEPLAY_EMOTE_HERO_08A_SORRY	Mis más sinceras disculpas.	
GAMEPLAY_EMOTE_HERO_08A_START	¡Que empiece la partida!	
GAMEPLAY_EMOTE_HERO_08A_THANKS	Te lo agradezco.	
GAMEPLAY_EMOTE_HERO_08A_THINK1	Mmm...	
GAMEPLAY_EMOTE_HERO_08A_THINK2	Interesante...	
GAMEPLAY_EMOTE_HERO_08A_THINK3	Quizás...	
GAMEPLAY_EMOTE_HERO_08A_THREATEN	¡Nada me detendrá! ¡Nada!	
GAMEPLAY_EMOTE_HERO_08A_TIMER	¡No debo confiarme!	
GAMEPLAY_EMOTE_HERO_08A_WELL_PLAYED	Bien jugado.	
GAMEPLAY_EMOTE_HERO_08A_WINTERVEIL_GREETINGS	Feliz Festival de Invierno.	
GAMEPLAY_EMOTE_HERO_08A_WOW	¡Es increíble!	
GAMEPLAY_EMOTE_HERO_08B_CONCEDE	Bien hecho. Tú ganas.	
GAMEPLAY_EMOTE_HERO_08B_ERROR_FULL_MINIONS	Tengo demasiados esbirros.	
GAMEPLAY_EMOTE_HERO_08B_ERROR_GENERIC	No puedo hacer eso.	
GAMEPLAY_EMOTE_HERO_08B_ERROR_HAND_FULL	¡Mi mano está llena!	
GAMEPLAY_EMOTE_HERO_08B_ERROR_I_ATTACKED	Ya he atacado.	
GAMEPLAY_EMOTE_HERO_08B_ERROR_JUST_PLAYED	El esbirro necesita un turno para prepararse.	
GAMEPLAY_EMOTE_HERO_08B_ERROR_MINION_ATTACKED	Ese esbirro ya ha atacado.	
GAMEPLAY_EMOTE_HERO_08B_ERROR_NEED_MANA	No tengo suficiente maná.	
GAMEPLAY_EMOTE_HERO_08B_ERROR_NEED_WEAPON	Necesito un arma.	
GAMEPLAY_EMOTE_HERO_08B_ERROR_PLAY	No puedo jugar eso.	
GAMEPLAY_EMOTE_HERO_08B_ERROR_STEALTH	No puedo seleccionar a esbirros en sigilo.	
GAMEPLAY_EMOTE_HERO_08B_ERROR_TARGET	No es un objetivo válido.	
GAMEPLAY_EMOTE_HERO_08B_ERROR_TAUNT	Se interpone un esbirro con Provocar.	
GAMEPLAY_EMOTE_HERO_08B_GOOD_GAME	Bueno. ¡Ha sido una buena partida!	
GAMEPLAY_EMOTE_HERO_08B_GREETINGS	Saludos, adalid de la verdad.	
GAMEPLAY_EMOTE_HERO_08B_LOW_CARDS	Casi no me quedan cartas.	
GAMEPLAY_EMOTE_HERO_08B_LUNAR_NEW_YEAR	Saludos, adalid de la verdad.	
GAMEPLAY_EMOTE_HERO_08B_MIRROR_START	Ojalá aprendamos mucho juntos.	
GAMEPLAY_EMOTE_HERO_08B_NO_CARDS	¡No me quedan cartas!	
GAMEPLAY_EMOTE_HERO_08B_OOPS	Vaya... Ups.	
GAMEPLAY_EMOTE_HERO_08B_SORRY	Oh, vaya. Lo siento.	
GAMEPLAY_EMOTE_HERO_08B_START	El conocimiento es poder.	
GAMEPLAY_EMOTE_HERO_08B_THANKS	Muchas gracias.	
GAMEPLAY_EMOTE_HERO_08B_THINK1	Mmm...	
GAMEPLAY_EMOTE_HERO_08B_THINK2	Observa y reflexiona...	
GAMEPLAY_EMOTE_HERO_08B_THINK3	Debe haber una forma…	
GAMEPLAY_EMOTE_HERO_08B_THREATEN	¡Es hora de que aprendas, insolente!	
GAMEPLAY_EMOTE_HERO_08B_TIMER	¡Se acaba el tiempo!	
GAMEPLAY_EMOTE_HERO_08B_WELL_PLAYED	Bien jugado.	
GAMEPLAY_EMOTE_HERO_08B_WINTERVEIL_GREETINGS	¡Feliz festín del Festival de Invierno!	
GAMEPLAY_EMOTE_HERO_08B_WOW	¡Maravilloso!	
GAMEPLAY_EMOTE_HERO_09_CONCEDE	Me has vencido.	
GAMEPLAY_EMOTE_HERO_09_ERROR_FULL_MINIONS	Tengo demasiados esbirros.	
GAMEPLAY_EMOTE_HERO_09_ERROR_GENERIC	No puedo hacer eso.	
GAMEPLAY_EMOTE_HERO_09_ERROR_HAND_FULL	¡Mi mano está llena!	
GAMEPLAY_EMOTE_HERO_09_ERROR_I_ATTACKED	Ya he atacado.	
GAMEPLAY_EMOTE_HERO_09_ERROR_JUST_PLAYED	El esbirro necesita un turno para prepararse.	
GAMEPLAY_EMOTE_HERO_09_ERROR_MINION_ATTACKED	Ese esbirro ya ha atacado.	
GAMEPLAY_EMOTE_HERO_09_ERROR_NEED_MANA	No tengo suficiente maná.	
GAMEPLAY_EMOTE_HERO_09_ERROR_NEED_WEAPON	Necesito un arma.	
GAMEPLAY_EMOTE_HERO_09_ERROR_PLAY	No puedo jugar eso.	
GAMEPLAY_EMOTE_HERO_09_ERROR_STEALTH	No puedo seleccionar a esbirros en sigilo.	
GAMEPLAY_EMOTE_HERO_09_ERROR_TARGET	No es un objetivo válido.	
GAMEPLAY_EMOTE_HERO_09_ERROR_TAUNT	Se interpone un esbirro con Provocar.	
GAMEPLAY_EMOTE_HERO_09_EVENT_LUNAR_NEW_YEAR	¡Saludos!	
GAMEPLAY_EMOTE_HERO_09_GOOD_GAME	¡Buena partida!	
GAMEPLAY_EMOTE_HERO_09_GREETINGS	¡Saludos!	
GAMEPLAY_EMOTE_HERO_09_LOW_CARDS	¡Casi me he quedado sin cartas!	
GAMEPLAY_EMOTE_HERO_09_MIRROR_START	¡La Luz sonríe a los justos!	
GAMEPLAY_EMOTE_HERO_09_NO_CARDS	¡No me quedan cartas!	
GAMEPLAY_EMOTE_HERO_09_OOPS	No es lo que tenía planeado...	
GAMEPLAY_EMOTE_HERO_09_SORRY	Discúlpame.	
GAMEPLAY_EMOTE_HERO_09_START	¡La Luz me concederá la victoria!	
GAMEPLAY_EMOTE_HERO_09_THANKS	Gracias.	
GAMEPLAY_EMOTE_HERO_09_THINK1	Mmm...	
GAMEPLAY_EMOTE_HERO_09_THINK2	Me pregunto...	
GAMEPLAY_EMOTE_HERO_09_THINK3	Debo considerar...	
GAMEPLAY_EMOTE_HERO_09_THREATEN	¡La Luz te consumirá!	
GAMEPLAY_EMOTE_HERO_09_TIMER	¡Debo decidirme ya!	
GAMEPLAY_EMOTE_HERO_09_WELL_PLAYED	Bien jugado.	
GAMEPLAY_EMOTE_HERO_09_WINTERVEIL_GREETINGS	¡Feliz festín del Festival de Invierno!	
GAMEPLAY_EMOTE_HERO_09_WOW	¡Vaya!	
GAMEPLAY_EMOTE_HERO_TBKTRAF_KT_CONCEDE	Vol... veré...	
GAMEPLAY_EMOTE_HERO_TBKTRAF_KT_GREETINGS	Por fin nos encontramos.	
GAMEPLAY_EMOTE_HERO_TBKTRAF_KT_LOW_CARDS	¡Me estoy quedando sin cartas!	
GAMEPLAY_EMOTE_HERO_TBKTRAF_KT_NO_CARDS	¡No! ¡Yo te maldigo, insolente!	
GAMEPLAY_EMOTE_HERO_TBKTRAF_KT_OOPS	Ay... Vuelta al punto de partida...	
GAMEPLAY_EMOTE_HERO_TBKTRAF_KT_SORRY	¡No! ¡Yo te maldigo, insolente!	
GAMEPLAY_EMOTE_HERO_TBKTRAF_KT_START	¡Enfréntate a mí, miserable!	
GAMEPLAY_EMOTE_HERO_TBKTRAF_KT_THANKS	De... ¿nada?	
GAMEPLAY_EMOTE_HERO_TBKTRAF_KT_THINK1	¿Quizás?	
GAMEPLAY_EMOTE_HERO_TBKTRAF_KT_THINK2	Sí... ¡Sí!	
GAMEPLAY_EMOTE_HERO_TBKTRAF_KT_THINK3	¿Qué te parece, Baldomero?	
GAMEPLAY_EMOTE_HERO_TBKTRAF_KT_THREATEN	¡Congelaré la sangre que corre por tus venas!	
GAMEPLAY_EMOTE_HERO_TBKTRAF_KT_WELL_PLAYED	Claro que he jugado bien. ¡Soy el maldito Kel'Thuzad!	
GAMEPLAY_EMOTE_HERO_TBKTRAF_RAF_CONCEDE	¡NO! ¡NO PODÉIS DERROTARME!	
GAMEPLAY_EMOTE_HERO_TBKTRAF_RAF_GREETINGS	Saludos, expedicionario.	
GAMEPLAY_EMOTE_HERO_TBKTRAF_RAF_LOW_CARDS	¡Me estoy quedando sin cartas!	
GAMEPLAY_EMOTE_HERO_TBKTRAF_RAF_NO_CARDS	¡Mis magníficos tesoros!	
GAMEPLAY_EMOTE_HERO_TBKTRAF_RAF_OOPS	¡Error!	
GAMEPLAY_EMOTE_HERO_TBKTRAF_RAF_SORRY	Me das pena.	
GAMEPLAY_EMOTE_HERO_TBKTRAF_RAF_START	¡RAFAAM! ¡EL ARQUEÓLOGO SUPREMO!	
GAMEPLAY_EMOTE_HERO_TBKTRAF_RAF_THANKS	Ah, gracias.	
GAMEPLAY_EMOTE_HERO_TBKTRAF_RAF_THINK1	Mmm...	
GAMEPLAY_EMOTE_HERO_TBKTRAF_RAF_THINK2	¿Cuál coger?	
GAMEPLAY_EMOTE_HERO_TBKTRAF_RAF_THINK3	Tentador...	
GAMEPLAY_EMOTE_HERO_TBKTRAF_RAF_THREATEN	¡PODER ABRUMADOR!	
GAMEPLAY_EMOTE_HERO_TBKTRAF_RAF_WELL_PLAYED	Bien hecho...	
GAMEPLAY_EMOTE_HERO_TBMECHWAR01_CONCEDE	<Me rindo.>	The text is in brackets because the VO files is just Annoy-o-Tron's greeting
GAMEPLAY_EMOTE_HERO_TBMECHWAR01_ERROR_FULL_MINIONS	<¡Error!>	The text is in brackets because the VO files is just Annoy-o-Tron's greeting
GAMEPLAY_EMOTE_HERO_TBMECHWAR01_ERROR_HAND_FULL	<¡Error!>	The text is in brackets because the VO files is just Annoy-o-Tron's greeting
GAMEPLAY_EMOTE_HERO_TBMECHWAR01_ERROR_I_ATTACKED	<¡Error!>	The text is in brackets because the VO files is just Annoy-o-Tron's greeting
GAMEPLAY_EMOTE_HERO_TBMECHWAR01_ERROR_JUST_PLAYED	<¡Error!>	The text is in brackets because the VO files is just Annoy-o-Tron's greeting
GAMEPLAY_EMOTE_HERO_TBMECHWAR01_ERROR_MINION_ATTACKED	<¡Error!>	The text is in brackets because the VO files is just Annoy-o-Tron's greeting
GAMEPLAY_EMOTE_HERO_TBMECHWAR01_ERROR_NEED_MANA	<¡Error!>	The text is in brackets because the VO files is just Annoy-o-Tron's greeting
GAMEPLAY_EMOTE_HERO_TBMECHWAR01_ERROR_NEED_WEAPON	<¡Error!>	The text is in brackets because the VO files is just Annoy-o-Tron's greeting
GAMEPLAY_EMOTE_HERO_TBMECHWAR01_ERROR_PLAY	<¡Error!>	The text is in brackets because the VO files is just Annoy-o-Tron's greeting
GAMEPLAY_EMOTE_HERO_TBMECHWAR01_ERROR_STEALTH	<¡Error!>	The text is in brackets because the VO files is just Annoy-o-Tron's greeting
GAMEPLAY_EMOTE_HERO_TBMECHWAR01_ERROR_TARGET	<¡Error!>	The text is in brackets because the VO files is just Annoy-o-Tron's greeting
GAMEPLAY_EMOTE_HERO_TBMECHWAR01_ERROR_TAUNT	<¡Error!>	The text is in brackets because the VO files is just Annoy-o-Tron's greeting
GAMEPLAY_EMOTE_HERO_TBMECHWAR01_GREETINGS	<Saludos.>	The text is in brackets because the VO files is just Annoy-o-Tron's greeting
GAMEPLAY_EMOTE_HERO_TBMECHWAR01_LOW_CARDS	<Pocas cartas.>	The text is in brackets because the VO files is just Annoy-o-Tron's greeting
GAMEPLAY_EMOTE_HERO_TBMECHWAR01_NO_CARDS	<Sin cartas.>	The text is in brackets because the VO files is just Annoy-o-Tron's greeting
GAMEPLAY_EMOTE_HERO_TBMECHWAR01_OOPS	<Error.>	The text is in brackets because the VO files is just Annoy-o-Tron's greeting
GAMEPLAY_EMOTE_HERO_TBMECHWAR01_SORRY	<Perdón.>	The text is in brackets because the VO files is just Annoy-o-Tron's greeting
GAMEPLAY_EMOTE_HERO_TBMECHWAR01_START	<Empezar.>	The text is in brackets because the VO files is just Annoy-o-Tron's greeting
GAMEPLAY_EMOTE_HERO_TBMECHWAR01_THANKS	<Gracias.>	The text is in brackets because the VO files is just Annoy-o-Tron's greeting
GAMEPLAY_EMOTE_HERO_TBMECHWAR01_THINK1	<Procesando...>	The text is in brackets because the VO files is just Annoy-o-Tron's greeting
GAMEPLAY_EMOTE_HERO_TBMECHWAR01_THINK2	<Estableciendo objetivo...>	The text is in brackets because the VO files is just Annoy-o-Tron's greeting
GAMEPLAY_EMOTE_HERO_TBMECHWAR01_THINK3	<Desperdiciando ciclos...>	The text is in brackets because the VO files is just Annoy-o-Tron's greeting
GAMEPLAY_EMOTE_HERO_TBMECHWAR01_THREATEN	<Amenaza.>	The text is in brackets because the VO files is just Annoy-o-Tron's attack
GAMEPLAY_EMOTE_HERO_TBMECHWAR01_TIMER	<Poco tiempo.>	The text is in brackets because the VO files is just Annoy-o-Tron's greeting
GAMEPLAY_EMOTE_HERO_TBMECHWAR01_WELL_PLAYED	<Bien jugado.>	The text is in brackets because the VO files is just Annoy-o-Tron's greeting
GAMEPLAY_EMOTE_HERO_TBMECHWAR01_WOW	<¡Increíble!>	The text is in brackets because the VO files is just Annoy-o-Tron's greeting
GAMEPLAY_EMOTE_HERO_TBMECHWAR02_CONCEDE	<Terminar sesión.>	The text is in brackets because the VO files is just Boom Bot's greeting
GAMEPLAY_EMOTE_HERO_TBMECHWAR02_ERROR_FULL_MINIONS	<¡Error!>	The text is in brackets because the VO files is just Boom Bot's greeting
GAMEPLAY_EMOTE_HERO_TBMECHWAR02_ERROR_HAND_FULL	<¡Error!>	The text is in brackets because the VO files is just Boom Bot's greeting
GAMEPLAY_EMOTE_HERO_TBMECHWAR02_ERROR_I_ATTACKED	<¡Error!>	The text is in brackets because the VO files is just Boom Bot's greeting
GAMEPLAY_EMOTE_HERO_TBMECHWAR02_ERROR_JUST_PLAYED	<¡Error!>	The text is in brackets because the VO files is just Boom Bot's greeting
GAMEPLAY_EMOTE_HERO_TBMECHWAR02_ERROR_MINION_ATTACKED	<¡Error!>	The text is in brackets because the VO files is just Boom Bot's greeting
GAMEPLAY_EMOTE_HERO_TBMECHWAR02_ERROR_NEED_MANA	<¡Error!>	The text is in brackets because the VO files is just Boom Bot's greeting
GAMEPLAY_EMOTE_HERO_TBMECHWAR02_ERROR_NEED_WEAPON	<¡Error!>	The text is in brackets because the VO files is just Boom Bot's greeting
GAMEPLAY_EMOTE_HERO_TBMECHWAR02_ERROR_PLAY	<¡Error!>	The text is in brackets because the VO files is just Boom Bot's greeting
GAMEPLAY_EMOTE_HERO_TBMECHWAR02_ERROR_STEALTH	<¡Error!>	The text is in brackets because the VO files is just Boom Bot's greeting
GAMEPLAY_EMOTE_HERO_TBMECHWAR02_ERROR_TARGET	<¡Error!>	The text is in brackets because the VO files is just Boom Bot's greeting
GAMEPLAY_EMOTE_HERO_TBMECHWAR02_ERROR_TAUNT	<¡Error!>	The text is in brackets because the VO files is just Boom Bot's greeting
GAMEPLAY_EMOTE_HERO_TBMECHWAR02_GREETINGS	<Saludos.>	The text is in brackets because the VO files is just Annoy-o-Tron's greeting
GAMEPLAY_EMOTE_HERO_TBMECHWAR02_LOW_CARDS	<Pocas cartas.>	The text is in brackets because the VO files is just Boom Bot's greeting
GAMEPLAY_EMOTE_HERO_TBMECHWAR02_NO_CARDS	<¡Sin cartas!>	The text is in brackets because the VO files is just Boom Bot's greeting
GAMEPLAY_EMOTE_HERO_TBMECHWAR02_OOPS	<¡Error!>	The text is in brackets because the VO files is just Boom Bot's greeting
GAMEPLAY_EMOTE_HERO_TBMECHWAR02_SORRY	<Disculpas.>	The text is in brackets because the VO files is just Boom Bot's greeting
GAMEPLAY_EMOTE_HERO_TBMECHWAR02_START	<Iniciar.>	The text is in brackets because the VO files is just Boom Bot's greeting
GAMEPLAY_EMOTE_HERO_TBMECHWAR02_THANKS	<Gracias.>	The text is in brackets because the VO files is just Boom Bot's greeting
GAMEPLAY_EMOTE_HERO_TBMECHWAR02_THINK1	<Procesando...>	The text is in brackets because the VO files is just Boom Bot's greeting
GAMEPLAY_EMOTE_HERO_TBMECHWAR02_THINK2	<Estableciendo objetivo...>	The text is in brackets because the VO files is just Boom Bot's greeting
GAMEPLAY_EMOTE_HERO_TBMECHWAR02_THINK3	<Desperdiciando ciclos...>	The text is in brackets because the VO files is just Boom Bot's greeting
GAMEPLAY_EMOTE_HERO_TBMECHWAR02_THREATEN	<¡Amenaza!>	The text is in brackets because the VO files is just Boom Bot's Attack sound
GAMEPLAY_EMOTE_HERO_TBMECHWAR02_TIMER	<Poco tiempo.>	The text is in brackets because the VO files is just Boom Bot's greeting
GAMEPLAY_EMOTE_HERO_TBMECHWAR02_WELL_PLAYED	<Bien jugado.>	The text is in brackets because the VO files is just Boom Bot's greeting
GAMEPLAY_EMOTE_HERO_TBMECHWAR02_WOW	<¡Brillante!>	The text is in brackets because the VO files is just Annoy-o-Tron's greeting
VO_BRM_027h__LUNAR_NEW_YEAR	¡QUE EL FUEGO TE PURIFIQUE!	
VO_BRM_027h_Attack_15	¡PRUEBA LAS LLAMAS DE SULFURON!	
VO_BRM_027h_Concede_11	¡TÚ GANAS! ¡BUENA PARTIDA!	
VO_BRM_027h_Emote_Start	¡Obtendré mi venganza, dragón!	
VO_BRM_027h_ERROR01_51	¡NECESITO UN ARMA!	
VO_BRM_027h_ERROR02_52	¡FALTA MANÁ!	
VO_BRM_027h_ERROR03_53	YA HA ATACADO.	
VO_BRM_027h_ERROR04_54	YA HE ATACADO.	
VO_BRM_027h_ERROR05_55	LOS MORTALES NECESITAN UN TURNO PARA PREPARARSE.	
VO_BRM_027h_ERROR06_56	DEMASIADAS CARTAS.	
VO_BRM_027h_ERROR07_57	¡¡DEMASIADOS ESBIRROS!!	
VO_BRM_027h_ERROR08_58	ESTÁ EN SIGILO.	
VO_BRM_027h_ERROR09_59	¡NO PUEDO JUGAR ESO!	
VO_BRM_027h_ERROR10_60	¡NO ES VÁLIDO!	
VO_BRM_027h_ERROR11_61	EL ESBIRRO CON PROVOCAR SE INTERPONE.	
VO_BRM_027h_ERROR12_62	¡NO PUEDO HACER ESO!	
VO_BRM_027h_GG_16	¡BUENA PARTIDA!	
VO_BRM_027h_Greetings_04	¡QUE EL FUEGO TE PURIFIQUE!	
VO_BRM_027h_HAPPY_NEW_YEAR_38	¡CONTEMPLARÉ EL AÑO NUEVO EN LLAMAS!	
VO_BRM_027h_LowCards_49	HE QUEMADO CASI TODAS MIS CARTAS.	
VO_BRM_027h_NoCards_50	HE QUEMADO TODAS MIS CARTAS.	
VO_BRM_027h_Oops_07	¡AH! ¡UN ERROR!	
VO_BRM_027h_Sorry_10	LO SIENTO.	
VO_BRM_027h_Thanks_09	MIS MÁS CÁLIDAS GRACIAS.	
VO_BRM_027h_Thinking1_12	MMMM...	
VO_BRM_027h_Thinking2_13	ME PREGUNTO...	
VO_BRM_027h_Thinking3_14	QUÉ QUEMAR PRIMERO...	
VO_BRM_027h_Threaten_08	¡FALLECERÁS EN LAS LLAMAS!	
VO_BRM_027h_Time_48	¡EL TIEMPO SE ESFUMA!	
VO_BRM_027h_Well_Played_06	BIEN JUGADO.	
VO_BRM_027h_Winterveil_Greetings	¡EL INVIERNO DEBERÍA SER MÁS CÁLIDO!	
VO_BRM_027h_WOW_20	¡FLAMANTE!	
VO_HERO_09a_Attack_15	¡Por Elune!	
VO_HERO_09a_CONCEDE_06	Aquí acaba. Tú ganas.	
VO_HERO_09a_ERROR_FULL_MINIONS_25	¡Tengo demasiados esbirros!	
VO_HERO_09a_ERROR_GENERIC_30	No puedo hacer eso.	
VO_HERO_09a_ERROR_HAND_FULL_24	¡Mi mano está llena!	
VO_HERO_09a_ERROR_I_ATTACKED_22	Ya he atacado.	
VO_HERO_09a_ERROR_JUST_PLAYED_23	El esbirro necesita un turno.	
VO_HERO_09a_ERROR_MINION_ATTACKED_21	Ese esbirro ya ha atacado.	
VO_HERO_09a_ERROR_NEED_MANA_20	No tengo suficiente maná.	
VO_HERO_09a_ERROR_NEED_WEAPON_19	Necesito un arma.	
VO_HERO_09a_ERROR_PLAY_27	No puedo jugar eso.	
VO_HERO_09a_ERROR_STEALTH_26	No puedo seleccionar a esbirros en sigilo.	
VO_HERO_09a_ERROR_TARGET_28	No es un objetivo válido.	
VO_HERO_09a_ERROR_TAUNT_29	Se interpone un esbirro con Provocar.	
VO_HERO_09a_GREETINGS_03	Bendiciones.	
VO_HERO_09a_HAPPY_HOLIDAYS_52	¡Feliz festín del Festival de Invierno!	
VO_HERO_09a_HAPPY_NEW_YEAR_53	Bendiciones.	
VO_HERO_09a_LOW_CARDS_17	Casi no me quedan cartas.	
VO_HERO_09a_MIRROR_GREETINGS_04	Igualmente.	
VO_HERO_09a_MIRROR_START_02	La diosa es mi escudo.	
VO_HERO_09a_NO_CARDS_18	¡No me quedan cartas!	
VO_HERO_09a_OOPS_08	Un error.	
VO_HERO_09a_PICKED_11	¡La diosa llama!	
VO_HERO_09a_SORRY_10	Lo siento.	
VO_HERO_09a_START_01	Elune, dame fuerza.	
VO_HERO_09a_START_MALFURION	Mi querido Malfurion.	
VO_HERO_09a_THANKS_09	Gracias.	
VO_HERO_09a_THINK1_12	Mmm…	
VO_HERO_09a_THINK2_13	Me pregunto…	
VO_HERO_09a_THINK3_14	¿Qué... deseará la diosa?	
VO_HERO_09a_THREATEN_05	Te arrepentirás de esto.	
VO_HERO_09a_TIMER_16	¡Aprisa!	
VO_HERO_09a_WELL_PLAYED_07	Bien jugado.	
VO_HERO_09a_WOW_10	¡Brillante!	
VO_TBA01_4__Concede	*Gruñido*	
VO_TBA01_4__Error_Full_Minions	*Gruñido*	
VO_TBA01_4__Error_Generic	*Gruñido*	
VO_TBA01_4__Error_Hand_Full	*Gruñido*	
VO_TBA01_4__Error_I_Attacked	*Gruñido*	
VO_TBA01_4__Error_Just_Played	*Gruñido*	
VO_TBA01_4__Error_Minion_Attacked	*Gruñido*	
VO_TBA01_4__Error_Need_Mana	*Gruñido*	
VO_TBA01_4__Error_Need_Weapon	*Gruñido*	
VO_TBA01_4__Error_Play	*Gruñido*	
VO_TBA01_4__Error_Stealth	*Gruñido*	
VO_TBA01_4__Good_Game	*Gruñido*	
VO_TBA01_4__Greetings	¡Que comiencen los juegos!	
VO_TBA01_4__Low_Cards	*Gruñido*	
VO_TBA01_4__No_Cards	*Gruñido*	
VO_TBA01_4__Oops	Uy.	
VO_TBA01_4__Sorry	Lo siento.	
VO_TBA01_4__Start	¡Yo soy aquí el maestro!	
VO_TBA01_4__Thanks	Gracias.	
VO_TBA01_4__Threaten	¡Ja, ja, ja! ¡Contempla el verdadero poder de NEFARIAN!	
VO_TBA01_4__Timer	*Gruñido*	
VO_TBA01_4__Well_Played	Bien jugado.	
