TAG	TEXT	COMMENT
GAMEPLAY_EMOTE_EX1_323h_CONCEDE	Hai vinto... MA IL TUO MONDO È ANCORA CONDANNATO!	
GAMEPLAY_EMOTE_EX1_323h_ERROR_FULL_MINIONS	TROPPI SERVITORI.	
GAMEPLAY_EMOTE_EX1_323h_ERROR_GENERIC	NON LO POSSO FARE.	
GAMEPLAY_EMOTE_EX1_323h_ERROR_HAND_FULL	TROPPE CARTE!	
GAMEPLAY_EMOTE_EX1_323h_ERROR_I_ATTACKED	HO GIÀ ATTACCATO.	
GAMEPLAY_EMOTE_EX1_323h_ERROR_JUST_PLAYED	È APPENA ARRIVATO!	
GAMEPLAY_EMOTE_EX1_323h_ERROR_MINION_ATTACKED	QUEL SERVITORE HA GIÀ ATTACCATO.	
GAMEPLAY_EMOTE_EX1_323h_ERROR_NEED_MANA	IL MANA NON BASTA!	
GAMEPLAY_EMOTE_EX1_323h_ERROR_NEED_WEAPON	DOV'È FINITA LA MIA ARMA?	
GAMEPLAY_EMOTE_EX1_323h_ERROR_PLAY	NON POSSO GIOCARE QUESTA CARTA!	
GAMEPLAY_EMOTE_EX1_323h_ERROR_STEALTH	È IN MODALITÀ FURTIVA!	
GAMEPLAY_EMOTE_EX1_323h_ERROR_TARGET	NON VALE!	
GAMEPLAY_EMOTE_EX1_323h_ERROR_TAUNT	QUEL SERVITORE MI HA PROVOCATO!	
GAMEPLAY_EMOTE_EX1_323h_FIRE_FESTIVAL	ACCENDETE I FUOCHI!	
GAMEPLAY_EMOTE_EX1_323h_GOOD_GAME	BELLA PARTITA!	
GAMEPLAY_EMOTE_EX1_323h_GREETINGS	Affrontate Jaraxxus, Signore Eredar della Legione Infuocata!	
GAMEPLAY_EMOTE_EX1_323h_HALLOWS_END	LE OMBRE TI ATTENDONO!	
GAMEPLAY_EMOTE_EX1_323h_LOW_CARDS	Il mio mazzo! Stanno per terminare le carte!	
GAMEPLAY_EMOTE_EX1_323h_LUNAR_NEW_YEAR	BUON ANNO.	
GAMEPLAY_EMOTE_EX1_323h_NO_CARDS	NO! HO FINITO LE CARTE!	
GAMEPLAY_EMOTE_EX1_323h_NOBLEGARDEN	BUONA FESTA DI NOBILUOVA!	
GAMEPLAY_EMOTE_EX1_323h_OOPS	ERRORE!	
GAMEPLAY_EMOTE_EX1_323h_PIRATE_DAY	SONO CAPITAN JARAXXUS!	
GAMEPLAY_EMOTE_EX1_323h_SORRY	JARAXXUS È... dispiaciuto.	
GAMEPLAY_EMOTE_EX1_323h_THANKS	GRAZIE.	
GAMEPLAY_EMOTE_EX1_323h_THINK1	Mmm...	
GAMEPLAY_EMOTE_EX1_323h_THINK2	Fammi pensare...	
GAMEPLAY_EMOTE_EX1_323h_THINK3	Come dovrei distruggerti...	
GAMEPLAY_EMOTE_EX1_323h_THREATEN	OOOBLIO!!!	
GAMEPLAY_EMOTE_EX1_323h_TIMER	IL TEMPO STA PER SCADERE!	
GAMEPLAY_EMOTE_EX1_323h_WELL_PLAYED	BELLA GIOCATA!	
GAMEPLAY_EMOTE_EX1_323h_WINTERVEIL_GREETINGS	PER QUESTO GRANDE INVERNO MI CIBERÒ DELLA TUA ANIMA!	
GAMEPLAY_EMOTE_EX1_323h_WOW_04	INCREDIBILE!	
GAMEPLAY_EMOTE_HERO_01_CONCEDE	Scelgo la morte!	
GAMEPLAY_EMOTE_HERO_01_ERROR_FULL_MINIONS	Ho troppi servitori.	
GAMEPLAY_EMOTE_HERO_01_ERROR_GENERIC	Non posso farlo.	
GAMEPLAY_EMOTE_HERO_01_ERROR_HAND_FULL	La mia mano è piena!	
GAMEPLAY_EMOTE_HERO_01_ERROR_I_ATTACKED	Ho già attaccato.	
GAMEPLAY_EMOTE_HERO_01_ERROR_JUST_PLAYED	Concedi a quel servitore un turno per prepararsi.	
GAMEPLAY_EMOTE_HERO_01_ERROR_MINION_ATTACKED	Quel servitore ha già attaccato.	
GAMEPLAY_EMOTE_HERO_01_ERROR_NEED_MANA	Non ho abbastanza Mana.	
GAMEPLAY_EMOTE_HERO_01_ERROR_NEED_WEAPON	Mi serve un'arma.	
GAMEPLAY_EMOTE_HERO_01_ERROR_PLAY	Non posso giocare questa carta.	
GAMEPLAY_EMOTE_HERO_01_ERROR_STEALTH	Non posso attaccare servitori furtivi.	
GAMEPLAY_EMOTE_HERO_01_ERROR_TARGET	Quel bersaglio non è valido.	
GAMEPLAY_EMOTE_HERO_01_ERROR_TAUNT	Devo attaccare i servitori con Provocazione.	
GAMEPLAY_EMOTE_HERO_01_EVENT_FIRE_FESTIVAL	Accendete le pire!	
GAMEPLAY_EMOTE_HERO_01_EVENT_LUNAR_NEW_YEAR	Buon anno!	
GAMEPLAY_EMOTE_HERO_01_GOOD_GAME	Bella partita.	
GAMEPLAY_EMOTE_HERO_01_GREETINGS	Ehi, salve.	
GAMEPLAY_EMOTE_HERO_01_GREETINGS_RESPONSE	Eheheh... Salve anche a te.	
GAMEPLAY_EMOTE_HERO_01_HALLOWS_END	Buona Veglia delle Ombre.	
GAMEPLAY_EMOTE_HERO_01_LOW_CARDS	Ho quasi finito le carte!	
GAMEPLAY_EMOTE_HERO_01_MIRROR_START	Ahahah! Preferisco la vittoria.	
GAMEPLAY_EMOTE_HERO_01_NO_CARDS	Ho finito le carte!	
GAMEPLAY_EMOTE_HERO_01_NOBLEGARDEN	Buona Festa di Nobiluova!	
GAMEPLAY_EMOTE_HERO_01_OOPS	Un deplorevole errore.	
GAMEPLAY_EMOTE_HERO_01_PIRATE_DAY	All'arrembaggiooo!	
GAMEPLAY_EMOTE_HERO_01_SORRY	Mi dispiace per ciò che è successo.	
GAMEPLAY_EMOTE_HERO_01_START	Vittoria o morte!	
GAMEPLAY_EMOTE_HERO_01_THANKS	Umpf... Ti ringrazio.	
GAMEPLAY_EMOTE_HERO_01_THINK1	Mmm...	
GAMEPLAY_EMOTE_HERO_01_THINK2	Fammi pensare...	
GAMEPLAY_EMOTE_HERO_01_THINK3	E adesso?	
GAMEPLAY_EMOTE_HERO_01_THREATEN	TI SCHIACCERÒ!	
GAMEPLAY_EMOTE_HERO_01_TIMER	Argh... DEVO SCEGLIERE!	
GAMEPLAY_EMOTE_HERO_01_WELL_PLAYED	Bella giocata.	
GAMEPLAY_EMOTE_HERO_01_WINTERVEIL_GREETINGS	Buona Vigilia di Grande Inverno!	
GAMEPLAY_EMOTE_HERO_01_WOW	Impressionante!	
GAMEPLAY_EMOTE_HERO_01A_CELEBRATE	Hip hip, urrà!	
GAMEPLAY_EMOTE_HERO_01A_CONCEDE	Direi che hai vinto tu.	
GAMEPLAY_EMOTE_HERO_01A_ERROR_FULL_MINIONS	Ho troppi servitori.	
GAMEPLAY_EMOTE_HERO_01A_ERROR_GENERIC	Non posso farlo.	
GAMEPLAY_EMOTE_HERO_01A_ERROR_HAND_FULL	La mia mano è piena.	
GAMEPLAY_EMOTE_HERO_01A_ERROR_I_ATTACKED	Ho già attaccato.	
GAMEPLAY_EMOTE_HERO_01A_ERROR_JUST_PLAYED	Concedi a quel servitore un turno per prepararsi.	
GAMEPLAY_EMOTE_HERO_01A_ERROR_MINION_ATTACKED	Quel servitore ha già attaccato.	
GAMEPLAY_EMOTE_HERO_01A_ERROR_NEED_MANA	Non ho abbastanza Mana.	
GAMEPLAY_EMOTE_HERO_01A_ERROR_NEED_WEAPON	Mi serve un'arma.	
GAMEPLAY_EMOTE_HERO_01A_ERROR_PLAY	Non posso giocare questa carta.	
GAMEPLAY_EMOTE_HERO_01A_ERROR_STEALTH	Non posso scegliere come bersagli i servitori con Furtività.	
GAMEPLAY_EMOTE_HERO_01A_ERROR_TARGET	Quel bersaglio non è valido.	
GAMEPLAY_EMOTE_HERO_01A_ERROR_TAUNT	Devo attaccare i servitori con Provocazione.	
GAMEPLAY_EMOTE_HERO_01A_EVENT_LUNAR_NEW_YEAR	Buon anno!	
GAMEPLAY_EMOTE_HERO_01A_FIRE_FESTIVAL	Buona festa di Mezza Estate!	
GAMEPLAY_EMOTE_HERO_01A_GOOD_GAME	Bella partita!	
GAMEPLAY_EMOTE_HERO_01A_GREETINGS	Ehi, salve!	
GAMEPLAY_EMOTE_HERO_01A_GREETINGS_RESPONSE	Salve a te!	
GAMEPLAY_EMOTE_HERO_01A_HALLOWS_END	Buona Veglia delle Ombre.	
GAMEPLAY_EMOTE_HERO_01A_LOW_CARDS	Ho quasi finito le carte.	
GAMEPLAY_EMOTE_HERO_01A_MIRROR_START	Sì, Khaz Modan!	
GAMEPLAY_EMOTE_HERO_01A_NO_CARDS	Ho finito le carte.	
GAMEPLAY_EMOTE_HERO_01A_NOBLEGARDEN	Buona Festa di Nobiluova!	
GAMEPLAY_EMOTE_HERO_01A_OOPS	Ho commesso un errore.	
GAMEPLAY_EMOTE_HERO_01A_PIRATE_DAY	Arrr! Sono il re del mare aperto!	
GAMEPLAY_EMOTE_HERO_01A_SORRY	Mi dispiace.	
GAMEPLAY_EMOTE_HERO_01A_START	Per Khaz Modan!	
GAMEPLAY_EMOTE_HERO_01A_THANKS	Ehi, grazie!	
GAMEPLAY_EMOTE_HERO_01A_THINK1	Mmm...	
GAMEPLAY_EMOTE_HERO_01A_THINK2	Forse potrei... No, no, no, no, no, no.	
GAMEPLAY_EMOTE_HERO_01A_THINK3	Cosa potrei mai fare?	
GAMEPLAY_EMOTE_HERO_01A_THREATEN	Temi la furia della montagna!	
GAMEPLAY_EMOTE_HERO_01A_TIMER	Devo darmi una mossa.	
GAMEPLAY_EMOTE_HERO_01A_WELL_PLAYED	Bella giocata.	
GAMEPLAY_EMOTE_HERO_01A_WINTERVEIL_GREETINGS	Buona Vigilia di Grande Inverno!	
GAMEPLAY_EMOTE_HERO_01A_WOW	Per la mia barba!	
GAMEPLAY_EMOTE_HERO_02_CONCEDE	Questa volta hai vinto tu.	
GAMEPLAY_EMOTE_HERO_02_ERROR_FULL_MINIONS	Ho troppi servitori.	
GAMEPLAY_EMOTE_HERO_02_ERROR_GENERIC	Non posso farlo.	
GAMEPLAY_EMOTE_HERO_02_ERROR_HAND_FULL	La mia mano è piena!	
GAMEPLAY_EMOTE_HERO_02_ERROR_I_ATTACKED	Ho già attaccato.	
GAMEPLAY_EMOTE_HERO_02_ERROR_JUST_PLAYED	Concedi a quel servitore un turno per prepararsi.	
GAMEPLAY_EMOTE_HERO_02_ERROR_MINION_ATTACKED	Quel servitore ha già attaccato.	
GAMEPLAY_EMOTE_HERO_02_ERROR_NEED_MANA	Non ho abbastanza Mana.	
GAMEPLAY_EMOTE_HERO_02_ERROR_NEED_WEAPON	Mi serve un'arma.	
GAMEPLAY_EMOTE_HERO_02_ERROR_PLAY	Non posso giocare questa carta.	
GAMEPLAY_EMOTE_HERO_02_ERROR_STEALTH	Non posso scegliere come bersagli i servitori con Furtività.	
GAMEPLAY_EMOTE_HERO_02_ERROR_TARGET	Quel bersaglio non è valido.	
GAMEPLAY_EMOTE_HERO_02_ERROR_TAUNT	Devo attaccare i servitori con Provocazione.	
GAMEPLAY_EMOTE_HERO_02_EVENT_FIRE_FESTIVAL	Una festa degli elementi!	
GAMEPLAY_EMOTE_HERO_02_EVENT_LUNAR_NEW_YEAR	Buon anno.	
GAMEPLAY_EMOTE_HERO_02_GOOD_GAME	Bella partita.	
GAMEPLAY_EMOTE_HERO_02_GREETINGS	Salute a te!	
GAMEPLAY_EMOTE_HERO_02_GREETINGS_RESPONSE	Felice di vederti!	
GAMEPLAY_EMOTE_HERO_02_HALLOWS_END	Buona Veglia delle Ombre.	
GAMEPLAY_EMOTE_HERO_02_LOW_CARDS	Ho quasi finito le carte!	
GAMEPLAY_EMOTE_HERO_02_MIRROR_START	Per i Lupi Bianchi!	
GAMEPLAY_EMOTE_HERO_02_NO_CARDS	Ho finito le carte!	
GAMEPLAY_EMOTE_HERO_02_NOBLEGARDEN	Buona Festa di Nobiluova.	
GAMEPLAY_EMOTE_HERO_02_OOPS	È stato un errore.	
GAMEPLAY_EMOTE_HERO_02_PIRATE_DAY	Bucanieri, è il Giorno dei Pirati!	
GAMEPLAY_EMOTE_HERO_02_SORRY	Mi dispiace per ciò che è successo.	
GAMEPLAY_EMOTE_HERO_02_START	Per Martelfato!	
GAMEPLAY_EMOTE_HERO_02_THANKS	Ti ringrazio.	
GAMEPLAY_EMOTE_HERO_02_THINK1	Mmm...	
GAMEPLAY_EMOTE_HERO_02_THINK2	Mmm... Fammi pensare...	
GAMEPLAY_EMOTE_HERO_02_THINK3	Mmm... Cosa fare...	
GAMEPLAY_EMOTE_HERO_02_THREATEN	Gli elementi ti distruggeranno.	
GAMEPLAY_EMOTE_HERO_02_TIMER	Resta poco tempo!	
GAMEPLAY_EMOTE_HERO_02_WELL_PLAYED	Bella giocata.	
GAMEPLAY_EMOTE_HERO_02_WINTERVEIL_GREETINGS	Felice Vigilia di Grande Inverno.	
GAMEPLAY_EMOTE_HERO_02_WOW	Incredibile!	
GAMEPLAY_EMOTE_HERO_02A_CELEBRATE	<Festa!>	
GAMEPLAY_EMOTE_HERO_02A_CONCEDE	<Sono stato sconfitto.>	
GAMEPLAY_EMOTE_HERO_02A_ERROR_FULL_MINIONS	<Ho troppi servitori.>	
GAMEPLAY_EMOTE_HERO_02A_ERROR_GENERIC	<Non posso farlo.>	
GAMEPLAY_EMOTE_HERO_02A_ERROR_HAND_FULL	<La mia mano è piena.>	
GAMEPLAY_EMOTE_HERO_02A_ERROR_I_ATTACKED	<Ho già attaccato.>	VO_HERO_15_ERROR04_43.wav
GAMEPLAY_EMOTE_HERO_02A_ERROR_JUST_PLAYED	<Quel servitore ha\nbisogno di prepararsi.>	
GAMEPLAY_EMOTE_HERO_02A_ERROR_MINION_ATTACKED	<Quel servitore ha\ngià attaccato.>	
GAMEPLAY_EMOTE_HERO_02A_ERROR_NEED_MANA	<Mi serve altro Mana.>	
GAMEPLAY_EMOTE_HERO_02A_ERROR_NEED_WEAPON	<Mi serve un'arma.>	
GAMEPLAY_EMOTE_HERO_02A_ERROR_PLAY	<Non posso giocare\nquesta carta.>	
GAMEPLAY_EMOTE_HERO_02A_ERROR_STEALTH	<Non posso attaccare\ni servitori con Furtività!>	
GAMEPLAY_EMOTE_HERO_02A_ERROR_TARGET	<Quel bersaglio\nnon è valido.>	
GAMEPLAY_EMOTE_HERO_02A_ERROR_TAUNT	<Devo attaccare i servitori\ncon Provocazione.>	
GAMEPLAY_EMOTE_HERO_02A_EVENT_LUNAR_NEW_YEAR	<Un caloroso augurio\ndi buon anno!>	
GAMEPLAY_EMOTE_HERO_02A_FIRE_FESTIVAL	<La mia gente non celebra\nla festa di Mezza Estate.>	
GAMEPLAY_EMOTE_HERO_02A_GREETINGS	<Salve, sfidante.>	
GAMEPLAY_EMOTE_HERO_02A_GREETINGS_RESPONSE	<Ehi, salve!>	
GAMEPLAY_EMOTE_HERO_02A_HALLOWS_END	<Buona Veglia\ndelle Ombre, girini.>	
GAMEPLAY_EMOTE_HERO_02A_LOW_CARDS	<Ho quasi finito le carte!>	
GAMEPLAY_EMOTE_HERO_02A_MIRROR_START	<Giovane?!? Hai molto\nda apprendere.>	
GAMEPLAY_EMOTE_HERO_02A_NO_CARDS	<Ho finito le carte!>	
GAMEPLAY_EMOTE_HERO_02A_NOBLEGARDEN	<Buona Festa di Nobiluova!>	
GAMEPLAY_EMOTE_HERO_02A_OOPS	<Maledizione!>	
GAMEPLAY_EMOTE_HERO_02A_PIRATE_DAY	<Pirati?!? Noi siamo\narrivati prima!>	
GAMEPLAY_EMOTE_HERO_02A_SORRY	<Mi dispiace, giovane.>	
GAMEPLAY_EMOTE_HERO_02A_START	<Preparati a una\nlezione, giovane!>	
GAMEPLAY_EMOTE_HERO_02A_THANKS	<I miei ringraziamenti.>	
GAMEPLAY_EMOTE_HERO_02A_THINK1	<Forse potrei...>	VO_HERO_15_Thinking1_13.wav
GAMEPLAY_EMOTE_HERO_02A_THINK2	<Pensiero interessante...>	
GAMEPLAY_EMOTE_HERO_02A_THINK3	<Una possibilità...>	
GAMEPLAY_EMOTE_HERO_02A_THREATEN	<Affronta la saggezza\ndei mari!>	
GAMEPLAY_EMOTE_HERO_02A_TIMER	<Presto, presto!>	
GAMEPLAY_EMOTE_HERO_02A_WELL_PLAYED	<Bella giocata.>	
GAMEPLAY_EMOTE_HERO_02A_WINTERVEIL_GREETINGS	<Felice Vigilia di\nGrande Inverno!>	
GAMEPLAY_EMOTE_HERO_02A_WOW	<Incredibile!>	
GAMEPLAY_EMOTE_HERO_03_CONCEDE	Mi arrendo.	
GAMEPLAY_EMOTE_HERO_03_ERROR_FULL_MINIONS	Ho troppi servitori.	
GAMEPLAY_EMOTE_HERO_03_ERROR_GENERIC	Non posso farlo.	
GAMEPLAY_EMOTE_HERO_03_ERROR_HAND_FULL	La mia mano è piena!	
GAMEPLAY_EMOTE_HERO_03_ERROR_I_ATTACKED	Ho già attaccato.	
GAMEPLAY_EMOTE_HERO_03_ERROR_JUST_PLAYED	Concedi a quel servitore un turno per prepararsi.	
GAMEPLAY_EMOTE_HERO_03_ERROR_MINION_ATTACKED	Quel servitore ha già attaccato.	
GAMEPLAY_EMOTE_HERO_03_ERROR_NEED_MANA	Non ho abbastanza Mana.	
GAMEPLAY_EMOTE_HERO_03_ERROR_NEED_WEAPON	Mi serve un'arma.	
GAMEPLAY_EMOTE_HERO_03_ERROR_PLAY	Non posso giocare questa carta.	
GAMEPLAY_EMOTE_HERO_03_ERROR_STEALTH	Non posso scegliere come bersagli i servitori con Furtività.	
GAMEPLAY_EMOTE_HERO_03_ERROR_TARGET	Quel bersaglio non è valido.	
GAMEPLAY_EMOTE_HERO_03_ERROR_TAUNT	Devo attaccare i servitori con Provocazione.	
GAMEPLAY_EMOTE_HERO_03_EVENT_LUNAR_NEW_YEAR	Buon anno.	
GAMEPLAY_EMOTE_HERO_03_FIRE_FESTIVAL	Buona festa di Mezza Estate.	
GAMEPLAY_EMOTE_HERO_03_GOOD_GAME	Bella partita.	
GAMEPLAY_EMOTE_HERO_03_GREETINGS	Il piacere è mio.	
GAMEPLAY_EMOTE_HERO_03_GREETINGS_RESPONSE	No, è tutto mio. Ah!	
GAMEPLAY_EMOTE_HERO_03_HALLOWS_END	Buona Veglia delle Ombre.	
GAMEPLAY_EMOTE_HERO_03_LOW_CARDS	Ho quasi finito le carte!	
GAMEPLAY_EMOTE_HERO_03_MIRROR_START	Lo faccio sempre.	
GAMEPLAY_EMOTE_HERO_03_NO_CARDS	Ho finito le carte!	
GAMEPLAY_EMOTE_HERO_03_NOBLEGARDEN	Buona Festa di Nobiluova.	
GAMEPLAY_EMOTE_HERO_03_OOPS	Sono stati compiuti errori.	
GAMEPLAY_EMOTE_HERO_03_PIRATE_DAY	Vento in poppa.	
GAMEPLAY_EMOTE_HERO_03_SORRY	Mi dispiace...	
GAMEPLAY_EMOTE_HERO_03_START	Guardati le spalle.	
GAMEPLAY_EMOTE_HERO_03_THANKS	Grazie.	
GAMEPLAY_EMOTE_HERO_03_THINK1	Mmm...	
GAMEPLAY_EMOTE_HERO_03_THINK2	Fammi pensare...	
GAMEPLAY_EMOTE_HERO_03_THINK3	Quante possibili opzioni...	
GAMEPLAY_EMOTE_HERO_03_THREATEN	Sarò la tua morte!	
GAMEPLAY_EMOTE_HERO_03_TIMER	Devo scegliere in fretta!	
GAMEPLAY_EMOTE_HERO_03_WELL_PLAYED	Bella giocata.	
GAMEPLAY_EMOTE_HERO_03_WINTERVEIL_GREETINGS	Felice Vigilia di Grande Inverno!	
GAMEPLAY_EMOTE_HERO_03_WOW	Incredibile.	
GAMEPLAY_EMOTE_HERO_04_CONCEDE	La vittoria è tua.	
GAMEPLAY_EMOTE_HERO_04_ERROR_FULL_MINIONS	Ho troppi servitori.	
GAMEPLAY_EMOTE_HERO_04_ERROR_GENERIC	Non posso farlo.	
GAMEPLAY_EMOTE_HERO_04_ERROR_HAND_FULL	La mia mano è piena!	
GAMEPLAY_EMOTE_HERO_04_ERROR_I_ATTACKED	Ho già attaccato.	
GAMEPLAY_EMOTE_HERO_04_ERROR_JUST_PLAYED	Concedi a quel servitore un turno per prepararsi.	
GAMEPLAY_EMOTE_HERO_04_ERROR_MINION_ATTACKED	Quel servitore ha già attaccato.	
GAMEPLAY_EMOTE_HERO_04_ERROR_NEED_MANA	Non ho abbastanza Mana.	
GAMEPLAY_EMOTE_HERO_04_ERROR_NEED_WEAPON	Mi serve un'arma.	
GAMEPLAY_EMOTE_HERO_04_ERROR_PLAY	Non posso giocare questa carta.	
GAMEPLAY_EMOTE_HERO_04_ERROR_STEALTH	Non posso scegliere come bersagli i servitori con Furtività.	
GAMEPLAY_EMOTE_HERO_04_ERROR_TARGET	Quel bersaglio non è valido.	
GAMEPLAY_EMOTE_HERO_04_ERROR_TAUNT	Devo attaccare i servitori con Provocazione.	
GAMEPLAY_EMOTE_HERO_04_EVENT_LUNAR_NEW_YEAR	Buon anno!	
GAMEPLAY_EMOTE_HERO_04_FIRE_FESTIVAL	Buona festa di Mezza Estate!	
GAMEPLAY_EMOTE_HERO_04_GOOD_GAME	Bella partita.	
GAMEPLAY_EMOTE_HERO_04_GREETINGS	Molto piacere!	
GAMEPLAY_EMOTE_HERO_04_GREETINGS_RESPONSE	Il piacere è mio!	
GAMEPLAY_EMOTE_HERO_04_HALLOWS_END	Buona Veglia delle Ombre.	VO_HERO_04_HAPPY_HALLOWEEN_13.wav
GAMEPLAY_EMOTE_HERO_04_LOW_CARDS	Ho quasi finito le carte!	
GAMEPLAY_EMOTE_HERO_04_MIRROR_START	E io dominerò la Luce!	
GAMEPLAY_EMOTE_HERO_04_NO_CARDS	Ho finito le carte!	
GAMEPLAY_EMOTE_HERO_04_NOBLEGARDEN	Buona Festa di Nobiluova!	VO_HERO_04_HAPPY_NOBLEGARDEN_17.wav
GAMEPLAY_EMOTE_HERO_04_OOPS	Un grave errore.	
GAMEPLAY_EMOTE_HERO_04_PIRATE_DAY	Pronti all'arrembaggio, pendagli da forca!	VO_HERO_04_PIRATE_DAY_33.wav
GAMEPLAY_EMOTE_HERO_04_SORRY	Mi spiace.	
GAMEPLAY_EMOTE_HERO_04_START	Mi batterò con onore!	
GAMEPLAY_EMOTE_HERO_04_THANKS	Grazie.	
GAMEPLAY_EMOTE_HERO_04_THINK1	Mmm...	
GAMEPLAY_EMOTE_HERO_04_THINK2	Chissà se...	
GAMEPLAY_EMOTE_HERO_04_THINK3	Fammi pensare...	
GAMEPLAY_EMOTE_HERO_04_THREATEN	La giustizia pretende il castigo!	
GAMEPLAY_EMOTE_HERO_04_TIMER	Devo agire in fretta!	
GAMEPLAY_EMOTE_HERO_04_WELL_PLAYED	Bella giocata.	
GAMEPLAY_EMOTE_HERO_04_WINTERVEIL_GREETINGS	Buona Vigilia di Grande Inverno!	
GAMEPLAY_EMOTE_HERO_04_WOW	Per la Luce Sacra!	
GAMEPLAY_EMOTE_HERO_04A_CELEBRATE	Oggi la Luce splende!	
GAMEPLAY_EMOTE_HERO_04A_CONCEDE	Hai vinto, complimenti.	
GAMEPLAY_EMOTE_HERO_04A_ERROR_FULL_MINIONS	Ho troppi servitori.	
GAMEPLAY_EMOTE_HERO_04A_ERROR_GENERIC	Non posso farlo.	
GAMEPLAY_EMOTE_HERO_04A_ERROR_HAND_FULL	La mia mano è piena.	
GAMEPLAY_EMOTE_HERO_04A_ERROR_I_ATTACKED	Ho già attaccato.	
GAMEPLAY_EMOTE_HERO_04A_ERROR_JUST_PLAYED	Concedi a quel servitore un turno per prepararsi.	
GAMEPLAY_EMOTE_HERO_04A_ERROR_MINION_ATTACKED	Quel servitore ha già attaccato.	
GAMEPLAY_EMOTE_HERO_04A_ERROR_NEED_MANA	Non ho abbastanza Mana.	
GAMEPLAY_EMOTE_HERO_04A_ERROR_NEED_WEAPON	Mi serve un'arma.	
GAMEPLAY_EMOTE_HERO_04A_ERROR_PLAY	Non posso giocare questa carta.	
GAMEPLAY_EMOTE_HERO_04A_ERROR_STEALTH	Non posso scegliere come bersagli i servitori con Furtività.	
GAMEPLAY_EMOTE_HERO_04A_ERROR_TARGET	Quel bersaglio non è valido.	
GAMEPLAY_EMOTE_HERO_04A_ERROR_TAUNT	Devo attaccare i servitori con Provocazione.	
GAMEPLAY_EMOTE_HERO_04A_FIRE_FESTIVAL	Buona festa di Mezza Estate!	
GAMEPLAY_EMOTE_HERO_04A_GOOD_GAME	Bella partita.	
GAMEPLAY_EMOTE_HERO_04A_GREETINGS	Ah, salve, sfidante.	
GAMEPLAY_EMOTE_HERO_04A_GREETINGS_RESPONSE	Salve!	
GAMEPLAY_EMOTE_HERO_04A_HALLOWS_END	Buona Veglia delle Ombre.	
GAMEPLAY_EMOTE_HERO_04A_LOW_CARDS	Ho quasi finito le carte.	
GAMEPLAY_EMOTE_HERO_04A_LUNAR_NEW_YEAR	Buon anno.	
GAMEPLAY_EMOTE_HERO_04A_MIRROR_START	Fuoco sacro è il mio secondo nome.	
GAMEPLAY_EMOTE_HERO_04A_NO_CARDS	Ho finito le carte.	
GAMEPLAY_EMOTE_HERO_04A_NOBLEGARDEN	Buona Festa di Nobiluova.	
GAMEPLAY_EMOTE_HERO_04A_OOPS	Un errore, senza dubbio.	
GAMEPLAY_EMOTE_HERO_04A_PIRATE_DAY	Arrr, il tuo tesoro sarà mio!	
GAMEPLAY_EMOTE_HERO_04A_SORRY	Ah, mi dispiace.	
GAMEPLAY_EMOTE_HERO_04A_START	La mia lama brucia con il Fuoco Sacro!	
GAMEPLAY_EMOTE_HERO_04A_THANKS	I miei più sinceri ringraziamenti.	
GAMEPLAY_EMOTE_HERO_04A_THINK1	Mmm...	
GAMEPLAY_EMOTE_HERO_04A_THINK2	Quante possibilità...	
GAMEPLAY_EMOTE_HERO_04A_THINK3	Forse dovrei...	
GAMEPLAY_EMOTE_HERO_04A_THREATEN	Pagherai per questo.	
GAMEPLAY_EMOTE_HERO_04A_TIMER	Devo fare in fretta.	
GAMEPLAY_EMOTE_HERO_04A_WELL_PLAYED	Bella giocata.	
GAMEPLAY_EMOTE_HERO_04A_WINTERVEIL_GREETINGS	Buona Vigilia di Grande Inverno!	
GAMEPLAY_EMOTE_HERO_04A_WOW	Ah, incredibile!	
GAMEPLAY_EMOTE_HERO_05_CONCEDE	Ben fatto, mi arrendo.	
GAMEPLAY_EMOTE_HERO_05_ERROR_FULL_MINIONS	Ho troppi servitori.	
GAMEPLAY_EMOTE_HERO_05_ERROR_GENERIC	Non posso farlo.	
GAMEPLAY_EMOTE_HERO_05_ERROR_HAND_FULL	La mia mano è piena!	
GAMEPLAY_EMOTE_HERO_05_ERROR_I_ATTACKED	Ho già attaccato.	
GAMEPLAY_EMOTE_HERO_05_ERROR_JUST_PLAYED	Concedi a quel servitore un turno per prepararsi.	
GAMEPLAY_EMOTE_HERO_05_ERROR_MINION_ATTACKED	Quel servitore ha già attaccato.	
GAMEPLAY_EMOTE_HERO_05_ERROR_NEED_MANA	Non ho abbastanza Mana.	
GAMEPLAY_EMOTE_HERO_05_ERROR_NEED_WEAPON	Mi serve un'arma.	
GAMEPLAY_EMOTE_HERO_05_ERROR_PLAY	Non posso giocare questa carta.	
GAMEPLAY_EMOTE_HERO_05_ERROR_STEALTH	Non posso attaccare servitori con Furtività.	
GAMEPLAY_EMOTE_HERO_05_ERROR_TARGET	Quel bersaglio non è valido.	
GAMEPLAY_EMOTE_HERO_05_ERROR_TAUNT	Devo attaccare i servitori con Provocazione.	
GAMEPLAY_EMOTE_HERO_05_EVENT_LUNAR_NEW_YEAR	Buona Festa della Luna.	
GAMEPLAY_EMOTE_HERO_05_FIRE_FESTIVAL	Buona festa di Mezza Estate.	
GAMEPLAY_EMOTE_HERO_05_GOOD_GAME	Bella partita.	
GAMEPLAY_EMOTE_HERO_05_GREETINGS	Salute, viandante.	
GAMEPLAY_EMOTE_HERO_05_GREETINGS_RESPONSE	Salute a te.	
GAMEPLAY_EMOTE_HERO_05_HALLOWS_END	Buona Veglia delle Ombre.	
GAMEPLAY_EMOTE_HERO_05_LOW_CARDS	Ho quasi finito le carte!	
GAMEPLAY_EMOTE_HERO_05_MIRROR_START	Non vedo l'ora.	
GAMEPLAY_EMOTE_HERO_05_NO_CARDS	Ho finito le carte!	
GAMEPLAY_EMOTE_HERO_05_NOBLEGARDEN	Buona Festa di Nobiluova!	
GAMEPLAY_EMOTE_HERO_05_OOPS	Non proprio quello che volevo.	
GAMEPLAY_EMOTE_HERO_05_PIRATE_DAY	Fate largo ai lupi di mare!	
GAMEPLAY_EMOTE_HERO_05_SORRY	Chiedo scusa.	
GAMEPLAY_EMOTE_HERO_05_START	Che la caccia abbia inizio!	
GAMEPLAY_EMOTE_HERO_05_THANKS	Ti ringrazio.	
GAMEPLAY_EMOTE_HERO_05_THINK1	Mmm...	
GAMEPLAY_EMOTE_HERO_05_THINK2	Fammi pensare...	
GAMEPLAY_EMOTE_HERO_05_THINK3	Mmm...	
GAMEPLAY_EMOTE_HERO_05_THREATEN	Ti darò la caccia!	
GAMEPLAY_EMOTE_HERO_05_TIMER	Il tempo mi è avverso!	
GAMEPLAY_EMOTE_HERO_05_WELL_PLAYED	Bella giocata.	
GAMEPLAY_EMOTE_HERO_05_WINTERVEIL_GREETINGS	Felice Vigilia di Grande Inverno!	
GAMEPLAY_EMOTE_HERO_05_WOW	Sbalorditivo!	
GAMEPLAY_EMOTE_HERO_05A_CELEBRATE	Ah ah, sì!	
GAMEPLAY_EMOTE_HERO_05A_CONCEDE	Impareggiabile. Mi arrendo.	
GAMEPLAY_EMOTE_HERO_05A_ERROR_FULL_MINIONS	Ho troppi servitori.	
GAMEPLAY_EMOTE_HERO_05A_ERROR_GENERIC	Non posso farlo.	
GAMEPLAY_EMOTE_HERO_05A_ERROR_HAND_FULL	La mia mano è piena.	
GAMEPLAY_EMOTE_HERO_05A_ERROR_I_ATTACKED	Ho già attaccato.	
GAMEPLAY_EMOTE_HERO_05A_ERROR_JUST_PLAYED	Concedi a quel servitore un turno per prepararsi.	
GAMEPLAY_EMOTE_HERO_05A_ERROR_MINION_ATTACKED	Quel servitore ha già attaccato.	
GAMEPLAY_EMOTE_HERO_05A_ERROR_NEED_MANA	Non ho abbastanza Mana.	
GAMEPLAY_EMOTE_HERO_05A_ERROR_NEED_WEAPON	Mi serve un'arma.	
GAMEPLAY_EMOTE_HERO_05A_ERROR_PLAY	Non posso giocare questa carta.	
GAMEPLAY_EMOTE_HERO_05A_ERROR_STEALTH	Non posso scegliere come bersagli i servitori con Furtività.	
GAMEPLAY_EMOTE_HERO_05A_ERROR_TARGET	Quel bersaglio non è valido.	
GAMEPLAY_EMOTE_HERO_05A_ERROR_TAUNT	Devo attaccare i servitori con Provocazione.	
GAMEPLAY_EMOTE_HERO_05A_EVENT_FIRE_FESTIVAL	La festa di Mezza Estate è arrivata.	
GAMEPLAY_EMOTE_HERO_05A_EVENT_HALLOWS_END	Buona Veglia delle Ombre.	
GAMEPLAY_EMOTE_HERO_05A_EVENT_LUNAR_NEW_YEAR	Buona Festa della Luna.	
GAMEPLAY_EMOTE_HERO_05A_EVENT_NOBLEGARDEN	Buona Festa di Nobiluova.	
GAMEPLAY_EMOTE_HERO_05A_EVENT_PIRATE_DAY	Arrr! Ti manderò a fondo!	
GAMEPLAY_EMOTE_HERO_05A_GOOD_GAME	Bella partita.	
GAMEPLAY_EMOTE_HERO_05A_GREETINGS	Salve, viandante.	
GAMEPLAY_EMOTE_HERO_05A_GREETINGS_RESPONSE	Ah, salve anche a te!	
GAMEPLAY_EMOTE_HERO_05A_LOW_CARDS	Ho quasi finito le carte.	
GAMEPLAY_EMOTE_HERO_05A_MIRROR_START	Io non tremo mai.	
GAMEPLAY_EMOTE_HERO_05A_NO_CARDS	Ho finito le carte.	
GAMEPLAY_EMOTE_HERO_05A_OOPS	Mmm, un errore.	
GAMEPLAY_EMOTE_HERO_05A_SORRY	Mi spiace.	
GAMEPLAY_EMOTE_HERO_05A_START	Trema di fronte alla potenza degli Elfi.	
GAMEPLAY_EMOTE_HERO_05A_THANKS	Grazie.	
GAMEPLAY_EMOTE_HERO_05A_THINK1	Mmm...	
GAMEPLAY_EMOTE_HERO_05A_THINK2	Chi dovrei colpire?	
GAMEPLAY_EMOTE_HERO_05A_THINK3	Cosa dovrei fare...	
GAMEPLAY_EMOTE_HERO_05A_THREATEN	La mia vendetta sarà rapida.	
GAMEPLAY_EMOTE_HERO_05A_TIMER	Presto, devo agire.	
GAMEPLAY_EMOTE_HERO_05A_WELL_PLAYED	Bella giocata.	
GAMEPLAY_EMOTE_HERO_05A_WINTERVEIL_GREETING	Buona Vigilia di Grande Inverno!	
GAMEPLAY_EMOTE_HERO_05A_WOW	Incredibile!	
GAMEPLAY_EMOTE_HERO_06_CONCEDE	Ammetto la sconfitta.	
GAMEPLAY_EMOTE_HERO_06_ERROR_FULL_MINIONS	Ho troppi servitori.	
GAMEPLAY_EMOTE_HERO_06_ERROR_GENERIC	Non posso farlo.	
GAMEPLAY_EMOTE_HERO_06_ERROR_HAND_FULL	La mia mano è piena!	
GAMEPLAY_EMOTE_HERO_06_ERROR_I_ATTACKED	Ho già attaccato.	
GAMEPLAY_EMOTE_HERO_06_ERROR_JUST_PLAYED	Concedi a quel servitore un turno per prepararsi.	
GAMEPLAY_EMOTE_HERO_06_ERROR_MINION_ATTACKED	Quel servitore ha già attaccato.	
GAMEPLAY_EMOTE_HERO_06_ERROR_NEED_MANA	Non ho abbastanza Mana.	
GAMEPLAY_EMOTE_HERO_06_ERROR_NEED_WEAPON	Mi serve un'arma.	
GAMEPLAY_EMOTE_HERO_06_ERROR_PLAY	Non posso giocare questa carta.	
GAMEPLAY_EMOTE_HERO_06_ERROR_STEALTH	Non posso scegliere come bersagli i servitori con Furtività.	
GAMEPLAY_EMOTE_HERO_06_ERROR_TARGET	Quel bersaglio non è valido.	
GAMEPLAY_EMOTE_HERO_06_ERROR_TAUNT	Devo attaccare i servitori con Provocazione.	
GAMEPLAY_EMOTE_HERO_06_EVENT_LUNAR_NEW_YEAR	Buon anno!	
GAMEPLAY_EMOTE_HERO_06_FIRE_FESTIVAL	Buona festa di Mezza Estate. Attenzione ai fuochi.	
GAMEPLAY_EMOTE_HERO_06_GOOD_GAME	Bella partita.	
GAMEPLAY_EMOTE_HERO_06_GREETINGS	I miei saluti.	
GAMEPLAY_EMOTE_HERO_06_GREETINGS_RESPONSE	Ricambio.	
GAMEPLAY_EMOTE_HERO_06_HALLOWS_END	Buona Veglia delle Ombre!	
GAMEPLAY_EMOTE_HERO_06_LOW_CARDS	Ho quasi finito le carte!	
GAMEPLAY_EMOTE_HERO_06_MIRROR_START	Non sei l'unico!	
GAMEPLAY_EMOTE_HERO_06_NO_CARDS	Ho finito le carte!	
GAMEPLAY_EMOTE_HERO_06_NOBLEGARDEN	Buona Festa di Nobiluova!	
GAMEPLAY_EMOTE_HERO_06_OOPS	Un errore naturale.	
GAMEPLAY_EMOTE_HERO_06_PIRATE_DAY	Tutti in coperta!	
GAMEPLAY_EMOTE_HERO_06_SORRY	Mi dispiace...	
GAMEPLAY_EMOTE_HERO_06_START	Devo proteggere la natura!	
GAMEPLAY_EMOTE_HERO_06_START_TYRANDE	Tyrande, mia amata.	
GAMEPLAY_EMOTE_HERO_06_THANKS	Un sentito ringraziamento.	
GAMEPLAY_EMOTE_HERO_06_THINK1	Mmm...	
GAMEPLAY_EMOTE_HERO_06_THINK2	Mmm... Fammi pensare...	
GAMEPLAY_EMOTE_HERO_06_THINK3	Cosa fare...	
GAMEPLAY_EMOTE_HERO_06_THREATEN	La natura si opporrà a te!	
GAMEPLAY_EMOTE_HERO_06_TIMER	Il tempo non aspetta nessuno!	
GAMEPLAY_EMOTE_HERO_06_WELL_PLAYED	Mmm, bella giocata.	
GAMEPLAY_EMOTE_HERO_06_WINTERVEIL_GREETINGS	Felice Vigilia di Grande Inverno!	
GAMEPLAY_EMOTE_HERO_06_WOW	Spettacolare!	
GAMEPLAY_EMOTE_HERO_07_CONCEDE	Questa volta... hai vinto.	
GAMEPLAY_EMOTE_HERO_07_ERROR_FULL_MINIONS	Ho troppi servitori.	
GAMEPLAY_EMOTE_HERO_07_ERROR_GENERIC	Non posso farlo.	
GAMEPLAY_EMOTE_HERO_07_ERROR_HAND_FULL	La mia mano è piena!	
GAMEPLAY_EMOTE_HERO_07_ERROR_I_ATTACKED	Ho già attaccato.	
GAMEPLAY_EMOTE_HERO_07_ERROR_JUST_PLAYED	Concedi a quel servitore un turno per prepararsi.	
GAMEPLAY_EMOTE_HERO_07_ERROR_MINION_ATTACKED	Quel servitore ha già attaccato.	
GAMEPLAY_EMOTE_HERO_07_ERROR_NEED_MANA	Non ho abbastanza Mana.	
GAMEPLAY_EMOTE_HERO_07_ERROR_NEED_WEAPON	Mi serve un'arma.	
GAMEPLAY_EMOTE_HERO_07_ERROR_PLAY	Non posso giocare questa carta.	
GAMEPLAY_EMOTE_HERO_07_ERROR_STEALTH	Non posso attaccare i servitori con Furtività.	
GAMEPLAY_EMOTE_HERO_07_ERROR_TARGET	Quel bersaglio non è valido.	
GAMEPLAY_EMOTE_HERO_07_ERROR_TAUNT	Devo attaccare i servitori con Provocazione.	
GAMEPLAY_EMOTE_HERO_07_EVENT_LUNAR_NEW_YEAR	Buon anno!	
GAMEPLAY_EMOTE_HERO_07_FIRE_FESTIVAL	Appiccate i fuochi.	
GAMEPLAY_EMOTE_HERO_07_GOOD_GAME	Bella partita.	
GAMEPLAY_EMOTE_HERO_07_GREETINGS	Salute.	
GAMEPLAY_EMOTE_HERO_07_GREETINGS_RESPONSE	Salute a te.	
GAMEPLAY_EMOTE_HERO_07_HALLOWS_END	Buona Veglia delle Ombre.	
GAMEPLAY_EMOTE_HERO_07_LOW_CARDS	Ho quasi finito le carte!	
GAMEPLAY_EMOTE_HERO_07_MIRROR_START	Io sono il tuo incubo!	
GAMEPLAY_EMOTE_HERO_07_NO_CARDS	Ho finito le carte!	
GAMEPLAY_EMOTE_HERO_07_NOBLEGARDEN	Buona Festa di Nobiluova.	
GAMEPLAY_EMOTE_HERO_07_OOPS	Un grave errore.	
GAMEPLAY_EMOTE_HERO_07_PIRATE_DAY	Il Giorno dei Pirati? Ma che senso ha?	
GAMEPLAY_EMOTE_HERO_07_SORRY	Mi dispiace.	
GAMEPLAY_EMOTE_HERO_07_START	La tua anima sarà mia!	
GAMEPLAY_EMOTE_HERO_07_THANKS	Grazie.	
GAMEPLAY_EMOTE_HERO_07_THINK1	Mmm...	
GAMEPLAY_EMOTE_HERO_07_THINK2	Mi chiedo...	
GAMEPLAY_EMOTE_HERO_07_THINK3	Quante possibilità...	
GAMEPLAY_EMOTE_HERO_07_THREATEN	La tua anima soffrirà!	
GAMEPLAY_EMOTE_HERO_07_TIMER	Ho quasi finito il tempo!	
GAMEPLAY_EMOTE_HERO_07_WELL_PLAYED	Bella giocata.	
GAMEPLAY_EMOTE_HERO_07_WINTERVEIL_GREETINGS	Buona Vigilia di Grande Inverno!	
GAMEPLAY_EMOTE_HERO_07_WOW	Straordinario.	
GAMEPLAY_EMOTE_HERO_08_CONCEDE	Hai vinto.	
GAMEPLAY_EMOTE_HERO_08_ERROR_FULL_MINIONS	Ho troppi servitori.	
GAMEPLAY_EMOTE_HERO_08_ERROR_GENERIC	Non posso farlo.	
GAMEPLAY_EMOTE_HERO_08_ERROR_HAND_FULL	La mia mano è piena!	
GAMEPLAY_EMOTE_HERO_08_ERROR_I_ATTACKED	Ho già attaccato.	
GAMEPLAY_EMOTE_HERO_08_ERROR_JUST_PLAYED	Quel servitore ha bisogno di un turno per prepararsi.	
GAMEPLAY_EMOTE_HERO_08_ERROR_MINION_ATTACKED	Quel servitore ha già attaccato.	
GAMEPLAY_EMOTE_HERO_08_ERROR_NEED_MANA	Non ho abbastanza Mana.	
GAMEPLAY_EMOTE_HERO_08_ERROR_NEED_WEAPON	Mi serve un'arma.	
GAMEPLAY_EMOTE_HERO_08_ERROR_PLAY	Non posso giocare questa carta.	
GAMEPLAY_EMOTE_HERO_08_ERROR_STEALTH	Non posso colpire i servitori con Furtività.	
GAMEPLAY_EMOTE_HERO_08_ERROR_TARGET	Quel bersaglio non è valido.	
GAMEPLAY_EMOTE_HERO_08_ERROR_TAUNT	Devo attaccare i servitori con Provocazione.	
GAMEPLAY_EMOTE_HERO_08_EVENT_LUNAR_NEW_YEAR	Buon anno!	
GAMEPLAY_EMOTE_HERO_08_FIRE_FESTIVAL	Buona festa di Mezza Estate!	
GAMEPLAY_EMOTE_HERO_08_GOOD_GAME	Bella partita.	
GAMEPLAY_EMOTE_HERO_08_GREETINGS	Salve!	
GAMEPLAY_EMOTE_HERO_08_GREETINGS_RESPONSE	Salve a te.	
GAMEPLAY_EMOTE_HERO_08_HALLOWS_END	Buona Veglia delle Ombre.	
GAMEPLAY_EMOTE_HERO_08_LOW_CARDS	Ho quasi finito le carte!	
GAMEPLAY_EMOTE_HERO_08_MIRROR_START	Ah, non vedo l'ora.	
GAMEPLAY_EMOTE_HERO_08_NO_CARDS	Ho finito le carte!	
GAMEPLAY_EMOTE_HERO_08_NOBLEGARDEN	Buona Festa di Nobiluova.	
GAMEPLAY_EMOTE_HERO_08_OOPS	Ops.	
GAMEPLAY_EMOTE_HERO_08_PIRATE_DAY	Arrr! Mollate gli ormeggi!	
GAMEPLAY_EMOTE_HERO_08_SORRY	Mi dispiace.	
GAMEPLAY_EMOTE_HERO_08_START	L'hai voluto tu!	
GAMEPLAY_EMOTE_HERO_08_THANKS	Ti ringrazio.	
GAMEPLAY_EMOTE_HERO_08_THINK1	Mmm...	
GAMEPLAY_EMOTE_HERO_08_THINK2	Fammi pensare...	
GAMEPLAY_EMOTE_HERO_08_THINK3	Che fare, che fare...	
GAMEPLAY_EMOTE_HERO_08_THREATEN	La mia magia ti farà a pezzi!	
GAMEPLAY_EMOTE_HERO_08_TIMER	Il mio tempo sta per scadere!	
GAMEPLAY_EMOTE_HERO_08_WELL_PLAYED	Bella giocata.	
GAMEPLAY_EMOTE_HERO_08_WINTERVEIL_GREETINGS	Felice Vigilia di Grande Inverno!	
GAMEPLAY_EMOTE_HERO_08_WOW	Fantastico!	
GAMEPLAY_EMOTE_HERO_08A_CELEBRATE	Sì, SÌ! Ah ah!	
GAMEPLAY_EMOTE_HERO_08A_CONCEDE	Scacco matto. Ammetto la sconfitta.	
GAMEPLAY_EMOTE_HERO_08A_ERROR_FULL_MINIONS	Ho troppi servitori.	
GAMEPLAY_EMOTE_HERO_08A_ERROR_GENERIC	Non posso farlo.	
GAMEPLAY_EMOTE_HERO_08A_ERROR_HAND_FULL	La mia mano è piena.	
GAMEPLAY_EMOTE_HERO_08A_ERROR_I_ATTACKED	Ho già attaccato.	
GAMEPLAY_EMOTE_HERO_08A_ERROR_JUST_PLAYED	Concedi a quel servitore un turno per prepararsi.	
GAMEPLAY_EMOTE_HERO_08A_ERROR_MINION_ATTACKED	Quel servitore ha già attaccato.	
GAMEPLAY_EMOTE_HERO_08A_ERROR_NEED_MANA	Non ho abbastanza Mana.	
GAMEPLAY_EMOTE_HERO_08A_ERROR_NEED_WEAPON	Mi serve un'arma.	
GAMEPLAY_EMOTE_HERO_08A_ERROR_PLAY	Non posso giocare questa carta.	
GAMEPLAY_EMOTE_HERO_08A_ERROR_STEALTH	Non posso scegliere come bersagli i servitori con Furtività.	
GAMEPLAY_EMOTE_HERO_08A_ERROR_TARGET	Quel bersaglio non è valido.	
GAMEPLAY_EMOTE_HERO_08A_ERROR_TAUNT	Devo attaccare i servitori con Provocazione.	
GAMEPLAY_EMOTE_HERO_08A_FIRE_FESTIVAL	È arrivata la Festa di Mezza Estate!	
GAMEPLAY_EMOTE_HERO_08A_GOOD_GAME	Bella partita.	
GAMEPLAY_EMOTE_HERO_08A_GREETINGS	Ah, salute.	
GAMEPLAY_EMOTE_HERO_08A_GREETINGS_RESPONSE	Salute a te, Guardiano.	
GAMEPLAY_EMOTE_HERO_08A_HALLOWS_END	Buona Veglia delle Ombre.	
GAMEPLAY_EMOTE_HERO_08A_LOW_CARDS	Ho quasi finito le carte.	
GAMEPLAY_EMOTE_HERO_08A_LUNAR_NEW_YEAR	Buon anno!	
GAMEPLAY_EMOTE_HERO_08A_MIRROR_START	Oh, sono già cominciati.	
GAMEPLAY_EMOTE_HERO_08A_NO_CARDS	Ho finito le carte.	
GAMEPLAY_EMOTE_HERO_08A_NOBLEGARDEN	Buona Festa di Nobiluova!	
GAMEPLAY_EMOTE_HERO_08A_OOPS	È stata una follia.	
GAMEPLAY_EMOTE_HERO_08A_PIRATE_DAY	Sono Medivh, il Guarrrdiano!	
GAMEPLAY_EMOTE_HERO_08A_SORRY	Le mie più sincere scuse.	
GAMEPLAY_EMOTE_HERO_08A_START	Che i giochi abbiano inizio.	
GAMEPLAY_EMOTE_HERO_08A_THANKS	Ti sono grato.	
GAMEPLAY_EMOTE_HERO_08A_THINK1	Mmm...	
GAMEPLAY_EMOTE_HERO_08A_THINK2	Interessante...	
GAMEPLAY_EMOTE_HERO_08A_THINK3	Forse potrei...	
GAMEPLAY_EMOTE_HERO_08A_THREATEN	Nulla può fermarmi. Nulla.	
GAMEPLAY_EMOTE_HERO_08A_TIMER	Non devo farmi distrarre.	
GAMEPLAY_EMOTE_HERO_08A_WELL_PLAYED	Bella giocata.	
GAMEPLAY_EMOTE_HERO_08A_WINTERVEIL_GREETINGS	Buone feste, sfidante!	
GAMEPLAY_EMOTE_HERO_08A_WOW	Incredibile.	
GAMEPLAY_EMOTE_HERO_08B_CONCEDE	Ben fatto. Hai vinto.	
GAMEPLAY_EMOTE_HERO_08B_ERROR_FULL_MINIONS	Ho troppi servitori.	
GAMEPLAY_EMOTE_HERO_08B_ERROR_GENERIC	Non posso farlo.	
GAMEPLAY_EMOTE_HERO_08B_ERROR_HAND_FULL	La mia mano è piena.	
GAMEPLAY_EMOTE_HERO_08B_ERROR_I_ATTACKED	Ho già attaccato.	
GAMEPLAY_EMOTE_HERO_08B_ERROR_JUST_PLAYED	Concedi a quel servitore un turno per prepararsi.	
GAMEPLAY_EMOTE_HERO_08B_ERROR_MINION_ATTACKED	Quel servitore ha già attaccato.	
GAMEPLAY_EMOTE_HERO_08B_ERROR_NEED_MANA	Non ho abbastanza Mana.	
GAMEPLAY_EMOTE_HERO_08B_ERROR_NEED_WEAPON	Mi serve un'arma.	
GAMEPLAY_EMOTE_HERO_08B_ERROR_PLAY	Non posso giocare questa carta.	
GAMEPLAY_EMOTE_HERO_08B_ERROR_STEALTH	Non posso scegliere come bersagli i servitori con Furtività.	
GAMEPLAY_EMOTE_HERO_08B_ERROR_TARGET	Quel bersaglio non è valido.	
GAMEPLAY_EMOTE_HERO_08B_ERROR_TAUNT	Devo attaccare i servitori con Provocazione.	
GAMEPLAY_EMOTE_HERO_08B_FIRE_FESTIVAL	Buona festa di Mezza Estate a te.	
GAMEPLAY_EMOTE_HERO_08B_GOOD_GAME	Però... Che bella partita!	
GAMEPLAY_EMOTE_HERO_08B_GREETINGS	Salute. Che la verità sia con te.	
GAMEPLAY_EMOTE_HERO_08B_GREETINGS_RESPONSE	Insieme, troveremo ciò che cerchiamo.	
GAMEPLAY_EMOTE_HERO_08B_HALLOWS_END	Buona Veglia delle Ombre.	
GAMEPLAY_EMOTE_HERO_08B_LOW_CARDS	Ho quasi finito le carte.	
GAMEPLAY_EMOTE_HERO_08B_LUNAR_NEW_YEAR	Buon anno.	
GAMEPLAY_EMOTE_HERO_08B_MIRROR_START	Impareremo molto insieme.	
GAMEPLAY_EMOTE_HERO_08B_NO_CARDS	Ho finito le carte.	
GAMEPLAY_EMOTE_HERO_08B_NOBLEGARDEN	Buona Festa di Nobiluova!	
GAMEPLAY_EMOTE_HERO_08B_OOPS	Oh, cielo. Ooops.	
GAMEPLAY_EMOTE_HERO_08B_PIRATE_DAY	Quindi oggi festeggiamo dei criminali? Ho capito bene?	
GAMEPLAY_EMOTE_HERO_08B_SORRY	Accidenti... Mi dispiace.	
GAMEPLAY_EMOTE_HERO_08B_START	La conoscenza è potere.	
GAMEPLAY_EMOTE_HERO_08B_THANKS	Grazie, davvero.	
GAMEPLAY_EMOTE_HERO_08B_THINK1	Mmm...	
GAMEPLAY_EMOTE_HERO_08B_THINK2	Osserva e rifletti, Khadgar...	
GAMEPLAY_EMOTE_HERO_08B_THINK3	Dev'esserci un modo...	
GAMEPLAY_EMOTE_HERO_08B_THREATEN	È ora di una lezione, poppante!	
GAMEPLAY_EMOTE_HERO_08B_TIMER	Il tempo scorre in fretta!	
GAMEPLAY_EMOTE_HERO_08B_WELL_PLAYED	Bella giocata.	
GAMEPLAY_EMOTE_HERO_08B_WINTERVEIL_GREETINGS	Felice Vigilia di Grande Inverno!	
GAMEPLAY_EMOTE_HERO_08B_WOW	Magnifico!	
GAMEPLAY_EMOTE_HERO_09_CONCEDE	Mi hai sconfitto.	
GAMEPLAY_EMOTE_HERO_09_ERROR_FULL_MINIONS	Ho troppi servitori.	
GAMEPLAY_EMOTE_HERO_09_ERROR_GENERIC	Non posso farlo.	
GAMEPLAY_EMOTE_HERO_09_ERROR_HAND_FULL	La mia mano è piena!	
GAMEPLAY_EMOTE_HERO_09_ERROR_I_ATTACKED	Ho già attaccato.	
GAMEPLAY_EMOTE_HERO_09_ERROR_JUST_PLAYED	Concedi a quel servitore un turno per prepararsi.	
GAMEPLAY_EMOTE_HERO_09_ERROR_MINION_ATTACKED	Quel servitore ha già attaccato.	
GAMEPLAY_EMOTE_HERO_09_ERROR_NEED_MANA	Non ho abbastanza Mana.	
GAMEPLAY_EMOTE_HERO_09_ERROR_NEED_WEAPON	Mi serve un'arma.	
GAMEPLAY_EMOTE_HERO_09_ERROR_PLAY	Non posso giocare questa carta.	
GAMEPLAY_EMOTE_HERO_09_ERROR_STEALTH	Non posso scegliere come bersagli i servitori con Furtività.	
GAMEPLAY_EMOTE_HERO_09_ERROR_TARGET	Quel bersaglio non è valido.	
GAMEPLAY_EMOTE_HERO_09_ERROR_TAUNT	Devo attaccare i servitori con Provocazione.	
GAMEPLAY_EMOTE_HERO_09_EVENT_LUNAR_NEW_YEAR	Buon anno!	
GAMEPLAY_EMOTE_HERO_09_FIRE_FESTIVAL	Non vedo l'ora di ammirare i fuochi d'artificio!	
GAMEPLAY_EMOTE_HERO_09_GOOD_GAME	Bella partita.	
GAMEPLAY_EMOTE_HERO_09_GREETINGS	Salve!	
GAMEPLAY_EMOTE_HERO_09_GREETINGS_DISABLED	Mmmpf!	
GAMEPLAY_EMOTE_HERO_09_GREETINGS_RESPONSE	Saluti a te.	
GAMEPLAY_EMOTE_HERO_09_HALLOWS_END	Buona Veglia delle Ombre!	
GAMEPLAY_EMOTE_HERO_09_LOW_CARDS	Ho quasi finito le carte!	
GAMEPLAY_EMOTE_HERO_09_MIRROR_START	La Luce sorride ai giusti!	
GAMEPLAY_EMOTE_HERO_09_NO_CARDS	Ho finito le carte!	
GAMEPLAY_EMOTE_HERO_09_NOBLEGARDEN	Buona Festa di Nobiluova!	
GAMEPLAY_EMOTE_HERO_09_OOPS	Non proprio come avevo programmato.	
GAMEPLAY_EMOTE_HERO_09_OOPS_DISABLED	Mmmpf?	
GAMEPLAY_EMOTE_HERO_09_PIRATE_DAY	Arrr!!! Uniamoci all'Equipaggio Fantasma!	
GAMEPLAY_EMOTE_HERO_09_SORRY	Chiedo scusa.	
GAMEPLAY_EMOTE_HERO_09_START	La Luce porterà alla vittoria!	
GAMEPLAY_EMOTE_HERO_09_THANKS	Grazie.	
GAMEPLAY_EMOTE_HERO_09_THANKS_DISABLED	Mmpfmm...	
GAMEPLAY_EMOTE_HERO_09_THINK1	Mmm...	
GAMEPLAY_EMOTE_HERO_09_THINK2	Fammi pensare...	
GAMEPLAY_EMOTE_HERO_09_THINK3	Devo pensarci bene...	
GAMEPLAY_EMOTE_HERO_09_THREATEN	La Luce ti brucerà!	
GAMEPLAY_EMOTE_HERO_09_THREATEN_DISABLED	Mmmmmmmmpf!!!	
GAMEPLAY_EMOTE_HERO_09_TIMER	Devo scegliere in fretta!	
GAMEPLAY_EMOTE_HERO_09_WELL_PLAYED	Bella giocata.	
GAMEPLAY_EMOTE_HERO_09_WELL_PLAYED_DISABLED	Mmmpf...	
GAMEPLAY_EMOTE_HERO_09_WINTERVEIL_GREETINGS	Felice Vigilia di Grande Inverno!	
GAMEPLAY_EMOTE_HERO_09_WOW	Accidenti!	
GAMEPLAY_EMOTE_HERO_09_WOW_DISABLED	Mmmmmmmmpf!!!	
GAMEPLAY_EMOTE_HERO_EVILBRM_START	Umpf!	
GAMEPLAY_EMOTE_HERO_EVILBRM_WOW	Muahahah!	
GAMEPLAY_EMOTE_HERO_TBKTRAF_KT_CONCEDE	Tornerò!	
GAMEPLAY_EMOTE_HERO_TBKTRAF_KT_GREETINGS	Finalmente ci incontriamo.	
GAMEPLAY_EMOTE_HERO_TBKTRAF_KT_LOW_CARDS	Ho quasi finito le carte!	
GAMEPLAY_EMOTE_HERO_TBKTRAF_KT_NO_CARDS	No!!! Che tu sia maledetto, intruso!	
GAMEPLAY_EMOTE_HERO_TBKTRAF_KT_OOPS	Mi tocca tornare alla fase di progettazione...	
GAMEPLAY_EMOTE_HERO_TBKTRAF_KT_SORRY	No!!!	
GAMEPLAY_EMOTE_HERO_TBKTRAF_KT_START	Vieni ad affrontarmi, intruso!	
GAMEPLAY_EMOTE_HERO_TBKTRAF_KT_THANKS	Ti sono grato.	
GAMEPLAY_EMOTE_HERO_TBKTRAF_KT_THINK1	Mmm... Forse...	
GAMEPLAY_EMOTE_HERO_TBKTRAF_KT_THINK2	Sì... SÌ!	
GAMEPLAY_EMOTE_HERO_TBKTRAF_KT_THINK3	Che cosa ne pensi, Signor Bigolo?	
GAMEPLAY_EMOTE_HERO_TBKTRAF_KT_THREATEN	Ti gelerò il sangue nelle vene!	
GAMEPLAY_EMOTE_HERO_TBKTRAF_KT_WELL_PLAYED	Ben fatto.	
GAMEPLAY_EMOTE_HERO_TBKTRAF_RAF_CONCEDE	NO! NON POSSO ESSERE SCONFITTO!	
GAMEPLAY_EMOTE_HERO_TBKTRAF_RAF_GREETINGS	Salve.	
GAMEPLAY_EMOTE_HERO_TBKTRAF_RAF_LOW_CARDS	Ho quasi finito le carte!	
GAMEPLAY_EMOTE_HERO_TBKTRAF_RAF_NO_CARDS	No! Le mie preziose carte!	
GAMEPLAY_EMOTE_HERO_TBKTRAF_RAF_OOPS	Fallimento!	
GAMEPLAY_EMOTE_HERO_TBKTRAF_RAF_SORRY	Mi fai pena.	
GAMEPLAY_EMOTE_HERO_TBKTRAF_RAF_START	Rafaam, l'archeologo supremo!	
GAMEPLAY_EMOTE_HERO_TBKTRAF_RAF_THANKS	Ah, ti ringrazio.	
GAMEPLAY_EMOTE_HERO_TBKTRAF_RAF_THINK1	Mmm...	
GAMEPLAY_EMOTE_HERO_TBKTRAF_RAF_THINK2	Che cosa scegliere...	
GAMEPLAY_EMOTE_HERO_TBKTRAF_RAF_THINK3	Sono tentato...	
GAMEPLAY_EMOTE_HERO_TBKTRAF_RAF_THREATEN	POTERE TRAVOLGENTE!	
GAMEPLAY_EMOTE_HERO_TBKTRAF_RAF_WELL_PLAYED	Ben fatto.	
GAMEPLAY_EMOTE_HERO_TBMECHWAR01_CONCEDE	<Mi arrendo.>	The text is in brackets because the VO files is just Annoy-o-Tron's greeting
GAMEPLAY_EMOTE_HERO_TBMECHWAR01_ERROR_FULL_MINIONS	<Errore!>	The text is in brackets because the VO files is just Annoy-o-Tron's greeting
GAMEPLAY_EMOTE_HERO_TBMECHWAR01_ERROR_HAND_FULL	<Errore!>	The text is in brackets because the VO files is just Annoy-o-Tron's greeting
GAMEPLAY_EMOTE_HERO_TBMECHWAR01_ERROR_I_ATTACKED	<Errore!>	The text is in brackets because the VO files is just Annoy-o-Tron's greeting
GAMEPLAY_EMOTE_HERO_TBMECHWAR01_ERROR_JUST_PLAYED	<Errore!>	The text is in brackets because the VO files is just Annoy-o-Tron's greeting
GAMEPLAY_EMOTE_HERO_TBMECHWAR01_ERROR_MINION_ATTACKED	<Errore!>	The text is in brackets because the VO files is just Annoy-o-Tron's greeting
GAMEPLAY_EMOTE_HERO_TBMECHWAR01_ERROR_NEED_MANA	<Errore!>	The text is in brackets because the VO files is just Annoy-o-Tron's greeting
GAMEPLAY_EMOTE_HERO_TBMECHWAR01_ERROR_NEED_WEAPON	<Errore!>	The text is in brackets because the VO files is just Annoy-o-Tron's greeting
GAMEPLAY_EMOTE_HERO_TBMECHWAR01_ERROR_PLAY	<Errore!>	The text is in brackets because the VO files is just Annoy-o-Tron's greeting
GAMEPLAY_EMOTE_HERO_TBMECHWAR01_ERROR_STEALTH	<Errore!>	The text is in brackets because the VO files is just Annoy-o-Tron's greeting
GAMEPLAY_EMOTE_HERO_TBMECHWAR01_ERROR_TARGET	<Errore!>	The text is in brackets because the VO files is just Annoy-o-Tron's greeting
GAMEPLAY_EMOTE_HERO_TBMECHWAR01_ERROR_TAUNT	<Errore!>	The text is in brackets because the VO files is just Annoy-o-Tron's greeting
GAMEPLAY_EMOTE_HERO_TBMECHWAR01_GREETINGS	<Salve.>	The text is in brackets because the VO files is just Annoy-o-Tron's greeting
GAMEPLAY_EMOTE_HERO_TBMECHWAR01_LOW_CARDS	<Restano poche carte.>	The text is in brackets because the VO files is just Annoy-o-Tron's greeting
GAMEPLAY_EMOTE_HERO_TBMECHWAR01_NO_CARDS	<Carte finite.>	The text is in brackets because the VO files is just Annoy-o-Tron's greeting
GAMEPLAY_EMOTE_HERO_TBMECHWAR01_OOPS	<Errore.>	The text is in brackets because the VO files is just Annoy-o-Tron's greeting
GAMEPLAY_EMOTE_HERO_TBMECHWAR01_SORRY	<Mi dispiace.>	The text is in brackets because the VO files is just Annoy-o-Tron's greeting
GAMEPLAY_EMOTE_HERO_TBMECHWAR01_START	<Avvio dei sistemi...>	The text is in brackets because the VO files is just Annoy-o-Tron's greeting
GAMEPLAY_EMOTE_HERO_TBMECHWAR01_THANKS	<Grazie.>	The text is in brackets because the VO files is just Annoy-o-Tron's greeting
GAMEPLAY_EMOTE_HERO_TBMECHWAR01_THINK1	<Analisi in corso...>	The text is in brackets because the VO files is just Annoy-o-Tron's greeting
GAMEPLAY_EMOTE_HERO_TBMECHWAR01_THINK2	<Ricerca bersaglio...>	The text is in brackets because the VO files is just Annoy-o-Tron's greeting
GAMEPLAY_EMOTE_HERO_TBMECHWAR01_THINK3	<Risparmio energia attivato...>	The text is in brackets because the VO files is just Annoy-o-Tron's greeting
GAMEPLAY_EMOTE_HERO_TBMECHWAR01_THREATEN	<Ti smantellerò!>	The text is in brackets because the VO files is just Annoy-o-Tron's attack
GAMEPLAY_EMOTE_HERO_TBMECHWAR01_TIMER	<Tempo quasi scaduto.>	The text is in brackets because the VO files is just Annoy-o-Tron's greeting
GAMEPLAY_EMOTE_HERO_TBMECHWAR01_WELL_PLAYED	<Bella giocata.>	The text is in brackets because the VO files is just Annoy-o-Tron's greeting
GAMEPLAY_EMOTE_HERO_TBMECHWAR01_WOW	<Incredibile!>	The text is in brackets because the VO files is just Annoy-o-Tron's greeting
GAMEPLAY_EMOTE_HERO_TBMECHWAR02_CONCEDE	<Fine dei giochi.>	The text is in brackets because the VO files is just Boom Bot's greeting
GAMEPLAY_EMOTE_HERO_TBMECHWAR02_ERROR_FULL_MINIONS	<Errore!>	The text is in brackets because the VO files is just Boom Bot's greeting
GAMEPLAY_EMOTE_HERO_TBMECHWAR02_ERROR_HAND_FULL	<Errore!>	The text is in brackets because the VO files is just Boom Bot's greeting
GAMEPLAY_EMOTE_HERO_TBMECHWAR02_ERROR_I_ATTACKED	<Errore!>	The text is in brackets because the VO files is just Boom Bot's greeting
GAMEPLAY_EMOTE_HERO_TBMECHWAR02_ERROR_JUST_PLAYED	<Errore!>	The text is in brackets because the VO files is just Boom Bot's greeting
GAMEPLAY_EMOTE_HERO_TBMECHWAR02_ERROR_MINION_ATTACKED	<Errore!>	The text is in brackets because the VO files is just Boom Bot's greeting
GAMEPLAY_EMOTE_HERO_TBMECHWAR02_ERROR_NEED_MANA	<Errore!>	The text is in brackets because the VO files is just Boom Bot's greeting
GAMEPLAY_EMOTE_HERO_TBMECHWAR02_ERROR_NEED_WEAPON	<Errore!>	The text is in brackets because the VO files is just Boom Bot's greeting
GAMEPLAY_EMOTE_HERO_TBMECHWAR02_ERROR_PLAY	<Errore!>	The text is in brackets because the VO files is just Boom Bot's greeting
GAMEPLAY_EMOTE_HERO_TBMECHWAR02_ERROR_STEALTH	<Errore!>	The text is in brackets because the VO files is just Boom Bot's greeting
GAMEPLAY_EMOTE_HERO_TBMECHWAR02_ERROR_TARGET	<Errore!>	The text is in brackets because the VO files is just Boom Bot's greeting
GAMEPLAY_EMOTE_HERO_TBMECHWAR02_ERROR_TAUNT	<Errore!>	The text is in brackets because the VO files is just Boom Bot's greeting
GAMEPLAY_EMOTE_HERO_TBMECHWAR02_GREETINGS	<Salve.>	The text is in brackets because the VO files is just Annoy-o-Tron's greeting
GAMEPLAY_EMOTE_HERO_TBMECHWAR02_LOW_CARDS	<Restano poche carte.>	The text is in brackets because the VO files is just Boom Bot's greeting
GAMEPLAY_EMOTE_HERO_TBMECHWAR02_NO_CARDS	<Carte finite!>	The text is in brackets because the VO files is just Boom Bot's greeting
GAMEPLAY_EMOTE_HERO_TBMECHWAR02_OOPS	<Errore!>	The text is in brackets because the VO files is just Boom Bot's greeting
GAMEPLAY_EMOTE_HERO_TBMECHWAR02_SORRY	<Chiedo scusa.>	The text is in brackets because the VO files is just Boom Bot's greeting
GAMEPLAY_EMOTE_HERO_TBMECHWAR02_START	<Inizializzazione in corso.>	The text is in brackets because the VO files is just Boom Bot's greeting
GAMEPLAY_EMOTE_HERO_TBMECHWAR02_THANKS	<Grazie.>	The text is in brackets because the VO files is just Boom Bot's greeting
GAMEPLAY_EMOTE_HERO_TBMECHWAR02_THINK1	<Analisi in corso...>	The text is in brackets because the VO files is just Boom Bot's greeting
GAMEPLAY_EMOTE_HERO_TBMECHWAR02_THINK2	<Ricerca bersaglio...>	The text is in brackets because the VO files is just Boom Bot's greeting
GAMEPLAY_EMOTE_HERO_TBMECHWAR02_THINK3	<Risparmio energia attivato...>	The text is in brackets because the VO files is just Boom Bot's greeting
GAMEPLAY_EMOTE_HERO_TBMECHWAR02_THREATEN	<Assaggerai le mie bombe!>	The text is in brackets because the VO files is just Boom Bot's Attack sound
GAMEPLAY_EMOTE_HERO_TBMECHWAR02_TIMER	<Tempo quasi scaduto.>	The text is in brackets because the VO files is just Boom Bot's greeting
GAMEPLAY_EMOTE_HERO_TBMECHWAR02_WELL_PLAYED	<Bella giocata.>	The text is in brackets because the VO files is just Boom Bot's greeting
GAMEPLAY_EMOTE_HERO_TBMECHWAR02_WOW	<Sbalorditivo!>	The text is in brackets because the VO files is just Annoy-o-Tron's greeting
GAMEPLAY_EMOTE_ICC_481_CONCEDE	Che il gelo accompagni la tua vittoria.	
GAMEPLAY_EMOTE_ICC_481_GREETINGS	Lasciati andare al gelido abbraccio della morte.	
GAMEPLAY_EMOTE_ICC_481_LOW_CARDS	Ho quasi finito le carte!	
GAMEPLAY_EMOTE_ICC_481_NO_CARDS	Ho finito le carte!	
GAMEPLAY_EMOTE_ICC_481_OOPS	Un grave errore.	
GAMEPLAY_EMOTE_ICC_481_START	Sono il gelido cuore del Flagello!	
GAMEPLAY_EMOTE_ICC_481_THANKS	Ahahah! Grazie.	
GAMEPLAY_EMOTE_ICC_481_THINK1	Mmm...	
GAMEPLAY_EMOTE_ICC_481_THINK2	Mmm... Gli elementi sono silenziosi.	
GAMEPLAY_EMOTE_ICC_481_THINK3	La scelta è soltanto mia.	
GAMEPLAY_EMOTE_ICC_481_THREATEN	Ti spezzerò!	
GAMEPLAY_EMOTE_ICC_481_TIMER	Devo decidermi!	
GAMEPLAY_EMOTE_ICC_481_WELL_PLAYED	Bella giocata.	
GAMEPLAY_EMOTE_ICC_481_WOW	Notevole!	
GAMEPLAY_EMOTE_ICC_827_CONCEDE	Oggi è il tuo giorno.	
GAMEPLAY_EMOTE_ICC_827_GREETINGS	Ti nascondi per la paura?	
GAMEPLAY_EMOTE_ICC_827_LOW_CARDS	Ho quasi finito le carte!	
GAMEPLAY_EMOTE_ICC_827_NO_CARDS	Ho finito le carte!	
GAMEPLAY_EMOTE_ICC_827_OOPS	Ah, che tragedia...	
GAMEPLAY_EMOTE_ICC_827_START	Non puoi sfuggire all'ombra della morte!	
GAMEPLAY_EMOTE_ICC_827_THANKS	Ti ringrazio.	
GAMEPLAY_EMOTE_ICC_827_THINK1	Mmm...	
GAMEPLAY_EMOTE_ICC_827_THINK2	L'ombra della morte si allunga...	
GAMEPLAY_EMOTE_ICC_827_THINK3	Il tempo sfugge...	
GAMEPLAY_EMOTE_ICC_827_THREATEN	Imparerai a temere la tua ombra.	
GAMEPLAY_EMOTE_ICC_827_TIMER	Devo fare presto!	
GAMEPLAY_EMOTE_ICC_827_WELL_PLAYED	Ammirevole.	
GAMEPLAY_EMOTE_ICC_827_WOW	Irreale!	
GAMEPLAY_EMOTE_ICC_828_CONCEDE	Oggi la caccia è tua.	
GAMEPLAY_EMOTE_ICC_828_GREETINGS	Comincia a correre, preda!	
GAMEPLAY_EMOTE_ICC_828_LOW_CARDS	Ho quasi finito le carte!	
GAMEPLAY_EMOTE_ICC_828_MIRROR_START	Inizia pure, ti do un po' di vantaggio.	
GAMEPLAY_EMOTE_ICC_828_NO_CARDS	Ho finito le carte!	
GAMEPLAY_EMOTE_ICC_828_OOPS	Un colpo mancato.	
GAMEPLAY_EMOTE_ICC_828_START	Che la caccia abbia inizio!	
GAMEPLAY_EMOTE_ICC_828_THANKS	Ti ringrazio.	
GAMEPLAY_EMOTE_ICC_828_THINK1	Mmm...	
GAMEPLAY_EMOTE_ICC_828_THINK2	Quale traccia dovrei seguire...	
GAMEPLAY_EMOTE_ICC_828_THINK3	Fammi pensare...	
GAMEPLAY_EMOTE_ICC_828_THREATEN	Ti darò la caccia... per sempre!	
GAMEPLAY_EMOTE_ICC_828_TIMER	La traccia sta scomparendo...	
GAMEPLAY_EMOTE_ICC_828_WELL_PLAYED	Bella giocata.	
GAMEPLAY_EMOTE_ICC_828_WOW	Notevole!	
GAMEPLAY_EMOTE_ICC_829_CONCEDE	Hai trionfato... questa volta.	
GAMEPLAY_EMOTE_ICC_829_GREETINGS	Ora esiste solo la MIA giustizia.	
GAMEPLAY_EMOTE_ICC_829_LOW_CARDS	Ho quasi finito le carte!	
GAMEPLAY_EMOTE_ICC_829_NO_CARDS	Ho finito le carte!	
GAMEPLAY_EMOTE_ICC_829_OOPS	Disdicevole.	
GAMEPLAY_EMOTE_ICC_829_START	La giustizia della Luce ha fallito.	
GAMEPLAY_EMOTE_ICC_829_THANKS	Ti ringrazio.	
GAMEPLAY_EMOTE_ICC_829_THINK1	Mmm...	
GAMEPLAY_EMOTE_ICC_829_THINK2	Gelidanima chiama.	
GAMEPLAY_EMOTE_ICC_829_THINK3	Il Trono di Ghiaccio chiama...	
GAMEPLAY_EMOTE_ICC_829_THREATEN	Chiederai pietà e non te la concederò!	
GAMEPLAY_EMOTE_ICC_829_TIMER	La fine si avvicina!	
GAMEPLAY_EMOTE_ICC_829_WELL_PLAYED	Bella giocata.	
GAMEPLAY_EMOTE_ICC_829_WOW	Incredibile!	
GAMEPLAY_EMOTE_ICC_830_CONCEDE	NO! La tua vittoria non prova nulla!	
GAMEPLAY_EMOTE_ICC_830_GREETINGS	La completa oscurità sarà la mia vendetta.	
GAMEPLAY_EMOTE_ICC_830_LOW_CARDS	Ho quasi finito le carte.	
GAMEPLAY_EMOTE_ICC_830_NO_CARDS	Ho finito le carte.	
GAMEPLAY_EMOTE_ICC_830_OOPS	Errare è umano.	
GAMEPLAY_EMOTE_ICC_830_START	L'oscurità porta la vittoria.	
GAMEPLAY_EMOTE_ICC_830_THANKS	Ti ringrazio.	
GAMEPLAY_EMOTE_ICC_830_THINK1	Mmm...	
GAMEPLAY_EMOTE_ICC_830_THINK2	L'oscurità mi parla...	
GAMEPLAY_EMOTE_ICC_830_THINK3	Le ombre mi consigliano...	
GAMEPLAY_EMOTE_ICC_830_THREATEN	L'oscurità ti consumerà!	
GAMEPLAY_EMOTE_ICC_830_TIMER	Il tempo è tiranno!	
GAMEPLAY_EMOTE_ICC_830_WELL_PLAYED	Bella giocata.	
GAMEPLAY_EMOTE_ICC_830_WOW	Prodigioso.	
GAMEPLAY_EMOTE_ICC_831_CONCEDE	Hai vinto... per ora.	
GAMEPLAY_EMOTE_ICC_831_GREETINGS	Trema!	
GAMEPLAY_EMOTE_ICC_831_LOW_CARDS	Ho quasi finito le carte!	
GAMEPLAY_EMOTE_ICC_831_NO_CARDS	Ho finito le carte!	
GAMEPLAY_EMOTE_ICC_831_OOPS	Un'azione senza senso.	
GAMEPLAY_EMOTE_ICC_831_START	Un patto forgiato nel sangue e nell'ombra.	
GAMEPLAY_EMOTE_ICC_831_THANKS	Ah... grazie.	
GAMEPLAY_EMOTE_ICC_831_THINK1	Mmm...	
GAMEPLAY_EMOTE_ICC_831_THINK2	La mia fame cresce...	
GAMEPLAY_EMOTE_ICC_831_THINK3	Troppe maledette decisioni...	
GAMEPLAY_EMOTE_ICC_831_THREATEN	La tua sofferenza sarà... leggendaria!	
GAMEPLAY_EMOTE_ICC_831_TIMER	Devo nutrirmi! Ora!	
GAMEPLAY_EMOTE_ICC_831_WELL_PLAYED	Ben fatto.	
GAMEPLAY_EMOTE_ICC_831_WOW	Per il Fuoco Infernale!	
GAMEPLAY_EMOTE_ICC_832_CONCEDE	Hai vinto. Ora posso riposare.	
GAMEPLAY_EMOTE_ICC_832_GREETINGS	La decomposizione ha inizio.	
GAMEPLAY_EMOTE_ICC_832_LOW_CARDS	Ho quasi finito le carte!	
GAMEPLAY_EMOTE_ICC_832_NO_CARDS	Ho finito le carte!	
GAMEPLAY_EMOTE_ICC_832_OOPS	Un errore fatale.	
GAMEPLAY_EMOTE_ICC_832_START	Il cerchio della vita si è spezzato!	
GAMEPLAY_EMOTE_ICC_832_THANKS	Un sentito ringraziamento.	
GAMEPLAY_EMOTE_ICC_832_THINK1	Mmm...	
GAMEPLAY_EMOTE_ICC_832_THINK2	Che ragnatela ingarbugliata...	
GAMEPLAY_EMOTE_ICC_832_THINK3	I miei pensieri sono infetti.	
GAMEPLAY_EMOTE_ICC_832_THREATEN	Appassirai e marcirai!	
GAMEPLAY_EMOTE_ICC_832_TIMER	La morte è eterna... il mio turno no!	
GAMEPLAY_EMOTE_ICC_832_WELL_PLAYED	Magistrale.	
GAMEPLAY_EMOTE_ICC_832_WOW	Strepitoso!	
GAMEPLAY_EMOTE_ICC_833_CONCEDE	Mi arrendo al tuo potere.	
GAMEPLAY_EMOTE_ICC_833_GREETINGS	Stai tremando... hai paura?	
GAMEPLAY_EMOTE_ICC_833_LOW_CARDS	Ho quasi finito le carte!	
GAMEPLAY_EMOTE_ICC_833_NO_CARDS	Ho finito le carte!	
GAMEPLAY_EMOTE_ICC_833_OOPS	Ah, un errore fatale.	
GAMEPLAY_EMOTE_ICC_833_START	Non è il potere che bisogna temere... ma chi lo detiene!	
GAMEPLAY_EMOTE_ICC_833_THANKS	Ahahah! Grazie.	
GAMEPLAY_EMOTE_ICC_833_THINK1	Mmm...	
GAMEPLAY_EMOTE_ICC_833_THINK2	Il tempo scorre...	
GAMEPLAY_EMOTE_ICC_833_THINK3	Mmm... Devo decidere.	
GAMEPLAY_EMOTE_ICC_833_THREATEN	Inchinati di fronte alla tua regina!	
GAMEPLAY_EMOTE_ICC_833_TIMER	Devo fare presto!	
GAMEPLAY_EMOTE_ICC_833_WELL_PLAYED	Bella giocata.	
GAMEPLAY_EMOTE_ICC_833_WOW	Per il mio gelido cuore!	
GAMEPLAY_EMOTE_ICC_834_CONCEDE	Scelgo la morte!	
GAMEPLAY_EMOTE_ICC_834_GREETINGS	Non sfuggirai all'ira di Malogrido!	
GAMEPLAY_EMOTE_ICC_834_LOW_CARDS	Ho quasi finito le carte.	
GAMEPLAY_EMOTE_ICC_834_NO_CARDS	Ho finito le carte.	
GAMEPLAY_EMOTE_ICC_834_OOPS	Fallimento.	
GAMEPLAY_EMOTE_ICC_834_START	Brucerò questo mondo... e governerò sulle sue ceneri!	
GAMEPLAY_EMOTE_ICC_834_THANKS	Ti ringrazio.	
GAMEPLAY_EMOTE_ICC_834_THINK1	Mmm...	
GAMEPLAY_EMOTE_ICC_834_THINK2	Il tempo passa...	
GAMEPLAY_EMOTE_ICC_834_THINK3	E adesso?	
GAMEPLAY_EMOTE_ICC_834_THREATEN	Inginocchiati!	
GAMEPLAY_EMOTE_ICC_834_TIMER	Devo scegliere.	
GAMEPLAY_EMOTE_ICC_834_WELL_PLAYED	Bella giocata.	
GAMEPLAY_EMOTE_ICC_834_WOW	Sbalorditivo!	
VO__Female_Naga_Concede_02	Hai vinto... quesssta volta.	
VO__Female_Naga_ERROR_FULL_MINIONS_01	Ho troppi servitori.	
VO__Female_Naga_ERROR_GENERIC_04	Non se ne parla.	
VO__Female_Naga_ERROR_HAND_FULL_01	La mia mano è piena.	
VO__Female_Naga_ERROR_I_ATTACKED_01	Sono esausssta!	
VO__Female_Naga_ERROR_MINION_ATTACKED_01	Quello ha già attaccato.	
VO__Female_Naga_ERROR_NEED_MANA_01	Ho bisogno di Mana.	
VO__Female_Naga_ERROR_NEED_WEAPON_01	Dammi un'Arma.	
VO__Female_Naga_ERROR_PLAY_01	Non posso giocare quella carta.	
VO__Female_Naga_ERROR_STEALTH_01	Quello è nascosto.	
VO__Female_Naga_ERROR_SUMMON_SICKNESS_01	No, quello deve riposare.	
VO__Female_Naga_ERROR_TARGET_01	Ho bisogno di un bersssaglio!	
VO__Female_Naga_ERROR_TAUNT_01	Non vedi che quell'idiota mi provoca?	
VO__Female_Naga_FIRE_FESTIVAL_01	Mi piacerebbe versare dell'acqua fredda su quesssto ridicolo Festival del Fuoco.	
VO__Female_Naga_Greetings_01	Salve, senzapinne.	
VO__Female_Naga_HAPPY_HALLOWEEN_01	È la Veglia delle Ombre? Quando arriva quella delle maree?	
VO__Female_Naga_HAPPY_HOLIDAYS_01	Nesssuno fa festa come gli Alti Nobili!	
VO__Female_Naga_HAPPY_NEW_YEAR_01	Buon anno!	
VO__Female_Naga_HAPPY_NEW_YEAR_LUNAR_01	Buon anno!	
VO__Female_Naga_HAPPY_NOBLEGARDEN_01	Nobiluova? Tutti i nobili sono in fondo al mare.	
VO__Female_Naga_LowCards_01	Ho quasi finito le carte.	
VO__Female_Naga_MIRROR_GREETINGS_01	Io? Senzapinne? Che sciocchezza.	
VO__Female_Naga_MIRROR_START_01	Troverò il modo di sopravvivere.	
VO__Female_Naga_NoCards_01	Non ho più carte!	
VO__Female_Naga_Oops_02	Maledizione!	
VO__Female_Naga_Picked_01	Ssssì, centro perfetto!	
VO__Female_Naga_PIRATE_DAY_01	Canaglie senzapinne! Arrr!	
VO__Female_Naga_Sorry_01	Mi dissspiace.	
VO__Female_Naga_Start_01	Il tuo momento è giunto!	
VO__Female_Naga_Start_Illidan_01	È un onore, Sire Illidan.	
VO__Female_Naga_Start_Maiev_01	Ah, la piccola Cussstode!	
VO__Female_Naga_Start_Morgl_01	Il mare ti richiama, piccoletto.	
VO__Female_Naga_Start_Tyrande_01	Diecimila anni e riesci ancora ad annoiarmi.	
VO__Female_Naga_Thanks_02	Un sentito ringraziamento.	
VO__Female_Naga_Thinking_01	Mmm...	
VO__Female_Naga_Thinking_02	<Sospiro>	
VO__Female_Naga_Thinking_03	Che scelte ardue...	
VO__Female_Naga_Threaten_01	Ti ssspezzo in due!	
VO__Female_Naga_Time_01	Il tempo vola.	
VO__Female_Naga_TRIGGER_ANCESTRAL_SPIRIT	Sono un'amante della tradizione.	
VO__Female_Naga_TRIGGER_EARTH_SHOCK	Questa ti calmerà!	
VO__Female_Naga_TRIGGER_EVERYFIN_IS_AWESOME	L'alta marea travolge tutto.	
VO__Female_Naga_TRIGGER_FORKED_LIGHTNING	Ehi, un po' di educazione!	
VO__Female_Naga_TRIGGER_LIGHTNING_STORM	Che nessuno venga risssparmiato!	
VO__Female_Naga_TRIGGER_MUTATE	Il cambiamento è potere.	
VO__Female_Naga_TRIGGER_SERPENT_WARD	Ahahah!	
VO__Female_Naga_TRIGGER_UNSTABLE_EVOLUTION	Una volta ero un'Elfa della Notte, sai?	
VO__Female_Naga_TRIGGER_WITCHS_BREW	Delizioso.	
VO__Female_Naga_Well_Played_01	Notevole.	
VO__Female_Naga_WOW_01	Fantassstico!	
VO__Female_Night Elf_Concede_01	La vittoria è tua!	
VO__Female_Night Elf_ERROR_FULL_MINIONS_01	Non posso controllare altri servitori.	
VO__Female_Night Elf_ERROR_GENERIC_01	Assolutamente impossibile.	
VO__Female_Night Elf_ERROR_HAND_FULL_02	Non ho spazio per altre carte!	
VO__Female_Night Elf_ERROR_I_ATTACKED_01	Ho già attaccato!	
VO__Female_Night Elf_ERROR_MINION_ATTACKED_01	Quel servitore è stanco.	
VO__Female_Night Elf_ERROR_NEED_MANA_02	Non ho abbastanza Mana.	
VO__Female_Night Elf_ERROR_NEED_WEAPON_01	Prima mi servirebbe un'Arma.	
VO__Female_Night Elf_ERROR_PLAY_01	Non posso farlo.	
VO__Female_Night Elf_ERROR_STEALTH_01	Quel servitore è furtivo.	
VO__Female_Night Elf_ERROR_SUMMON_SICKNESS_01	Ha bisogno di un sonnellino.	
VO__Female_Night Elf_ERROR_TARGET_01	Quello è fuori dalla mia portata.	
VO__Female_Night Elf_ERROR_TAUNT_01	Un servitore con Provocazione mi ostacola.	
VO__Female_Night Elf_FIRE_FESTIVAL_01	Fa' attenzione a giocare col fuoco quest'oggi.	
VO__Female_Night Elf_Greetings_01	Oh, salve.	
VO__Female_Night Elf_HAPPY_HALLOWEEN_01	Le origini della Veglia delle Ombre sono terrificanti!	
VO__Female_Night Elf_HAPPY_HOLIDAYS_01	Chissà se Babbo Inverno ti porterà dei doni...	
VO__Female_Night Elf_HAPPY_NEW_YEAR_01	Buon anno!	
VO__Female_Night Elf_HAPPY_NEW_YEAR_LUNAR_01	Buon anno!	
VO__Female_Night Elf_HAPPY_NOBLEGARDEN_01	Oh, adoro la Festa di Nobiluova!	
VO__Female_Night Elf_LowCards_01	Sto finendo le carte? Strano.	
VO__Female_Night Elf_MIRROR_GREETINGS_01	Cosa studiamo oggi?	
VO__Female_Night Elf_MIRROR_START_01	Spero sia di archeologia...	
VO__Female_Night Elf_NoCards_01	Oh, no... le mie carte sono finite.	
VO__Female_Night Elf_Oops_01	Sbagliando s'impara.	
VO__Female_Night Elf_Picked_01	Sono una studiosa della foresta e un'insegnante per molti.	
VO__Female_Night Elf_PIRATE_DAY_01	Capitano Scrutastelle a rapporto, arrr!	
VO__Female_Night Elf_Sorry_01	Permettimi di scusarmi.	
VO__Female_Night Elf_Start_01	La lezione ha inizio!	
VO__Female_Night Elf_Thanks_02	Te ne sono davvero grata!	
VO__Female_Night Elf_Thinking_01	Mmm...	
VO__Female_Night Elf_Thinking_03	Curioso...	
VO__Female_Night Elf_Thinking_04	Così tante contraddizioni...	
VO__Female_Night Elf_Threaten_03	Ti darò una bella lezione.	
VO__Female_Night Elf_Time_01	Non si può fermare lo scorrere del tempo.	
VO__Female_Night Elf_Well_Played_01	Le tue abilità sono leggendarie!	
VO__Female_Night Elf_WOW_01	Ho assistito a qualcosa di formidabile.	
VO__Female_Val'kyr_Attack_01	Ti concederò l'oblio!	
VO__Female_Val'kyr_Concede_01	Il tuo valore ha prevalso.	
VO__Female_Val'kyr_Death_02	Ugh... È finita...	
VO__Female_Val'kyr_ERROR_FULL_MINIONS_01	Ho troppi servitori al mio comando.	
VO__Female_Val'kyr_ERROR_GENERIC_03	Non può essere.	
VO__Female_Val'kyr_ERROR_HAND_FULL_01	La mia mano è piena.	
VO__Female_Val'kyr_ERROR_I_ATTACKED_01	Ho già colpito il nemico.	
VO__Female_Val'kyr_ERROR_MINION_ATTACKED_01	Quello deve riposare, ora.	
VO__Female_Val'kyr_ERROR_NEED_MANA_01	Non ho abbastanza Mana.	
VO__Female_Val'kyr_ERROR_NEED_WEAPON_01	Mi serve un'Arma.	
VO__Female_Val'kyr_ERROR_PLAY_01	Non posso giocare questa carta.	
VO__Female_Val'kyr_ERROR_STEALTH_01	Quello è nascosto.	
VO__Female_Val'kyr_ERROR_SUMMON_SICKNESS_01	Sta ancora riposando.	
VO__Female_Val'kyr_ERROR_TARGET_01	Questo va oltre le mie possibilità.	
VO__Female_Val'kyr_ERROR_TAUNT_01	Un altro mi provoca.	
VO__Female_Val'kyr_FIRE_FESTIVAL_01	I più meritevoli saranno i più celebrati durante il Festival del Fuoco!	
VO__Female_Val'kyr_Greetings_01	Salve, sfidante.	
VO__Female_Val'kyr_HAPPY_HALLOWEEN_01	Rendi omaggio ai gloriosi caduti.	
VO__Female_Val'kyr_HAPPY_HOLIDAYS_01	Questo periodo dell'anno mi riscalda il cuore.	
VO__Female_Val'kyr_HAPPY_NEW_YEAR_01	Felice anno nuovo.	
VO__Female_Val'kyr_HAPPY_NEW_YEAR_LUNAR_01	Felice anno nuovo.	
VO__Female_Val'kyr_HAPPY_NOBLEGARDEN_01	Tu fai collezione di uova, io di guerrieri.	
VO__Female_Val'kyr_LowCards_01	Le mie carte sono quasi finite.	
VO__Female_Val'kyr_MIRROR_GREETINGS_01	Salute a te, degna avversaria.	
VO__Female_Val'kyr_MIRROR_START_01	Lo stavo per fare io!	
VO__Female_Val'kyr_NoCards_01	Ho terminato le carte.	
VO__Female_Val'kyr_Oops_01	Questo è davvero strano.	
VO__Female_Val'kyr_Picked_01	Sono sempre degna!	
VO__Female_Val'kyr_PIRATE_DAY_01	Arrr, corpo di mille guerrieri caduti! Grazie a me!	
VO__Female_Val'kyr_Sorry_01	Le mie più sentite scuse.	
VO__Female_Val'kyr_Start_01	Alzati ed esegui la volontà della nostra signora!	
VO__Female_Val'kyr_Start_Sylvanas_01	Non prenderò il tuo posto questa volta, mia signora.	
VO__Female_Val'kyr_Thanks_02	Hai la mia gratitudine.	
VO__Female_Val'kyr_Thinking_01	Mmm...	
VO__Female_Val'kyr_Thinking_03	Sono degna o non sono degna?	
VO__Female_Val'kyr_Thinking_04	E adesso?	
VO__Female_Val'kyr_Threaten_01	Affronta il tuo destino!	
VO__Female_Val'kyr_Time_01	Il tempo vola.	
VO__Female_Val'kyr_TRIGGER_BRAWL_01	Chi si aggiudicherà la vittoria?	
VO__Female_Val'kyr_TRIGGER_DEAD_MANS_HAND_01	La morte non mi turba.	
VO__Female_Val'kyr_TRIGGER_DEADLY_ARSENAL_01	Ohhh! Quante armi!	
VO__Female_Val'kyr_TRIGGER_DEVASTATE_01	La tua fine sarà gloriosa!	
VO__Female_Val'kyr_TRIGGER_FORGE_OF_SOULS_01	La forza... è eterna!	
VO__Female_Val'kyr_TRIGGER_HEROIC_STRIKE_01	Il destino chiama!	
VO__Female_Val'kyr_TRIGGER_MORTAL_STRIKE_01	Il richiamo dell'oscurità!	
VO__Female_Val'kyr_TRIGGER_RAMPAGE_01	Non è ancora la tua ora.	
VO__Female_Val'kyr_TRIGGER_WARPATH_01	Ecco un assaggio di quello che verrà!	
VO__Female_Val'kyr_Well_Played_01	Il mio giudizio è... positivo.	
VO__Female_Val'kyr_WOW_01	Che giocata meravigliosa!	
VO__Male_Dragon_Attack_01	Nulla può essermi negato!	
VO__Male_Dragon_Concede_02	Questa è la fine di OGNI COSA!	
VO__Male_Dragon_ERROR_FULL_MINIONS_02	Non posso comandare altri stolti.	
VO__Male_Dragon_ERROR_GENERIC_01	Non posso farlo.	
VO__Male_Dragon_ERROR_HAND_FULL_01	Non posso tenerne altre!	
VO__Male_Dragon_ERROR_I_ATTACKED_01	Ho già scatenato la mia furia!	
VO__Male_Dragon_ERROR_MINION_ATTACKED_01	Quel servitore ha già attaccato.	
VO__Male_Dragon_ERROR_NEED_MANA_02	Tu, portami del mana!	
VO__Male_Dragon_ERROR_NEED_WEAPON_02	Ho bisogno di un'Arma, la mia rabbia non basta.	
VO__Male_Dragon_ERROR_PLAY_01	Non posso farlo!	
VO__Male_Dragon_ERROR_STEALTH_01	Quel miserabile si è nascosto.	
VO__Male_Dragon_ERROR_SUMMON_SICKNESS_01	Quel servitore non può ancora colpire.	
VO__Male_Dragon_ERROR_TARGET_01	Mi serve un bersaglio.	
VO__Male_Dragon_ERROR_TAUNT_01	Quella NULLITÀ mi provoca.	
VO__Male_Dragon_FIRE_FESTIVAL_01	Tutto deve bruciare, durante il Festival del Fuoco!	
VO__Male_Dragon_Greetings_01	Ammira l'aspetto della morte!	
VO__Male_Dragon_HAPPY_BIRTHDAY_01	Quindi oggi è il tuo compleanno? Mmm...	
VO__Male_Dragon_HAPPY_BREWFEST_01	Cos'è la Festa della Birra? Perché non sta bruciando nulla?	
VO__Male_Dragon_HAPPY_HALLOWEEN_01	Un giorno di tenebra e morte? Delizioso.	
VO__Male_Dragon_HAPPY_HOLIDAYS_01	Festeggia pure... finché puoi!	
VO__Male_Dragon_HAPPY_NEW_YEAR_01	Buon anno!	
VO__Male_Dragon_HAPPY_NEW_YEAR_LUNAR_01	Buon anno!	
VO__Male_Dragon_HAPPY_NOBLEGARDEN_01	Ruba le uova che vuoi, ma non quelle dello Stormo dei Draghi Neri!	
VO__Male_Dragon_LowCards_01	Rimangono poche carte!	
VO__Male_Dragon_MIRROR_GREETINGS_01	Ah... non sei che un'ombra del passato...	
VO__Male_Dragon_MIRROR_START_01	Sì... la fine è inevitabile...	
VO__Male_Dragon_NoCards_01	Sono privo di carte!	
VO__Male_Dragon_Oops_01	Non si può essere sempre perfetti!	
VO__Male_Dragon_Picked_01	Distruggerò questo mondo!	
VO__Male_Dragon_PIRATE_DAY_01	Sono NelthARRRion!	
VO__Male_Dragon_Sorry_01	Me ne rammarico infinitamente.	
VO__Male_Dragon_Start_01	Vieni! Accogli il caos!	
VO__Male_Dragon_Thanks_01	Mmm... grazie.	
VO__Male_Dragon_Thinking_01	Mmm...	
VO__Male_Dragon_Thinking_03	Mmm... Che dilemma...	
VO__Male_Dragon_Thinking_04	Mmm... Devo bruciarli tutti...	
VO__Male_Dragon_Threaten_01	Non c'è riparo dalla mia furia.	
VO__Male_Dragon_Time_01	Devo fare presto!	
VO__Male_Dragon_Well_Played_01	Mmm... la tua tenacia è ammirevole.	
VO__Male_Dragon_WOW_01	Cataclismatico!	
VO__Male_Mogu_Concede_01	La vittoria è tua. Questa volta.	
VO__Male_Mogu_ERROR_FULL_MINIONS_02	Non posso reclutare altri servitori.	
VO__Male_Mogu_ERROR_GENERIC_02	È impossibile.	
VO__Male_Mogu_ERROR_HAND_FULL_02	Ho già troppe carte.	
VO__Male_Mogu_ERROR_I_ATTACKED_01	Gli ho già dato una strigliata.	
VO__Male_Mogu_ERROR_MINION_ATTACKED_02	Quel servitore ha già attaccato.	
VO__Male_Mogu_ERROR_NEED_MANA_02	Mi serve più Mana.	
VO__Male_Mogu_ERROR_NEED_WEAPON_01	Dammi un'Arma!	
VO__Male_Mogu_ERROR_PLAY_02	Non posso giocare questa carta.	
VO__Male_Mogu_ERROR_STEALTH_01	Quello si nasconde... per ora.	
VO__Male_Mogu_ERROR_SUMMON_SICKNESS_01	Non può ancora combattere.	
VO__Male_Mogu_ERROR_TARGET_01	Mi serve un bersaglio!	
VO__Male_Mogu_ERROR_TAUNT_01	Qualcuno provoca il Re del Tuono!	
VO__Male_Mogu_FIRE_FESTIVAL_01	Onora il fuoco e i fulmini che gli danno vita!	
VO__Male_Mogu_Greetings_01	Ammira la mia potenza.	
VO__Male_Mogu_HAPPY_HALLOWEEN_01	Dilettati pure con caramelle e costumi. Io penso al mio piano.	
VO__Male_Mogu_HAPPY_HOLIDAYS_01	Goditi le feste e onora la tradizione.	
VO__Male_Mogu_HAPPY_NEW_YEAR_01	Buon anno!	
VO__Male_Mogu_HAPPY_NEW_YEAR_LUNAR_01	Buon anno!	
VO__Male_Mogu_HAPPY_NOBLEGARDEN_01	Non lasciare che la primavera affievolisca il tuo desiderio di conquista.	
VO__Male_Mogu_LowCards_01	Ho quasi finito le carte.	
VO__Male_Mogu_MIRROR_GREETINGS_01	Credi non l'abbia già vista?	
VO__Male_Mogu_MIRROR_START_01	Allora non sei degno della mia attenzione.	
VO__Male_Mogu_NoCards_01	Non ho più carte.	
VO__Male_Mogu_Oops_01	Ho un po' la testa tra le nuvole...	
VO__Male_Mogu_Picked_01	Il mio potere non può essere contrastato!	
VO__Male_Mogu_PIRATE_DAY_01	I pirati possono depredare ogni cosa, ma il bottino va al re.	
VO__Male_Mogu_Sorry_01	Un errore di calcolo.	
VO__Male_Mogu_Start_01	Sono uno sterminatore di re e divinità!	
VO__Male_Mogu_Thanks_01	Mi hai servito bene.	
VO__Male_Mogu_Thinking_01	Mmm...	
VO__Male_Mogu_Thinking_02	Devo meditare...	
VO__Male_Mogu_Thinking_03	Che confusione...	
VO__Male_Mogu_Threaten_03	Inginocchiati al mio cospetto!	
VO__Male_Mogu_Time_01	Devo fare in fretta!	
VO__Male_Mogu_Well_Played_01	La tua fame di vittoria è formidabile.	
VO__Male_Mogu_WOW_01	Mi hai sorpreso. Incredibile.	
VO_AnnoyO_Male_Mech_Attack_01	CIAO!	
VO_AnnoyO_Male_Mech_Concede_02	Ciao...	
VO_AnnoyO_Male_Mech_Death_01	Cia... ooo...	
VO_AnnoyO_Male_Mech_ERROR_FULL_MINIONS_01	Ciao!	
VO_AnnoyO_Male_Mech_ERROR_GENERIC_04	Ciao.	
VO_AnnoyO_Male_Mech_ERROR_HAND_FULL_02	AAAH! CIAO!!!	
VO_AnnoyO_Male_Mech_ERROR_I_ATTACKED_02	Cia... Ciao.	
VO_AnnoyO_Male_Mech_ERROR_MINION_ATTACKED_01	Ciao! Ciao.	
VO_AnnoyO_Male_Mech_ERROR_NEED_MANA_01	Ciao! Ciao.	
VO_AnnoyO_Male_Mech_ERROR_NEED_WEAPON_01	Ciao.	
VO_AnnoyO_Male_Mech_ERROR_PLAY_01	Ciao!	
VO_AnnoyO_Male_Mech_ERROR_STEALTH_01	Ciaaaooo...	
VO_AnnoyO_Male_Mech_ERROR_SUMMON_SICKNESS_01	Ciao? Ciao! Ciao.	
VO_AnnoyO_Male_Mech_ERROR_TARGET_01	Ciao.	
VO_AnnoyO_Male_Mech_ERROR_TAUNT_01	Ciao!	
VO_AnnoyO_Male_Mech_FIRE_FESTIVAL_01	Ciao? Ciao! CIAO!	
VO_AnnoyO_Male_Mech_GG_01	Ciao!	
VO_AnnoyO_Male_Mech_Greetings_03	Ciao! Ciao! Ciao!	
VO_AnnoyO_Male_Mech_HAPPY_HALLOWEEN_01	Ombre! Ombre! Ombre!	
VO_AnnoyO_Male_Mech_HAPPY_HOLIDAYS_01	Ciao, oh, oh, oh!	
VO_AnnoyO_Male_Mech_HAPPY_NEW_YEAR_01	Ciao. Ciao. Ciao.	
VO_AnnoyO_Male_Mech_HAPPY_NEW_YEAR_LUNAR_01	Ciao. Ciao. Ciao.	
VO_AnnoyO_Male_Mech_HAPPY_NOBLEGARDEN_01	Ciaaaooo!	
VO_AnnoyO_Male_Mech_LowCards_01	Ciao?!?	
VO_AnnoyO_Male_Mech_MIRROR_GREETINGS_02	Ciao! Ciao! Ciao!	
VO_AnnoyO_Male_Mech_MIRROR_START_01	Ciao? Ciao. Ma ciaaaooo!	
VO_AnnoyO_Male_Mech_NoCards_01	Ciaaaooo!!!	
VO_AnnoyO_Male_Mech_Oops_01	Ciaaaooo.	
VO_AnnoyO_Male_Mech_Picked_01	Ciao! Ciao! Ciao!	
VO_AnnoyO_Male_Mech_PIRATE_DAY_02	Arrr! Arrr! Arrr!	
VO_AnnoyO_Male_Mech_Sorry_01	Ciao...	
VO_AnnoyO_Male_Mech_Start_01	Ciao! Ciao! Ciao!	
VO_AnnoyO_Male_Mech_Thanks_01	Ciao!	
VO_AnnoyO_Male_Mech_Thinking_02	Ciao? Ciaaaooo!	
VO_AnnoyO_Male_Mech_Thinking_03	Cia... ooo?	
VO_AnnoyO_Male_Mech_Thinking_07	Ciao. Ciao. Ciao?	
VO_AnnoyO_Male_Mech_Threaten_01	Ciao!	
VO_AnnoyO_Male_Mech_Time_01	Ciao. Ciao! CIAO!	
VO_AnnoyO_Male_Mech_Well_Played_01	Ciaaaooo!	
VO_AnnoyO_Male_Mech_WOW_01	Ma ciaaaooo!	
VO_Arthas_Male_Human_Attack_01	Il male verrà purificato!	
VO_Arthas_Male_Human_CONCEDE_01	La battaglia è finita. Hai vinto.	
VO_Arthas_Male_Human_ERROR_FULL_MINIONS_01	Ho troppi servitori!	
VO_Arthas_Male_Human_ERROR_GENERIC_01	Non posso farlo.	
VO_Arthas_Male_Human_ERROR_HAND_FULL_01	La mia mano è piena!	
VO_Arthas_Male_Human_ERROR_I_ATTACKED_01	Ho già attaccato.	
VO_Arthas_Male_Human_ERROR_JUST_PLAYED_01	Devo concedere a quel servitore un turno per prepararsi.	
VO_Arthas_Male_Human_ERROR_MINION_ATTACKED_01	Quel servitore ha già attaccato.	
VO_Arthas_Male_Human_ERROR_NEED_MANA_01	Non ho abbastanza Mana.	
VO_Arthas_Male_Human_ERROR_NEED_WEAPON_01	Mi serve un'arma.	
VO_Arthas_Male_Human_ERROR_PLAY_01	Non posso giocare questa carta.	
VO_Arthas_Male_Human_ERROR_STEALTH_01	Non posso scegliere come bersagli i servitori con Furtività.	
VO_Arthas_Male_Human_ERROR_TARGET_01	Quel bersaglio non è valido.	
VO_Arthas_Male_Human_ERROR_TAUNT_01	Devo attaccare i servitori con Provocazione.	
VO_Arthas_Male_Human_FIRE_FESTIVAL_01	Accendete i falò!	
VO_Arthas_Male_Human_GREETINGS_01	Salute a te.	
VO_Arthas_Male_Human_GREETINGS_RESPONSE	Altrettanto.	
VO_Arthas_Male_Human_HAPPY_HALLOWEEN_01	Felice Veglia delle Ombre!	
VO_Arthas_Male_Human_HAPPY_HOLIDAYS_01	Buona Vigilia di Grande Inverno!	
VO_Arthas_Male_Human_HAPPY_NEW_YEAR_01	Buon anno!	
VO_Arthas_Male_Human_HAPPY_NEW_YEAR_LUNAR_01	Buon anno!	
VO_Arthas_Male_Human_HAPPY_NOBLEGARDEN	Buona Festa di Nobiluova.	
VO_Arthas_Male_Human_LOW_CARDS_01	Ho quasi finito le carte.	
VO_Arthas_Male_Human_MIRROR_GREETINGS_01	Altrettanto.	
VO_Arthas_Male_Human_MIRROR_START_01	Per mio padre, il Re!	
VO_Arthas_Male_Human_NO_CARDS_01	Ho finito le carte!	
VO_Arthas_Male_Human_OOPS_01	Un passo falso.	
VO_Arthas_Male_Human_PIRATE_DAY_01	È bello essere Arrrthas.	
VO_Arthas_Male_Human_SORRY_01	Le mie regali scuse.	
VO_Arthas_Male_Human_START_01	Per Lordaeron!	
VO_Arthas_Male_Human_THANKS_01	Hai la mia riconoscenza.	
VO_Arthas_Male_Human_THINK1_01	Mmm...	
VO_Arthas_Male_Human_THINK2_01	Che sentiero dovrei seguire...	
VO_Arthas_Male_Human_THINK3_01	Che cosa farebbe Uther?	
VO_Arthas_Male_Human_THREATEN_01	Non puoi sperare nella redenzione!	
VO_Arthas_Male_Human_TIMER_01	Devo agire in fretta!	
VO_Arthas_Male_Human_WELL_PLAYED_01	Bella giocata.	
VO_Arthas_Male_Human_WOW_01	Per la Luce Sacra!	
VO_BOT_238_Male_Goblin_Concede_01	Ci rinuncio. AUTODISTRUZIONE!	
VO_BOT_238_Male_Goblin_Greetings_02	Boom! Ahahahah...	
VO_BOT_238_Male_Goblin_HAPPY_HALLOWEEN_01	Buuu! Ahahah! Buona Veglia delle Ombre. 	
VO_BOT_238_Male_Goblin_LowCards_01	Quasi finito le carte...	
VO_BOT_238_Male_Goblin_NoCards_01	Ecco, ho finito le carte!	
VO_BOT_238_Male_Goblin_Oops_01	Uh, quindi il fallimento È contemplato.	
VO_BOT_238_Male_Goblin_Thanks_01	Grazie! Aspetterò un po' a distruggerti.	
VO_BOT_238_Male_Goblin_Thinking_01	Dunque...	
VO_BOT_238_Male_Goblin_Thinking_02	Mmm... sarebbe il momento giusto per un piano...	
VO_BOT_238_Male_Goblin_Thinking_03	Mmm...	
VO_BOT_238_Male_Goblin_Threaten_01	Non farmi premere i pulsanti!	
VO_BOT_238_Male_Goblin_Time_03	Oh, adoro quando compare la miccia.	
VO_BOT_238_Male_Goblin_Well_Played_02	Ehi... ci sai fare.	
VO_BOT_238_Male_Goblin_WOW_01	Fantastico!	
VO_BRM_027h__LUNAR_NEW_YEAR	CHE IL FUOCO TI PURIFICHI!	
VO_BRM_027h_Attack_15	ASSAGGIA LE FIAMME DI SULFURON!	
VO_BRM_027h_Concede_11	HAI VINTO! BELLA PARTITA!	
VO_BRM_027h_Emote_Start	Avrò la mia vendetta, drago!	
VO_BRM_027h_ERROR01_51	MI SERVE UN'ARMA!	
VO_BRM_027h_ERROR02_52	IL MANA NON BASTA!	
VO_BRM_027h_ERROR03_53	HA GIÀ ATTACCATO.	
VO_BRM_027h_ERROR04_54	HO GIÀ ATTACCATO.	
VO_BRM_027h_ERROR05_55	I MORTALI HANNO BISOGNO DI UN TURNO PER PREPARARSI.	
VO_BRM_027h_ERROR06_56	TROPPE CARTE!	
VO_BRM_027h_ERROR07_57	TROPPI SERVITORI.	
VO_BRM_027h_ERROR08_58	È IN MODALITÀ FURTIVA!	
VO_BRM_027h_ERROR09_59	NON POSSO GIOCARE QUESTA CARTA.	
VO_BRM_027h_ERROR10_60	NON SI PUÒ!	
VO_BRM_027h_ERROR11_61	QUEL SERVITORE MI HA PROVOCATO!	
VO_BRM_027h_ERROR12_62	NON LO POSSO FARE.	
VO_BRM_027h_FIRE_FESTIVAL	FINALMENTE UNA FESTA IN MIO ONORE!	
VO_BRM_027h_GG_16	BELLA PARTITA!	
VO_BRM_027h_Greetings_04	CHE IL FUOCO TI PURIFICHI!	
VO_BRM_027h_GREETINGS_RESPONSE	PURIFICARE, PURIFICARE, PURIFICARE!	
VO_BRM_027h_HALLOWS_END	FELICE VEGLIA DELLE OMBRE!	
VO_BRM_027h_HAPPY_NEW_YEAR_38	CHE IL FUOCO TI PURIFICHI!	
VO_BRM_027h_LowCards_49	HO BRUCIATO QUASI TUTTE LE MIE CARTE!	
VO_BRM_027h_NOBLEGARDEN	BOLLIRAI COME UN UOVO!	
VO_BRM_027h_NoCards_50	HO BRUCIATO TUTTE LE MIE CARTE!	
VO_BRM_027h_Oops_07	AH! CHE ERRORE!	
VO_BRM_027h_PIRATE_DAY	AMMIRATE L'ARRRDENTE SIGNORE DEL FUOCO!	
VO_BRM_027h_Sorry_10	MI DISPIACE!	
VO_BRM_027h_Thanks_09	UN CALDO RINGRAZIAMENTO.	
VO_BRM_027h_Thinking1_12	MMM...	
VO_BRM_027h_Thinking2_13	FAMMI PENSARE...	
VO_BRM_027h_Thinking3_14	CHI BRUCIO PER PRIMO...	
VO_BRM_027h_Threaten_08	PERIRAI TRA LE FIAMME!	
VO_BRM_027h_Time_48	RISCHIO DI FINIRE BRUCIATO SUL TEMPO!	
VO_BRM_027h_Well_Played_06	BELLA GIOCATA!	
VO_BRM_027h_Winterveil_Greetings	L'inverno dovrebbe essere più caldo!	
VO_BRM_027h_WOW_20	DAVVERO FIAMMEGGIANTE!	
VO_DRG_600_Male_Dragon_Concede_01	Hai sconfitto la mia armata. Congratulazioni.	
VO_DRG_600_Male_Dragon_Greetings_01	Brucia nel vilfuoco!	
VO_DRG_600_Male_Dragon_MIRROR_GREETINGS_01	Lo sto già facendo!	
VO_DRG_600_Male_Dragon_MIRROR_START_01	Anche a te!	
VO_DRG_600_Male_Dragon_Oops_01	È stato... doloroso.	
VO_DRG_600_Male_Dragon_Picked_01	È ora di dar fuoco al mondo intero!	
VO_DRG_600_Male_Dragon_Sorry_01	Sono dispiaciuto. Ma tu... lo sarai ancora di più.	
VO_DRG_600_Male_Dragon_Start_01	Fuoco! Fuoco a tutto quanto!	
VO_DRG_600_Male_Dragon_Thanks_01	Grazie per i tuoi futili sforzi.	
VO_DRG_600_Male_Dragon_Threaten_01	L'eternità non sarà tenera con la tua anima.	
VO_DRG_600_Male_Dragon_Time_01	Il mio tempo sta finendo!	
VO_DRG_600_Male_Dragon_Well_Played_01	Notevole... per un mortale.	
VO_DRG_600_Male_Dragon_WOW_01	Che cosa meravigliosamente vile.	
VO_DRG_610_Male_Dragon_Concede_01	L'incubo è finito. Hai vinto.	
VO_DRG_610_Male_Dragon_Greetings_01	La tua paura è deliziosa.	
VO_DRG_610_Male_Dragon_MIRROR_GREETINGS_01	Spaventi solo te stesso.	
VO_DRG_610_Male_Dragon_MIRROR_START_01	Ti mostrerò il vero significato del terrore.	
VO_DRG_610_Male_Dragon_Oops_01	Francamente terribile.	
VO_DRG_610_Male_Dragon_Picked_01	Vedo che hai scelto l'oscurità... Saggia decisione.	
VO_DRG_610_Male_Dragon_Sorry_01	Scusa... Ti ho spaventato?	
VO_DRG_610_Male_Dragon_Start_01	Non ti sveglierai mai da quest'incubo.	
VO_DRG_610_Male_Dragon_Thanks_01	Ti ringrazio. Sarai tra gli ultimi che annienterò.	
VO_DRG_610_Male_Dragon_Threaten_01	Le tue urla mi deliziano.	
VO_DRG_610_Male_Dragon_Time_01	L'oscurità svanisce!	
VO_DRG_610_Male_Dragon_Well_Played_01	Il tuo autocontrollo è... lodevole.	
VO_DRG_610_Male_Dragon_WOW_01	Sorprendente!	
VO_DRG_620_Male_Dragon_Concede_01	La tempesta è passata. Mi arrendo.	
VO_DRG_620_Male_Dragon_Greetings_01	Sei in grado di affrontare la tempesta?	
VO_DRG_620_Male_Dragon_MIRROR_GREETINGS_01	La tempesta obbedisce ai MIEI comandi!	
VO_DRG_620_Male_Dragon_MIRROR_START_01	I cieli s'inchinano solo dinanzi a me!	
VO_DRG_620_Male_Dragon_Oops_01	Un disastro naturale!	
VO_DRG_620_Male_Dragon_Picked_01	Trema dinanzi al maelstrom!	
VO_DRG_620_Male_Dragon_Sorry_01	Mi dispiace, ma bisogna compiere dei sacrifici.	
VO_DRG_620_Male_Dragon_Start_01	Io sono la tempesta! Io sono l'uragano!	
VO_DRG_620_Male_Dragon_Thanks_01	Grazie. Altro combustibile per i miei fuochi.	
VO_DRG_620_Male_Dragon_Threaten_02	Come puoi sperare di resistere a una forza della natura?	
VO_DRG_620_Male_Dragon_Time_01	L'occhio del ciclone si avvicina!	
VO_DRG_620_Male_Dragon_Well_Played_01	Una giocata da far tremare la terra!	
VO_DRG_620_Male_Dragon_WOW_01	Che turbine!	
VO_DRG_650_Male_Dragon_Concede_01	Stavolta mi hai fermato... ma tornerò!	
VO_DRG_650_Male_Dragon_Greetings_01	Inchinati dinanzi all'indistruttibile!	
VO_DRG_650_Male_Dragon_MIRROR_GREETINGS_01	Vedremo chi si spezzerà per primo.	
VO_DRG_650_Male_Dragon_MIRROR_START_01	Due forze inarrestabili? Ah! Ci sarà da divertirsi!	
VO_DRG_650_Male_Dragon_Oops_02	Un errore enorme!	
VO_DRG_650_Male_Dragon_Picked_01	La mia forza è impareggiabile.	
VO_DRG_650_Male_Dragon_Sorry_01	Scusa... non avevo nemmeno notato.	
VO_DRG_650_Male_Dragon_Start_01	Non hai alcuna speranza di vittoria.	
VO_DRG_650_Male_Dragon_Thanks_01	Grazie per il tuo piccolo dono.	
VO_DRG_650_Male_Dragon_Threaten_01	Siete come moscerini di fronte a un gigante!	
VO_DRG_650_Male_Dragon_Time_01	Sono indistruttibile, ma il tempo vola!	
VO_DRG_650_Male_Dragon_Well_Played_01	Una giocata colossale!	
VO_DRG_650_Male_Dragon_WOW_02	Questo... mi ha impressionato.	
VO_DRG_660_Male_Dragon_Concede_01	Mi arrendo. Goditi il silenzio.	
VO_DRG_660_Male_Dragon_Greetings_01	Ti vedo...	
VO_DRG_660_Male_Dragon_MIRROR_GREETINGS_01	Chi ha detto che mi stavo nascondendo?	
VO_DRG_660_Male_Dragon_MIRROR_START_01	E con me soltanto.	
VO_DRG_660_Male_Dragon_Oops_01	Oh, che orrore!	
VO_DRG_660_Male_Dragon_Picked_01	Mandiamo in rovina il loro mondo!	
VO_DRG_660_Male_Dragon_Sorry_01	Scusami. Cosa avevo in mente?	
VO_DRG_660_Male_Dragon_Start_01	I sussurri... parlano solo con me.	
VO_DRG_660_Male_Dragon_Thanks_01	La tua follia... è gradevole.	
VO_DRG_660_Male_Dragon_Threaten_01	La tua mente vacilla.	
VO_DRG_660_Male_Dragon_Time_01	Cosa?!? Il tempo sta scadendo!	
VO_DRG_660_Male_Dragon_Well_Played_01	Approvo questa pazzia.	
VO_DRG_660_Male_Dragon_WOW_01	È stato... fantasioso.	
VO_DRG_6x_Male_Dragon_ERROR_FULL_MINIONS_01	Il mio lato del campo è pieno.	
VO_DRG_6x_Male_Dragon_ERROR_GENERIC_01	Impossibile.	
VO_DRG_6x_Male_Dragon_ERROR_HAND_FULL_01	Ho troppe carte!	
VO_DRG_6x_Male_Dragon_ERROR_I_ATTACKED_01	Non posso attaccare di nuovo.	
VO_DRG_6x_Male_Dragon_ERROR_MINION_ATTACKED_01	Quel servitore ha già attaccato.	
VO_DRG_6x_Male_Dragon_ERROR_NEED_MANA_01	Mi serve più Mana per quella.	
VO_DRG_6x_Male_Dragon_ERROR_NEED_WEAPON_01	Mi serve un'Arma. O degli artigli.	
VO_DRG_6x_Male_Dragon_ERROR_PLAY_01	Non posso farlo.	
VO_DRG_6x_Male_Dragon_ERROR_STEALTH_01	Quel servitore è furtivo.	
VO_DRG_6x_Male_Dragon_ERROR_SUMMON_SICKNESS_01	Concedi a quel rammollito un turno per prepararsi.	
VO_DRG_6x_Male_Dragon_ERROR_TARGET_01	Non posso sceglierlo come bersaglio.	
VO_DRG_6x_Male_Dragon_ERROR_TAUNT_01	Devo attaccare i servitori con Provocazione.	
VO_DRG_6x_Male_Dragon_FIRE_FESTIVAL_01	Fuochi d'artificio. Li adoro.	
VO_DRG_6x_Male_Dragon_HAPPY_HALLOWEEN_01	La Veglia delle Ombre... La mia festa preferita.	
VO_DRG_6x_Male_Dragon_HAPPY_HOLIDAYS_01	Felice Vigilia di Grande Inverno.	
VO_DRG_6x_Male_Dragon_HAPPY_NEW_YEAR_01	Buon anno.	
VO_DRG_6x_Male_Dragon_HAPPY_NEW_YEAR_LUNAR_01	Buon anno.	
VO_DRG_6x_Male_Dragon_HAPPY_NOBLEGARDEN_01	Nobiluova... La detesto.	
VO_DRG_6x_Male_Dragon_LowCards_01	Ho quasi finito le carte.	
VO_DRG_6x_Male_Dragon_NoCards_01	Ho finito le carte!	
VO_DRG_6x_Male_Dragon_PIRATE_DAY_01	Arrr! Galakrond razzierà i cieli!	
VO_DRG_6x_Male_Dragon_Thinking_01	E se invece...	
VO_DRG_6x_Male_Dragon_Thinking_02	E se facessi...	
VO_DRG_6x_Male_Dragon_Thinking_03	Forse...	
VO_EX1_323h_HAPPY_NEW_YEAR_13	BUON ANNO.	
VO_GIL_504_Female_Orc_Concede_01	Hai vinto questa volta.	
VO_GIL_504_Female_Orc_Greetings_02	Ti do il benvenuto nel mio dominio.	
VO_GIL_504_Female_Orc_GREETINGS_RESPONSE	Continuiamo assieme, allora.	
VO_GIL_504_Female_Orc_LowCards_01	Ho quasi finito le carte!	
VO_GIL_504_Female_Orc_NoCards_01	Non ho più carte!	
VO_GIL_504_Female_Orc_Oops_01	Una mossa poco saggia.	
VO_GIL_504_Female_Orc_Start_01	Di notte il bosco è pericoloso.	
VO_GIL_504_Female_Orc_Thanks_01	Grazie.	
VO_GIL_504_Female_Orc_Thinking_01	Mmm...	
VO_GIL_504_Female_Orc_Thinking_02	Sono incerta...	
VO_GIL_504_Female_Orc_Thinking_03	Un sentiero poco illuminato...	
VO_GIL_504_Female_Orc_Threaten_02	La maledizione ti annienterà!	
VO_GIL_504_Female_Orc_Time_01	Devo decidere!	
VO_GIL_504_Female_Orc_Well_Played_01	Bella giocata.	
VO_GIL_504_Female_Orc_Wow_01	Per la notte!	
VO_GILA_400h_Male_Human_Concede_01	Sei troppo forte per me!	
VO_GILA_400h_Male_Human_Death_02	<Morte>	
VO_GILA_400h_Male_Human_ERROR_FULL_MINIONS_01	Non c'è spazio per un altro servitore.	
VO_GILA_400h_Male_Human_ERROR_GENERIC_01	Non posso farlo.	
VO_GILA_400h_Male_Human_ERROR_GENERIC_04	Non si può fare.	
VO_GILA_400h_Male_Human_ERROR_HAND_FULL_01	Ho troppe carte!	
VO_GILA_400h_Male_Human_ERROR_I_ATTACKED_01	Ho già attaccato.	
VO_GILA_400h_Male_Human_ERROR_MINION_ATTACKED_01	Quel servitore ha già attaccato.	
VO_GILA_400h_Male_Human_ERROR_NEED_MANA_02	Non ho più Mana!	
VO_GILA_400h_Male_Human_ERROR_NEED_WEAPON_02	Mi servirebbe un'Arma!	
VO_GILA_400h_Male_Human_ERROR_STEALTH_01	Non posso, il bersaglio è furtivo!	
VO_GILA_400h_Male_Human_ERROR_SUMMON_SICKNESS_01	Quel servitore non è pronto.	
VO_GILA_400h_Male_Human_ERROR_TARGET_01	Non posso sceglierlo come bersaglio.	
VO_GILA_400h_Male_Human_ERROR_TAUNT_01	Un servitore con Provocazione ci blocca.	
VO_GILA_400h_Male_Human_Greetings_01	Non mi piaci. E non piaci neanche ai miei cani.	
VO_GILA_400h_Male_Human_GREETINGS_RESPONSE	Non piaccio a nessuno.	
VO_GILA_400h_Male_Human_LowCards_01	Ho quasi finito le carte...	
VO_GILA_400h_Male_Human_NoCards_01	Non ho più carte!	
VO_GILA_400h_Male_Human_Oops_01	È stato un grosso sbaglio.	
VO_GILA_400h_Male_Human_Sorry_01	Scusa.	
VO_GILA_400h_Male_Human_Start_01	Guarda un po' cos'hanno trovato i cani...	
VO_GILA_400h_Male_Human_Thanks_01	Ti ringrazio.	
VO_GILA_400h_Male_Human_Thinking_01	Mmm...	
VO_GILA_400h_Male_Human_Thinking_03	Devo pensarci bene...	
VO_GILA_400h_Male_Human_Thinking_04	Forza, forza...	
VO_GILA_400h_Male_Human_Threaten_04	Ti conviene far finta di morire.	
VO_GILA_400h_Male_Human_Time_01	Il tempo sta per scadere.	
VO_GILA_400h_Male_Human_Well_Played_01	Bel trucchetto!	
VO_GILA_400h_Male_Human_WOW_01	Porco cane!	
VO_GILA_500h3_Female_Human_Concede_01	Non posso sconfiggerti!	
VO_GILA_500h3_Female_Human_ERROR_FULL_MINIONS_01	Non c'è abbastanza spazio.	
VO_GILA_500h3_Female_Human_ERROR_GENERIC_04	Va contro le regole!	
VO_GILA_500h3_Female_Human_ERROR_HAND_FULL_02	La mia mano è piena!	
VO_GILA_500h3_Female_Human_ERROR_I_ATTACKED_02	Non posso attaccare di nuovo!	
VO_GILA_500h3_Female_Human_ERROR_MINION_ATTACKED_01	Quel servitore ha già attaccato.	
VO_GILA_500h3_Female_Human_ERROR_NEED_MANA_02	Non ho abbastanza Mana.	
VO_GILA_500h3_Female_Human_ERROR_NEED_WEAPON_02	Ho bisogno di un'Arma.	
VO_GILA_500h3_Female_Human_ERROR_PLAY_01	Non posso modificare le regole.	
VO_GILA_500h3_Female_Human_ERROR_STEALTH_01	Non riesco a vederlo!	
VO_GILA_500h3_Female_Human_ERROR_SUMMON_SICKNESS_01	Quel servitore non è pronto.	
VO_GILA_500h3_Female_Human_ERROR_TARGET_01	Non posso sceglierlo come bersaglio.	
VO_GILA_500h3_Female_Human_ERROR_TAUNT_01	Devo attaccare i servitori con Provocazione.	
VO_GILA_500h3_Female_Human_Greetings_01	I Senza Corona ti mandano i loro saluti.	
VO_GILA_500h3_Female_Human_GREETINGS_RESPONSE	Ricambierò la cortesia...	
VO_GILA_500h3_Female_Human_LowCards_01	Non mi restano molte carte...	
VO_GILA_500h3_Female_Human_NoCards_01	Non ho più carte!	
VO_GILA_500h3_Female_Human_Oops_02	Una conseguenza... inaspettata.	
VO_GILA_500h3_Female_Human_Sorry_01	Mi dispiace...	
VO_GILA_500h3_Female_Human_Start_01	Il sentiero mi ha condotto qui.	
VO_GILA_500h3_Female_Human_Thanks_01	Grazie.	
VO_GILA_500h3_Female_Human_Thinking_02	Dev'esserci un modo...	
VO_GILA_500h3_Female_Human_Thinking_03	Pensa, Tess, pensa.	
VO_GILA_500h3_Female_Human_Thinking_05	Ahhh... mmm...	
VO_GILA_500h3_Female_Human_Threaten_03	Ti distruggerò!	
VO_GILA_500h3_Female_Human_Time_01	Devo agire in fretta.	
VO_GILA_500h3_Female_Human_Well_Played_01	Ottima mossa. 	
VO_GILA_500h3_Female_Human_WOW_01	Assolutamente incredibile.	
VO_GILA_600h_Male_Worgen_Concede_01	Mi hai surclassato!	
VO_GILA_600h_Male_Worgen_ERROR_FULL_MINIONS_02	Ho troppi servitori sul campo.	
VO_GILA_600h_Male_Worgen_ERROR_GENERIC_01	Impossibile.	
VO_GILA_600h_Male_Worgen_ERROR_GENERIC_02	Non posso farlo.	
VO_GILA_600h_Male_Worgen_ERROR_HAND_FULL_01	Troppe carte!	
VO_GILA_600h_Male_Worgen_ERROR_I_ATTACKED_01	Ho già attaccato.	
VO_GILA_600h_Male_Worgen_ERROR_MINION_ATTACKED_01	Quel servitore ha già attaccato.	
VO_GILA_600h_Male_Worgen_ERROR_NEED_MANA_01	Ho finito il Mana. 	
VO_GILA_600h_Male_Worgen_ERROR_NEED_WEAPON_02	Mi serve un'Arma.	
VO_GILA_600h_Male_Worgen_ERROR_STEALTH_01	Grrr... quel servitore si nasconde!	
VO_GILA_600h_Male_Worgen_ERROR_SUMMON_SICKNESS_01	Non è ancora pronto ad attaccare.	
VO_GILA_600h_Male_Worgen_ERROR_TARGET_01	Non posso sceglierlo come bersaglio.	
VO_GILA_600h_Male_Worgen_ERROR_TAUNT_01	Un servitore con Provocazione blocca la via!	
VO_GILA_600h_Male_Worgen_Greetings_01	Saluta il mio amicone.	
VO_GILA_600h_Male_Worgen_GREETINGS_RESPONSE	Salve, grosso amico.	
VO_GILA_600h_Male_Worgen_LowCards_01	Ho quasi finito le carte.	
VO_GILA_600h_Male_Worgen_NoCards_01	Ho finito tutte le carte!	
VO_GILA_600h_Male_Worgen_Oops_01	Grrr... che errore!	
VO_GILA_600h_Male_Worgen_Sorry_01	Mi dispiace.	
VO_GILA_600h_Male_Worgen_Start_01	Sono in posizione.	
VO_GILA_600h_Male_Worgen_Thanks_01	Grazie.	
VO_GILA_600h_Male_Worgen_Thinking_01	Mmm...	
VO_GILA_600h_Male_Worgen_Thinking_02	Quale sarà la mia prossima mossa?	
VO_GILA_600h_Male_Worgen_Thinking_04	Troverò un modo...	
VO_GILA_600h_Male_Worgen_Threaten_01	Ti farò saltare in aria!	
VO_GILA_600h_Male_Worgen_Time_01	Non mettermi fretta!	
VO_GILA_600h_Male_Worgen_Well_Played_01	Una mossa eccezionale.	
VO_GILA_600h_Male_Worgen_WOW_01	Incredibile!	
VO_GILA_900h_Female_Gnome_Concede_01	Le ho provate tutte. Hai vinto!	
VO_GILA_900h_Female_Gnome_ERROR_FULL_MINIONS_02	Non posso controllare altri servitori.	
VO_GILA_900h_Female_Gnome_ERROR_GENERIC_01	Non posso farlo.	
VO_GILA_900h_Female_Gnome_ERROR_HAND_FULL_01	Ho troppe carte!	
VO_GILA_900h_Female_Gnome_ERROR_I_ATTACKED_02	Non posso attaccare di nuovo!	
VO_GILA_900h_Female_Gnome_ERROR_MINION_ATTACKED_01	Quel servitore ha già attaccato.	
VO_GILA_900h_Female_Gnome_ERROR_NEED_MANA_01	Non ho abbastanza Mana.	
VO_GILA_900h_Female_Gnome_ERROR_NEED_WEAPON_01	Non ho un'Arma.	
VO_GILA_900h_Female_Gnome_ERROR_PLAY_01	Neppure io posso farlo. 	
VO_GILA_900h_Female_Gnome_ERROR_STEALTH_01	Quel bersaglio è furtivo.	
VO_GILA_900h_Female_Gnome_ERROR_SUMMON_SICKNESS_01	Quel servitore ha bisogno di un turno per prepararsi.	
VO_GILA_900h_Female_Gnome_ERROR_TARGET_01	Quel bersaglio non è valido.	
VO_GILA_900h_Female_Gnome_ERROR_TAUNT_01	Devo attaccare i servitori con Provocazione.	
VO_GILA_900h_Female_Gnome_GG_01	Ottima partita, davvero!	
VO_GILA_900h_Female_Gnome_Greetings_01	Oh, salve. Di nuovo tu.	
VO_GILA_900h_Female_Gnome_GREETINGS_RESPONSE	Oh, sembra che abbia DAVVERO sconquassato la linea temporale...	
VO_GILA_900h_Female_Gnome_LowCards_01	Non mi restano tante carte...	
VO_GILA_900h_Female_Gnome_NoCards_01	Non ho più carte!	
VO_GILA_900h_Female_Gnome_Oops_02	Credo sia stato un grave errore.	
VO_GILA_900h_Female_Gnome_Sorry_01	Uh... mi dispiace.	
VO_GILA_900h_Female_Gnome_Start_01	Il tuo tempo è scaduto!	
VO_GILA_900h_Female_Gnome_Thanks_01	Grazie.	
VO_GILA_900h_Female_Gnome_Thinking_02	Mmmmmm...	
VO_GILA_900h_Female_Gnome_Thinking_03	Devo pensare quadrimensionalmente...	
VO_GILA_900h_Female_Gnome_Thinking_05	Gli ingranaggi ruotano...	
VO_GILA_900h_Female_Gnome_Threaten_01	Ti cancellerò da questa linea temporale!	
VO_GILA_900h_Female_Gnome_Time_01	Il mio tempo sta scadendo? Non è possibile!	
VO_GILA_900h_Female_Gnome_Well_Played_01	Non avrei potuto fare di meglio!	
VO_GILA_900h_Female_Gnome_WOW_02	Inconcepibile!	
VO_HERO_01_HAPPY_NEW_YEAR_06	Buon anno!	
VO_HERO_01_Male_Orc_Emote_01	Non sono cattivo... È solo che non sono Thrall.	
VO_HERO_01_Male_Orc_Emote_02	Quanto potere!	
VO_HERO_01_Male_Orc_Emote_03	Se solo potessi risolvere tutto con un viaggio nel tempo...	
VO_HERO_01_Male_Orc_Emote_05	Non ho fatto niente di male!	
VO_HERO_01_Male_Orc_Emote_06	Lode al VERO Capoguerra! 	
VO_HERO_01_Male_Orc_Emote_08	Sangue e tuono!	
VO_HERO_01_Male_Orc_Emote_09	Per l'Orda!	
VO_HERO_01_Male_Orc_Emote_10	Lok'narosh!	
VO_HERO_01_Male_Orc_Emote_11	Malogrido ti osserva!	
VO_HERO_01_Male_Orc_Emote_12	Non avrò alcuna pietà!	
VO_HERO_01d_Male_Orc_Attack_01	Per i Mag'har!	
VO_HERO_01d_Male_Orc_Greetings_01	Mok'rah.	
VO_HERO_01d_Male_Orc_MIRROR_GREETINGS_01	Sono qui, amico.	
VO_HERO_01d_Male_Orc_MIRROR_START_01	Solo se sarà vittorioso.	
VO_HERO_01d_Male_Orc_Oops_01	Imbarazzante.	
VO_HERO_01d_Male_Orc_Start_01	Accogli il tuo destino.	
VO_HERO_01d_Male_Orc_Thanks_01	Ti ringrazio.	
VO_HERO_01d_Male_Orc_Threaten_01	Non obbedisco a NESSUNO!	
VO_HERO_01d_Male_Orc_Well_Played_01	Tu sai cos'è l'onore.	
VO_HERO_01d_Male_Orc_Wow_01	Sono sbalordito.	
VO_HERO_01f_Male_Orc_Greetings_01	Salute a te.	
VO_HERO_01f_Male_Orc_MIRROR_START_01	Osserva anche te.	
VO_HERO_01f_Male_Orc_Oops_01	Non c'è posto per gli errori.	
VO_HERO_01f_Male_Orc_Thanks_01	Ti sono grato.	
VO_HERO_01f_Male_Orc_Wow_01	Che fantastica visione.	
VO_HERO_01g_Male_Orc_Attack_01	Ammira la mia forza!	
VO_HERO_01g_Male_Orc_Greetings_01	Tieni duro.	
VO_HERO_01g_Male_Orc_IntroValeera_01	Hai proprio ragione.	
VO_HERO_01g_Male_Orc_MIRROR_GREETINGS_01	E non mollare mai la presa.	
VO_HERO_01g_Male_Orc_MIRROR_START_01	Ne sei sicuro?	
VO_HERO_01g_Male_Orc_Oops_01	Anche i più grandi guerrieri sbagliano.	
VO_HERO_01g_Male_Orc_Start_01	Nessuno sopravvive contro di me!	
VO_HERO_01g_Male_Orc_Thanks_01	Accetta la mia riconoscenza. 	
VO_HERO_01g_Male_Orc_Threaten_01	Hai molto da imparare...	
VO_HERO_01g_Male_Orc_Well_Played_01	Una giocata degna della mia attenzione.	
VO_HERO_01g_Male_Orc_Wow_01	Incredibile!	
VO_HERO_01i_Female_Orc_Attack_01	Lupi Bianchi!	
VO_HERO_01i_Female_Orc_Greetings_01	Salve.	
VO_HERO_01i_Female_Orc_MIRROR_GREETINGS_01	Salve anche a te.	
VO_HERO_01i_Female_Orc_MIRROR_START_01	Allora comportati come tale!	
VO_HERO_01i_Female_Orc_Oops_01	Ooops!	
VO_HERO_01i_Female_Orc_Picked_01	Un giorno sarò una grande guerriera.	
VO_HERO_01i_Female_Orc_Start_01	Voglio diventare una guerriera!	
VO_HERO_01i_Female_Orc_Thanks_01	Ne sono felice.	
VO_HERO_01i_Female_Orc_Threaten_01	Pusillanime!	
VO_HERO_01i_Female_Orc_Well_Played_01	Hai combattuto bene.	
VO_HERO_01i_Female_Orc_Wow_01	Non ci credo!	
VO_HERO_01j_Female_Orc_Attack_01	Solo i forti sopravvivono!	
VO_HERO_01j_Female_Orc_Greetings_01	Io sono Rokara, del Clan Lupi Bianchi.	
VO_HERO_01j_Female_Orc_MIRROR_GREETINGS_01	Lo so, sciocchina.	
VO_HERO_01j_Female_Orc_MIRROR_START_01	E anche quando vuoi.	
VO_HERO_01j_Female_Orc_Oops_01	Un errore da principianti.	
VO_HERO_01j_Female_Orc_Picked_01	Dobbiamo restituire la vita alle terre dell'Orda.	
VO_HERO_01j_Female_Orc_Start_01	Combatterò dove vuoi!	
VO_HERO_01j_Female_Orc_Thanks_01	Ti devo molto.	
VO_HERO_01j_Female_Orc_Threaten_01	T'insegnerò il significato di "distruzione totale".	
VO_HERO_01j_Female_Orc_Well_Played_01	Corri col branco.	
VO_HERO_01j_Female_Orc_Wow_01	È davvero incredibile!	
VO_HERO_01k_Female_Orc_Attack_01	Per l'Orda!	
VO_HERO_01k_Female_Orc_Greetings_01	La nostra sarà una battaglia gloriosa!	
VO_HERO_01k_Female_Orc_MIRROR_GREETINGS_01	Che se ne parli per gli anni a venire.	
VO_HERO_01k_Female_Orc_MIRROR_START_01	Arrivo, arrivo.	
VO_HERO_01k_Female_Orc_Oops_01	Gli errori smussano le nostre lame, ma affinano le nostre abilità.	
VO_HERO_01k_Female_Orc_Picked_01	Non sono troppo giovane per combattere!	
VO_HERO_01k_Female_Orc_Start_01	Vieni fuori a giocare!	
VO_HERO_01k_Female_Orc_Thanks_01	Sei troppo gentile.	
VO_HERO_01k_Female_Orc_Threaten_01	Assomigli a un wendigo e puzzi  come una bestia delle nevi!	
VO_HERO_01k_Female_Orc_Well_Played_01	Questi sono gli scontri che sogno.	
VO_HERO_01k_Female_Orc_Wow_01	Per Azeroth, cos'hai fatto?!?	
VO_HERO_01l_Female_Orc_Attack_02	<Attacco>	
VO_HERO_01l_Female_Orc_Attack_03	<Attacco>	
VO_HERO_01l_Female_Orc_BRB_01	Mi serve solo un attimo!	
VO_HERO_01l_Female_Orc_CELEBRATE_01	Celebriamo questa vittoria!	
VO_HERO_01l_Female_Orc_CHEER_01	Lok'tar!	
VO_HERO_01l_Female_Orc_Concede_01	Impossibile!	
VO_HERO_01l_Female_Orc_CONGRATULATIONS_01	Hai meritato la vittoria.	
VO_HERO_01l_Female_Orc_CRY_01	<Pianto>	
VO_HERO_01l_Female_Orc_DAY_OF_THE_DEAD_01	Oggi onoriamo coloro che sono caduti.	
VO_HERO_01l_Female_Orc_Death_01	<Morte>	
VO_HERO_01l_Female_Orc_END_OF_SEASON_01	Alla fine di ogni stagione, conto le tacche sulla mia ascia.	
VO_HERO_01l_Female_Orc_ERROR_FULL_MINIONS_01	Non c'è spazio per altri servitori.	
VO_HERO_01l_Female_Orc_ERROR_GENERIC_01	Non funzionerà.	
VO_HERO_01l_Female_Orc_ERROR_GENERIC_02	Se solo potessi farlo.	
VO_HERO_01l_Female_Orc_ERROR_HAND_FULL_01	La mia mano è piena!	
VO_HERO_01l_Female_Orc_ERROR_I_ATTACKED_01	Ho già attaccato!	
VO_HERO_01l_Female_Orc_ERROR_MINION_ATTACKED_01	Quel servitore è esausto.	
VO_HERO_01l_Female_Orc_ERROR_NEED_MANA_01	Mi serve più Mana.	
VO_HERO_01l_Female_Orc_ERROR_NEED_WEAPON_01	Mi serve un'Arma!	
VO_HERO_01l_Female_Orc_ERROR_PLAY_01	Non posso giocarla!	
VO_HERO_01l_Female_Orc_ERROR_STEALTH_01	Maledetto servitore... Mostrati!	
VO_HERO_01l_Female_Orc_ERROR_SUMMON_SICKNESS_01	Quel servitore ha bisogno di un turno per prepararsi.	
VO_HERO_01l_Female_Orc_ERROR_TARGET_01	Non posso sceglierlo come bersaglio.	
VO_HERO_01l_Female_Orc_ERROR_TAUNT_01	C'è un servitore con Provocazione che va eliminato.	
VO_HERO_01l_Female_Orc_FACTION_CRY_01	Per l'Orda!	
VO_HERO_01l_Female_Orc_FIDGET_01	Non ne sono molto sicura.	
VO_HERO_01l_Female_Orc_FIRE_FESTIVAL_01	Goditi il Festival del Fuoco!	
VO_HERO_01l_Female_Orc_GG_01	Me ne ricorderò per sempre.	
VO_HERO_01l_Female_Orc_Greetings_01	Forza e onore.	
VO_HERO_01l_Female_Orc_HAPPY_BIRTHDAY_01	Buon compleanno! Io lo trascorro affilando le mie lame.	
VO_HERO_01l_Female_Orc_HAPPY_BREWFEST_01	Festa della Birra? Brindiamo a Durotan!	
VO_HERO_01l_Female_Orc_HAPPY_EVENT_01	Mi fa piacere festeggiare degli eventi così felici.	
VO_HERO_01l_Female_Orc_HAPPY_HALLOWEEN_01	Felice Veglia delle Ombre! Guff si è mangiato i miei dolcetti.	
VO_HERO_01l_Female_Orc_HAPPY_HOLIDAYS_01	Buona Vigilia di Grande Inverno!	
VO_HERO_01l_Female_Orc_HAPPY_NEW_YEAR_01	Buon anno!	
VO_HERO_01l_Female_Orc_HAPPY_NEW_YEAR_LUNAR_01	Buon anno!	
VO_HERO_01l_Female_Orc_HAPPY_NOBLEGARDEN_01	Nobiluova? Un tempo davo la caccia ai conigli di Alterac.	
VO_HERO_01l_Female_Orc_HUNGRY_01	Che fame... ci sono delle costolette? Mi andrebbe bene anche un Biscotto di Mana.	
VO_HERO_01l_Female_Orc_INDEED_01	Già.	
VO_HERO_01l_Female_Orc_KIDS_WEEK_01	Non vedo l'ora d'incontrare i giovani Grunt al campo di addestramento.	
VO_HERO_01l_Female_Orc_KISS_01	<Bacio>	
VO_HERO_01l_Female_Orc_LAUGH_01	<Risata>	
VO_HERO_01l_Female_Orc_LowCards_01	Ho le spalle al muro.	
VO_HERO_01l_Female_Orc_MIRROR_GREETINGS_04	Per i Lupi Bianchi!	
VO_HERO_01l_Female_Orc_MIRROR_START_01	Sì, finché ognuno fa la propria parte.	
VO_HERO_01l_Female_Orc_NICE_CARD_BACK_01	Adoro il tuo dorso delle carte.	
VO_HERO_01l_Female_Orc_NoCards_01	Ho finito le carte. Ora o mai più!	
VO_HERO_01l_Female_Orc_Oops_01	Oh oh.	
VO_HERO_01l_Female_Orc_PARTY_01	Facciamo festa come si fa ad Alterac!	
VO_HERO_01l_Female_Orc_Picked_01	Restiamo uniti!	
VO_HERO_01l_Female_Orc_PIRATE_DAY_01	Yo oh! Ho del rum da trincare e boccaporti da fissare.	
VO_HERO_01l_Female_Orc_SALUTE_01	Usando le parole dei miei antenati: zug-zug.	
VO_HERO_01l_Female_Orc_Sorry_01	Scusa!	
VO_HERO_01l_Female_Orc_Start_01	Oggi è un bel giorno per combattere.	
VO_HERO_01l_Female_Orc_Start_Brukan_01	Lascia che ti mostri cos'ho imparato.	
VO_HERO_01l_Female_Orc_Start_Guff_01	Non trattenerti, Guff.	
VO_HERO_01l_Female_Orc_START_OF_SEASON_01	Inizia una nuova stagione! Non vedo l'ora di migliorarmi. 	
VO_HERO_01l_Female_Orc_Start_Tavish_01	Il Clan Lupi Bianchi non si tirerà indietro.	
VO_HERO_01l_Female_Orc_Thanks_01	Ti ringrazio.	
VO_HERO_01l_Female_Orc_Thinking_01	Vediamo...	
VO_HERO_01l_Female_Orc_Thinking_02	Mmm...	
VO_HERO_01l_Female_Orc_Thinking_03	Dev'esserci un modo.	
VO_HERO_01l_Female_Orc_Thinking_04	Cosa farebbe Garrosh?	
VO_HERO_01l_Female_Orc_Threaten_01	Sarò anche inesperta, ma ti sconfiggerò!	
VO_HERO_01l_Female_Orc_Time_01	Devo sbrigarmi!	
VO_HERO_01l_Female_Orc_TRIGGER_BRAWL_01	Ne rimarrà soltanto uno!	
VO_HERO_01l_Female_Orc_TRIGGER_CONDITIONING_01	Sarò la migliore di tutti!	
VO_HERO_01l_Female_Orc_TRIGGER_EXECUTE_01	Ti finisco!	
VO_HERO_01l_Female_Orc_TRIGGER_GOREHOWL_01	Oh, sì!	
VO_HERO_01l_Female_Orc_TRIGGER_GOREHOWL_02	Non dire a nessuno che l'ho rubata.	
VO_HERO_01l_Female_Orc_TRIGGER_HEAVYPLATE_01	È tempo di cambiarsi!	
VO_HERO_01l_Female_Orc_TRIGGER_RAIDTHEDOCKS_01	Avanti, ciurma!	
VO_HERO_01l_Female_Orc_TRIGGER_RANCOR_01	È finita!	
VO_HERO_01l_Female_Orc_TRIGGER_SHIELDSLAM_01	Bong!	
VO_HERO_01l_Female_Orc_TRIGGER_WARCACHE_01	Ottimo, un bottino!	
VO_HERO_01l_Female_Orc_VALENTINES_01	Buon Amore nell'Aria, ma la mia unica cotta è quella di maglia.	
VO_HERO_01l_Female_Orc_WELCOME_01	Ti do il benvenuto.	
VO_HERO_01l_Female_Orc_Well_Played_01	Possano le tue lame non consumarsi mai.	
VO_HERO_01l_Female_Orc_WOW_01	Non ci credo!	
VO_HERO_02_HAPPY_NEW_YEAR_07	Buon anno.	
VO_HERO_02b_Male_Troll_Concede_01	Combatti bene. È finita per me...	
VO_HERO_02b_Male_Troll_ERROR_FULL_MINIONS_02	Tengo troppi servitori.	
VO_HERO_02b_Male_Troll_ERROR_GENERIC_02	No. Non posso farlo.	
VO_HERO_02b_Male_Troll_ERROR_HAND_FULL_01	La mia mano è piena!	
VO_HERO_02b_Male_Troll_ERROR_I_ATTACKED_02	Ho già attaccato.	
VO_HERO_02b_Male_Troll_ERROR_MINION_ATTACKED_01	Quel servitore ha già attaccato.	
VO_HERO_02b_Male_Troll_ERROR_NEED_MANA_01	Tengo bisogno di Mana.	
VO_HERO_02b_Male_Troll_ERROR_NEED_WEAPON_01	Tengo bisogno di un'Arma.	
VO_HERO_02b_Male_Troll_ERROR_PLAY_01	Non posso farlo.	
VO_HERO_02b_Male_Troll_ERROR_STEALTH_01	Quel servitore si nasconde!	
VO_HERO_02b_Male_Troll_ERROR_SUMMON_SICKNESS_01	Dagli nu poco di tempo per prepararsi.	
VO_HERO_02b_Male_Troll_ERROR_TARGET_01	Mi serve nu bersaglio.	
VO_HERO_02b_Male_Troll_ERROR_TAUNT_02	Devo attaccare i servitori con Provocazione.	
VO_HERO_02b_Male_Troll_FIRE_FESTIVAL_01	Il Festival del Fuoco è arrivato!	
VO_HERO_02b_Male_Troll_Greetings_01	Salve! Inchinati pure.	
VO_HERO_02b_Male_Troll_HAPPY_HALLOWEEN_01	Ahahah! La Veglia delle Ombre sta accà!	
VO_HERO_02b_Male_Troll_HAPPY_HOLIDAYS_01	Buone feste a te.	
VO_HERO_02b_Male_Troll_HAPPY_NEW_YEAR_01	Ti auguro nu buon anno nuovo.	
VO_HERO_02b_Male_Troll_HAPPY_NEW_YEAR_LUNAR_01	Ti auguro nu buon anno nuovo.	
VO_HERO_02b_Male_Troll_HAPPY_NOBLEGARDEN_01	Per l'ultima volta, non ci stanno uova nel cappello mio!	
VO_HERO_02b_Male_Troll_LowCards_01	Ho quasi finito le carte.	
VO_HERO_02b_Male_Troll_MIRROR_GREETINGS_01	Nun mi far perdere il ritmo.	
VO_HERO_02b_Male_Troll_MIRROR_START_01	E presto uno di noi s'inginocchierà.	
VO_HERO_02b_Male_Troll_NoCards_01	Ho finito le carte!	
VO_HERO_02b_Male_Troll_Oops_02	Sono cose che capitano.	
VO_HERO_02b_Male_Troll_Picked_01	È bello essere Re.	
VO_HERO_02b_Male_Troll_PIRATE_DAY_01	Corpo di mille balene!	
VO_HERO_02b_Male_Troll_Sorry_01	Mi dispiace.	
VO_HERO_02b_Male_Troll_Start_02	Ti trovi al cospetto di Re Rastakhan!	
VO_HERO_02b_Male_Troll_Thanks_01	Ti ringrazio.	
VO_HERO_02b_Male_Troll_Thinking_05	Ah... Mmm...	
VO_HERO_02b_Male_Troll_Thinking_11	Per la gloria mia...	
VO_HERO_02b_Male_Troll_Thinking_15	I Loa mi parlano...	
VO_HERO_02b_Male_Troll_Threaten_04	Trema dinanzi a me!	
VO_HERO_02b_Male_Troll_Time_01	Nessuno può mettermi fretta!	
VO_HERO_02b_Male_Troll_Well_Played_01	Davvero notevole.	
VO_HERO_02b_Male_Troll_WOW_01	Com'è possibile?!?	
VO_HERO_02f_Male_Orc_Attack_01	Per l'onore e la gloria!	
VO_HERO_02f_Male_Orc_Greetings_01	Ti sento.	
VO_HERO_02f_Male_Orc_MIRROR_GREETINGS_01	Ho detto qualcosa?	
VO_HERO_02f_Male_Orc_MIRROR_START_01	Che riecheggi in ogni dove!	
VO_HERO_02f_Male_Orc_Oops_01	Sono stato maldestro.	
VO_HERO_02f_Male_Orc_Picked_01	Il fuoco ha risposto subito alla mia chiamata.	
VO_HERO_02f_Male_Orc_Start_01	Porto con me la furia degli elementi!	
VO_HERO_02f_Male_Orc_Thanks_01	Un sentito ringraziamento.	
VO_HERO_02f_Male_Orc_Threaten_01	Mi hai forzato la mano.	
VO_HERO_02f_Male_Orc_Well_Played_01	Mi onori.	
VO_HERO_02f_Male_Orc_Wow_01	Sono stupito!	
VO_HERO_02g_Male_Orc_Attack_01	Basta!	
VO_HERO_02g_Male_Orc_Greetings_01	Ti vedo.	
VO_HERO_02g_Male_Orc_MIRROR_GREETINGS_01	Non avevo dubbi.	
VO_HERO_02g_Male_Orc_MIRROR_START_01	E quindi anche la tua.	
VO_HERO_02g_Male_Orc_Oops_01	Cos'è stato?	
VO_HERO_02g_Male_Orc_Picked_01	Dov'è il nemico?	
VO_HERO_02g_Male_Orc_Start_01	La tua ora è giunta.	
VO_HERO_02g_Male_Orc_Thanks_01	Sei davvero molto gentile.	
VO_HERO_02g_Male_Orc_Threaten_01	Sono stato cresciuto dagli Umani, ma non sono stupido.	
VO_HERO_02g_Male_Orc_Well_Played_01	La tua forza è ammirevole.	
VO_HERO_02g_Male_Orc_Wow_01	Uno spettacolo sbalorditivo.	
VO_HERO_02h_Male_Orc_Attack_01	Trema di paura!	
VO_HERO_02h_Male_Orc_Greetings_01	Gli spiriti sono irrequieti.	
VO_HERO_02h_Male_Orc_MIRROR_GREETINGS_01	Lo sono anch'io.	
VO_HERO_02h_Male_Orc_MIRROR_START_01	Il nostro clan non ha mai vacillato!	
VO_HERO_02h_Male_Orc_Oops_01	Un grave errore.	
VO_HERO_02h_Male_Orc_Picked_01	Difenderò la valle a ogni costo.	
VO_HERO_02h_Male_Orc_Start_01	Affronta la potenza dei Lupi Bianchi!	
VO_HERO_02h_Male_Orc_Thanks_01	I Lupi Bianchi ti ringraziano.	
VO_HERO_02h_Male_Orc_Threaten_01	La terra ti divorerà.	
VO_HERO_02h_Male_Orc_Well_Played_01	Riconosco il tuo valore.	
VO_HERO_02h_Male_Orc_Wow_01	Per i miei antenati!	
VO_HERO_02i_Male_Orc_Attack_01	La potenza dell'Orda!	
VO_HERO_02i_Male_Orc_Greetings_01	Throm'ka.	
VO_HERO_02i_Male_Orc_MIRROR_GREETINGS_01	Lok-regar ogull.	
VO_HERO_02i_Male_Orc_MIRROR_START_01	La terra è dalla MIA parte...	
VO_HERO_02i_Male_Orc_Oops_01	Un errore di calcolo?	
VO_HERO_02i_Male_Orc_Picked_01	Oggi cavalchiamo verso la vittoria.	
VO_HERO_02i_Male_Orc_Start_01	La terra stessa è mia alleata!	
VO_HERO_02i_Male_Orc_Thanks_01	Il Capoguerra ti sorride.	
VO_HERO_02i_Male_Orc_Threaten_01	Io sono la furia dell'Orda.	
VO_HERO_02i_Male_Orc_Well_Played_01	Ti batti con determinazione.	
VO_HERO_02i_Male_Orc_Wow_01	Per gli spiriti!	
VO_HERO_02j_Male_Orc_Attack_01	Lok-Narash!	
VO_HERO_02j_Male_Orc_Greetings_01	Forza e onore.	
VO_HERO_02j_Male_Orc_MIRROR_GREETINGS_01	Ci guideranno sempre.	
VO_HERO_02j_Male_Orc_MIRROR_START_01	Un nobile scopo.	
VO_HERO_02j_Male_Orc_Oops_01	Mmm... un errore.	
VO_HERO_02j_Male_Orc_Picked_01	Ho trovato la mia gente. 	
VO_HERO_02j_Male_Orc_Start_01	Porterò l'Orda alla libertà!	
VO_HERO_02j_Male_Orc_Thanks_01	Ti sono grata.	
VO_HERO_02j_Male_Orc_Threaten_01	Neghi la potenza dell'Orda?	
VO_HERO_02j_Male_Orc_Well_Played_01	Sei un degno avversario.	
VO_HERO_02j_Male_Orc_Wow_01	Per gli elementi!	
VO_HERO_02k_Male_Orc_Attack_01	Tutto questo finisce ora!	
VO_HERO_02k_Male_Orc_Greetings_01	Gloria all'Orda.	
VO_HERO_02k_Male_Orc_MIRROR_GREETINGS_01	Che possa restare nobile.	
VO_HERO_02k_Male_Orc_MIRROR_START_01	Non la temo affatto... Io la comando!	
VO_HERO_02k_Male_Orc_Oops_01	Peccato...	
VO_HERO_02k_Male_Orc_Picked_01	Ogni tempesta finisce, prima o poi.	
VO_HERO_02k_Male_Orc_Start_01	Temi la furia della tempesta!	
VO_HERO_02k_Male_Orc_Thanks_01	Che gli antenati ti benedicano.	
VO_HERO_02k_Male_Orc_Threaten_01	Le tempeste inghiottiranno i miei nemici!	
VO_HERO_02k_Male_Orc_Well_Played_01	Combatti bene.	
VO_HERO_02k_Male_Orc_Wow_01	Che spettacolo per gli occhi!	
VO_HERO_03_Female_BloodElf_Emote_01	Sono io a forgiare il mio destino.	
VO_HERO_03_Female_BloodElf_Emote_02	Rimani nelle ombre!	
VO_HERO_03_Female_BloodElf_Emote_03	Niente mi può sfuggire.	
VO_HERO_03_Female_BloodElf_Emote_04	Che cos'è più tagliente? Le tue lame o la tua lingua?	
VO_HERO_03_Female_BloodElf_Emote_05	Chi, io? Sospetta?	
VO_HERO_03_Female_BloodElf_Emote_06	Perché tu... Valeera.	
VO_HERO_03_Female_BloodElf_Emote_07	Non c'è niente da vedere qui...	
VO_HERO_03_Female_BloodElf_Emote_08	Qualcuno ha ordinato un Menù Due Lame?	
VO_HERO_03_Female_BloodElf_Emote_09	Senza lasciare traccia.	
VO_HERO_03_Female_BloodElf_Emote_10	La mia lealtà è affar mio. 	
VO_HERO_03_Female_BloodElf_Emote_11	Non mi metterei i bastoni tra le ruote, se fossi in te. 	
VO_HERO_03_Female_BloodElf_Emote_12	Tiro fuori il meglio di te. 	
VO_HERO_03_HAPPY_NEW_YEAR_06	Buon anno.	
VO_HERO_03a_Attack_15	La giustizia è mia!	
VO_HERO_03a_CONCEDE_06	Hai giocato bene. Mi arrendo.	
VO_HERO_03a_ERROR_FULL_MINIONS_25	Ho troppi servitori.	
VO_HERO_03a_ERROR_GENERIC_30	Non posso farlo.	
VO_HERO_03a_ERROR_HAND_FULL_24	La mia mano è piena!	
VO_HERO_03a_ERROR_I_ATTACKED_22	Ho già attaccato.	
VO_HERO_03a_ERROR_JUST_PLAYED_23	Concedi a quel servitore un turno per prepararsi.	
VO_HERO_03a_ERROR_MINION_ATTACKED_21	Quel servitore ha già attaccato.	
VO_HERO_03a_ERROR_NEED_MANA_20	Non ho abbastanza Mana.	
VO_HERO_03a_ERROR_NEED_WEAPON_19	Mi serve un'arma.	
VO_HERO_03a_ERROR_PLAY_27	Non posso giocare questa carta.	
VO_HERO_03a_ERROR_STEALTH_26	Non posso scegliere come bersagli i servitori con Furtività.	
VO_HERO_03a_ERROR_TARGET_28	Quel bersaglio non è valido.	
VO_HERO_03a_ERROR_TAUNT_29	Devo attaccare i servitori con Provocazione.	
VO_Hero_03a_Female_NightElf_Start_Illidan_01	Ho trovato la mia preda!	
VO_HERO_03a_FIRE_FESTIVAL	Buona festa di Mezza Estate!	
VO_HERO_03a_GREETINGS_03	Ehilà.	
VO_HERO_03a_GREETINGS_RESPONSE	Che piacevole sorpresa. Salve!	
VO_HERO_03a_HALLOWS_END	Buona Veglia delle Ombre.	
VO_HERO_03a_HAPPY_HOLIDAYS_52	Felice Vigilia di Grande Inverno.	
VO_HERO_03a_HAPPY_NEW_YEAR_53	Buon anno.	
VO_HERO_03a_HAPPY_NEW_YEAR_LUNAR_16	Buon anno.	
VO_HERO_03a_LOW_CARDS_17	Ho quasi finito le carte.	
VO_HERO_03a_MIRROR_GREETINGS_04	Che piacevole sorpresa. Salve.	
VO_HERO_03a_MIRROR_START_02	Sono il pugno di ferro della giustizia.	
VO_HERO_03a_NO_CARDS_18	Ho finito le carte.	
VO_HERO_03a_NOBLEGARDEN	Buona Festa di Nobiluova. Aspettati una sorpresa.	
VO_HERO_03a_OOPS_08	Un errore tattico.	
VO_HERO_03a_PICKED_11	Il momento è giunto!	
VO_HERO_03a_PIRATE_DAY	Tutti in coperta, bucanieri!	
VO_HERO_03a_SORRY_10	Mi dispiace.	
VO_HERO_03a_START_01	Nessuno può sfuggire alla mia furia.	
VO_HERO_03a_THANKS_09	Ti ringrazio.	
VO_HERO_03a_THINK1_12	Mmm...	
VO_HERO_03a_THINK2_13	Mmm... Fammi pensare...	
VO_HERO_03a_THINK3_14	Pensa, Maiev, pensa...	
VO_HERO_03a_THREATEN_05	Incorrerai nella mia ira!	
VO_HERO_03a_TIMER_16	Devo fare presto!	
VO_HERO_03a_WELL_PLAYED_07	Bella giocata.	
VO_HERO_03a_WOW_35	Fantastico!	
VO_HERO_03d_Female_BloodElf_Greetings_01	Sei qui per una chiacchierata?	
VO_HERO_03d_Female_BloodElf_MIRROR_GREETINGS_01	Mi conosci bene.	
VO_HERO_03d_Female_BloodElf_MIRROR_START_01	Lo stesso vale per me. 	
VO_HERO_03d_Female_BloodElf_Thanks_01	Ti sono grata.	
VO_HERO_03d_Female_BloodElf_Wow_01	Magnifico!	
VO_HERO_03e_Female_BloodElf_Attack_01	Ah!	
VO_HERO_03e_Female_BloodElf_Greetings_01	Oh, salve!	
VO_HERO_03e_Female_BloodElf_IntroGarrosh_01	Ora ci divertiamo!	
VO_HERO_03e_Female_BloodElf_MIRROR_GREETINGS_01	Un volto familiare...	
VO_HERO_03e_Female_BloodElf_MIRROR_START_01	Perché no...	
VO_HERO_03e_Female_BloodElf_Oops_01	Un errore?	
VO_HERO_03e_Female_BloodElf_Start_01	Vogliamo ballare?	
VO_HERO_03e_Female_BloodElf_Thanks_01	Grazie infinite.	
VO_HERO_03e_Female_BloodElf_Threaten_01	Anche i fiori hanno le spine.	
VO_HERO_03e_Female_BloodElf_Well_Played_01	Hai combattuto bene.	
VO_HERO_03e_Female_BloodElf_Wow_01	Intrigante.	
VO_HERO_03f_Female_BloodElf_Attack_01	Acciaio freddo e tagliente!	
VO_HERO_03f_Female_BloodElf_Greetings_01	È un bel giorno per combattere.	
VO_HERO_03f_Female_BloodElf_MIRROR_GREETINGS_01	Davvero!	
VO_HERO_03f_Female_BloodElf_MIRROR_START_01	Difficile dimenticarle.	
VO_HERO_03f_Female_BloodElf_Oops_01	Ooops!	
VO_HERO_03f_Female_BloodElf_Start_01	Ricorda le mie lame!	
VO_HERO_03f_Female_BloodElf_Thanks_01	Ti sono debitrice.	
VO_HERO_03f_Female_BloodElf_Threaten_01	Sarà rapido e indolore.	
VO_HERO_03f_Female_BloodElf_Well_Played_01	Non te la cavi affatto male...	
VO_HERO_03f_Female_BloodElf_Wow_01	È... fantastico!	
VO_HERO_03g_Female_BloodElf_Picked_01	Non te ne pentirai.	
VO_HERO_04_HAPPY_NEW_YEAR_15	Buon anno!	
VO_HERO_04b_Male_Human_START_Illidan_01	Le nostre abilità non sono poi così diverse.	
VO_HERO_04b_Male_Human_START_Jaina_01	Mi dispiace, Jaina.	
VO_HERO_04b_Male_Human_START_Sylvanas_01	Un destino oscuro ci attende, Ventolesto.	
VO_HERO_04b_Male_Human_START_Uther_01	Lotterò duramente, proprio come mi hai insegnato!	
VO_HERO_04e_Male_Human_Attack_01	Per Lordaeron!	
VO_HERO_04e_Male_Human_Greetings_01	Salute a te.	
VO_HERO_04e_Male_Human_MIRROR_GREETINGS_01	Che la Luce ti benedica.	
VO_HERO_04e_Male_Human_MIRROR_START_01	Mai quanto me.	
VO_HERO_04e_Male_Human_Oops_01	Un abbaglio...	
VO_HERO_04e_Male_Human_PICKED_01	In ricordo di Lothar.	
VO_HERO_04e_Male_Human_Start_01	Porterò onore alla Mano d'Argento!	
VO_HERO_04e_Male_Human_Thanks_01	Ti sono debitore.	
VO_HERO_04e_Male_Human_Threaten_01	La tua vita è giunta alla fine.	
VO_HERO_04e_Male_Human_Well_Played_01	Mi hai sorpreso.	
VO_HERO_04e_Male_Human_Wow_01	Meraviglioso!	
VO_HERO_04f_Male_Human_Attack_01	Silenzio, verme!	
VO_HERO_04f_Male_Human_Greetings_01	La notte è arrivata, è ora di una cavalcata!	
VO_HERO_04f_Male_Human_MIRROR_GREETINGS_01	Forza, iniziamo la nostra crociata!	
VO_HERO_04f_Male_Human_MIRROR_START_01	AHAH, AH!	
VO_HERO_04f_Male_Human_Oops_01	Un errore? Che orrore!	
VO_HERO_04f_Male_Human_Picked_01	AHAH, AH!	
VO_HERO_04f_Male_Human_Start_01	AHAHAHAHAAA!	
VO_HERO_04f_Male_Human_Thanks_01	Ti ringrazio, pagherò dazio.	
VO_HERO_04f_Male_Human_Threaten_01	Ho sempre pensato che avrei dominato...	
VO_HERO_04f_Male_Human_Well_Played_01	Che giocata... inaspettata. 	
VO_HERO_04f_Male_Human_Wow_01	Sono colpito! Quasi sbigottito.	
VO_HERO_04g_Male_Human_Attack_01	Devi obbedire!	
VO_HERO_04g_Male_Human_Greetings_01	Dichiara le tue intenzioni.	
VO_HERO_04g_Male_Human_MIRROR_GREETINGS_01	Ci vorrà un po'...	
VO_HERO_04g_Male_Human_MIRROR_START_01	Obiezione!	
VO_HERO_04g_Male_Human_Oops_01	Detesto gli errori.	
VO_HERO_04g_Male_Human_Start_01	Riporterò l'ordine!	
VO_HERO_04g_Male_Human_Thanks_01	Hai la mia gratitudine.	
VO_HERO_04g_Male_Human_Threaten_01	Chi rifugge la Luce è condannato all'oscurità eterna.	
VO_HERO_04g_Male_Human_Well_Played_01	Ben fatto.	
VO_HERO_04g_Male_Human_Wow_01	Stupefacente!	
VO_HERO_04h_Male_Human_Attack_01	Per il valore!	
VO_HERO_04h_Male_Human_Greetings_01	Comportati con onore.	
VO_HERO_04h_Male_Human_MIRROR_GREETINGS_01	È l'unico modo.	
VO_HERO_04h_Male_Human_MIRROR_START_01	Non c'è altro modo.	
VO_HERO_04h_Male_Human_Oops_01	Che imbarazzo!	
VO_HERO_04h_Male_Human_Picked_01	Con onore!	
VO_HERO_04h_Male_Human_Start_01	Sarà la giustizia a decidere!	
VO_HERO_04h_Male_Human_Thanks_01	Ti ringrazio.	
VO_HERO_04h_Male_Human_Threaten_01	Combatto per ciò che è giusto. Puoi dire altrettanto?	
VO_HERO_04h_Male_Human_Well_Played_01	Hai combattuto con dignità.	
VO_HERO_04h_Male_Human_Wow_01	Glorioso!	
VO_HERO_05_FACTION_CRY_24	Per l'Orda!	
VO_HERO_05_FIDGET_09	Il tempo passa...	
VO_HERO_05_HAPPY_NEW_YEAR_15	Buona Festa della Luna.	
VO_HERO_05_INDEED_05	Invero.	
VO_HERO_05_SALUTE_07	Notevole.	
VO_HERO_05b_Female_Undead_Concede_01	Ho resistito abbastanza...	
VO_HERO_05b_Female_Undead_ERROR_FULL_MINIONS_02	Ho già troppi servitori.	
VO_HERO_05b_Female_Undead_ERROR_GENERIC_02	Non posso farlo. 	
VO_HERO_05b_Female_Undead_ERROR_HAND_FULL_01	La mia mano è piena!	
VO_HERO_05b_Female_Undead_ERROR_I_ATTACKED_01	Ho già attaccato.	
VO_HERO_05b_Female_Undead_ERROR_MINION_ATTACKED_01	Quel servitore ha già attaccato.	
VO_HERO_05b_Female_Undead_ERROR_NEED_MANA_01	Ho bisogno di Mana.	
VO_HERO_05b_Female_Undead_ERROR_NEED_WEAPON_01	Ho bisogno di un'Arma.	
VO_HERO_05b_Female_Undead_ERROR_PLAY_01	Non posso giocare quella carta.	
VO_HERO_05b_Female_Undead_ERROR_STEALTH_01	Quel servitore è furtivo.	
VO_HERO_05b_Female_Undead_ERROR_SUMMON_SICKNESS_01	Quel servitore non può ancora combattere.	
VO_HERO_05b_Female_Undead_ERROR_TARGET_01	Mi serve un bersaglio.	
VO_HERO_05b_Female_Undead_ERROR_TAUNT_01	Devo attaccare i servitori con Provocazione.	
VO_HERO_05b_Female_Undead_FIRE_FESTIVAL_01	Che tutto bruci!	
VO_HERO_05b_Female_Undead_Greetings_01	Salve. Confido che tu non intenda farmi perdere tempo.	
VO_HERO_05b_Female_Undead_HAPPY_HALLOWEEN_01	La Veglia delle Ombre! La notte più temuta.	
VO_HERO_05b_Female_Undead_HAPPY_HOLIDAYS_01	Buone feste!	
VO_HERO_05b_Female_Undead_HAPPY_NEW_YEAR_01	Buon anno!	
VO_HERO_05b_Female_Undead_HAPPY_NEW_YEAR_LUNAR_01	Buon anno!	
VO_HERO_05b_Female_Undead_HAPPY_NOBLEGARDEN_01	Buona Festa di Nobiluova.	
VO_HERO_05b_Female_Undead_LowCards_01	Ho quasi finito le carte.	
VO_HERO_05b_Female_Undead_MIRROR_GREETINGS_01	Ma quante sorelle Ventolesto ci sono?	
VO_HERO_05b_Female_Undead_MIRROR_START_01	Vittoria per... ME.	
VO_HERO_05b_Female_Undead_NoCards_01	Ho finito le carte!	
VO_HERO_05b_Female_Undead_Oops_02	Un errore.	
VO_HERO_05b_Female_Undead_Picked_01	Che la mia mira sia precisa.	
VO_HERO_05b_Female_Undead_PIRATE_DAY_02	Che mi prenda un... bah, quello che è.	
VO_HERO_05b_Female_Undead_Sorry_01	Mi dispiace.	
VO_HERO_05b_Female_Undead_Start_01	Vittoria per i Reietti!	
VO_HERO_05b_Female_Undead_Thanks_02	Hai la mia gratitudine.	
VO_HERO_05b_Female_Undead_Thinking_02	La vendetta si avvicina...	
VO_HERO_05b_Female_Undead_Thinking_03	Che nessuno sopravviva...	
VO_HERO_05b_Female_Undead_Thinking_04	La vittoria è nelle mie mani...	
VO_HERO_05b_Female_Undead_Threaten_02	Anche TU soffrirai.	
VO_HERO_05b_Female_Undead_Time_01	Non ho tempo per giocare!	
VO_HERO_05b_Female_Undead_Well_Played_01	Davvero una bella giocata.	
VO_HERO_05b_Female_Undead_WOW_01	Molto perspicace.	
VO_HERO_05e_Male_OrcOgre_Attack_01	La preda si avvicina.	
VO_HERO_05e_Male_OrcOgre_Greetings_01	Le nostre strade s'incrociano.	
VO_HERO_05e_Male_OrcOgre_MIRROR_GREETINGS_01	Ma dove ci condurranno?	
VO_HERO_05e_Male_OrcOgre_MIRROR_START_01	Naturalmente.	
VO_HERO_05e_Male_OrcOgre_Oops_01	Capita di fare un passo falso.	
VO_HERO_05e_Male_OrcOgre_Picked_01	Troveremo la nostra strada.	
VO_HERO_05e_Male_OrcOgre_Start_01	Agisco d'istinto!	
VO_HERO_05e_Male_OrcOgre_Thanks_01	Ti ringrazio.	
VO_HERO_05e_Male_OrcOgre_Threaten_01	Sarai cibo per le bestie...	
VO_HERO_05e_Male_OrcOgre_Well_Played_01	Cacci bene.	
VO_HERO_05e_Male_OrcOgre_Wow_01	Stupefacente!	
VO_HERO_05f_Male_OrcOgre_Attack_01	Dritto in faccia!	
VO_HERO_05f_Male_OrcOgre_Greetings_01	Lok'tar ogar!	
VO_HERO_05f_Male_OrcOgre_MIRROR_GREETINGS_01	Sì, vittoria o morte!	
VO_HERO_05f_Male_OrcOgre_MIRROR_START_01	Richiama tutto ciò che è libero e selvaggio!	
VO_HERO_05f_Male_OrcOgre_Oops_01	Un deplorevole errore.	
VO_HERO_05f_Male_OrcOgre_Picked_01	Dammi una sfida e la supererò.	
VO_HERO_05f_Male_OrcOgre_Start_01	Sento il richiamo della selva.	
VO_HERO_05f_Male_OrcOgre_Thanks_01	Accetta i miei più umili ringraziamenti.	
VO_HERO_05f_Male_OrcOgre_Threaten_01	Ti darò la caccia.	
VO_HERO_05f_Male_OrcOgre_Well_Played_01	Non sbagli mai un colpo.	
VO_HERO_05f_Male_OrcOgre_Wow_01	Fantassstico!	
VO_HERO_05g_Male_OrcOgre_Attack_01	Per i Mok'nathal!	
VO_HERO_05g_Male_OrcOgre_Greetings_01	Ti tengo d'occhio.	
VO_HERO_05g_Male_OrcOgre_MIRROR_GREETINGS_01	Goditi il panorama.	
VO_HERO_05g_Male_OrcOgre_MIRROR_START_01	O con le unghie e con i denti!	
VO_HERO_05g_Male_OrcOgre_Oops_01	Un errore increscioso.	
VO_HERO_05g_Male_OrcOgre_Picked_01	Combattere è nella nostra natura.	
VO_HERO_05g_Male_OrcOgre_Start_01	Con le zanne e con gli artigli!	
VO_HERO_05g_Male_OrcOgre_Thanks_01	La natura ti ringrazia.	
VO_HERO_05g_Male_OrcOgre_Threaten_01	Ti darò una degna fine.	
VO_HERO_05g_Male_OrcOgre_Well_Played_01	Le tue azioni parlano per te.	
VO_HERO_05g_Male_OrcOgre_Wow_01	Che spettacolo!	
VO_HERO_06_HAPPY_NEW_YEAR_15	Buon anno!	
VO_Hero_06_Male_NightElf_Start_Illidan_01	Hai molto di cui rispondere.	
VO_HERO_06e_Male_NightElf_Attack_01	Attenti a voi, nemici della natura!	
VO_HERO_06e_Male_NightElf_Greetings_01	Ti ascolto.	
VO_HERO_06e_Male_NightElf_MIRROR_GREETINGS_01	È la cosa che ti riesce meglio.	
VO_HERO_06e_Male_NightElf_MIRROR_START_01	Può guidare solo uno di noi!	
VO_HERO_06e_Male_NightElf_Oops_01	Un minuscolo errore.	
VO_HERO_06e_Male_NightElf_Picked_01	Sono un custode della natura.	
VO_HERO_06e_Male_NightElf_Start_01	Che Cenarius mi guidi alla vittoria!	
VO_HERO_06e_Male_NightElf_Thanks_01	Non potrò mai ringraziarti abbastanza.	
VO_HERO_06e_Male_NightElf_Threaten_01	Nessuno sfugge ai venti di guerra.	
VO_HERO_06e_Male_NightElf_Well_Played_01	Che abilità straordinaria.	
VO_HERO_06e_Male_NightElf_Wow_01	Per Elune!	
VO_Hero_06e_Male_Tauren_Attack_01	La natura resiste!	
VO_Hero_06e_Male_Tauren_Concede_01	Mi arrendo.	
VO_Hero_06e_Male_Tauren_ERROR_FULL_MINIONS_01	Ho troppi servitori.	
VO_Hero_06e_Male_Tauren_ERROR_GENERIC_01	Non posso.	
VO_Hero_06e_Male_Tauren_ERROR_GENERIC_02	Impossibile.	
VO_Hero_06e_Male_Tauren_ERROR_HAND_FULL_01	La mia mano è piena.	
VO_Hero_06e_Male_Tauren_ERROR_I_ATTACKED_01	Non posso colpire di nuovo.	
VO_Hero_06e_Male_Tauren_ERROR_MINION_ATTACKED_01	Ha già attaccato!	
VO_Hero_06e_Male_Tauren_ERROR_NEED_MANA_01	Non ho abbastanza Mana.	
VO_Hero_06e_Male_Tauren_ERROR_NEED_WEAPON_01	Mi serve un'Arma!	
VO_Hero_06e_Male_Tauren_ERROR_PLAY_01	Non rientra nei miei poteri.	
VO_Hero_06e_Male_Tauren_ERROR_STEALTH_01	Quel servitore si nasconde.	
VO_Hero_06e_Male_Tauren_ERROR_SUMMON_SICKNESS_01	Non è ancora pronto.	
VO_Hero_06e_Male_Tauren_ERROR_TARGET_01	Non riesco.	
VO_Hero_06e_Male_Tauren_ERROR_TAUNT_01	Un nemico mi sta provocando.	
VO_Hero_06e_Male_Tauren_FIRE_FESTIVAL_01	Il fuoco è una fonte di rinnovamento per la foresta... e per noi!	
VO_Hero_06e_Male_Tauren_Greetings_01	Che i venti ti guidino.	
VO_Hero_06e_Male_Tauren_HAPPY_HALLOWEEN_01	Fa' attenzione! Per la Veglia delle Ombre arrivano gli spiriti...	
VO_Hero_06e_Male_Tauren_HAPPY_HOLIDAYS_01	È il momento di festeggiare a dovere!	
VO_Hero_06e_Male_Tauren_HAPPY_NEW_YEAR_01	Buon anno!	
VO_Hero_06e_Male_Tauren_HAPPY_NEW_YEAR_LUNAR_01	Buon anno!	
VO_Hero_06e_Male_Tauren_HAPPY_NOBLEGARDEN_01	Che la natura benedica la tua Nobiluova quest'anno.	
VO_Hero_06e_Male_Tauren_LowCards_01	Ho poche carte.	
VO_Hero_06e_Male_Tauren_MIRROR_GREETINGS_01	Possano guidare anche te.	
VO_Hero_06e_Male_Tauren_MIRROR_START_01	Già, e noi due ci bilanciamo bene!	
VO_Hero_06e_Male_Tauren_NoCards_01	Ho finito le carte!	
VO_Hero_06e_Male_Tauren_Oops_01	Un abbaglio...	
VO_Hero_06e_Male_Tauren_Picked_01	Io servo la terra.	
VO_Hero_06e_Male_Tauren_PIRATE_DAY_01	I totem di Hamuul sono al vostro servizio, canaglie! Arrr!	
VO_Hero_06e_Male_Tauren_Sorry_01	Mi dispiace.	
VO_Hero_06e_Male_Tauren_Start_01	La natura cerca sempre l'equilibrio.	
VO_Hero_06e_Male_Tauren_Start_Malfurion_01	Mi fa piacere vederti, Shan'do.	
VO_Hero_06e_Male_Tauren_Thanks_01	Ti sono grato.	
VO_Hero_06e_Male_Tauren_Thinking_01	Mmm...	
VO_Hero_06e_Male_Tauren_Thinking_02	Interessante...	
VO_Hero_06e_Male_Tauren_Thinking_03	Fammi pensare...	
VO_Hero_06e_Male_Tauren_Threaten_02	Impara a mitigare la forza con la saggezza!	
VO_Hero_06e_Male_Tauren_Time_01	Il tempo corre!	
VO_Hero_06e_Male_Tauren_TRIGGER_FORCE_OF_NATURE_01	Ho imparato dal migliore... 	
VO_Hero_06e_Male_Tauren_TRIGGER_GIFT_OF_THE_WILD_01	Siate forti, amici! 	
VO_Hero_06e_Male_Tauren_TRIGGER_LUNAR_VISIONS_01	Mi unisco alla natura...	
VO_Hero_06e_Male_Tauren_TRIGGER_MOONGLADE_PORTAL_01	La saggezza di Radaluna!	
VO_Hero_06e_Male_Tauren_TRIGGER_MULCH_01	Tutto ritorna alla terra... 	
VO_Hero_06e_Male_Tauren_TRIGGER_WISPERING_WOODS_01	La foresta mi parla... 	
VO_Hero_06e_Male_Tauren_Well_Played_01	Ben fatto!	
VO_Hero_06e_Male_Tauren_WOW_01	Incredibile!	
VO_HERO_06g_Male_NightElf_Attack_01	Anu'dorini Talah!	
VO_HERO_06g_Male_NightElf_Greetings_01	Ishnu'alah.	
VO_HERO_06g_Male_NightElf_MIRROR_GREETINGS_01	Elune-Adore.	
VO_HERO_06g_Male_NightElf_MIRROR_START_01	È sempre con me.	
VO_HERO_06g_Male_NightElf_Oops_01	Un errore in buona fede.	
VO_HERO_06g_Male_NightElf_Picked_01	Nel momento del bisogno, io ci sarò.	
VO_HERO_06g_Male_NightElf_Start_01	Senti il potere della natura!	
VO_HERO_06g_Male_NightElf_Thanks_01	Shaha lor'ma.	
VO_HERO_06g_Male_NightElf_Threaten_01	Ciò che fiorisce può anche avvizzire.	
VO_HERO_06g_Male_NightElf_Well_Played_01	Una mossa saggia.	
VO_HERO_06g_Male_NightElf_Wow_01	Magnifico!	
VO_HERO_07_HAPPY_NEW_YEAR_15	Buon anno!	
VO_Hero_07d_Male_OldGod_Attack_02	<Attacco>	
VO_Hero_07d_Male_OldGod_Concede_01	Torno... al mio sonno...	
VO_Hero_07d_Male_OldGod_Death_02	È finita...	
VO_Hero_07d_Male_OldGod_ERROR_FULL_MINIONS_02	Ce ne sono troppi.	
VO_Hero_07d_Male_OldGod_ERROR_GENERIC_04	Non si può fare.	
VO_Hero_07d_Male_OldGod_ERROR_HAND_FULL_01	La mia mano è piena.	
VO_Hero_07d_Male_OldGod_ERROR_I_ATTACKED_01	Non posso attaccare.	
VO_Hero_07d_Male_OldGod_ERROR_MINION_ATTACKED_01	Quel servitore è esausto.	
VO_Hero_07d_Male_OldGod_ERROR_NEED_MANA_02	Il Mana non basta.	
VO_Hero_07d_Male_OldGod_ERROR_NEED_WEAPON_01	Ho bisogno di un'Arma.	
VO_Hero_07d_Male_OldGod_ERROR_PLAY_01	Non posso giocarla.	
VO_Hero_07d_Male_OldGod_ERROR_STEALTH_01	Quel servitore è furtivo.	
VO_Hero_07d_Male_OldGod_ERROR_STEALTH_02	Non posso vedere ciò che è nascosto.	
VO_Hero_07d_Male_OldGod_ERROR_SUMMON_SICKNESS_02	Dagli un po' di tempo per prepararsi.	
VO_Hero_07d_Male_OldGod_ERROR_TARGET_01	Ho bisogno di un bersaglio.	
VO_Hero_07d_Male_OldGod_ERROR_TAUNT_01	Devo attaccare il servitore con Provocazione.	
VO_Hero_07d_Male_OldGod_FIRE_FESTIVAL_01	Il fuoco consuma, ma le fiamme purificano. 	
VO_Hero_07d_Male_OldGod_Greetings_01	Un benvenuto a un altro dei miei prescelti.	
VO_Hero_07d_Male_OldGod_HAPPY_BIRTHDAY_01	Le candele luccicano sulla torta. Esprimi un desiderio!	
VO_Hero_07d_Male_OldGod_HAPPY_BIRTHDAY_02	Tanti auguri... a te.	
VO_Hero_07d_Male_OldGod_HAPPY_HALLOWEEN_01	Alla Veglia delle Ombre, il velo viene squarciato...	
VO_Hero_07d_Male_OldGod_HAPPY_HOLIDAYS_01	Sono giunte le feste.	
VO_Hero_07d_Male_OldGod_HAPPY_NEW_YEAR_01	Un altro anno... è l'alba della fine.	
VO_Hero_07d_Male_OldGod_HAPPY_NEW_YEAR_LUNAR_01	Un altro anno... l'alba della fine.	
VO_Hero_07d_Male_OldGod_HAPPY_NOBLEGARDEN_01	Innumerevoli uova nascoste nelle profondità...	
VO_Hero_07d_Male_OldGod_LowCards_01	La fine del mio mazzo è prossima...	
VO_Hero_07d_Male_OldGod_MIRROR_GREETINGS_01	Insieme sogniamo, ma solo uno si risveglierà.	
VO_Hero_07d_Male_OldGod_MIRROR_START_01	E la città dormiente si risveglierà.	
VO_Hero_07d_Male_OldGod_NoCards_01	Il mio mazzo è vuoto!	
VO_Hero_07d_Male_OldGod_Oops_02	Con un sussurro giunge il caos.	
VO_Hero_07d_Male_OldGod_Picked_01	Io posso salvarti da ciò che sta arrivando.	
VO_Hero_07d_Male_OldGod_PIRATE_DAY_01	Yo... ho... ho...	
VO_Hero_07d_Male_OldGod_Sorry_01	Farò ammenda.	
VO_Hero_07d_Male_OldGod_Start_01	Tutti gli occhi saranno aperti!	
VO_Hero_07d_Male_OldGod_START_ARTHAS_01	Il tuo futuro è alle porte, Principe. La tua corona aprirà la strada.	
VO_Hero_07d_Male_OldGod_START_AZSHARA_01	Vanità. Solo vanità.	
VO_Hero_07d_Male_OldGod_START_DEATHWING_01	Devastamondi. Hai udito la mia chiamata dagli abissi.	
VO_Hero_07d_Male_OldGod_START_DRUID_01	Sento le tue radici nel profondo, che risvegliano l'Incubo.	
VO_Hero_07d_Male_OldGod_START_GARROSH_01	I nostri doni non sono le tue armi, Capoguerra.	
VO_Hero_07d_Male_OldGod_START_LADYPRESTOR_01	Ti vedo per ciò che sei realmente.	
VO_Hero_07d_Male_OldGod_START_LADYVASHJ_01	Ah, i doni che ho conferito alla tua gente, alla tua Regina...	
VO_Hero_07d_Male_OldGod_START_LAZUL_01	I miei sussurri ti hanno raggiunta da tempo...	
VO_Hero_07d_Male_OldGod_START_MORGL_01	Unisciti a me negli abissi, piccoletto.	
VO_Hero_07d_Male_OldGod_START_NEMSY_01	Anche tu hai udito la chiamata dagli abissi.	
VO_Hero_07d_Male_OldGod_START_SYLVANAS_01	Vedo le macchinazioni del tuo cuore oscuro.	
VO_Hero_07d_Male_OldGod_START_THUNDERKING_01	Servo dei Titani, la tua ora è giunta.	
VO_Hero_07d_Male_OldGod_Thanks_01	Grazie.	
VO_Hero_07d_Male_OldGod_Thinking_01	Mmm...	
VO_Hero_07d_Male_OldGod_Thinking_02	...infinite verità...	
VO_Hero_07d_Male_OldGod_Thinking_04	...il velo si squarcia...	
VO_Hero_07d_Male_OldGod_Threaten_02	Sogna con me...	
VO_Hero_07d_Male_OldGod_Time_01	Il momento si avvicina.	
VO_Hero_07d_Male_OldGod_TRIGGER_BANEOFDOOM_01	La sua fine non è che l'inizio. 	
VO_Hero_07d_Male_OldGod_TRIGGER_DECKOFCHAOS_01	Il futuro è la storia riscritta.	
VO_Hero_07d_Male_OldGod_TRIGGER_DISCARD_01	Negli abissi...	
VO_Hero_07d_Male_OldGod_TRIGGER_DRAINLIFE_01	La tua sofferenza è la mia forza. 	
VO_Hero_07d_Male_OldGod_TRIGGER_HELLFIRE_01	Tutto andrà in Rovina.	
VO_Hero_07d_Male_OldGod_TRIGGER_HEROPOWER_01	Sacrificio...	
VO_Hero_07d_Male_OldGod_TRIGGER_HEROPOWER_02	Di più...	
VO_Hero_07d_Male_OldGod_TRIGGER_HEROPOWER_03	Mi nutro...	
VO_Hero_07d_Male_OldGod_TRIGGER_NZOTH_01	Io sono moltitudine. 	
VO_Hero_07d_Male_OldGod_TRIGGER_OPPONENT_SHADOWFORM_01	Sì. Accogli le ombre.	
VO_Hero_07d_Male_OldGod_TRIGGER_PLOTTWIST_01	Niente è come sembra...	
VO_Hero_07d_Male_OldGod_TRIGGER_SHADOWFLAME_01	Si è affidato a me.	
VO_Hero_07d_Male_OldGod_TRIGGER_SOULFRAGMENT_01	I miei occhi si aprono.	
VO_Hero_07d_Male_OldGod_TRIGGER_TWISTEDKNOWLEDGE_01	Conosco l'imperscrutabile. Vedo l'invisibile.	
VO_Hero_07d_Male_OldGod_TRIGGER_TWISTINGNETHER_01	Il vuoto consuma.	
VO_Hero_07d_Male_OldGod_Well_Played_01	Magnifico e tremendo!	
VO_Hero_07d_Male_OldGod_WOW_01	Stupefacente!	
VO_HERO_08_Female_Human_START_Arthas_01	Non c'è niente di cui dovrei preoccuparmi... vero, Arthas?	
VO_HERO_08_HAPPY_NEW_YEAR_15	Buon anno!	
VO_HERO_08b_HAPPY_NEW_YEAR_53	Buon anno.	
VO_Hero_08e_Male_Lich_Concede_01	La vittoria è tua.	
VO_Hero_08e_Male_Lich_ERROR_FULL_MINIONS_01	Il mio culto ha già troppi adepti!	
VO_Hero_08e_Male_Lich_ERROR_GENERIC_01	No!	
VO_Hero_08e_Male_Lich_ERROR_HAND_FULL_01	Troppe carte!	
VO_Hero_08e_Male_Lich_ERROR_I_ATTACKED_01	Ho già attaccato.	
VO_Hero_08e_Male_Lich_ERROR_MINION_ATTACKED_01	Non può attaccare di nuovo.	
VO_Hero_08e_Male_Lich_ERROR_NEED_MANA_01	Non ho abbastanza Mana.	
VO_Hero_08e_Male_Lich_ERROR_NEED_WEAPON_02	Mi serve un'Arma!	
VO_Hero_08e_Male_Lich_ERROR_PLAY_01	Non posso farlo.	
VO_Hero_08e_Male_Lich_ERROR_STEALTH_01	Quello si nasconde al mio sguardo.	
VO_Hero_08e_Male_Lich_ERROR_SUMMON_SICKNESS_01	Non è ancora pronto.	
VO_Hero_08e_Male_Lich_ERROR_TARGET_01	Non posso sceglierlo come bersaglio.	
VO_Hero_08e_Male_Lich_ERROR_TAUNT_02	Devo attaccare prima quello che mi sta provocando.	
VO_Hero_08e_Male_Lich_FIRE_FESTIVAL_01	Perché armeggiano tutti col fuoco? Non possono smetterla?	
VO_Hero_08e_Male_Lich_Greetings_01	Saluti dalla gelida oscurità.	
VO_Hero_08e_Male_Lich_HAPPY_HALLOWEEN_01	Quanti costumi alla Veglia delle Ombre! C'è anche il Re dei Litchi!	
VO_Hero_08e_Male_Lich_HAPPY_HOLIDAYS_01	Adoro l'inverno... il freddo, la neve... i regali rubati!	
VO_Hero_08e_Male_Lich_HAPPY_NEW_YEAR_01	Buon anno!	
VO_Hero_08e_Male_Lich_HAPPY_NEW_YEAR_LUNAR_01	Buon anno!	
VO_Hero_08e_Male_Lich_HAPPY_NOBLEGARDEN_01	Chi ha scambiato il mio filatterio con un uovo?!? Sei stato TU?	
VO_Hero_08e_Male_Lich_LowCards_01	Ho quasi finito le carte.	
VO_Hero_08e_Male_Lich_MIRROR_GREETINGS_01	Ah, il mio posto preferito!	
VO_Hero_08e_Male_Lich_MIRROR_START_01	Troppo tardi.	
VO_Hero_08e_Male_Lich_NoCards_01	Ho finito le carte!	
VO_Hero_08e_Male_Lich_Oops_01	Una distrazione!	
VO_Hero_08e_Male_Lich_Picked_01	Rispondi alla chiamata!	
VO_Hero_08e_Male_Lich_PIRATE_DAY_01	Con una faccia come questa, potrei fare la bandiera dei pirati!	
VO_Hero_08e_Male_Lich_Sorry_01	Sono terribilmente dispiaciuto.	
VO_Hero_08e_Male_Lich_Start_01	La curiosità sarà la tua fine.	
VO_Hero_08e_Male_Lich_Start_Arthas_01	Sei davvero promettente.	
VO_Hero_08e_Male_Lich_Start_Jaina_01	Sei ancora schierata dalla parte sbagliata, Jaina.	
VO_Hero_08e_Male_Lich_Start_Sylvanas_01	Ah, quindi combatti ancora...	
VO_Hero_08e_Male_Lich_Thanks_01	Grazie!	
VO_Hero_08e_Male_Lich_Thinking_01	Mmm...	
VO_Hero_08e_Male_Lich_Thinking_02	Oh?	
VO_Hero_08e_Male_Lich_Thinking_04	Ogni cosa a suo tempo.	
VO_Hero_08e_Male_Lich_Threaten_01	Il nero vuoto ti attende!	
VO_Hero_08e_Male_Lich_Time_01	Il tempo mi gioca contro!	
VO_Hero_08e_Male_Lich_TRIGGER_Blizzard_01	Ti gelerò il sangue nelle vene!	
VO_Hero_08e_Male_Lich_TRIGGER_Cone_of_Cold_01	Ora la tua anima è legata a me!	
VO_Hero_08e_Male_Lich_TRIGGER_Deep_Freeze_01	Non ti muovere!	
VO_Hero_08e_Male_Lich_TRIGGER_Evocation_01	Ho studiato per molti anni...	
VO_Hero_08e_Male_Lich_TRIGGER_Font_of_Power_01	Guerrieri delle Distese Ghiacciate, levatevi!	
VO_Hero_08e_Male_Lich_TRIGGER_Frost_Nova_01	Cerca di essere paziente...	
VO_Hero_08e_Male_Lich_TRIGGER_Frostbolt_01	Implora misericordia!	
VO_Hero_08e_Male_Lich_TRIGGER_Icicle_01	Le tue piccole Magie sono inutili!	
VO_Hero_08e_Male_Lich_TRIGGER_Snap_Freeze_01	Muahahah!	
VO_Hero_08e_Male_Lich_Well_Played_01	Bella giocata, intruso.	
VO_Hero_08e_Male_Lich_WOW_01	Potere inarrestabile!	
VO_HERO_08f_Female_Human_Attack_01	Che ti sia di lezione!	
VO_HERO_08f_Female_Human_Greetings_01	Che gioia vederti!	
VO_HERO_08f_Female_Human_MIRROR_GREETINGS_01	Ci incontriamo spesso.	
VO_HERO_08f_Female_Human_MIRROR_START_01	Magia del gelo o arcana?	
VO_HERO_08f_Female_Human_Oops_01	Solo un piccolo errore.	
VO_HERO_08f_Female_Human_Picked_01	Sono pronta a imparare.	
VO_HERO_08f_Female_Human_Start_01	L'unica cosa che volevo era studiare!	
VO_HERO_08f_Female_Human_Thanks_01	Grazie per l'aiuto.	
VO_HERO_08f_Female_Human_Threaten_01	Diventerò una grande Maga, un giorno. Vedrai.	
VO_HERO_08f_Female_Human_Well_Played_01	Che classe!	
VO_HERO_08f_Female_Human_Wow_01	Entusiasmante!	
VO_HERO_08g_Female_Human_Attack_01	Per il Kirin Tor!	
VO_HERO_08g_Female_Human_Greetings_01	Che cosa cerchi?	
VO_HERO_08g_Female_Human_MIRROR_GREETINGS_01	Giustizia, pace, metamorfare i nemici...	
VO_HERO_08g_Female_Human_MIRROR_START_01	Il migliore, oserei dire.	
VO_HERO_08g_Female_Human_Oops_01	È stato... intenzionale?	
VO_HERO_08g_Female_Human_Picked_01	Ho passato anni a perfezionare le arti arcane.	
VO_HERO_08g_Female_Human_Start_01	La conoscenza è potere!	
VO_HERO_08g_Female_Human_Thanks_01	Hai la mia più sincera gratitudine.	
VO_HERO_08g_Female_Human_Threaten_01	Non tollererò insurrezioni!	
VO_HERO_08g_Female_Human_Well_Played_01	Ci sai davvero fare.	
VO_HERO_08g_Female_Human_Wow_01	Incantevole!	
VO_HERO_08h_Female_Human_Attack_01	Arrenditi!	
VO_HERO_08h_Female_Human_Greetings_01	Sono qui per aiutare!	
VO_HERO_08h_Female_Human_MIRROR_GREETINGS_01	Molto gentile da parte tua!	
VO_HERO_08h_Female_Human_MIRROR_START_01	Che buffo, anch'io!	
VO_HERO_08h_Female_Human_Oops_01	Ooops!	
VO_HERO_08h_Female_Human_Picked_01	Rispolveriamo gli elementali.	
VO_HERO_08h_Female_Human_Start_01	Sono sicura che ci divertiremo.	
VO_HERO_08h_Female_Human_Thanks_01	Oh, grazie!	
VO_HERO_08h_Female_Human_Threaten_01	Odio ricorrere alla violenza!	
VO_HERO_08h_Female_Human_Well_Played_01	Sei davvero eccezionale.	
VO_HERO_08h_Female_Human_Wow_01	È meraviglioso!	
VO_HERO_08i_Female_Human_Attack_01	Stai sprecando il mio tempo!	
VO_HERO_08i_Female_Human_Greetings_01	Non fidarti di nessuno.	
VO_HERO_08i_Female_Human_MIRROR_GREETINGS_01	Sento di potermi fidare di te.	
VO_HERO_08i_Female_Human_MIRROR_START_01	Né la domanda.	
VO_HERO_08i_Female_Human_Oops_01	Un grave errore di distrazione.	
VO_HERO_08i_Female_Human_Picked_01	Non dimenticherò mai Theramore.	
VO_HERO_08i_Female_Human_Start_01	La pace non è sempre la risposta!	
VO_HERO_08i_Female_Human_Thanks_01	Sono in debito con te.	
VO_HERO_08i_Female_Human_Threaten_01	La situazione sta per farsi gelida.	
VO_HERO_08i_Female_Human_Well_Played_01	Mai moderare il proprio ardore.	
VO_HERO_08i_Female_Human_Wow_01	Spettacolare!	
VO_HERO_08j_Female_Human_Attack_01	Dev'essere fatto!	
VO_HERO_08j_Female_Human_Greetings_01	Abbiamo tutti i nostri fantasmi.	
VO_HERO_08j_Female_Human_MIRROR_GREETINGS_01	Alcuni più di altri.	
VO_HERO_08j_Female_Human_MIRROR_START_01	Forse non è mai davvero iniziato.	
VO_HERO_08j_Female_Human_Oops_01	Una svista...	
VO_HERO_08j_Female_Human_Picked_01	Non ti fidar della figlia del mar.	
VO_HERO_08j_Female_Human_Start_01	Il tempo dei sogni è finito.	
VO_HERO_08j_Female_Human_Thanks_01	Ti sono grata per il tuo aiuto.	
VO_HERO_08j_Female_Human_Threaten_01	Una sola scintilla può incendiare il mondo.	
VO_HERO_08j_Female_Human_Well_Played_01	Hai un tale potere... ma assicurati di controllarlo.	
VO_HERO_08j_Female_Human_Wow_01	Incredibile!	
VO_HERO_08k_Female_Human_Attack_01	Dubita di ogni cosa!	
VO_HERO_08k_Female_Human_Greetings_01	Un caldo benvenuto a te.	
VO_HERO_08k_Female_Human_MIRROR_GREETINGS_01	Le Immagini Speculari possono parlare???	
VO_HERO_08k_Female_Human_MIRROR_START_01	Credo che tu sia sulla buona strada.	
VO_HERO_08k_Female_Human_Oops_01	Cos'è stato?	
VO_HERO_08k_Female_Human_Picked_01	Il mio potere porterà la pace, in un modo o nell'altro.	
VO_HERO_08k_Female_Human_Start_01	La mia magia prevarrà.	
VO_HERO_08k_Female_Human_Thanks_01	Grazie mille.	
VO_HERO_08k_Female_Human_Threaten_01	E con questo ho chiuso con te!	
VO_HERO_08k_Female_Human_Well_Played_01	Mi hai stregata.	
VO_HERO_08k_Female_Human_Wow_01	Che momento magico!	
VO_HERO_09_HAPPY_NEW_YEAR_15	Buon anno!	
VO_HERO_09_Male_Human_Emote_01	Giustizia per la Luce!	
VO_HERO_09_Male_Human_Emote_02	Pregherò per te.	
VO_HERO_09_Male_Human_Emote_03	I veri Sacerdoti usano armature a piastre.	
VO_HERO_09_Male_Human_Emote_04	Ho bisogno di cure!	
VO_HERO_09_Male_Human_Emote_05	Per la Luce!	
VO_HERO_09_Male_Human_Emote_06	Non vedo l'ora di diventare Re.	
VO_HERO_09_Male_Human_Emote_07	Non gioco sempre pulito. Be'... di solito sì.	
VO_HERO_09_Male_Human_Emote_08	Per l'Alleanza!	
VO_HERO_09_Male_Human_Emote_09	Roccavento resisterà! 	
VO_HERO_09_Male_Human_Emote_10	Vale sempre la pena combattere per una giusta causa.	
VO_HERO_09_Male_Human_Emote_11	La nobiltà di un Re si vede dalle carte che gioca.	
VO_HERO_09_Male_Human_Emote_12	Non perdere mai la speranza. 	
VO_HERO_09a_Attack_15	Per Elune!	
VO_HERO_09a_CONCEDE_06	È finita. Hai vinto.	
VO_HERO_09a_ERROR_FULL_MINIONS_25	Ho troppi servitori.	
VO_HERO_09a_ERROR_GENERIC_30	Non posso farlo.	
VO_HERO_09a_ERROR_HAND_FULL_24	La mia mano è piena!	
VO_HERO_09a_ERROR_I_ATTACKED_22	Ho già attaccato.	
VO_HERO_09a_ERROR_JUST_PLAYED_23	Concedi a quel servitore un turno per prepararsi.	
VO_HERO_09a_ERROR_MINION_ATTACKED_21	Quel servitore ha già attaccato.	
VO_HERO_09a_ERROR_NEED_MANA_20	Non ho abbastanza Mana.	
VO_HERO_09a_ERROR_NEED_WEAPON_19	Mi serve un'arma.	
VO_HERO_09a_ERROR_PLAY_27	Non posso giocare questa carta.	
VO_HERO_09a_ERROR_STEALTH_26	Non posso scegliere come bersagli i servitori con Furtività.	
VO_HERO_09a_ERROR_TARGET_28	Quel bersaglio non è valido.	
VO_HERO_09a_ERROR_TAUNT_29	Devo attaccare i servitori con Provocazione.	
VO_Hero_09a_Female_NightElf_Start_Illidan_01	La potenza allo stato grezzo non è vera forza.	
VO_HERO_09a_FIRE_FESTIVAL	Buona festa di Mezza Estate!	
VO_HERO_09a_GREETINGS_03	Che Elune ti benedica.	
VO_HERO_09a_GREETINGS_RESPONSE	Anche a te.	
VO_HERO_09a_HALLOWS_END	Buona Veglia delle Ombre.	
VO_HERO_09a_HAPPY_HOLIDAYS_52	Felice Vigilia di Grande Inverno!	
VO_HERO_09a_HAPPY_NEW_YEAR_01	Buon anno!	
VO_HERO_09a_HAPPY_NEW_YEAR_LUNAR_53	Buon anno!	
VO_HERO_09a_LOW_CARDS_17	Ho quasi finito le carte.	
VO_HERO_09a_MIRROR_GREETINGS_04	Anche a te.	
VO_HERO_09a_MIRROR_START_02	La mia Dea è il mio scudo.	
VO_HERO_09a_NO_CARDS_18	Ho finito le carte!	
VO_HERO_09a_NOBLEGARDEN	Buona Festa di Nobiluova.	
VO_HERO_09a_OOPS_08	Mmm, un errore.	
VO_HERO_09a_PICKED_11	La Dea mi chiama!	
VO_HERO_09a_PIRATE_DAY	Parola del Potere: arrr!	
VO_HERO_09a_SORRY_10	Chiedo scusa.	
VO_HERO_09a_START_01	Elune, dammi la forza.	
VO_HERO_09a_START_MALFURION	Malfurion, tesoro!	
VO_HERO_09a_THANKS_09	Ti ringrazio.	
VO_HERO_09a_THINK1_12	Mmm...	
VO_HERO_09a_THINK2_13	Fammi pensare...	
VO_HERO_09a_THINK3_14	Cosa vorrebbe Elune?	
VO_HERO_09a_THREATEN_05	Te ne pentirai!	
VO_HERO_09a_TIMER_16	Devo fare in fretta!	
VO_HERO_09a_WELL_PLAYED_07	Bella giocata.	
VO_HERO_09a_WOW_10	Geniale!	
VO_HERO_09b_Female_Troll_Concede_01	Hai vinto. Era nel destino tuo.	
VO_HERO_09b_Female_Troll_ERROR_FULL_MINIONS_02	Il lato del campo mio è già pieno!	
VO_HERO_09b_Female_Troll_ERROR_GENERIC_02	Chesto è impossibile.	
VO_HERO_09b_Female_Troll_ERROR_HAND_FULL_01	La mano mia è piena!	
VO_HERO_09b_Female_Troll_ERROR_I_ATTACKED_01	Ho già attaccato.	
VO_HERO_09b_Female_Troll_ERROR_MINION_ATTACKED_01	Chel servitore ha già attaccato.	
VO_HERO_09b_Female_Troll_ERROR_NEED_MANA_02	Tengo bisogno di Mana!	
VO_HERO_09b_Female_Troll_ERROR_NEED_WEAPON_01	Tengo bisogno di un'Arma.	
VO_HERO_09b_Female_Troll_ERROR_PLAY_01	Nun posso giocarla.	
VO_HERO_09b_Female_Troll_ERROR_STEALTH_01	Ahhh, chello è furtivo.	
VO_HERO_09b_Female_Troll_ERROR_SUMMON_SICKNESS_01	Oh, dagli nu po' di tempo per prepararsi.	
VO_HERO_09b_Female_Troll_ERROR_TARGET_01	Mi serve nu bersaglio.	
VO_HERO_09b_Female_Troll_ERROR_TAUNT_01	Devo prima occuparmi di chel servitore con Provocazione.	
VO_HERO_09b_Female_Troll_FIRE_FESTIVAL_01	Il Festival del Fuoco sta accà!	
VO_HERO_09b_Female_Troll_Greetings_01	Ti do il benvenuto! Vuoi conoscere il futuro tuo?	
VO_HERO_09b_Female_Troll_HAPPY_HALLOWEEN_01	Ahhh, la Veglia delle Ombre.	
VO_HERO_09b_Female_Troll_HAPPY_HOLIDAYS_01	Buone feste.	
VO_HERO_09b_Female_Troll_HAPPY_NEW_YEAR_01	Inizia nu nuovo anno...	
VO_HERO_09b_Female_Troll_HAPPY_NEW_YEAR_LUNAR_01	Inizia nu nuovo anno...	
VO_HERO_09b_Female_Troll_HAPPY_NOBLEGARDEN_01	Buona Festa di Nobiluova! 	
VO_HERO_09b_Female_Troll_LowCards_02	Ho quasi finito le carte.	
VO_HERO_09b_Female_Troll_MIRROR_GREETINGS_02	Sapevo che l'avresti detto.	
VO_HERO_09b_Female_Troll_MIRROR_START_01	Allora sai già come andrà a finire...	
VO_HERO_09b_Female_Troll_NoCards_02	Ho finito le carte!	
VO_HERO_09b_Female_Troll_Oops_01	Ooops, chesta sì che è na storia da raccontare.	
VO_HERO_09b_Female_Troll_Picked_02	Facciamo nu po' di caos, che ne dici?	
VO_HERO_09b_Female_Troll_PIRATE_DAY_01	Yo oh oh! 	
VO_HERO_09b_Female_Troll_Sorry_01	Mi dispiace.	
VO_HERO_09b_Female_Troll_Start_02	Avevo previsto chesto incontro...	
VO_HERO_09b_Female_Troll_Thanks_01	Grazie.	
VO_HERO_09b_Female_Troll_Thinking_06	Mmm...	
VO_HERO_09b_Female_Troll_Thinking_11	Cosa dicono le carte?	
VO_HERO_09b_Female_Troll_Thinking_12	Cosa dovrei fare...	
VO_HERO_09b_Female_Troll_Threaten_03	Il destino tuo è già segnato!	
VO_HERO_09b_Female_Troll_Time_02	La fine è vicina.	
VO_HERO_09b_Female_Troll_Well_Played_01	Bella giocata!	
VO_HERO_09b_Female_Troll_WOW_01	Per gli Dei Antichi!	
VO_HERO_09d_Male_Human_Greetings_01	Buona giornata.	
VO_HERO_09d_Male_Human_MIRROR_GREETINGS_01	Anche a te, amico stranamente familiare!	
VO_HERO_09d_Male_Human_MIRROR_START_01	Così ho sempre creduto.	
VO_HERO_09d_Male_Human_Oops_01	Soprassediamo.	
VO_HERO_09d_Male_Human_Thanks_01	Grazie, davvero.	
VO_HERO_09d_Male_Human_Well_Played_01	La Luce ti guida.	
VO_HERO_09d_Male_Human_Wow_01	Fantastico!	
VO_HERO_09e_Male_Human_Attack_01	Per Roccavento!	
VO_HERO_09e_Male_Human_Greetings_01	Ehilà.	
VO_HERO_09e_Male_Human_MIRROR_GREETINGS_01	Ehi, non è questo il saluto in codice!	
VO_HERO_09e_Male_Human_MIRROR_START_01	Non sarai solo!	
VO_HERO_09e_Male_Human_Oops_01	Com'è successo?	
VO_HERO_09e_Male_Human_Start_01	Proteggerò l'Alleanza.	
VO_HERO_09e_Male_Human_Thanks_01	Un sentito ringraziamento.	
VO_HERO_09e_Male_Human_Threaten_01	Non provocarmi...	
VO_HERO_09e_Male_Human_Well_Played_01	Combatti bene!	
VO_HERO_09e_Male_Human_Wow_01	Accidenti, incredibile.	
VO_HERO_09f_Male_Human_Attack_01	Arrenditi!	
VO_HERO_09f_Male_Human_Greetings_01	Saluti.	
VO_HERO_09f_Male_Human_MIRROR_GREETINGS_01	Mi piace il tuo stile.	
VO_HERO_09f_Male_Human_MIRROR_START_01	Una bella strategia...	
VO_HERO_09f_Male_Human_Oops_01	Meglio pensarci bene la prossima volta.	
VO_HERO_09f_Male_Human_Start_01	La saggezza porterà alla vittoria!	
VO_HERO_09f_Male_Human_Thanks_01	Ti sono riconoscente.	
VO_HERO_09f_Male_Human_Threaten_01	Anche lo spirito è un'arma.	
VO_HERO_09f_Male_Human_Well_Played_01	Una giocata saggia.	
VO_HERO_09f_Male_Human_Wow_01	Incredibile.	
VO_HERO_09h_Female_Draenei_Attack_01	Stai indietro!	
VO_HERO_09h_Female_Draenei_Greetings_01	Ti do il benvenuto!	
VO_HERO_09h_Female_Draenei_MIRROR_GREETINGS_01	Grazie per avermi invitata.	
VO_HERO_09h_Female_Draenei_MIRROR_START_01	Intendi il MIO momento.	
VO_HERO_09h_Female_Draenei_Oops_01	Gli errori ci fanno crescere.	
VO_HERO_09h_Female_Draenei_Picked_01	Non avrò pace finché il Naaru non sarà ricomposto.	
VO_HERO_09h_Female_Draenei_Start_01	Questo è il mio momento.	
VO_HERO_09h_Female_Draenei_Thanks_01	Lo apprezzo molto.	
VO_HERO_09h_Female_Draenei_Threaten_01	Non fermerai la mia missione.	
VO_HERO_09h_Female_Draenei_Well_Played_01	Ah, che maestria!	
VO_HERO_09h_Female_Draenei_Wow_01	Sono sbalordita!	
VO_HERO_09i_Female_Draenei_Attack_01	Che la Luce mi guidi!	
VO_HERO_09i_Female_Draenei_Greetings_01	Archenon poros!	
VO_HERO_09i_Female_Draenei_MIRROR_GREETINGS_01	Anche a te e alla tua famiglia.	
VO_HERO_09i_Female_Draenei_MIRROR_START_01	E io porrò fine all'oscurità.	
VO_HERO_09i_Female_Draenei_Oops_01	L'importante è rialzarsi dopo ogni caduta!	
VO_HERO_09i_Female_Draenei_Picked_01	Non avrò pace finché il Naaru non sarà ricomposto.	
VO_HERO_09i_Female_Draenei_Start_01	Illuminerò la via.	
VO_HERO_09i_Female_Draenei_Thanks_01	Ti sono grata.	
VO_HERO_09i_Female_Draenei_Threaten_01	Affronta la mia ira!	
VO_HERO_09i_Female_Draenei_Well_Played_01	Sono... impressionata.	
VO_HERO_09i_Female_Draenei_Wow_01	Memorabile!	
VO_HERO_09j_Female_Draenei_Attack_01	Krypta voros!	
VO_HERO_09j_Female_Draenei_Greetings_01	Non sarà facile batterti.	
VO_HERO_09j_Female_Draenei_MIRROR_GREETINGS_01	La penso allo stesso modo.	
VO_HERO_09j_Female_Draenei_MIRROR_START_01	Solo io posso tener fede a quel giuramento.	
VO_HERO_09j_Female_Draenei_Oops_01	Un errore non è mica la fine del mondo!	
VO_HERO_09j_Female_Draenei_Picked_01	Siamo troppo vicini alla fine per fermarci adesso!	
VO_HERO_09j_Female_Draenei_Start_01	Per la Luce. Per mia figlia!	
VO_HERO_09j_Female_Draenei_Thanks_01	Quanta generosità.	
VO_HERO_09j_Female_Draenei_Threaten_01	Pentiti!	
VO_HERO_09j_Female_Draenei_Well_Played_01	Uno scontro leggendario!	
VO_HERO_09j_Female_Draenei_Wow_01	Viviamo davvero in un'epoca di meraviglie!	
VO_HERO_09k_Female_Draenei_Attack_01	<Attacco>	
VO_HERO_09k_Female_Draenei_BRB_01	Torno subito.	
VO_HERO_09k_Female_Draenei_CELEBRATE_01	Ti auguro una gioia infinita!	
VO_HERO_09k_Female_Draenei_CHEER_01	Meraviglioso!	
VO_HERO_09k_Female_Draenei_Concede_01	Questa battaglia... è tua...	
VO_HERO_09k_Female_Draenei_CONGRATULATIONS_01	Le mie congratulazioni.	
VO_HERO_09k_Female_Draenei_CRY_01	<Piange>	
VO_HERO_09k_Female_Draenei_CRY_02	È... troppo... 	
VO_HERO_09k_Female_Draenei_DAY_OF_THE_DEAD_01	Un giorno per ricordare tutti quelli che abbiamo perso.	
VO_HERO_09k_Female_Draenei_Death_01	<Morte>	
VO_HERO_09k_Female_Draenei_END_OF_SEASON_01	La stagione si appresta alla fine.	
VO_HERO_09k_Female_Draenei_ERROR_FULL_MINIONS_01	Non c'è spazio.	
VO_HERO_09k_Female_Draenei_ERROR_GENERIC_01	È impossibile.	
VO_HERO_09k_Female_Draenei_ERROR_GENERIC_02	Non posso farlo.	
VO_HERO_09k_Female_Draenei_ERROR_HAND_FULL_01	La mia mano è piena!	
VO_HERO_09k_Female_Draenei_ERROR_I_ATTACKED_01	Ho già attaccato.	
VO_HERO_09k_Female_Draenei_ERROR_MINION_ATTACKED_01	Quel servitore ha già attaccato.	
VO_HERO_09k_Female_Draenei_ERROR_NEED_MANA_01	Mi serve più Mana.	
VO_HERO_09k_Female_Draenei_ERROR_NEED_MANA_02	Mi serve più potere. 	
VO_HERO_09k_Female_Draenei_ERROR_NEED_WEAPON_01	Ho bisogno di un'Arma.	
VO_HERO_09k_Female_Draenei_ERROR_PLAY_01	Non posso giocarla.	
VO_HERO_09k_Female_Draenei_ERROR_STEALTH_01	Quel servitore è furtivo.	
VO_HERO_09k_Female_Draenei_ERROR_STEALTH_02	Non riesco a vederlo.	
VO_HERO_09k_Female_Draenei_ERROR_SUMMON_SICKNESS_01	Quel servitore non è pronto!	
VO_HERO_09k_Female_Draenei_ERROR_SUMMON_SICKNESS_02	Quel servitore ha bisogno di tempo per prepararsi.	
VO_HERO_09k_Female_Draenei_ERROR_TARGET_01	Ho bisogno di un bersaglio.	
VO_HERO_09k_Female_Draenei_ERROR_TAUNT_01	C'è un servitore con Provocazione sulla mia strada.	
VO_HERO_09k_Female_Draenei_ERROR_TAUNT_02	Devo attaccare il servitore con Provocazione.	
VO_HERO_09k_Female_Draenei_FACTION_CRY_01	Per l'Alleanza!	
VO_HERO_09k_Female_Draenei_FIDGET_01	Mi darò una pulita agli zoccoli nel frattempo.	
VO_HERO_09k_Female_Draenei_FIRE_FESTIVAL_01	Festeggiamo la purezza della fiamma!	
VO_HERO_09k_Female_Draenei_GG_01	Che mossa magistrale!	
VO_HERO_09k_Female_Draenei_Greetings_01	Ti porgo i miei saluti.	
VO_HERO_09k_Female_Draenei_HAPPY_BIRTHDAY_01	Buon compleanno!	
VO_HERO_09k_Female_Draenei_HAPPY_BREWFEST_01	Un'intera festa dedicata alla birra. Mi piace.	
VO_HERO_09k_Female_Draenei_HAPPY_EVENT_01	È tempo di festeggiare!	
VO_HERO_09k_Female_Draenei_HAPPY_HALLOWEEN_01	La Veglia delle Ombre? Un'usanza strana e oscura!	
VO_HERO_09k_Female_Draenei_HAPPY_HOLIDAYS_01	Buone feste!	
VO_HERO_09k_Female_Draenei_HAPPY_NEW_YEAR_01	Buon anno nuovo!	
VO_HERO_09k_Female_Draenei_HAPPY_NEW_YEAR_LUNAR_01	Buon anno nuovo!	
VO_HERO_09k_Female_Draenei_HAPPY_NOBLEGARDEN_01	S'inseguono i conigli, no? E... le uova? Sono confusa.	
VO_HERO_09k_Female_Draenei_HUNGRY_01	Non tutti i viandanti si sono smarriti, ma molti sono affamati...	
VO_HERO_09k_Female_Draenei_INDEED_01	Puoi dirlo forte.	
VO_HERO_09k_Female_Draenei_KIDS_WEEK_01	Darei TUTTO per mia figlia...	
VO_HERO_09k_Female_Draenei_KISS_01	<Bacio>	
VO_HERO_09k_Female_Draenei_KISS_02	Smack!	
VO_HERO_09k_Female_Draenei_LAUGH_01	Ahahah!	
VO_HERO_09k_Female_Draenei_LowCards_01	Sto finendo le carte.	
VO_HERO_09k_Female_Draenei_MIRROR_GREETINGS_01	Anche io.	
VO_HERO_09k_Female_Draenei_MIRROR_START_01	Non ti lascerò scelta.	
VO_HERO_09k_Female_Draenei_NICE_CARD_BACK_01	Il tuo dorso delle carte è incantevole.	
VO_HERO_09k_Female_Draenei_NoCards_01	Ho finito le carte!	
VO_HERO_09k_Female_Draenei_Oops_01	Nessuno voleva che accadesse...	
VO_HERO_09k_Female_Draenei_PARTY_01	Scateniamoci come se questo fosse il nostro ultimo pianeta!	
VO_HERO_09k_Female_Draenei_Picked_01	La Luce guiderà i nostri passi!	
VO_HERO_09k_Female_Draenei_PIRATE_DAY_01	Non capisco questo "Giorno dei Pirati". Non siamo sulla stessa barca.	
VO_HERO_09k_Female_Draenei_SALUTE_01	Ti rendo onore.	
VO_HERO_09k_Female_Draenei_Sorry_01	Ah, sì... Scusa. 	
VO_HERO_09k_Female_Draenei_Start_01	Non devo vacillare.	
VO_HERO_09k_Female_Draenei_Start_Cariel_01	Mi dispiace che siamo giunte a questo.	
VO_HERO_09k_Female_Draenei_Start_Horde_01	Un mercenario dell'Orda!	
VO_HERO_09k_Female_Draenei_Start_Kazakus_01	La Luce del Naaru non è per te.	
VO_HERO_09k_Female_Draenei_Start_Kurtrus_01	Non lasciare che la rabbia ti definisca, Kurtrus.	
VO_HERO_09k_Female_Draenei_START_OF_SEASON_01	Inizia una nuova stagione! Che possa portarti gioia.	
VO_HERO_09k_Female_Draenei_Start_Scabbs_01	Vedo che vai subito dritto al punto.	
VO_HERO_09k_Female_Draenei_Start_Tavish_01	La ricerca continua, Tavish.	
VO_HERO_09k_Female_Draenei_Thanks_01	Ti ringrazio.	
VO_HERO_09k_Female_Draenei_Thinking_01	Mmm...	
VO_HERO_09k_Female_Draenei_Thinking_02	Guida la mia mano...	
VO_HERO_09k_Female_Draenei_Thinking_03	Devo insistere...	
VO_HERO_09k_Female_Draenei_Thinking_04	Sì, ma come?	
VO_HERO_09k_Female_Draenei_Threaten_01	Non mi tirerò indietro.	
VO_HERO_09k_Female_Draenei_Time_01	Non c'è tempo!	
VO_HERO_09k_Female_Draenei_TRIGGER_AGAINST_ALL_ODDS_01	Una situazione... impari.	
VO_HERO_09k_Female_Draenei_TRIGGER_AGAINST_ALL_ODDS_02	Restate al mio fianco, amici!	
VO_HERO_09k_Female_Draenei_TRIGGER_CIRCLE_OF_HEALING_01	Statemi accanto!	
VO_HERO_09k_Female_Draenei_TRIGGER_CONDEMN_LEVEL_1_01	Indietro, tutti voi!	
VO_HERO_09k_Female_Draenei_TRIGGER_CONDEMN_LEVEL_2_01	State indietro!	
VO_HERO_09k_Female_Draenei_TRIGGER_CONDEMN_LEVEL_3_01	Vi condanno tutti!	
VO_HERO_09k_Female_Draenei_TRIGGER_DESPERATE_PRAYER_01	La battaglia non è ancora finita.	
VO_HERO_09k_Female_Draenei_TRIGGER_HOLY_NOVA_01	Nessuno può nascondersi dalla Luce!	
VO_HERO_09k_Female_Draenei_TRIGGER_HYSTERIA_01	Che furia!	
VO_HERO_09k_Female_Draenei_TRIGGER_IDOL_OF_YSHAARJ_01	Questo mondo contiene molti orrori...	
VO_HERO_09k_Female_Draenei_TRIGGER_MIND_CONTROL_01	Lo prendo in prestito.	
VO_HERO_09k_Female_Draenei_TRIGGER_MOUNT_01	In sella!	
VO_HERO_09k_Female_Draenei_TRIGGER_PALM_READING_01	Ti ho in palmo di mano...	
VO_HERO_09k_Female_Draenei_TRIGGER_POWER_WORD_SHIELD_01	Che la Luce sia con te!	
VO_HERO_09k_Female_Draenei_TRIGGER_SHADOW_WORD_DEATH_01	Sparisci!	
VO_HERO_09k_Female_Draenei_TRIGGER_SHADOW_WORD_PAIN_01	Era una vera seccatura.	
VO_HERO_09k_Female_Draenei_TRIGGER_SILENCE_01	Shhh...	
VO_HERO_09k_Female_Draenei_VALENTINES_01	Noi non siamo altro che carne. L'amore... l'amore è eterno. 	
VO_HERO_09k_Female_Draenei_WELCOME_01	Ti do il benvenuto!	
VO_HERO_09k_Female_Draenei_Well_Played_02	Sei formidabile.	
VO_HERO_09k_Female_Draenei_WOW_02	Per tutte le stelle del firmamento!	
VO_Hero_10_Male_NightElf_Attack_01	La vendetta è mia.	
VO_Hero_10_Male_NightElf_Concede_01	Mi arrendo... per ora.	
VO_Hero_10_Male_NightElf_ERROR_FULL_MINIONS_01	Ho troppi servitori al mio comando.	
VO_Hero_10_Male_NightElf_ERROR_GENERIC_03	Non è possibile.	
VO_Hero_10_Male_NightElf_ERROR_HAND_FULL_01	La mia mano è piena!	
VO_Hero_10_Male_NightElf_ERROR_I_ATTACKED_01	Ho già sferrato un attacco!	
VO_Hero_10_Male_NightElf_ERROR_MINION_ATTACKED_01	Non posso attaccare di nuovo.	
VO_Hero_10_Male_NightElf_ERROR_NEED_MANA_01	Non ho abbastanza Mana.	
VO_Hero_10_Male_NightElf_ERROR_NEED_WEAPON_01	Ho bisogno di un'Arma.	
VO_Hero_10_Male_NightElf_ERROR_PLAY_01	Non posso.	
VO_Hero_10_Male_NightElf_ERROR_STEALTH_01	Quello si nasconde nell'ombra.	
VO_Hero_10_Male_NightElf_ERROR_SUMMON_SICKNESS_01	Quello NON è ancora pronto.	
VO_Hero_10_Male_NightElf_ERROR_TARGET_01	Non posso farlo.	
VO_Hero_10_Male_NightElf_ERROR_TAUNT_01	Un altro mi provoca! Come osa?	
VO_Hero_10_Male_NightElf_FIRE_FESTIVAL_01	Il nostro fuoco brucerà più della Legione stessa!	
VO_Hero_10_Male_NightElf_Greetings_01	Il male si avvicina.	
VO_Hero_10_Male_NightElf_HAPPY_HALLOWEEN_01	L'oscurità ci circonda... È la Veglia delle Ombre.	
VO_Hero_10_Male_NightElf_HAPPY_HOLIDAYS_01	Non esistono feste per i traditori.	
VO_Hero_10_Male_NightElf_HAPPY_NEW_YEAR_01	Buon anno.	
VO_Hero_10_Male_NightElf_HAPPY_NEW_YEAR_LUNAR_01	Buon anno.	
VO_Hero_10_Male_NightElf_HAPPY_NOBLEGARDEN_01	Cercare le uova è un ottimo allenamento per la caccia ai demoni.	
VO_Hero_10_Male_NightElf_LowCards_01	Non mi restano tante carte...	
VO_Hero_10_Male_NightElf_MIRROR_GREETINGS_01	Già. Perché ci sei TU qui. 	
VO_Hero_10_Male_NightElf_MIRROR_START_01	Come osi rivolgermi la parola?	
VO_Hero_10_Male_NightElf_NoCards_01	Ho finito le carte!	
VO_Hero_10_Male_NightElf_Oops_01	Un buco nell'acqua?	
VO_Hero_10_Male_NightElf_Picked_01	Sono stato imprigionato nell'oscurità.	
VO_Hero_10_Male_NightElf_PIRATE_DAY_01	Tutti a bordo della Traditrice, salpiamo verso i mari dell'infedeltà!	
VO_Hero_10_Male_NightElf_Sorry_01	Chiedo scusa.	
VO_Hero_10_Male_NightElf_Start_01	Tutto questo finisce ora!	
VO_Hero_10_Male_NightElf_Start_Aranna_01	Non mi tirerò indietro questa volta.	
VO_Hero_10_Male_NightElf_Start_Arthas_01	Ora e sempre... sono migliore di te, Arthas.	
VO_Hero_10_Male_NightElf_Start_Maiev_01	Non puoi dare la caccia a un cacciatore.	
VO_Hero_10_Male_NightElf_Start_Malfurion_01	Non è ancora finita tra noi, fratello.	
VO_Hero_10_Male_NightElf_Start_Mecha_Jaraxxus_01	Ne vuoi ancora, demone?	
VO_Hero_10_Male_NightElf_Start_Tyrande_01	Ti dimostrerò il mio valore.	
VO_Hero_10_Male_NightElf_Start_Vashj_01	Mettiamo alla prova la nostra forza.	
VO_Hero_10_Male_NightElf_Thanks_01	Ti ringrazio.	
VO_Hero_10_Male_NightElf_Thinking_01	Mmm...	
VO_Hero_10_Male_NightElf_Thinking_02	Così tanti conflitti...	
VO_Hero_10_Male_NightElf_Thinking_03	Demoni? Demoni.	
VO_Hero_10_Male_NightElf_Thinking_04	Inizio a spazientirmi.	
VO_Hero_10_Male_NightElf_Threaten_01	Non siete... pronti!	
VO_Hero_10_Male_NightElf_Time_01	Il tempo stringe.	
VO_Hero_10_Male_NightElf_TRIGGER_Command_the_Illidari_01	Servi il tuo padrone!	
VO_Hero_10_Male_NightElf_TRIGGER_Inner_Demon_01	Tutti abbiamo dei demoni.	
VO_Hero_10_Male_NightElf_TRIGGER_Mana_Burn_01	Brucia e trasformati in cenere...	
VO_Hero_10_Male_NightElf_TRIGGER_Metamorphosis_01	Ora sono completo!	
VO_Hero_10_Male_NightElf_TRIGGER_Skull_of_Guldan_01	Oh, povero Stregone...	
VO_Hero_10_Male_NightElf_TRIGGER_Spectral_Sight_01	Vedo ogni cosa...	
VO_Hero_10_Male_NightElf_Well_Played_01	Possiedi un grande potere.	
VO_Hero_10_Male_NightElf_WOW_01	Com'è possibile?	
VO_HERO_10c_Male_NightElf_Attack_01	Un gioco da ragazzi!	
VO_HERO_10c_Male_NightElf_Greetings_01	Metterò fine alla mia caccia.	
VO_HERO_10c_Male_NightElf_MIRROR_GREETINGS_01	Fa' il tuo dovere.	
VO_HERO_10c_Male_NightElf_MIRROR_START_01	La nostra furia non svanirà col tempo.	
VO_HERO_10c_Male_NightElf_Oops_01	Una mossa sbagliata?	
VO_HERO_10c_Male_NightElf_Picked_01	Persino i demoni mi temono.	
VO_HERO_10c_Male_NightElf_Start_01	La furia della Legione impallidisce di fronte alla mia.	
VO_HERO_10c_Male_NightElf_Thanks_01	Devo ringraziarti.	
VO_HERO_10c_Male_NightElf_Threaten_01	Ti pentirai di avermi affrontato!	
VO_HERO_10c_Male_NightElf_Well_Played_01	Sei un avversario interessante.	
VO_HERO_10c_Male_NightElf_Wow_01	Che potenza travolgente!	
VO_HERO_10d_Male_NightElf_Attack_01	Inizio a spazientirmi!	
VO_HERO_10d_Male_NightElf_Greetings_01	Chi osa rivolgersi a me?	
VO_HERO_10d_Male_NightElf_MIRROR_GREETINGS_01	Be'... te stesso, in realtà.	
VO_HERO_10d_Male_NightElf_MIRROR_START_01	Brucia per sempre nella mia anima.	
VO_HERO_10d_Male_NightElf_Oops_01	Mossa sbagliata?	
VO_HERO_10d_Male_NightElf_Picked_01	Vediamo come finirà.	
VO_HERO_10d_Male_NightElf_Start_01	Assapora un odio vecchio di diecimila anni!	
VO_HERO_10d_Male_NightElf_Thanks_01	Ti ripagherò, un giorno.	
VO_HERO_10d_Male_NightElf_Threaten_01	Ora e sempre, sono migliore di te.	
VO_HERO_10d_Male_NightElf_Well_Played_01	Il tuo valore è innegabile.	
VO_HERO_10d_Male_NightElf_Wow_01	Che magnificenza!	
VO_HERO_10e_Male_NightElf_Attack_01	<Attacco>	
VO_HERO_10e_Male_NightElf_Attack_02	<Attacco>	
VO_HERO_10e_Male_NightElf_Greetings_01	Salute.	
VO_HERO_10e_Male_NightElf_MIRROR_GREETINGS_01	Saltiamo i convenevoli.	
VO_HERO_10e_Male_NightElf_MIRROR_START_01	...e finisce con Anetheron.	
VO_HERO_10e_Male_NightElf_Oops_01	Ops.	
VO_HERO_10e_Male_NightElf_Picked_01	Ho un unico scopo.	
VO_HERO_10e_Male_NightElf_Start_01	Il mio viaggio inizia...	
VO_HERO_10e_Male_NightElf_Thanks_01	Grazie.	
VO_HERO_10e_Male_NightElf_Threaten_01	Trema dinanzi a me.	
VO_HERO_10e_Male_NightElf_Well_Played_01	Bella giocata.	
VO_HERO_10e_Male_NightElf_Wow_01	Ohhh.	
VO_HERO_10f_Male_NightElf_Attack_01	Colpi su colpi!	
VO_HERO_10f_Male_NightElf_Greetings_01	Ti vedo.	
VO_HERO_10f_Male_NightElf_MIRROR_GREETINGS_01	Per modo di dire.	
VO_HERO_10f_Male_NightElf_MIRROR_START_01	Non me lo sognerei neanche.	
VO_HERO_10f_Male_NightElf_Oops_01	Umpf. Un piccolo contrattempo.	
VO_HERO_10f_Male_NightElf_Picked_01	Il mio dolore mi spinge a continuare.	
VO_HERO_10f_Male_NightElf_Start_01	Non intralciarmi la strada.	
VO_HERO_10f_Male_NightElf_Thanks_01	Ti sono grato.	
VO_HERO_10f_Male_NightElf_Threaten_01	Fatti da parte e non muoverti.	
VO_HERO_10f_Male_NightElf_Well_Played_01	Il nostro scontro vivrà nei secoli.	
VO_HERO_10f_Male_NightElf_Wow_01	Da non credere!	
VO_HERO_10g_Male_NightElf_Attack_01	Finalmente!	
VO_HERO_10g_Male_NightElf_Attack_02	Finalmente!	
VO_HERO_10g_Male_NightElf_Greetings_01	Ci vediamo, infine.	
VO_HERO_10g_Male_NightElf_MIRROR_GREETINGS_01	Eh.	
VO_HERO_10g_Male_NightElf_MIRROR_START_01	È solo la prima.	
VO_HERO_10g_Male_NightElf_Oops_01	Tsk... Vile follia.	
VO_HERO_10g_Male_NightElf_Picked_01	Oggi è un bel giorno per vendicarsi.	
VO_HERO_10g_Male_NightElf_Start_01	È questa la mia forma finale?	
VO_HERO_10g_Male_NightElf_Thanks_01	Mostro la mia gratitudine con le azioni, non a parole.	
VO_HERO_10g_Male_NightElf_Threaten_01	Ti troverò.	
VO_HERO_10g_Male_NightElf_Well_Played_01	Che questa sia l'ultima volta.	
VO_HERO_10g_Male_NightElf_Wow_01	Fenomenale.	
VO_HERO_10i_Male_NightElf_Attack_01	Ti ho in pugno!	
VO_HERO_10i_Male_NightElf_Attack_02	<Attacco>	
VO_HERO_10i_Male_NightElf_BRB_01	Sono AFK. Andato a finire Kil'jaeden.	
VO_HERO_10i_Male_NightElf_CELEBRATE_01	Festeggiamo!	
VO_HERO_10i_Male_NightElf_CHEER_01	Sì!	
VO_HERO_10i_Male_NightElf_Concede_01	No, aspetta! ARGH!	
VO_HERO_10i_Male_NightElf_CONGRATULATIONS_01	Congratulazioni.	
VO_HERO_10i_Male_NightElf_CRY_01	<Pianto>	
VO_HERO_10i_Male_NightElf_DAY_OF_THE_DEAD_01	In questo giorno, ricorderò coloro che abbiamo perso.	
VO_HERO_10i_Male_NightElf_Death_01	<Morte>	
VO_HERO_10i_Male_NightElf_END_OF_SEASON_01	La miccia di questa stagione è quasi esaurita.	
VO_HERO_10i_Male_NightElf_ERROR_FULL_MINIONS_01	Il mio lato del campo è pieno.	
VO_HERO_10i_Male_NightElf_ERROR_GENERIC_01	No.	
VO_HERO_10i_Male_NightElf_ERROR_GENERIC_02	Niente da fare.	
VO_HERO_10i_Male_NightElf_ERROR_HAND_FULL_01	La mia mano è piena!	
VO_HERO_10i_Male_NightElf_ERROR_I_ATTACKED_01	Non ancora.	
VO_HERO_10i_Male_NightElf_ERROR_MINION_ATTACKED_01	Quel servitore ha già attaccato.	
VO_HERO_10i_Male_NightElf_ERROR_NEED_MANA_01	Non ho abbastanza Mana.	
VO_HERO_10i_Male_NightElf_ERROR_NEED_WEAPON_01	Mi serve un'Arma!	
VO_HERO_10i_Male_NightElf_ERROR_PLAY_01	Impossibile.	
VO_HERO_10i_Male_NightElf_ERROR_STEALTH_01	Quel servitore è furtivo.	
VO_HERO_10i_Male_NightElf_ERROR_SUMMON_SICKNESS_01	Quel servitore ha bisogno di un turno per prepararsi.	
VO_HERO_10i_Male_NightElf_ERROR_TARGET_01	Non posso sceglierlo come bersaglio.	
VO_HERO_10i_Male_NightElf_ERROR_TAUNT_01	Non vedi che quel servitore ha Provocazione?	
VO_HERO_10i_Male_NightElf_FACTION_CRY_01	Per l'Alleanza!	
VO_HERO_10i_Male_NightElf_FACTION_CRY_02	Per gli Illidari!	
VO_HERO_10i_Male_NightElf_FIDGET_01	Non dubiterò della mia missione.	
VO_HERO_10i_Male_NightElf_FIRE_FESTIVAL_01	Godiamoci questa giornata, anche se non mi piace il fuoco.	
VO_HERO_10i_Male_NightElf_GG_01	Bella partita.	
VO_HERO_10i_Male_NightElf_Greetings_01	Sei con me o contro di me?	
VO_HERO_10i_Male_NightElf_HAPPY_BIRTHDAY_01	Il tuo compleanno mi ricorda che siamo un anno più vicini alla morte.	
VO_HERO_10i_Male_NightElf_HAPPY_BREWFEST_01	Buona Festa della Birra!	
VO_HERO_10i_Male_NightElf_HAPPY_EVENT_01	Oggi è un bel giorno.	
VO_HERO_10i_Male_NightElf_HAPPY_HALLOWEEN_01	È la Veglia delle Ombre. Attenzione ai demoni in agguato.	
VO_HERO_10i_Male_NightElf_HAPPY_HOLIDAYS_01	Buona Vigilia di Grande Inverno! Dov'è la mia nuova lama da guerra?	
VO_HERO_10i_Male_NightElf_HAPPY_NEW_YEAR_01	Buon anno nuovo!	
VO_HERO_10i_Male_NightElf_HAPPY_NEW_YEAR_LUNAR_01	Buon anno nuovo!	
VO_HERO_10i_Male_NightElf_HAPPY_NOBLEGARDEN_01	Nobiluova? Do la caccia ai demoni, non alle uova.	
VO_HERO_10i_Male_NightElf_HUNGRY_01	Ho sete di vendetta... e anche fame.	
VO_HERO_10i_Male_NightElf_INDEED_01	Già.	
VO_HERO_10i_Male_NightElf_KIDS_WEEK_01	Bisogna proteggere e prendersi cura dei bambini.	
VO_HERO_10i_Male_NightElf_KISS_01	<Bacio>	
VO_HERO_10i_Male_NightElf_LAUGH_01	<Risata>	
VO_HERO_10i_Male_NightElf_LowCards_01	Sto finendo le carte.	
VO_HERO_10i_Male_NightElf_MIRROR_GREETINGS_01	I nemici di Anetheron sono miei amici.	
VO_HERO_10i_Male_NightElf_MIRROR_START_01	Alla salute, allora!	
VO_HERO_10i_Male_NightElf_NICE_CARD_BACK_01	Bel dorso delle carte. Il mio è tutto bruciacchiato dal vilfuoco.	
VO_HERO_10i_Male_NightElf_NoCards_01	Ho finito le carte!	
VO_HERO_10i_Male_NightElf_Oops_01	No, no, no!	
VO_HERO_10i_Male_NightElf_PARTY_01	È tempo di fare baldoria!	
VO_HERO_10i_Male_NightElf_Picked_01	Unisciti alla mia ricerca di vendetta.	
VO_HERO_10i_Male_NightElf_PIRATE_DAY_01	Oggi buttiamo a mare i demoni.	
VO_HERO_10i_Male_NightElf_SALUTE_01	I miei rispetti.	
VO_HERO_10i_Male_NightElf_Sorry_01	Provo pietà per te.	
VO_HERO_10i_Male_NightElf_Start_01	Devo placare la mia sete di vendetta.	
VO_HERO_10i_Male_NightElf_Start_Illidan_01	Non avrò pace finché Anetheron vivrà.	
VO_HERO_10i_Male_NightElf_Start_MECHAJARAXXUS_01	Goditi i tuoi ultimi e insignificanti momenti, demone.	
VO_HERO_10i_Male_NightElf_START_OF_SEASON_01	Inizia una nuova stagione, e la caccia continua.	
VO_HERO_10i_Male_NightElf_Start_Tamsin_01	Dovrai prima vedertela con me.	
VO_HERO_10i_Male_NightElf_Thanks_01	Ti sono grato.	
VO_HERO_10i_Male_NightElf_Thinking_01	Mmm...	
VO_HERO_10i_Male_NightElf_Thinking_02	La risposta è qui.	
VO_HERO_10i_Male_NightElf_Thinking_03	La mia caccia continua.	
VO_HERO_10i_Male_NightElf_Thinking_04	Che cosa farebbe Illidan?	
VO_HERO_10i_Male_NightElf_Threaten_01	Per fortuna non ci vedo, almeno non devo guardarti in faccia.	
VO_HERO_10i_Male_NightElf_Threaten_02	Ti inserisco sulla mia lista.	
VO_HERO_10i_Male_NightElf_Time_01	Le ombre si allungano...	
VO_HERO_10i_Male_NightElf_TRIGGER_AFIGHTOFFURY_01	Stai al mio fianco. Salva Roccavento.	
VO_HERO_10i_Male_NightElf_TRIGGER_AFIGHTOFFURY_ALT_01	Questo è il giorno della tua morte, Anetheron.	
VO_HERO_10i_Male_NightElf_TRIGGER_CHAOSNOVA_01	Caos totale!	
VO_HERO_10i_Male_NightElf_TRIGGER_COORDINATEDSTRIKE_01	Unisciti a me e combatti!	
VO_HERO_10i_Male_NightElf_TRIGGER_FEASTOFSOULS_01	La guerra ha molto da insegnarci.	
VO_HERO_10i_Male_NightElf_TRIGGER_FURY_01	<Urlo di rabbia>	
VO_HERO_10i_Male_NightElf_TRIGGER_INNERDEMON_01	A qualsiasi costo!	
VO_HERO_10i_Male_NightElf_TRIGGER_METAMORPHOSIS_01	Non mi è rimasto altro che questo potere!	
VO_HERO_10i_Male_NightElf_TRIGGER_SKULLOFGULDAN_01	Stregoni... tutti uguali.	
VO_HERO_10i_Male_NightElf_TRIGGER_SPECTRALSIGHT_01	Non smetterò mai di cercare.	
VO_HERO_10i_Male_NightElf_VALENTINES_01	Che le stelle ti guidino, amore mio. Veglia sui nostri figli.	
VO_HERO_10i_Male_NightElf_WELCOME_01	Ti do il benvenuto!	
VO_HERO_10i_Male_NightElf_Well_Played_01	Sei davvero eccezionale.	
VO_HERO_10i_Male_NightElf_WOW_01	Non credo ai miei occhi.	
VO_HERO_11_HAPPY_NEW_YEAR_20	Buon anno!	
VO_HERO_12_HAPPY_NEW_YEAR_20	Buon anno!	
VO_HERO_13_HAPPY_NEW_YEAR_20	Buon anno.	
VO_HERO_14_HAPPY_NEW_YEAR_20	Buon anno.	
VO_HERO_15_HAPPY_NEW_YEAR_24	<Buon anno!>	
VO_HERO_16_Female_Dryad_Concede_01	Non posso vincerle tutte.	
VO_HERO_16_Female_Dryad_ERROR_01	Non ho nessun'arma.	
VO_HERO_16_Female_Dryad_ERROR_02	Mi serve più mana!	
VO_HERO_16_Female_Dryad_ERROR_03	Questo servitore non può attaccare di nuovo.	
VO_HERO_16_Female_Dryad_ERROR_04	Ho già attaccato.	
VO_HERO_16_Female_Dryad_ERROR_05	Questo servitore non può ancora attaccare.	
VO_HERO_16_Female_Dryad_ERROR_06	La mia mano è piena!	
VO_HERO_16_Female_Dryad_ERROR_07	Ho troppi servitori!	
VO_HERO_16_Female_Dryad_ERROR_08	Quel servitore codardo si nasconde!	
VO_HERO_16_Female_Dryad_ERROR_09	Non posso farlo.	
VO_HERO_16_Female_Dryad_ERROR_10	Non è possibile.	
VO_HERO_16_Female_Dryad_ERROR_11	Devo attaccare i servitori con Provocazione.	
VO_HERO_16_Female_Dryad_ERROR_12	Non succederà.	
VO_HERO_16_Female_Dryad_FIRE_FESTIVAL_01	Adoro i fuochi di Mezza Estate!	
VO_HERO_16_Female_Dryad_Greetings_01	Che la natura ti benedica.	
VO_HERO_16_Female_Dryad_GREETINGS_RESPONSE	Anche a te.	
VO_HERO_16_Female_Dryad_HAPPY_HALLOWEEN_01	FELICE VEGLIA DELLE OMBRE!	
VO_HERO_16_Female_Dryad_HAPPY_HOLIDAYS_01	Buona Vigilia di Grande Inverno!	
VO_HERO_16_Female_Dryad_HAPPY_NEW_YEAR_01	Festeggiamo assieme l'anno nuovo!	
VO_HERO_16_Female_Dryad_HAPPY_NEW_YEAR_LUNAR_01	Festeggiamo assieme l'anno nuovo!	
VO_HERO_16_Female_Dryad_HAPPY_NOBLEGARDEN_01	Buona Festa di Nobiluova!	
VO_HERO_16_Female_Dryad_LowCards_01	Ho quasi finito le carte!	
VO_HERO_16_Female_Dryad_MALFURION_START_01	Ishnu'alah, Arcidruido.	
VO_HERO_16_Female_Dryad_MIRROR_GREETINGS_01	Anche a te.	
VO_HERO_16_Female_Dryad_MIRROR_START_01	Per le terre selvagge!	
VO_HERO_16_Female_Dryad_NoCards_01	Ho finito le carte!	
VO_HERO_16_Female_Dryad_Oops_02	Che erroraccio.	
VO_HERO_16_Female_Dryad_PIRATE_DAY_01	Yarrr, sono un pirata!	
VO_HERO_16_Female_Dryad_Sorry_01	Devo chiederti scusa.	
VO_HERO_16_Female_Dryad_Start_01	La foresta non perdona.	
VO_HERO_16_Female_Dryad_Thanks_01	I miei ringraziamenti.	
VO_HERO_16_Female_Dryad_Thinking_01	Vediamo...	
VO_HERO_16_Female_Dryad_Thinking_02	Come potrei...	
VO_HERO_16_Female_Dryad_Thinking_03	E se facessi...	
VO_HERO_16_Female_Dryad_Threaten_01	Soffri come ha sofferto la terra!	
VO_HERO_16_Female_Dryad_Time_01	Il tempo vola.	
VO_HERO_16_Female_Dryad_Well_Played_01	Bella giocata.	
VO_HERO_16_Female_Dryad_WOW_01	Davvero selvaggio!	
VO_HERO_17_Female_Treant_CONCEDE	Un albero cade perché possa crescere un seme.	
VO_HERO_17_Female_Treant_ERROR_FULL_MINIONS	Il campo è un po' troppo pieno.	
VO_HERO_17_Female_Treant_ERROR_GENERIC	Mi spiace, tesoro, non posso.	
VO_HERO_17_Female_Treant_ERROR_HAND_FULL	Non riesco a tenerne così tante.	
VO_HERO_17_Female_Treant_ERROR_I_ATTACKED	Non ho più l'età.	
VO_HERO_17_Female_Treant_ERROR_JUST_PLAYED	Ha bisogno di riposo.	
VO_HERO_17_Female_Treant_ERROR_MINION_ATTACKED	Lascia che si riposi.	
VO_HERO_17_Female_Treant_ERROR_NEED_MANA	A quanto pare ho finito il Mana.	
VO_HERO_17_Female_Treant_ERROR_NEED_WEAPON	Non sono armata.	
VO_HERO_17_Female_Treant_ERROR_PLAY	No, no, no, no, non possiamo farlo.	
VO_HERO_17_Female_Treant_ERROR_STEALTH	Non riesco a vedere bene...	
VO_HERO_17_Female_Treant_ERROR_TARGET	E come faccio?	
VO_HERO_17_Female_Treant_ERROR_TAUNT	Ah, quel monello ha Provocazione.	
VO_HERO_17_Female_Treant_FIRE_FESTIVAL	Fa' attenzione con i fuochi di Mezza Estate.	
VO_HERO_17_Female_Treant_GREETINGS	Salve, tesoro.	
VO_HERO_17_Female_Treant_GREETINGS_RESPONSE	Erano secoli che non mi chiamavano così.	VO_HERO_17_Female_Treant_MIRROR_GREETINGS_01.wav
VO_HERO_17_Female_Treant_HALLOWS_END	Sto diventando troppo vecchia per la Veglia delle Ombre.	
VO_HERO_17_Female_Treant_HAPPY_NEW_YEAR_20	E così un altro anno è passato...	
VO_HERO_17_Female_Treant_LOW_CARDS	Mmm... dove sono finite le mie carte?	
VO_HERO_17_Female_Treant_LUNAR_NEW_YEAR	E così, un altro anno è passato...	
VO_HERO_17_Female_Treant_MIRROR_START	Fa piacere anche a me rivederti.	
VO_HERO_17_Female_Treant_NO_CARDS	Credo di aver smarrito tutte le mie carte.	
VO_HERO_17_Female_Treant_NOBLEGARDEN	Ti auguro una piacevole festa di Nobiluova.	
VO_HERO_17_Female_Treant_OOPS	Devo essermi appisolata...	
VO_HERO_17_Female_Treant_PICKED	Lascia che ti racconti una storia.	
VO_HERO_17_Female_Treant_PIRATE_DAY	Pirati? Eheheh, sembra divertente.	
VO_HERO_17_Female_Treant_SORRY	Oh, le mie scuse, tesoro.	
VO_HERO_17_Female_Treant_START	Che bello, una visita!	
VO_HERO_17_Female_Treant_START_MALFURION	Malfurion! Quanto sei cresciuto...	
VO_HERO_17_Female_Treant_THANKS	Grazie infinite!	
VO_HERO_17_Female_Treant_THINK1	Mmm...	
VO_HERO_17_Female_Treant_THINK2	Ahhh, sì.	
VO_HERO_17_Female_Treant_THINK3	A cosa stavo pensando?	
VO_HERO_17_Female_Treant_THREATEN	Dovresti portare più rispetto agli anziani.	
VO_HERO_17_Female_Treant_TIMER	Non mettetemi premura.	
VO_HERO_17_Female_Treant_WELL_PLAYED	Davvero notevole.	
VO_HERO_17_Female_Treant_WINTERVEIL_GREETINGS	Felice Vigilia di Grande Inverno.	
VO_HERO_17_Female_Treant_WOW	Magnifico!	
VO_HERO_18_Female_Gnome_Concede_01	Notevole! Questa volta hai vinto tu.	
VO_HERO_18_Female_Gnome_ERROR_01	Non mi servirebbe un'Arma?	
VO_HERO_18_Female_Gnome_ERROR_03	Non ho abbastanza Mana!	
VO_HERO_18_Female_Gnome_ERROR_04	Ha già attaccato!	
VO_HERO_18_Female_Gnome_ERROR_06	Non posso attaccare ancora!	
VO_HERO_18_Female_Gnome_ERROR_07	Shhh, sta ancora riposando!	
VO_HERO_18_Female_Gnome_ERROR_08	Accidenti, troppe carte!	
VO_HERO_18_Female_Gnome_ERROR_10	Massimo sette servitori, bellezza.	
VO_HERO_18_Female_Gnome_ERROR_12	Si nasconde con Furtività!	
VO_HERO_18_Female_Gnome_ERROR_14	Umpf. Non posso farlo.	
VO_HERO_18_Female_Gnome_ERROR_15	Non posso sceglierlo come bersaglio.	
VO_HERO_18_Female_Gnome_ERROR_17	C'è un servitore con Provocazione!	
VO_HERO_18_Female_Gnome_ERROR_19	Non si può proprio!	
VO_HERO_18_Female_Gnome_FIRE_FESTIVAL_01	I Fuochi di Mezza Estate sono il massimo!	
VO_HERO_18_Female_Gnome_Greetings_01	Ehilà, ciao!	
VO_HERO_18_Female_Gnome_GREETINGS_RESPONSE	Eheheh... Ciao!	
VO_HERO_18_Female_Gnome_HAPPY_HALLOWEEN_01	La Veglia delle Ombre! Uhhh, che paura!	
VO_HERO_18_Female_Gnome_HAPPY_HOLIDAYS_01	Buona Vigilia di Grande Inverno!	
VO_HERO_18_Female_Gnome_HAPPY_NEW_YEAR_01	Buon anno nuovo!	
VO_HERO_18_Female_Gnome_HAPPY_NEW_YEAR_LUNAR_16	Buon anno nuovo!	
VO_HERO_18_Female_Gnome_LowCards_01	Sto finendo le carte!	
VO_HERO_18_Female_Gnome_MIRROR_START_01	Sì! Sarà MAGNIFICO!	
VO_HERO_18_Female_Gnome_NOBLEGARDEN	Adoro la festa di Nobiluova!	
VO_HERO_18_Female_Gnome_NoCards_01	Non ho più carte!	
VO_HERO_18_Female_Gnome_Oops_02	Ooops!	
VO_HERO_18_Female_Gnome_PIRATE_DAY_01	Yarrr, sono un pirata! YARRR!	
VO_HERO_18_Female_Gnome_Sorry_01	Ohhh, mi dispiace...	
VO_HERO_18_Female_Gnome_Start_01	Divertiamoci un po'! Eheh!	
VO_HERO_18_Female_Gnome_Thanks_02	Ohhh, grazie mille!	
VO_HERO_18_Female_Gnome_Thinking_01	Mmm...	
VO_HERO_18_Female_Gnome_Thinking_03	Mmm, vediamo un po'...	
VO_HERO_18_Female_Gnome_Thinking_04	Chissà se...	
VO_HERO_18_Female_Gnome_Threaten_01	Eheh, farò di te una bella marionetta!	
VO_HERO_18_Female_Gnome_Time_01	Mi devo muovere!	
VO_HERO_18_Female_Gnome_Well_Played_01	Accidenti, bella giocata!	
VO_HERO_18_Female_Gnome_WOW_01	Davvero pazzesco!	
VO_ICC08_LichKing_Male_Human_YoungArthas_02	Odio gli scontri a specchio...	
VO_INNKEEPER_Male_Dwarf_HERONAME_ANNHYLDE_01	Annhylde!	
VO_INNKEEPER_Male_Dwarf_HERONAME_DEATHWING_01	Alamorte!	
VO_INNKEEPER_Male_Dwarf_HERONAME_ELISE_02	Elise!	
VO_Innkeeper_Male_Dwarf_HERONAME_ILLIDAN_01	Illidan!	
VO_Innkeeper_Male_Dwarf_HERONAME_KELTHUZAD_01	Kel'Thuzad!	
VO_INNKEEPER_Male_Dwarf_HERONAME_LAZUL_01	Lazul!	
VO_INNKEEPER_Male_Dwarf_HERONAME_LAZUL_02	Lazul!	
VO_INNKEEPER_Male_Dwarf_HERONAME_MECHAJAR_03	Robo-Jaraxxus!	
VO_INNKEEPER_Male_Dwarf_HERONAME_NZOTH_02	N'zoth!	
VO_INNKEEPER_Male_Dwarf_HERONAME_NZOTH_03	N'zoth!	
VO_INNKEEPER_Male_Dwarf_HERONAME_RASTAKHAN_01	Rastakhan!	
VO_INNKEEPER_Male_Dwarf_HERONAME_RASTAKHAN_02	Rastakhan!	
VO_INNKEEPER_Male_Dwarf_Heroname_ThunderKing_01	Il Re del Tuono!	
VO_INNKEEPER_Male_Naga_HERONAME_VASHJ_01	Dama Vashj!	
VO_MechaJar_Male_Demon_Concede_01	Hai vinto... MA IL TUO MONDO È ANCORA CONDANNATO!	
VO_MechaJar_Male_Demon_ERROR_FULL_MINIONS_01	IL MIO LATO DEL CAMPO È PIENO.	
VO_MechaJar_Male_Demon_ERROR_GENERIC_01	NON POSSO FARLO.	
VO_MechaJar_Male_Demon_ERROR_HAND_FULL_01	LA MIA MANO È PIENA.	
VO_MechaJar_Male_Demon_ERROR_I_ATTACKED_01	HO GIÀ ATTACCATO.	
VO_MechaJar_Male_Demon_ERROR_MINION_ATTACKED_01	QUEL SERVITORE HA GIÀ ATTACCATO.	
VO_MechaJar_Male_Demon_ERROR_NEED_MANA_01	MI SERVE MANA.	
VO_MechaJar_Male_Demon_ERROR_NEED_WEAPON_01	NON HO NESSUN'ARMA.	
VO_MechaJar_Male_Demon_ERROR_PLAY_01	NON POSSO GIOCARE QUESTA CARTA.	
VO_MechaJar_Male_Demon_ERROR_STEALTH_01	QUEL PATETICO SERVITORE SI NASCONDE!	
VO_MechaJar_Male_Demon_ERROR_SUMMON_SICKNESS_01	HA BISOGNO DI UN TURNO PER PREPARARSI.	
VO_MechaJar_Male_Demon_ERROR_TARGET_01	NON POSSO SCEGLIERLO COME BERSAGLIO.	
VO_MechaJar_Male_Demon_ERROR_TAUNT_01	UN SERVITORE CON PROVOCAZIONE BLOCCA LA VIA.	
VO_MechaJar_Male_Demon_FIRE_FESTIVAL_01	Buon Festival del Fuoco. TUTTI PERIRANNO TRA LE FIAMME.	
VO_MechaJar_Male_Demon_Greetings_02	Ti do il benvenuto... NELL'OBLIO!	
VO_MechaJar_Male_Demon_HAPPY_HALLOWEEN_01	È la Veglia delle Ombre. E TU STAI PER MORIRE.	
VO_MechaJar_Male_Demon_HAPPY_HOLIDAYS_01	Goditi la Vigilia di Grande Inverno. FINCHÉ PUOI.	
VO_MechaJar_Male_Demon_HAPPY_NEW_YEAR_01	Buon anno nuovo. PER TE SARÀ L'ULTIMO.	
VO_MechaJar_Male_Demon_HAPPY_NEW_YEAR_LUNAR_01	BUON ANNO NUOVO!	
VO_MechaJar_Male_Demon_HAPPY_NOBLEGARDEN_01	CHE LA FESTA DI NOBILUOVA ABBIA INIZIO.	
VO_MechaJar_Male_Demon_LowCards_01	IL MIO MAZZO SI AVVICINA ALLA FINE.	
VO_MechaJar_Male_Demon_MIRROR_GREETINGS_03	Tu hai abbracciato l'oblio. IO VI SONO NATO!	
VO_MechaJar_Male_Demon_MIRROR_START_01	ANCHE TU, IDIOTA!	
VO_MechaJar_Male_Demon_NoCards_01	LE MIE CARTE SONO TERMINATE.	
VO_MechaJar_Male_Demon_Oops_02	ERRORE! ERRORE!	
VO_MechaJar_Male_Demon_Picked_01	JARAXXUS ATTIVATO.	
VO_MechaJar_Male_Demon_PIRATE_DAY_01	MODALITÀ CACCIA AL TESORO ATTIVATA.	
VO_MechaJar_Male_Demon_Sorry_01	Mi... DISPIACE!	
VO_MechaJar_Male_Demon_Start_02	Affronti ROBO-JARAXXUS!	
VO_MechaJar_Male_Demon_Thanks_01	GRAZIE.	
VO_MechaJar_Male_Demon_Thinking_01	MMM...	
VO_MechaJar_Male_Demon_Thinking_02	DEVO... DISTRUGGERE...	
VO_MechaJar_Male_Demon_Thinking_05	ANALISI IN CORSO...	
VO_MechaJar_Male_Demon_Threaten_04	LA TUA ARROGANZA SARÀ LA TUA ROVINA!	
VO_MechaJar_Male_Demon_Time_01	IL TEMPO STA PER SCADERE.	
VO_MechaJar_Male_Demon_TRIGGER_DOOM_01	APOCALISSE!	
VO_MechaJar_Male_Demon_TRIGGER_RENOUCEDARKNESS_01	OSCURITÀ ABIURATA!	
VO_MechaJar_Male_Demon_Well_Played_01	BELLA GIOCATA!	
VO_MechaJar_Male_Demon_WOW_01	NOTEVOLE.	
VO_Story_Hero_Rexxar_Male_Orc-Ogre_Story_Rexxar_Attack_01	Non voglio farlo... ma lo farò.	
VO_Story_Hero_Rexxar_Male_Orc-Ogre_Story_Rexxar_Greetings_01	Salve.	
VO_TBA01_4__Concede	ROAR!	
VO_TBA01_4__Error_Full_Minions	ROAR!	
VO_TBA01_4__Error_Generic	ROAR!	
VO_TBA01_4__Error_Hand_Full	ROAR!	
VO_TBA01_4__Error_I_Attacked	ROAR!	
VO_TBA01_4__Error_Just_Played	ROAR!	
VO_TBA01_4__Error_Minion_Attacked	ROAR!	
VO_TBA01_4__Error_Need_Mana	ROAR!	
VO_TBA01_4__Error_Need_Weapon	ROAR!	
VO_TBA01_4__Error_Play	ROAR!	
VO_TBA01_4__Error_Stealth	ROAR!	
VO_TBA01_4__Good_Game	ROAR!	
VO_TBA01_4__Greetings	Che i giochi abbiano inizio!	
VO_TBA01_4__Low_Cards	ROAR!	
VO_TBA01_4__No_Cards	ROAR!	
VO_TBA01_4__Oops	Ops.	
VO_TBA01_4__Sorry	Mi dispiace.	
VO_TBA01_4__Start	Qui sono io il padrone!	
VO_TBA01_4__Thanks	Grazie.	
VO_TBA01_4__Threaten	Ahahah! Contempla il vero potere di NEFARIAN!	
VO_TBA01_4__Timer	ROAR!	
VO_TBA01_4__Well_Played	Bella giocata.	
VO_TRLA_204h_Male_Troll_Concede_03	Hai vinto... ma io nun dimentico... e nun perdono!	
VO_TRLA_204h_Male_Troll_Greetings_01	Ah, guarda nu poco chi ci sta!	
VO_TRLA_204h_Male_Troll_LowCards_01	Tengo bisogno di più carte...	
VO_TRLA_204h_Male_Troll_Mirror_Greetings_01	Sei tu. Fatti controllare la vista.	
VO_TRLA_204h_Male_Troll_NoCards_01	Ho finito le carte!	
VO_TRLA_204h_Male_Troll_Oops_01	Oh, questo è stato n'errore.	
VO_TRLA_204h_Male_Troll_Thanks_01	Sei troppo gentile.	
VO_TRLA_204h_Male_Troll_Thinking_03	Mmm... 	
VO_TRLA_204h_Male_Troll_Thinking_09	Cosa devo fare con te? Eheheh.	
VO_TRLA_204h_Male_Troll_Thinking_10	Questo farà male assai... 	
VO_TRLA_204h_Male_Troll_Threaten_01	Lascia che ti presenti l'ascia!	
VO_TRLA_204h_Male_Troll_Time_01	Devo darmi na mossa!	
VO_TRLA_204h_Male_Troll_Well_Played_02	Bella giocata.	
VO_TRLA_204h_Male_Troll_WOW_01	Per il Loa della gente mia!	
VO_ULDA_Brann_Male_Dwarf_Attack_02	Sei storia vecchia!	
VO_ULDA_Brann_Male_Dwarf_Concede_01	Gli altri mi vendicheranno!	
VO_ULDA_Brann_Male_Dwarf_Death_02	Ce l'avevo... quasi fatta...	
VO_ULDA_Brann_Male_Dwarf_ERROR_FULL_MINIONS_02	Ho troppi servitori.	
VO_ULDA_Brann_Male_Dwarf_ERROR_GENERIC_03	Non posso farlo.	
VO_ULDA_Brann_Male_Dwarf_ERROR_HAND_FULL_01	La mia mano è piena!	
VO_ULDA_Brann_Male_Dwarf_ERROR_I_ATTACKED_01	Ho già attaccato.	
VO_ULDA_Brann_Male_Dwarf_ERROR_MINION_ATTACKED_01	Quel servitore ha già attaccato.	
VO_ULDA_Brann_Male_Dwarf_ERROR_NEED_MANA_02	Mi serve più Mana per farlo. 	
VO_ULDA_Brann_Male_Dwarf_ERROR_NEED_WEAPON_01	Ho bisogno di un'Arma.	
VO_ULDA_Brann_Male_Dwarf_ERROR_PLAY_01	Non posso giocare questa carta.	
VO_ULDA_Brann_Male_Dwarf_ERROR_STEALTH_01	Quel servitore è furtivo.	
VO_ULDA_Brann_Male_Dwarf_ERROR_SUMMON_SICKNESS_01	Quel servitore ha bisogno di tempo per prepararsi.	
VO_ULDA_Brann_Male_Dwarf_ERROR_TARGET_02	Dammi un bersaglio valido!	
VO_ULDA_Brann_Male_Dwarf_ERROR_TAUNT_01	Devo attaccare i servitori con Provocazione.	
VO_ULDA_Brann_Male_Dwarf_Greetings_01	Ehi, salve!	
VO_ULDA_Brann_Male_Dwarf_HAPPY_BIRTHDAY_01	Buon compleanno!	
VO_ULDA_Brann_Male_Dwarf_HAPPY_BREWFEST_01	Ah, la Festa della Birra! Boccali per tutti!	
VO_ULDA_Brann_Male_Dwarf_HAPPY_HALLOWEEN_01	Fa' attenzione, c'è la Veglia delle Ombre!	
VO_ULDA_Brann_Male_Dwarf_HAPPY_HOLIDAYS_01	Buone feste!	
VO_ULDA_Brann_Male_Dwarf_HAPPY_NEW_YEAR_01	Buon anno!	
VO_ULDA_Brann_Male_Dwarf_HAPPY_NEW_YEAR_LUNAR_01	Buon anno!	
VO_ULDA_Brann_Male_Dwarf_HAPPY_NOBLEGARDEN_01	Queste uova di Nobiluova non hanno segreti per me.	
VO_ULDA_Brann_Male_Dwarf_LowCards_01	Devo trovare altre carte.	
VO_ULDA_Brann_Male_Dwarf_MIRROR_GREETINGS_01	Salve anche a te!	
VO_ULDA_Brann_Male_Dwarf_MIRROR_START_01	Qualcuno ha duplicato il mio Grido di Battaglia!	
VO_ULDA_Brann_Male_Dwarf_NoCards_01	Ho finito le carte!	
VO_ULDA_Brann_Male_Dwarf_Oops_02	Nessuno deve sapere di questo errore.	
VO_ULDA_Brann_Male_Dwarf_Picked_01	Le risposte sono qui, me lo sento!	
VO_ULDA_Brann_Male_Dwarf_PIRATE_DAY_01	Arrr, corpo di mille dinosauri! Ehm... non mi è venuta molto bene.	
VO_ULDA_Brann_Male_Dwarf_Sorry_01	Oh... Mi dispiace.	
VO_ULDA_Brann_Male_Dwarf_Start_01	Sei con le spalle al muro.	
VO_ULDA_Brann_Male_Dwarf_Thanks_02	Ti ringrazio.	
VO_ULDA_Brann_Male_Dwarf_Thinking_01	Mmm...	
VO_ULDA_Brann_Male_Dwarf_Thinking_02	Forse è una trappola...	
VO_ULDA_Brann_Male_Dwarf_Thinking_03	Pensa, Brann, pensa...	
VO_ULDA_Brann_Male_Dwarf_Thinking_04	Se me la gioco bene...	
VO_ULDA_Brann_Male_Dwarf_Thinking_05	Sapete chi siam... la Lega degli Esploratori!	
VO_ULDA_Brann_Male_Dwarf_Thinking_06	Eccoci qui... Unitevi a noi...	
VO_ULDA_Brann_Male_Dwarf_Threaten_02	Non riuscirai a fermarmi!	
VO_ULDA_Brann_Male_Dwarf_Time_01	Il tempo stringe.	
VO_ULDA_Brann_Male_Dwarf_Well_Played_01	Oh, COSÌ si fa!	
VO_ULDA_Brann_Male_Dwarf_WOW_01	Per la barba di diamante di Magni!	
VO_ULDA_Elise_Female_NightElf_Concede_02	Sarà meglio... ritirarsi!	
VO_ULDA_Elise_Female_NightElf_Death_02	Non così...	
VO_ULDA_Elise_Female_NightElf_ERROR_FULL_MINIONS_01	Non posso controllare altri servitori.	
VO_ULDA_Elise_Female_NightElf_ERROR_GENERIC_01	Assolutamente impossibile.	
VO_ULDA_Elise_Female_NightElf_ERROR_HAND_FULL_01	Non ho spazio per altre carte!	
VO_ULDA_Elise_Female_NightElf_ERROR_I_ATTACKED_01	Ho già attaccato.	
VO_ULDA_Elise_Female_NightElf_ERROR_MINION_ATTACKED_01	Quel servitore è stanco. 	
VO_ULDA_Elise_Female_NightElf_ERROR_NEED_MANA_01	Non ho abbastanza Mana.	
VO_ULDA_Elise_Female_NightElf_ERROR_NEED_WEAPON_01	Prima mi servirebbe un'Arma.	
VO_ULDA_Elise_Female_NightElf_ERROR_PLAY_01	Non penso proprio.	
VO_ULDA_Elise_Female_NightElf_ERROR_STEALTH_01	Quel servitore è furtivo.	
VO_ULDA_Elise_Female_NightElf_ERROR_SUMMON_SICKNESS_01	Ha bisogno di un sonnellino.	
VO_ULDA_Elise_Female_NightElf_ERROR_TARGET_01	Quello è fuori dalla mia portata.	
VO_ULDA_Elise_Female_NightElf_ERROR_TAUNT_01	Un servitore con Provocazione mi ostacola.	
VO_ULDA_Elise_Female_NightElf_Greetings_01	Sono Elise Cercastelle e tu non la passerai liscia!	
VO_ULDA_Elise_Female_NightElf_HAPPY_BIRTHDAY_01	Ti auguro un compleanno pieno di tesori.	
VO_ULDA_Elise_Female_NightElf_HAPPY_HALLOWEEN_01	Le origini della Veglia delle Ombre sono terrificanti!	
VO_ULDA_Elise_Female_NightElf_HAPPY_HOLIDAYS_01	Chissà se Babbo Inverno ti porterà dei doni...	
VO_ULDA_Elise_Female_NightElf_HAPPY_NEW_YEAR_01	Buon anno!	
VO_ULDA_Elise_Female_NightElf_HAPPY_NEW_YEAR_LUNAR_01	Buon anno!	
VO_ULDA_Elise_Female_NightElf_HAPPY_NOBLEGARDEN_01	Oh, adoro la Festa di Nobiluova!	
VO_ULDA_Elise_Female_NightElf_LowCards_01	Ho quasi finito le carte.	
VO_ULDA_Elise_Female_NightElf_MIRROR_GREETINGS_01	Non c'è molto che tu possa fare per sorprendermi. 	
VO_ULDA_Elise_Female_NightElf_MIRROR_START_01	A quanto pare sono il mio peggior nemico.	
VO_ULDA_Elise_Female_NightElf_NoCards_01	Le mie carte sono finite!	
VO_ULDA_Elise_Female_NightElf_Oops_01	Un errore.	
VO_ULDA_Elise_Female_NightElf_Picked_01	È ora di scendere in campo.	
VO_ULDA_Elise_Female_NightElf_PIRATE_DAY_01	Capitano Scrutastelle a rapporto, arrr!	
VO_ULDA_Elise_Female_NightElf_Sorry_01	Permettimi di scusarmi.	
VO_ULDA_Elise_Female_NightElf_Start_02	La Lega degli Esploratori non può fallire!	
VO_ULDA_Elise_Female_NightElf_Thanks_02	Te ne sono davvero grata!	
VO_ULDA_Elise_Female_NightElf_Thinking_01	Non posso sbagliare...	
VO_ULDA_Elise_Female_NightElf_Thinking_02	La posta in gioco è troppo alta...	
VO_ULDA_Elise_Female_NightElf_Thinking_03	Mmm...	
VO_ULDA_Elise_Female_NightElf_Thinking_04	Curioso...	
VO_ULDA_Elise_Female_NightElf_Threaten_01	Ti avverto. Mi sono preparata per questo combattimento.	
VO_ULDA_Elise_Female_NightElf_Time_01	Il tempo stringe. 	
VO_ULDA_Elise_Female_NightElf_Well_Played_01	Questa battaglia rimarrà negli annali.	
VO_ULDA_Elise_Female_NightElf_WOW_01	Incredibile.	
VO_ULDA_Finley_Male_Murloc_Concede_01	Ben fatto, la vittoria è tua.	
VO_ULDA_Finley_Male_Murloc_ERROR_FULL_MINIONS_01	Non c'è abbastanza spazio.	
VO_ULDA_Finley_Male_Murloc_ERROR_GENERIC_04	Sarebbe alquanto scortese.	
VO_ULDA_Finley_Male_Murloc_ERROR_HAND_FULL_02	Troppe carte... oh. Oh! Accidenti.	
VO_ULDA_Finley_Male_Murloc_ERROR_I_ATTACKED_02	Un gentilmurloc attacca una sola volta per turno.	
VO_ULDA_Finley_Male_Murloc_ERROR_MINION_ATTACKED_01	Quel servitore ha già attaccato.	
VO_ULDA_Finley_Male_Murloc_ERROR_NEED_MANA_02	Ho bisogno di più Mana per quella. 	
VO_ULDA_Finley_Male_Murloc_ERROR_NEED_WEAPON_02	Mi serve un'Arma per farlo.	
VO_ULDA_Finley_Male_Murloc_ERROR_PLAY_01	Non posso giocare quella carta.	
VO_ULDA_Finley_Male_Murloc_ERROR_STEALTH_01	Quel servitore è furtivo.	
VO_ULDA_Finley_Male_Murloc_ERROR_SUMMON_SICKNESS_01	Concedi a quel servitore un momento per prepararsi.	
VO_ULDA_Finley_Male_Murloc_ERROR_TARGET_02	Avere un bersaglio è categorico.	
VO_ULDA_Finley_Male_Murloc_ERROR_TAUNT_02	Quel servitore con Provocazione è una vera seccatura.	
VO_ULDA_Finley_Male_Murloc_Greetings_01	Oh, salve. Buona giornata.	
VO_ULDA_Finley_Male_Murloc_HAPPY_BIRTHDAY_01	Buon compleanno!	
VO_ULDA_Finley_Male_Murloc_HAPPY_BREWFEST_01	La Festa della Birra? Ora mi spiego la presenza di quelle spugne.	
VO_ULDA_Finley_Male_Murloc_HAPPY_HALLOWEEN_01	La Veglia delle Ombre! Oh, una festa abominevole.	
VO_ULDA_Finley_Male_Murloc_HAPPY_HOLIDAYS_01	Buone feste!	
VO_ULDA_Finley_Male_Murloc_HAPPY_NEW_YEAR_01	Buon anno!	
VO_ULDA_Finley_Male_Murloc_HAPPY_NEW_YEAR_LUNAR_01	Buon anno!	
VO_ULDA_Finley_Male_Murloc_HAPPY_NOBLEGARDEN_01	Fermiamoci a riflettere sulle origini pagane della Festa di Nobiluova.	
VO_ULDA_Finley_Male_Murloc_LowCards_01	Sono tremendamente a corto di carte. 	
VO_ULDA_Finley_Male_Murloc_MIRROR_GREETINGS_01	Ser Pinnus, presumo? 	
VO_ULDA_Finley_Male_Murloc_MIRROR_START_01	Grande Occhiobuio! Il mio contromurloc! 	
VO_ULDA_Finley_Male_Murloc_NoCards_01	Sono rimasto a secco!	
VO_ULDA_Finley_Male_Murloc_Oops_01	Perbacco, che abbaglio.	
VO_ULDA_Finley_Male_Murloc_Picked_02	Un giorno squisito per un'avventura! Piaghe a parte, naturalmente.	
VO_ULDA_Finley_Male_Murloc_PIRATE_DAY_01	Oh, vogliamo fare i pirati, quindi? Arrr!	
VO_ULDA_Finley_Male_Murloc_Sorry_01	Oh, chiedo venia. 	
VO_ULDA_Finley_Male_Murloc_Start_01	Fatti da parte, demonio! Abbiamo un mondo da salvare. 	
VO_ULDA_Finley_Male_Murloc_Thanks_01	Un sentito ringraziamento!	
VO_ULDA_Finley_Male_Murloc_Thinking_01	Mmmmmm...	
VO_ULDA_Finley_Male_Murloc_Thinking_02	Che fare...	
VO_ULDA_Finley_Male_Murloc_Thinking_03	...bel pasticcio...	
VO_ULDA_Finley_Male_Murloc_Thinking_04	Mmmmmm...	
VO_ULDA_Finley_Male_Murloc_Thinking_05	Mmmmmm...	
VO_ULDA_Finley_Male_Murloc_Threaten_03	D'accordo, è ora di passare ai fatti.	
VO_ULDA_Finley_Male_Murloc_Time_01	L'ora del tè è finita. 	
VO_ULDA_Finley_Male_Murloc_Well_Played_01	Un gran bello spettacolo.	
VO_ULDA_Finley_Male_Murloc_WOW_01	Per tutti i Murloc!	
VO_ULDA_Reno_Male_Human_Attack_01	<Attacco>	
VO_ULDA_Reno_Male_Human_Concede_01	Mai mollare. Scappare!	
VO_ULDA_Reno_Male_Human_Death_01	<Morte>	
VO_ULDA_Reno_Male_Human_ERROR_FULL_MINIONS_01	Non c'è abbastanza spazio.	
VO_ULDA_Reno_Male_Human_ERROR_GENERIC_02	Se potessi... lo farei.	
VO_ULDA_Reno_Male_Human_ERROR_HAND_FULL_02	Che ci faccio con tutte queste carte?!?	
VO_ULDA_Reno_Male_Human_ERROR_I_ATTACKED_02	Fammi riprendere fiato!	
VO_ULDA_Reno_Male_Human_ERROR_MINION_ATTACKED_01	Quel servitore ha già attaccato.	
VO_ULDA_Reno_Male_Human_ERROR_NEED_MANA_01	Ho bisogno di Mana!	
VO_ULDA_Reno_Male_Human_ERROR_NEED_WEAPON_01	Ho bisogno di un'Arma.	
VO_ULDA_Reno_Male_Human_ERROR_PLAY_01	Non posso giocare questa carta. 	
VO_ULDA_Reno_Male_Human_ERROR_STEALTH_02	Si sta nascondendo. Dannato codardo.	
VO_ULDA_Reno_Male_Human_ERROR_SUMMON_SICKNESS_01	Ha bisogno di un turno per prepararsi.	
VO_ULDA_Reno_Male_Human_ERROR_TARGET_01	Mi serve un bersaglio!	
VO_ULDA_Reno_Male_Human_ERROR_TAUNT_01	Devo attaccare i servitori con Provocazione.	
VO_ULDA_Reno_Male_Human_Greetings_01	Mi levo il cappello di fronte a te!	
VO_ULDA_Reno_Male_Human_HAPPY_BIRTHDAY_02	Ehi, è il tuo compleanno! Scegli tutti i regali che vuoi!	
VO_ULDA_Reno_Male_Human_HAPPY_BREWFEST_01	La Festa della Birra! Non posso perdermela. 	
VO_ULDA_Reno_Male_Human_HAPPY_HALLOWEEN_01	La Veglia delle Ombre mi mette i brividi.	
VO_ULDA_Reno_Male_Human_HAPPY_HOLIDAYS_01	Buone feste!	
VO_ULDA_Reno_Male_Human_HAPPY_NEW_YEAR_01	Buon anno!	
VO_ULDA_Reno_Male_Human_HAPPY_NEW_YEAR_LUNAR_01	Buon anno!	
VO_ULDA_Reno_Male_Human_HAPPY_NOBLEGARDEN_01	È la Festa di Nobiluova! Passami il cesto!	
VO_ULDA_Reno_Male_Human_KISS_01	Smack!	
VO_ULDA_Reno_Male_Human_LowCards_01	Sono un po' a corto di carte qui...	
VO_ULDA_Reno_Male_Human_MIRROR_GREETINGS_01	Ma... quello è il MIO cappello.	
VO_ULDA_Reno_Male_Human_MIRROR_START_01	Anche una sola delle due non sarebbe male.	
VO_ULDA_Reno_Male_Human_NoCards_01	Ho finito le carte!	
VO_ULDA_Reno_Male_Human_Oops_02	Nessuno l'ha visto. Ahahah! Spero.	
VO_ULDA_Reno_Male_Human_Picked_02	Tienimi il cappello, Pinnus. Mi butto nella mischia!	
VO_ULDA_Reno_Male_Human_PIRATE_DAY_01	Il Capitano Jackson è in arrrrrrivo, canaglia! Oh, che spasso.	
VO_ULDA_Reno_Male_Human_Sorry_01	Immagino dovrei chiederti scusa.	
VO_ULDA_Reno_Male_Human_Start_01	Diventeremo ricchi! E salveremo il mondo!	
VO_ULDA_Reno_Male_Human_Thanks_01	Oh, grazie.	
VO_ULDA_Reno_Male_Human_Thinking_01	Mmm...	
VO_ULDA_Reno_Male_Human_Thinking_02	La vedo male...	
VO_ULDA_Reno_Male_Human_Thinking_03	È così folle... che potrebbe funzionare.	
VO_ULDA_Reno_Male_Human_Thinking_04	Ti sei trovato in situazioni ben peggiori, Reno...	
VO_ULDA_Reno_Male_Human_Threaten_02	Possiamo farlo con le buone... o A MODO MIO.	
VO_ULDA_Reno_Male_Human_Time_01	Devo fare in fretta...	
VO_ULDA_Reno_Male_Human_Well_Played_01	Una mossa brillante!	
VO_ULDA_Reno_Male_Human_WOW_01	Per tutti i Murloc!	
VO_YOD_009_Male_Human_Concede_01	Ah, mi hai sconfitto!	
VO_YOD_009_Male_Human_ERROR_FULL_MINIONS_02	Ho già troppi servitori.	
VO_YOD_009_Male_Human_Greetings_01	Ah ah! Diventerò ricco!	
VO_YOD_009_Male_Human_LowCards_01	Grimorio quasi esaurito!	
VO_YOD_009_Male_Human_MIRROR_GREETINGS_01	Ah... Saremo ricchi!	
VO_YOD_009_Male_Human_MIRROR_START_01	Ehi! L'avevo vista prima io!	
VO_YOD_009_Male_Human_NoCards_01	Ho finito le carte!	
VO_YOD_009_Male_Human_Oops_01	Ah! Ehm... L'ho fatto apposta.	
VO_YOD_009_Male_Human_Picked_01	Lanciamo qualche Magia.	
VO_YOD_009_Male_Human_Sorry_01	Fantastico! Oh... m... mi dispiace.	
VO_YOD_009_Male_Human_Start_01	Sbrighiamoci, ho una tomba da saccheggiare.	
VO_YOD_009_Male_Human_Thanks_01	Grazie. È vero, sono incredibile.	
VO_YOD_009_Male_Human_Thinking_01	Mmm...	
VO_YOD_009_Male_Human_Thinking_03	Se potessi... lanciare quella...	
VO_YOD_009_Male_Human_Thinking_04	Come possiamo diventare ricchi?	
VO_YOD_009_Male_Human_Threaten_01	Non costringermi a usare le Magie GROSSE.	
VO_YOD_009_Male_Human_Time_01	Ah! Credevo di avere più tempo!	
VO_YOD_009_Male_Human_Well_Played_01	Sembra che anche tu conosca qualche trucchetto!	
VO_YOD_009_Male_Human_WOW_01	Fenomenale! Proprio come me!	
