TAG	TEXT	COMMENT
GLOBAL_AADC_BUTTON_PRIVACY	Privacy	
GLOBAL_AADC_BUTTON_PRIVACYSETTINGS	Impostazioni Privacy	
GLOBAL_AADC_CHATSETTINGS_DISABLEDESCRIPTION	Disabilitare la chat ti impedirà di inviare e ricevere messaggi dagli amici.	
GLOBAL_AADC_CHATSETTINGS_DISABLEHEADER	Disabilita messaggi di chat	
GLOBAL_AADC_CHATSETTINGS_ENABLEDESCRIPTION	Abilitare la chat ti permetterà di inviare e ricevere messaggi dagli amici. Fa' attenzione e non condividere informazioni personali.	
GLOBAL_AADC_CHATSETTINGS_ENABLEHEADER	Abilita messaggi di chat	
GLOBAL_AADC_CHATSETTINGS_SETTINGSUPDATED	Impostazioni chat aggiornate	
GLOBAL_AADC_CHATSETTINGS_TITLE	Impostazioni chat	
GLOBAL_AADC_CHATSETTINGS_UPDATINGSETTINGS	Aggiornamento impostazioni chat	
GLOBAL_AADC_CHATWARNING	Fa' attenzione e non condividere informazioni personali nei messaggi.	
GLOBAL_AADC_FRIENDSETTINGS_DISABLEDESCRIPTION	Disabilitando gli amici vicini, impedirai ai giocatori vicini alla tua posizione di vedere le tue attività di gioco nell'elenco amici.	
GLOBAL_AADC_FRIENDSETTINGS_DISABLEHEADER	Disabilita amici vicini	
GLOBAL_AADC_FRIENDSETTINGS_ENABLEDESCRIPTION	Abilitando gli amici vicini, permetterai ai giocatori vicini alla tua posizione di vedere le tue attività di gioco nell'elenco amici.	
GLOBAL_AADC_FRIENDSETTINGS_ENABLEHEADER	Abilita amici vicini	
GLOBAL_AADC_FRIENDSETTINGS_SETTINGSUPDATED	Amici vicini aggiornati	
GLOBAL_AADC_FRIENDSETTINGS_TITLE	Impostazioni amici	
GLOBAL_AADC_FRIENDSETTINGS_UPDATINGSETTINGS	Aggiornamento amici vicini	
GLOBAL_AADC_LOCATIONSERVICES_DISABLEDESCRIPTION	Disabilitando i servizi di posizione, non potrai organizzare o partecipare ai Fireside Gathering.	
GLOBAL_AADC_LOCATIONSERVICES_DISABLEHEADER	Disabilita servizi di posizione	
GLOBAL_AADC_LOCATIONSERVICES_ENABLEDESCRIPTION	Abilitando i servizi di posizione, potrai trovare giocatori vicini e partecipare ai Fireside Gathering.	
GLOBAL_AADC_LOCATIONSERVICES_ENABLEHEADER	Abilita servizi di posizione	
GLOBAL_AADC_LOCATIONSERVICES_SETTINGSUPDATED	Impostazioni di posizione aggiornate	
GLOBAL_AADC_LOCATIONSERVICES_TITLE	Impostazioni di posizione	
GLOBAL_AADC_LOCATIONSERVICES_UPDATINGSETTINGS	Aggiornamento impostazioni posizione	
GLOBAL_AADC_PARENTALLOCK_DESCRIPTION	Cambiando questa opzione, un tuo genitore o tutore legale dovrà aggiornare le impostazioni di privacy in Battle.net	
GLOBAL_AADC_PRIVACYSETTINGSMENU_PRIVACYRIGHTS	Diritti alla privacy	
GLOBAL_AADC_PRIVACYSETTINGSPOPUP_DEVICE_LOCATIONSETTINGS	Abilita impostazioni di posizione	
GLOBAL_AADC_PRIVACYSETTINGSPOPUP_DEVICE_PUSHNOTIFICATIONS	Abilita notifiche push	
GLOBAL_AADC_PRIVACYSETTINGSPOPUP_SECTIONHEADER_DEVICE	Opzioni dispositivo	
GLOBAL_AADC_PRIVACYSETTINGSPOPUP_SECTIONHEADER_SOCIAL	Opzioni social	
GLOBAL_AADC_PRIVACYSETTINGSPOPUP_SOCIAL_CHATMESSAGES	Abilita messaggi di chat	
GLOBAL_AADC_PRIVACYSETTINGSPOPUP_SOCIAL_NEARBYFRIENDS	Abilita amici vicini	
GLOBAL_AADC_PRIVACYSETTINGSPOPUP_SOCIAL_SPECIALOFFERS	Abilita offerte del negozio personalizzate	
GLOBAL_AADC_PUSHNOTIFICATIONS_DISABLEDESCRIPTION	Disabilitando le notifiche push, impedirai a Hearthstone di inviare notifiche al tuo dispositivo.	
GLOBAL_AADC_PUSHNOTIFICATIONS_DISABLEHEADER	Disabilita notifiche push	
GLOBAL_AADC_PUSHNOTIFICATIONS_ENABLEDESCRIPTION	Abilitando le notifiche push, permetterai a Hearthstone di inviare notifiche al tuo dispositivo.	
GLOBAL_AADC_PUSHNOTIFICATIONS_ENABLEHEADER	Abilita notifiche push	
GLOBAL_AADC_PUSHNOTIFICATIONS_SETTINGSUPDATED	Impostazioni notifiche aggiornate	
GLOBAL_AADC_PUSHNOTIFICATIONS_TITLE	Impostazioni notifiche	
GLOBAL_AADC_PUSHNOTIFICATIONS_UPDATINGSETTINGS	Aggiornamento impostazioni notifiche	
GLOBAL_AADC_SHOPSETTINGS_DISABLEDESCRIPTION	Disabilitando le offerte del negozio personalizzate, non potrai vedere le offerte del negozio basate sui tuoi dati di gioco.	
GLOBAL_AADC_SHOPSETTINGS_DISABLEHEADER	Disabilita offerte personalizzate	
GLOBAL_AADC_SHOPSETTINGS_ENABLEDESCRIPTION	Abilitando le offerte del negozio personalizzate, potrai vedere le offerte del negozio basate sui tuoi dati di gioco.	
GLOBAL_AADC_SHOPSETTINGS_ENABLEHEADER	Abilita offerte personalizzate	
GLOBAL_AADC_SHOPSETTINGS_SETTINGSUPDATED	Impostazioni negozio aggiornate	
GLOBAL_AADC_SHOPSETTINGS_TITLE	Impostazioni negozio	
GLOBAL_AADC_SHOPSETTINGS_UPDATINGSETTINGS	Aggiornamento impostazioni negozio	
GLOBAL_AADC_UPDATESETTINGSPOPUP_DESCRIPTION	Ora sono abilitate tutte le tue impostazioni social e dei dispositivi, incluse quelle legate a messaggi di chat, negozio e offerte personalizzate.	
GLOBAL_AADC_UPDATESETTINGSPOPUP_TITLE	Impostazioni aggiornate	
GLOBAL_ACCOUNT	Account	
GLOBAL_ADDFRIEND_BUTTON	Aggiungi come amico	
GLOBAL_ADDFRIEND_ERROR_ALREADY_FRIEND	Questa persona è già nel tuo elenco amici.	
GLOBAL_ADDFRIEND_ERROR_MALFORMED	Devi digitare un indirizzo e-mail o un BattleTag.	
GLOBAL_ADDFRIEND_HEADER	Aggiungi un amico	
GLOBAL_ADDFRIEND_INSTRUCTION	Inserisci il BattleTag o l'indirizzo e-mail	
GLOBAL_ADDFRIEND_SENT_CONFIRMATION	Richiesta d'amicizia inviata.	
GLOBAL_ADVENTURE_CHOOSE_BUTTON_TEXT	Scegli	
GLOBAL_ADVENTURE_DESC_HEADER	Avventura	
GLOBAL_ADVENTURE_TRAY_HEADER	Scegli un'avventura	
GLOBAL_APPROXIMATE_DATETIME	~{0}	0=time string
GLOBAL_APPROXIMATE_DATETIME_RANGE	~{0} - {1}	0=min seconds 1=max seconds string
GLOBAL_ARENA_MEDAL_0	Chiave da Novizio	
GLOBAL_ARENA_MEDAL_1	Chiave da Apprendista	
GLOBAL_ARENA_MEDAL_10	Chiave del Gelo	
GLOBAL_ARENA_MEDAL_11	Chiave Ardente	
GLOBAL_ARENA_MEDAL_12	Chiave della Luce	
GLOBAL_ARENA_MEDAL_2	Chiave da Praticante	
GLOBAL_ARENA_MEDAL_3	Chiave di Rame	
GLOBAL_ARENA_MEDAL_4	Chiave d'Argento	
GLOBAL_ARENA_MEDAL_5	Chiave d'Oro	
GLOBAL_ARENA_MEDAL_6	Chiave di Platino	
GLOBAL_ARENA_MEDAL_7	Chiave di Diamante	
GLOBAL_ARENA_MEDAL_8	Chiave da Campione	
GLOBAL_ARENA_MEDAL_9	Chiave di Rubino	
GLOBAL_ARENA_SEASON_ERROR_NOT_ACTIVE	Spiacenti, la modalità Arena richiesta non è più disponibile. Attendi qualche minuto e riprova.	
GLOBAL_ASSET_DOWNLOAD	Scaricamento dati	
GLOBAL_ASSET_DOWNLOAD_ALERT	Lo scaricamento elementi è disattivato in partita.	
GLOBAL_ASSET_DOWNLOAD_AWAITING_FETCH	Ricerca aggiornamenti...	
GLOBAL_ASSET_DOWNLOAD_AWAITING_OTHER_DOWNLOAD	In attesa	
GLOBAL_ASSET_DOWNLOAD_AWAITING_WIFI	Richiede la rete Wi-Fi	
GLOBAL_ASSET_DOWNLOAD_BYTE_SYMBOL	B	
GLOBAL_ASSET_DOWNLOAD_CELLULAR_DATA_BODY	Scarica i dati con la rete mobile.	
GLOBAL_ASSET_DOWNLOAD_CELLULAR_DATA_HEADER	Rete mobile	
GLOBAL_ASSET_DOWNLOAD_CELLULAR_POPUP_ADDITIONAL_BODY	La rete Wi-Fi non è disponibile. Vuoi scaricare {0} di dati restanti aggiuntivi con la rete mobile?	
GLOBAL_ASSET_DOWNLOAD_CELLULAR_POPUP_HEADER	Rete mobile	
GLOBAL_ASSET_DOWNLOAD_CELLULAR_POPUP_INITIAL_BODY	La rete Wi-Fi non è disponibile. Vuoi scaricare {0} di dati restanti richiesti con la rete mobile?	
GLOBAL_ASSET_DOWNLOAD_COMPLETE	Completato	
GLOBAL_ASSET_DOWNLOAD_DETAILS_AUDIO	Audio	
GLOBAL_ASSET_DOWNLOAD_DETAILS_HIGHRES	Texture ad alta risoluzione	
GLOBAL_ASSET_DOWNLOAD_DISABLED	Disattivato	
GLOBAL_ASSET_DOWNLOAD_ENABLE_DOWNLOAD_BODY	Permetti a Hearthstone di scaricare elementi.	
GLOBAL_ASSET_DOWNLOAD_ENABLE_DOWNLOAD_HEADER	Attiva scaricamento	
GLOBAL_ASSET_DOWNLOAD_ENABLED	Attivato	
GLOBAL_ASSET_DOWNLOAD_ERROR_AGENT_IMPEDED	Connessione lenta	
GLOBAL_ASSET_DOWNLOAD_ERROR_CELLULAR_DISABLED	Rete mobile disattivata	
GLOBAL_ASSET_DOWNLOAD_ERROR_DOWNLOAD_DISABLED	Scaricamento disattivato	
GLOBAL_ASSET_DOWNLOAD_ERROR_OUT_OF_STORAGE	Spazio esaurito	
GLOBAL_ASSET_DOWNLOAD_GIGABYTE_SYMBOL	GB	
GLOBAL_ASSET_DOWNLOAD_INTENTION_PAUSED	{0} (In pausa)	
GLOBAL_ASSET_DOWNLOAD_IOS_REQ_POPUP_BODY	Scaricamento disponibile. Vuoi scaricare {0} di dati restanti?	
GLOBAL_ASSET_DOWNLOAD_IOS_REQ_POPUP_HEADER	Dati aggiuntivi	
GLOBAL_ASSET_DOWNLOAD_KILOBYTE_SYMBOL	KB	
GLOBAL_ASSET_DOWNLOAD_MEGABYTE_SYMBOL	MB	
GLOBAL_ASSET_DOWNLOAD_PAUSED	In pausa	
GLOBAL_ASSET_DOWNLOAD_SETTINGS	Impostazioni	
GLOBAL_ASSET_DOWNLOAD_STATUS	{0} rimanenti a {1}/s	
GLOBAL_ASSET_DOWNLOAD_STATUS_DECIMAL_FORMAT	{0},{1} {2}	
GLOBAL_ASSET_DOWNLOAD_STATUS_SHORT	{0} a {1}/s	
GLOBAL_ASSET_INTENTION_DONE	Fine	
GLOBAL_ASSET_INTENTION_DOWNLOADING_EXPANSION_MUSIC	Audio aggiuntivo (2/3)	
GLOBAL_ASSET_INTENTION_DOWNLOADING_FONTS	Caratteri	
GLOBAL_ASSET_INTENTION_DOWNLOADING_HERO_MUSIC	Musica eroe	
GLOBAL_ASSET_INTENTION_DOWNLOADING_HIGH_RES_PORTRAITS	Disegni ad alta risoluzione	
GLOBAL_ASSET_INTENTION_DOWNLOADING_LEGEND_STINGERS	Audio aggiuntivo (1/3)	
GLOBAL_ASSET_INTENTION_DOWNLOADING_MINION_PLAY_SOUNDS	Audio dei servitori	
GLOBAL_ASSET_INTENTION_DOWNLOADING_MISSION_SOUNDS	Audio delle Avventure	
GLOBAL_ASSET_INTENTION_DOWNLOADING_OTHER_MINION_SOUNDS	Audio aggiuntivo (3/3)	
GLOBAL_ASSET_INTENTION_DOWNLOADING_PREMIUM_ANIMATIONS	Animazioni dorate	
GLOBAL_ASSET_INTENTION_DOWNLOADING_SPELL_SOUNDS	Audio delle Magie	
GLOBAL_ASSET_INTENTION_UNINITIALIZED	Avvio	
GLOBAL_ATTACK	Attacco	
GLOBAL_BACK	Indietro	
GLOBAL_BASIC_DECK_NAME	{0}	0=class name
GLOBAL_BATTLEGROUNDS	Battaglia	
GLOBAL_BETA_REIMBURSEMENT_DETAILS	Questo è l'oro accreditato per gli acquisti passati. Grazie mille!	
GLOBAL_BETA_REIMBURSEMENT_HEADLINE	Credito del reset dell'account	
GLOBAL_BRAWLISEUM	Rissodromo	
GLOBAL_BUTTON_AWESOME	Ottimo!	
GLOBAL_BUTTON_BUY	ACQUISTA	
GLOBAL_BUTTON_CLOSE	Chiudi	
GLOBAL_BUTTON_CONVERT	Converti	
GLOBAL_BUTTON_GO	Vai!	
GLOBAL_BUTTON_INFO_LETTER	i	
GLOBAL_BUTTON_LATER	Dopo	
GLOBAL_BUTTON_NEXT	Avanti	
GLOBAL_BUTTON_NO	No	
GLOBAL_BUTTON_NOT_NOW	Non ora	
GLOBAL_BUTTON_OK	OK	
GLOBAL_BUTTON_OR	O	
GLOBAL_BUTTON_OWNED	Posseduto	
GLOBAL_BUTTON_YES	Sì	
GLOBAL_CANCEL	Annulla	
GLOBAL_CARD_SET_BAR	Forgiati nelle Savane	
GLOBAL_CARD_SET_BAR_SEARCHABLE_SHORTHAND_NAMES	sav fns fs	This is a space-separated list indicating all of the allowable search keywords that can be used in Collection Manager screen's text-search feature to narrow down the cards to this specific Card Set via shorthand names (note: the full name above is also used for this feature). Also note: letter case is ignored.
GLOBAL_CARD_SET_BAR_SHORT	Savane	
GLOBAL_CARD_SET_BASIC	Base	
GLOBAL_CARD_SET_BOOMSDAY	Operazione Apocalisse	
GLOBAL_CARD_SET_BOOMSDAY_SEARCHABLE_SHORTHAND_NAMES	bd tbp bdp tbdp bp db boa dboa oa	This is a space-separated list indicating all of the allowable search keywords that can be used in Collection Manager screen's text-search feature to narrow down the cards to this specific Card Set via shorthand names (note: the full name above is also used for this feature). Also note: letter case is ignored.
GLOBAL_CARD_SET_BOOMSDAY_SHORT	Apocalisse	
GLOBAL_CARD_SET_BRM	Massiccio Roccianera	
GLOBAL_CARD_SET_BRM_SEARCHABLE_SHORTHAND_NAMES	brm mr	This is a space-separated list indicating all of the allowable search keywords that can be used in Collection Manager screen's text-search feature to narrow down the cards to this specific Card Set via shorthand names (note: the full name above is also used for this feature). Also note: letter case is ignored.
GLOBAL_CARD_SET_BT	Ceneri delle Terre Esterne	
GLOBAL_CARD_SET_BT_SEARCHABLE_SHORTHAND_NAMES	cdte cte ceneri	This is a space-separated list indicating all of the allowable search keywords that can be used in Collection Manager screen's text-search feature to narrow down the cards to this specific Card Set via shorthand names (note: the full name above is also used for this feature). Also note: letter case is ignored.
GLOBAL_CARD_SET_BT_SHORT	Terre Esterne	
GLOBAL_CARD_SET_CORE	Principale	
GLOBAL_CARD_SET_CORE_SEARCHABLE_SHORTHAND_NAMES	principale	This is a space-separated list indicating all of the allowable search keywords that can be used in Collection Manager screen's text-search feature to narrow down the cards to this specific Card Set via shorthand names (note: the full name above is also used for this feature). Also note: letter case is ignored.
GLOBAL_CARD_SET_CORE_SHORT	Principale	
GLOBAL_CARD_SET_DALARAN	L'ascesa delle ombre	
GLOBAL_CARD_SET_DALARAN_SEARCHABLE_SHORTHAND_NAMES	ado	This is a space-separated list indicating all of the allowable search keywords that can be used in Collection Manager screen's text-search feature to narrow down the cards to this specific Card Set via shorthand names (note: the full name above is also used for this feature). Also note: letter case is ignored.
GLOBAL_CARD_SET_DALARAN_SHORT	L'ascesa delle ombre	
GLOBAL_CARD_SET_DEBUG	Fanghiglia	
GLOBAL_CARD_SET_DED		
GLOBAL_CARD_SET_DED_SEARCHABLE_SHORTHAND_NAMES	Mdm	This is a space-separated list indicating all of the allowable search keywords that can be used in Collection Manager screen's text-search feature to narrow down the cards to this specific Card Set via shorthand names (note: the full name above is also used for this feature). Also note: letter case is ignored.
GLOBAL_CARD_SET_DED_SHORT	Miniere della Morte	
GLOBAL_CARD_SET_DHI	Apprendista Cacciatore di Demoni	
GLOBAL_CARD_SET_DHI_SEARCHABLE_SHORTHAND_NAMES	acd	This is a space-separated list indicating all of the allowable search keywords that can be used in Collection Manager screen's text-search feature to narrow down the cards to this specific Card Set via shorthand names (note: the full name above is also used for this feature). Also note: letter case is ignored.
GLOBAL_CARD_SET_DHI_SHORT	Apprendista	
GLOBAL_CARD_SET_DMF	Follia alla Fiera di Lunacupa	
GLOBAL_CARD_SET_DMF_SEARCHABLE_SHORTHAND_NAMES	flc	This is a space-separated list indicating all of the allowable search keywords that can be used in Collection Manager screen's text-search feature to narrow down the cards to this specific Card Set via shorthand names (note: the full name above is also used for this feature). Also note: letter case is ignored.
GLOBAL_CARD_SET_DMF_SHORT	Lunacupa	
GLOBAL_CARD_SET_DRG	La Discesa dei Draghi	
GLOBAL_CARD_SET_DRG_SEARCHABLE_SHORTHAND_NAMES	lddd dd	This is a space-separated list indicating all of the allowable search keywords that can be used in Collection Manager screen's text-search feature to narrow down the cards to this specific Card Set via shorthand names (note: the full name above is also used for this feature). Also note: letter case is ignored.
GLOBAL_CARD_SET_DRG_SHORT	Draghi	
GLOBAL_CARD_SET_EXPERT1	Classiche	
GLOBAL_CARD_SET_GANGS	Bassifondi di Meccania	
GLOBAL_CARD_SET_GANGS_RESERVE	Riserva delle bande	
GLOBAL_CARD_SET_GANGS_SEARCHABLE_SHORTHAND_NAMES	msg msog bdm ibdm bm	This is a space-separated list indicating all of the allowable search keywords that can be used in Collection Manager screen's text-search feature to narrow down the cards to this specific Card Set via shorthand names (note: the full name above is also used for this feature). Also note: letter case is ignored.
GLOBAL_CARD_SET_GANGS_SHORT	Meccania	
GLOBAL_CARD_SET_GILNEAS	Boscotetro	
GLOBAL_CARD_SET_GILNEAS_SEARCHABLE_SHORTHAND_NAMES	bt	This is a space-separated list indicating all of the allowable search keywords that can be used in Collection Manager screen's text-search feature to narrow down the cards to this specific Card Set via shorthand names (note: the full name above is also used for this feature). Also note: letter case is ignored.
GLOBAL_CARD_SET_GILNEAS_SHORT	Boscotetro	
GLOBAL_CARD_SET_GVG	Goblin vs Gnomi	
GLOBAL_CARD_SET_GVG_SEARCHABLE_SHORTHAND_NAMES	gvg	This is a space-separated list indicating all of the allowable search keywords that can be used in Collection Manager screen's text-search feature to narrow down the cards to this specific Card Set via shorthand names (note: the full name above is also used for this feature). Also note: letter case is ignored.
GLOBAL_CARD_SET_HOF	Vecchie Glorie	
GLOBAL_CARD_SET_ICECROWN	Cavalieri del Trono di Ghiaccio	
GLOBAL_CARD_SET_ICECROWN_SHORT	Trono di Ghiaccio	
GLOBAL_CARD_SET_KARA	Una notte a Karazhan	
GLOBAL_CARD_SET_KARA_RESERVE	Riserva di Karazhan	
GLOBAL_CARD_SET_KARA_SHORT	Karazhan	
GLOBAL_CARD_SET_LEGACY	Retaggio	
GLOBAL_CARD_SET_LEGACY_SEARCHABLE_SHORTHAND_NAMES	rtgg	This is a space-separated list indicating all of the allowable search keywords that can be used in Collection Manager screen's text-search feature to narrow down the cards to this specific Card Set via shorthand names (note: the full name above is also used for this feature). Also note: letter case is ignored.
GLOBAL_CARD_SET_LEGACY_SHORT	Retaggio	
GLOBAL_CARD_SET_LOE	Lega degli Esploratori	
GLOBAL_CARD_SET_LOE_SEARCHABLE_SHORTHAND_NAMES	loe lde	This is a space-separated list indicating all of the allowable search keywords that can be used in Collection Manager screen's text-search feature to narrow down the cards to this specific Card Set via shorthand names (note: the full name above is also used for this feature). Also note: letter case is ignored.
GLOBAL_CARD_SET_LOE_SHORT	Lega degli Esploratori	
GLOBAL_CARD_SET_LOOTAPALOOZA	Coboldi & Catacombe	
GLOBAL_CARD_SET_LOOTAPALOOZA_SEARCHABLE_SHORTHAND_NAMES	cc cec c&c	This is a space-separated list indicating all of the allowable search keywords that can be used in Collection Manager screen's text-search feature to narrow down the cards to this specific Card Set via shorthand names (note: the full name above is also used for this feature). Also note: letter case is ignored.
GLOBAL_CARD_SET_LOOTAPALOOZA_SHORT	Coboldi & Catacombe	
GLOBAL_CARD_SET_NAXX	Naxxramas	
GLOBAL_CARD_SET_NAXX_SEARCHABLE_SHORTHAND_NAMES	Nax Naxx	This is a space-separated list indicating all of the allowable search keywords that can be used in Collection Manager screen's text-search feature to narrow down the cards to this specific Card Set via shorthand names (note: the full name above is also used for this feature). Also note: letter case is ignored.
GLOBAL_CARD_SET_OG	Sussurri degli Dei Antichi	
GLOBAL_CARD_SET_OG_RESERVE	Riserva degli Dei Antichi	
GLOBAL_CARD_SET_OG_SEARCHABLE_SHORTHAND_NAMES	tog wotog wog sda sdda	This is a space-separated list indicating all of the allowable search keywords that can be used in Collection Manager screen's text-search feature to narrow down the cards to this specific Card Set via shorthand names (note: the full name above is also used for this feature). Also note: letter case is ignored.  For Whispers of the Old Gods, 'tog' should be available in all locales; wotog and wog are additional English shorthands, which should be replaced by locale specific variants.
GLOBAL_CARD_SET_OG_SHORT	Dei Antichi	
GLOBAL_CARD_SET_PROMO	Promozione	
GLOBAL_CARD_SET_SCH	L'Accademia di Scholomance	
GLOBAL_CARD_SET_SCH_SEARCHABLE_SHORTHAND_NAMES	scholo as	This is a space-separated list indicating all of the allowable search keywords that can be used in Collection Manager screen's text-search feature to narrow down the cards to this specific Card Set via shorthand names (note: the full name above is also used for this feature). Also note: letter case is ignored.
GLOBAL_CARD_SET_SCH_SHORT	Scholomance	
GLOBAL_CARD_SET_SW	Uniti a Roccavento	
GLOBAL_CARD_SET_SW_SEARCHABLE_SHORTHAND_NAMES	rv	uis
GLOBAL_CARD_SET_SW_SHORT	Roccavento	
GLOBAL_CARD_SET_TGT	Gran Torneo	
GLOBAL_CARD_SET_TGT_SEARCHABLE_SHORTHAND_NAMES	tgt gt	This is a space-separated list indicating all of the allowable search keywords that can be used in Collection Manager screen's text-search feature to narrow down the cards to this specific Card Set via shorthand names (note: the full name above is also used for this feature). Also note: letter case is ignored.
GLOBAL_CARD_SET_TGT_SHORT	Gran Torneo	
GLOBAL_CARD_SET_TROLL	La sfida di Rastakhan	
GLOBAL_CARD_SET_TROLL_SEARCHABLE_SHORTHAND_NAMES	sr	This is a space-separated list indicating all of the allowable search keywords that can be used in Collection Manager screen's text-search feature to narrow down the cards to this specific Card Set via shorthand names (note: the full name above is also used for this feature). Also note: letter case is ignored.
GLOBAL_CARD_SET_TROLL_SHORT	Sfida di Rastakhan	
GLOBAL_CARD_SET_ULDUM	Salvatori di Uldum	
GLOBAL_CARD_SET_ULDUM_SEARCHABLE_SHORTHAND_NAMES	sdu	This is a space-separated list indicating all of the allowable search keywords that can be used in Collection Manager screen's text-search feature to narrow down the cards to this specific Card Set via shorthand names (note: the full name above is also used for this feature). Also note: letter case is ignored.
GLOBAL_CARD_SET_ULDUM_SHORT	Uldum	
GLOBAL_CARD_SET_UNGORO	Viaggio a Un'Goro	
GLOBAL_CARD_SET_UNGORO_SHORT	Un'Goro	
GLOBAL_CARD_SET_VANILLA	Classico	
GLOBAL_CARD_SET_VANILLA_FORMAT_SEARCHABLE_SHORTHAND_NAMES	fmtclsc	This is a space-separated list indicating all of the allowable search keywords that can be used in Collection Manager screen's text-search feature to narrow down the cards to this specific Card Set via shorthand names (note: the full name above is also used for this feature). Also note: letter case is ignored.
GLOBAL_CARD_SET_VANILLA_FORMAT_SHORT	Classico	
GLOBAL_CARD_SET_WC	Caverna dei Lamenti	
GLOBAL_CARD_SET_WC_SEARCHABLE_SHORTHAND_NAMES	cl	This is a space-separated list indicating all of the allowable search keywords that can be used in Collection Manager screen's text-search feature to narrow down the cards to this specific Card Set via shorthand names (note: the full name above is also used for this feature). Also note: letter case is ignored.
GLOBAL_CARD_SET_WC_SHORT	Caverna	
GLOBAL_CARD_SET_WILD_EVENT	Evento Selvaggio	
GLOBAL_CARD_SET_WILD_EVENT_SHORT	Evento Selvaggio	
GLOBAL_CARD_SET_YOD	Il Risveglio di Galakrond	
GLOBAL_CARD_SET_YOD_SHORT	Il Risveglio di Galakrond	
GLOBAL_CARDTYPE_ENCHANTMENT	Incantamento	
GLOBAL_CARDTYPE_HERO	Eroe	
GLOBAL_CARDTYPE_HEROPOWER	Potere Eroe	
GLOBAL_CARDTYPE_ITEM	Oggetto	
GLOBAL_CARDTYPE_MINION	Servitore	
GLOBAL_CARDTYPE_SPELL	Magia	
GLOBAL_CARDTYPE_TOKEN	Pedina	
GLOBAL_CARDTYPE_WEAPON	Arma	
GLOBAL_CHAT_BUBBLE_RECEIVER_NAME	A: {0}	0=player name
GLOBAL_CHAT_CHALLENGE	Sfida	
GLOBAL_CHAT_NO_FRIENDS_ONLINE	Nessuno dei tuoi amici è attualmente online.	
GLOBAL_CHAT_NO_RECENT_CONVERSATIONS	Usa il menu degli amici per avviare una conversazione con un amico.	
GLOBAL_CHAT_RECEIVER_OFFLINE	{0} è offline.	0=player name
GLOBAL_CHAT_RECEIVER_ONLINE	{0} è online.	0=player name
GLOBAL_CHAT_SENDER_APPEAR_OFFLINE	Non puoi inviare messaggi quando sei impostato come invisibile.	
GLOBAL_CHAT_SENDER_OFFLINE	Sei attualmente offline.	
GLOBAL_CHOOSE_PAYMENT	Modalità di pagamento	
GLOBAL_CLASS_DEATHKNIGHT	Cavaliere della Morte	
GLOBAL_CLASS_DEMONHUNTER	Cacciatore di Demoni	
GLOBAL_CLASS_DRUID	Druido	
GLOBAL_CLASS_HUNTER	Cacciatore	
GLOBAL_CLASS_MAGE	Mago	
GLOBAL_CLASS_NEUTRAL	Generiche	
GLOBAL_CLASS_PALADIN	Paladino	
GLOBAL_CLASS_PRIEST	Sacerdote	
GLOBAL_CLASS_ROGUE	Ladro	
GLOBAL_CLASS_SHAMAN	Sciamano	
GLOBAL_CLASS_WARLOCK	Stregone	
GLOBAL_CLASS_WARRIOR	Guerriero	
GLOBAL_CLASSIC	Classico	
GLOBAL_CLICK_TO_CONTINUE	Clicca per continuare	
GLOBAL_CLICK_TO_CONTINUE_TOUCH	Tocca per continuare	
GLOBAL_COLLECTION_GOLDEN	(Dorata)	
GLOBAL_COMMA_SEPARATOR	,	
GLOBAL_CONCEDE	Resa	
GLOBAL_CONFIRM	Conferma	
GLOBAL_CONTINUE	Continua	
GLOBAL_COST	Costo	
GLOBAL_CREATE	Crea	
GLOBAL_CURRENT_DATE	{0:dd/MM/yy}	see http://msdn.microsoft.com/en-us/library/8kb3ddd4.aspx
GLOBAL_CURRENT_TIME	{0:HH:mm}	see http://msdn.microsoft.com/en-us/library/8kb3ddd4.aspx
GLOBAL_CURRENT_TIME_AM	AM	
GLOBAL_CURRENT_TIME_AND_DATE_DEV	{0} ({1} - {2})	
GLOBAL_CURRENT_TIME_PM	PM	
GLOBAL_DATETIME_AFK_DAY	Assente da più di un giorno	
GLOBAL_DATETIME_AFK_DAYS	Assente da {0} |4(giorno,giorni)	
GLOBAL_DATETIME_AFK_HOURS	Assente da {0} |4(ora,ore)	
GLOBAL_DATETIME_AFK_MINUTES	Assente da {0} |4(minuto,minuti)	
GLOBAL_DATETIME_AFK_MONTH	Assente da più di un mese	
GLOBAL_DATETIME_AFK_SECONDS	Assente da meno di un minuto	
GLOBAL_DATETIME_AFK_WEEKS	Assente da {0} |4(settimana,settimane)	
GLOBAL_DATETIME_COMING_SOON	Prossimamente	
GLOBAL_DATETIME_COMING_SOON_DAYS	Disponibile fra\n{0} |4(giorno,giorni)	
GLOBAL_DATETIME_COMING_SOON_HOURS	Disponibile fra\n{0} |4(ora,ore)	
GLOBAL_DATETIME_COMING_SOON_MINUTES	Disponibile fra\nmeno di un'ora	
GLOBAL_DATETIME_COMING_SOON_WEEKS	Disponibile fra\n{0} |4(settimana,settimane)	
GLOBAL_DATETIME_FRIENDREQUEST_DAY	ieri	
GLOBAL_DATETIME_FRIENDREQUEST_DAYS	{0} |4(giorno,giorni) fa	
GLOBAL_DATETIME_FRIENDREQUEST_HOURS	{0} |4(ora,ore) fa	
GLOBAL_DATETIME_FRIENDREQUEST_MINUTES	{0} |4(minuto,minuti) fa	
GLOBAL_DATETIME_FRIENDREQUEST_MONTH	più di un mese fa	
GLOBAL_DATETIME_FRIENDREQUEST_SECONDS	meno di un minuto fa	
GLOBAL_DATETIME_FRIENDREQUEST_WEEKS	{0} |4(settimana,settimane) fa	
GLOBAL_DATETIME_GREATER_THAN_X_MINUTES	> {0} |4(minuto,minuti)	
GLOBAL_DATETIME_LASTONLINE_DAY	Ultima connessione: ieri	
GLOBAL_DATETIME_LASTONLINE_DAYS	Ultima connessione: {0} |4(giorno,giorni) fa	
GLOBAL_DATETIME_LASTONLINE_HOURS	Ultima connessione: {0} |4(ora,ore) fa	
GLOBAL_DATETIME_LASTONLINE_MINUTES	Ultima connessione: {0} |4(minuto,minuti) fa	
GLOBAL_DATETIME_LASTONLINE_MONTH	Ultima connessione: più di un mese fa	
GLOBAL_DATETIME_LASTONLINE_SECONDS	Ultima connessione: meno di un minuto fa	
GLOBAL_DATETIME_LASTONLINE_WEEKS	Ultima connessione: {0} |4(settimana,settimane) fa	
GLOBAL_DATETIME_SPINNER_DAY	> 1 giorno	
GLOBAL_DATETIME_SPINNER_DAYS	{0} |4(giorno,giorni)	
GLOBAL_DATETIME_SPINNER_HOURS	{0} |4(ora,ore)	
GLOBAL_DATETIME_SPINNER_MINUTES	{0} |4(minuto,minuti)	
GLOBAL_DATETIME_SPINNER_MONTH	Più di un mese	
GLOBAL_DATETIME_SPINNER_SECONDS	{0} |4(secondo,secondi)	
GLOBAL_DATETIME_SPINNER_WEEKS	{0} |4(settimana,settimane)	
GLOBAL_DATETIME_SPLASHSCREEN_DAY	> 1 giorno	
GLOBAL_DATETIME_SPLASHSCREEN_DAYS	{0} |4(giorno,giorni)	
GLOBAL_DATETIME_SPLASHSCREEN_HOURS	{0} |4(ora,ore)	
GLOBAL_DATETIME_SPLASHSCREEN_MINUTES	{0} |4(minuto,minuti)	
GLOBAL_DATETIME_SPLASHSCREEN_MONTH	Più di un mese	
GLOBAL_DATETIME_SPLASHSCREEN_SECONDS	< 1 min	
GLOBAL_DATETIME_SPLASHSCREEN_WEEKS	{0} |4(settimana,settimane)	
GLOBAL_DATETIME_UNLOCKS_SOON_WEEKS	Sbloccato fra {0} |4(settimana,settimane)	
GLOBAL_DECK_SHARE_ACCEPT_REQUEST	Condividi	
GLOBAL_DECK_SHARE_DECLINE_REQUEST	No, grazie!	
GLOBAL_DECK_SHARE_ERROR	Errore durante la condivisione dei mazzi.	
GLOBAL_DECK_SHARE_HEADER	Richiesta mazzi	
GLOBAL_DECK_SHARE_REQUEST_CANCELED	{0} ha annullato la sua richiesta di condivisione dei mazzi.	0=friend name
GLOBAL_DECK_SHARE_REQUEST_DECLINED	{0} ha rifiutato la tua richiesta di condivisione dei mazzi.	0=friend name
GLOBAL_DECK_SHARE_REQUEST_WAITING_RESPONSE	In attesa che {0} risponda alla tua richiesta di condivisione dei mazzi.	
GLOBAL_DECK_SHARE_REQUESTED	{0} vorrebbe avere in prestito uno dei tuoi mazzi.	0=friend name
GLOBAL_DEFAULT_ALERT_HEADER	Avviso	
GLOBAL_DEMO_COMPLETE_BODY	Grazie per aver giocato a questa demo di Hearthstone!	
GLOBAL_DEMO_COMPLETE_HEADER	Congratulazioni!	
GLOBAL_DEMO_DISCLAIMER	Questa versione di Hearthstone è stata creata unicamente per ragioni dimostrative.	
GLOBAL_DEMO_LEARN_MORE	Maggiori informazioni	
GLOBAL_DISABLE	Disattiva	
GLOBAL_DONE	Fine	
GLOBAL_ENABLE	Attiva	
GLOBAL_END_GAME	Termina partita	
GLOBAL_ENTER	Avvia	
GLOBAL_ERROR	Errore	
GLOBAL_ERROR_ACCOUNT_LICENSES	Abbiamo avuto dei problemi a recuperare i dati del tuo account e qualcosa potrebbe mancare all'appello. Rieseguiremo il controllo la prossima volta che ti connetterai!	
GLOBAL_ERROR_ASSET_CREATE_PERSISTENT_DATA_PATH	Impossibile creare una cartella per salvare i dati in {0}.	0=folder path
GLOBAL_ERROR_ASSET_DOWNLOAD_FAILED	Impossibile scaricare l'elemento {0}.	0=asset name
GLOBAL_ERROR_ASSET_INCORRECT_DATA	L'elemento {0} contiene dati errati.	0=asset name
GLOBAL_ERROR_ASSET_LOAD_FAILED	Impossibile caricare l'elemento {0}.	0=asset name
GLOBAL_ERROR_ASSET_MANIFEST	Impossibile caricare il manifesto dati	
GLOBAL_ERROR_ASSET_NO_FILE_PATH	Impossibile trovare il percorso per l'elemento {0}.	0=asset name
GLOBAL_ERROR_CURRENCY_INVALID	È stato richiesto l'utilizzo di una valuta non valida per l'acquisto.	
GLOBAL_ERROR_FIND_GAME_SCENARIO_INCORRECT_NUM_PLAYERS	Errore durante l'avvio della partita! Lo scenario ha un numero inatteso di giocatori.	
GLOBAL_ERROR_FIND_GAME_SCENARIO_MISCONFIGURED	Errore durante l'avvio della partita! I dati dello scenario non sono corretti.	
GLOBAL_ERROR_FIND_GAME_SCENARIO_NO_DECK_SPECIFIED	Errore durante l'avvio della partita! Nessun mazzo specificato da un giocatore.	
GLOBAL_ERROR_GAME_DENIED	Errore durante l'avvio della partita! Attendi qualche minuto e riprova.	
GLOBAL_ERROR_GAME_OPPONENT_TIMEOUT	La partita non si è avviata poiché l'avversario non si è connesso. Riprova.	
GLOBAL_ERROR_GENERIC_HEADER	Errore	
GLOBAL_ERROR_INACTIVITY_KICK	È passato molto tempo dalla tua ultima azione su Hearthstone e sei stato disconnesso dal server. Riavvia il gioco quando sei pronto!	
GLOBAL_ERROR_NETWORK_ACCOUNT_BANNED	Il tuo account è stato sospeso permanentemente.	
GLOBAL_ERROR_NETWORK_ACCOUNT_CURFEW_REACHED	[Contro la dipendenza] In accordo con le pertinenti regole e leggi nazionali, i giocatori minorenni non possono effettuare l'accesso al gioco dalle 22:00 alle 08:00 del giorno successivo.	
GLOBAL_ERROR_NETWORK_ACCOUNT_INVALID_NID	Non puoi procedere finché non superi la verifica del nome reale. Per ulteriori informazioni, consulta la pagina https://www.battlenet.com.cn/support/zh/article/210633.	
GLOBAL_ERROR_NETWORK_ACCOUNT_PLAYTIME_EXCEEDED	[Contro la dipendenza] In accordo con le pertinenti regole e leggi nazionali, il tempo giornaliero trascorso online per i giocatori minorenni non dovrebbe superare un'ora e mezza. Quest'oggi hai raggiunto il tuo limite di tempo online. Organizza il tuo tempo di gioco in maniera responsabile.	
GLOBAL_ERROR_NETWORK_ACCOUNT_SUSPENDED	Il tuo account è stato sospeso.	
GLOBAL_ERROR_NETWORK_ADMIN_KICKED	Sei stato rimosso dal servizio di gioco Blizzard. Riavvia Hearthstone per riconnetterti.	
GLOBAL_ERROR_NETWORK_ADVENTURE_RECONNECT_TIMEOUT	La tua partita è stata salvata. Riavvia Hearthstone per riprendere da dove avevi lasciato.	
GLOBAL_ERROR_NETWORK_CONNECTION_TIMEOUT	Richiesta di connessione scaduta. Controlla la connessione a Internet.	
GLOBAL_ERROR_NETWORK_DISCONNECT	Sei stato disconnesso dal servizio di gioco Blizzard. Riavvia Hearthstone per riconnetterti.	
GLOBAL_ERROR_NETWORK_DISCONNECT_GAME_SERVER	Sei stato disconnesso dal servizio di gioco di Hearthstone.	
GLOBAL_ERROR_NETWORK_DISCONNECT_GENERIC	Sei stato disconnesso.	
GLOBAL_ERROR_NETWORK_DUPLICATE_LOGIN	Questo account Blizzard si è appena connesso a Hearthstone da un'altra periferica.\n\nQuesto client è stato disconnesso poiché può essere attiva una sola connessione alla volta.	
GLOBAL_ERROR_NETWORK_GENERIC	Si è verificato un errore di rete interno.	
GLOBAL_ERROR_NETWORK_INCORRECT_REGION	Il tuo account Blizzard non soddisfa i requisiti per partecipare al beta test di Hearthstone di questa regione. Riprova quando la beta di Hearthstone sarà disponibile nella tua regione!	
GLOBAL_ERROR_NETWORK_LOGIN_FAILURE	Impossibile connettersi al servizio di gioco Blizzard. Attendi un paio di minuti e riprova.	
GLOBAL_ERROR_NETWORK_LOST_GAME_CONNECTION	Sei stato disconnesso dal servizio di gioco Blizzard. Puoi provare a riconnetterti avviando una nuova partita.	
GLOBAL_ERROR_NETWORK_NO_CONNECTION	Impossibile connettersi. Controlla la connessione a Internet.	
GLOBAL_ERROR_NETWORK_NO_GAME_SERVER	Oops! Non è stato possibile creare la tua partita. Riprova.	
GLOBAL_ERROR_NETWORK_PARENTAL_CONTROLS	L'accesso a questo account è attualmente limitato dal controllo parentale.	
GLOBAL_ERROR_NETWORK_PHONE_LOCK	Chiama il numero Phone Lock di Blizzard per effettuare l'accesso.\nTaiwan: 0800-303-585\nHong Kong: 396-54666	
GLOBAL_ERROR_NETWORK_RISK_ACCOUNT_LOCKED	Abbiamo bloccato il tuo account! Vai su https://eu.battle.net/support/it/ e cerca l’articolo 7537 per saperne di più!	
GLOBAL_ERROR_NETWORK_SPAM	Sei stato disconnesso dal servizio di gioco Blizzard per aver inviato troppe richieste in breve tempo. Riavvia Hearthstone per riconnetterti.	
GLOBAL_ERROR_NETWORK_TITLE	ERRORE DI RETE	
GLOBAL_ERROR_NETWORK_UNAVAILABLE_NEW_VERSION	Il tuo account sta utilizzando una versione più recente del gioco. Attendi l'aggiornamento prima di giocare su questo dispositivo.	
GLOBAL_ERROR_NETWORK_UNAVAILABLE_OFFLINE	Hearthstone non è al momento disponibile. Attendi qualche minuto e riprova.	
GLOBAL_ERROR_NETWORK_UNAVAILABLE_UNKNOWN	Ooops! Dei folletti dispettosi sono intervenuti mentre Hearthstone si collegava ai nostri server. Aspetta che se che se ne vadano e riprova fra qualche minuto.	
GLOBAL_ERROR_NETWORK_UNAVAILABLE_UPGRADE	Hearthstone è stato aggiornato! Scarica la versione più recente.	
GLOBAL_ERROR_NETWORK_UTIL_TIMEOUT	Richiesta di connessione scaduta durante la ricezione di dati dal servizio di Hearthstone. Riavvia Hearthstone per riconnetterti.	
GLOBAL_ERROR_NO_MAGE_PRECON	Ci deve essere stato un problema di connessione mentre caricavamo le carte della tua collezione. Riavvia Hearthstone per recuperare le carte perdute e ricominciare a giocare!	
GLOBAL_ERROR_STREAMING_ASSET_TIMEOUT	Tempo scaduto in attesa del sistema di streaming. Elemento in caricamento: {0}.	0=asset name
GLOBAL_ERROR_UNKNOWN_ERROR	Ooops! Dei folletti dispettosi sono intervenuti mentre Hearthstone si collegava al servizio di gioco Blizzard. Rimani qualche minuto in attesa che se ne vadano e prova a rilanciare il gioco.	
GLOBAL_EXIT	Esci	
GLOBAL_FEATURE_DISABLED_MESSAGE_BATTLEGROUNDS	Spiacenti, la Battaglia al momento è disabilitata.	
GLOBAL_FEATURE_DISABLED_MESSAGE_COLLECTION	Spiacenti, la collezione non è al momento disponibile.	
GLOBAL_FEATURE_DISABLED_MESSAGE_FORGE	Spiacenti, l'Arena non è al momento disponibile.	
GLOBAL_FEATURE_DISABLED_MESSAGE_PLAY	Spiacenti, la modalità Gioco non è al momento disponibile.	
GLOBAL_FEATURE_DISABLED_MESSAGE_PRACTICE	Spiacenti, la modalità Allenamento non è al momento disponibile.	
GLOBAL_FEATURE_DISABLED_TITLE	Disattivato	
GLOBAL_FINISH	Fine	
GLOBAL_FIRESIDE_BRAWL	Rissa Fireside	
GLOBAL_FIRESIDE_GATHERING	Fireside Gathering	
GLOBAL_FIRESIDE_GATHERING_CHOOSE_HEADER	Scegli un'opzione	
GLOBAL_FIRESIDE_GATHERING_DEFAULT_TAVERN_NAME	Fireside Gathering	
GLOBAL_FIRESIDE_GATHERING_FIRST_TIME_TAVERN_NAME	Locanda di {0}	0=innkeeper battle tag
GLOBAL_FIRESIDE_GATHERING_PATRON_LIST_FOOTER_TEXT_LARGE_SCALE	Più di {0} giocatori a questo Gathering.	This is shown on the Friends List button whenever player is checked into a large scale Fireside Gathering (one that doesn't show the full patron list). the design decision was to show 99+ regardless of how many people are actually checked in.
GLOBAL_FIRESIDE_GATHERING_PATRON_LIST_FOOTER_TEXT_SOFT_LIMIT	{0} giocatori a questo Gathering.	0=The number of patrons up to 99.
GLOBAL_FIRESIDE_GATHERING_REUNPACK	Modifica configurazione	
GLOBAL_FIRESIDE_GATHERING_SOCIAL_BUTTON_LARGE_SCALE_LABEL	<size=32>99<size=26>+</size></size>	This is shown on the Friends List button whenever player is checked into a large scale Fireside Gathering (one that doesn't show the full patron list). the design decision was to show 99+ regardless of how many people are actually checked in. NOTE: the size tag was used in enUS to shrink the + sign, to make sure 99+ fit into the small button.
GLOBAL_FORGE_END_DONE	Fine	
GLOBAL_FORGE_END_JOKE_0	Davvero sbalorditivo!	
GLOBAL_FORGE_END_JOKE_1	Non ho parole!	
GLOBAL_FORGE_END_JOKE_2	Non riesco a crederci!	
GLOBAL_FORGE_END_JOKE_3	Hai delle capacità uniche.	
GLOBAL_FORGE_END_JOKE_4	Riuscirai a ripeterti?	
GLOBAL_FORGE_END_JOKE_5	Davvero indimenticabile!	
GLOBAL_FORGE_END_JOKE_6	Che cosa incredibile!	
GLOBAL_FORGE_END_JOKE_7	Ammirevole!	
GLOBAL_FORGE_END_JOKE_8	Non è ancora finita! No, aspetta, è davvero finita.	
GLOBAL_FORGE_END_TITLE	Arena completata	
GLOBAL_FRIEND_CHALLENGE_ACCEPT	Accetta	
GLOBAL_FRIEND_CHALLENGE_BODY_BACON	Sei stato invitato a unirti a\nun gruppo per la Battaglia da:	
GLOBAL_FRIEND_CHALLENGE_BODY1	Hai ricevuto una sfida da:	
GLOBAL_FRIEND_CHALLENGE_BODY1_STANDARD	Hai ricevuto una sfida in formato Standard da:	
GLOBAL_FRIEND_CHALLENGE_BODY1_WILD	Hai ricevuto una sfida\nin formato Selvaggio da:	
GLOBAL_FRIEND_CHALLENGE_BODY2	Vuoi accettarla?	
GLOBAL_FRIEND_CHALLENGE_DECLINE	Rifiuta	
GLOBAL_FRIEND_CHALLENGE_FIRESIDE_BRAWL_BODY1	Hai ricevuto un invito per una Rissa Fireside da:	
GLOBAL_FRIEND_CHALLENGE_HEADER	Sfida!	
GLOBAL_FRIEND_CHALLENGE_NEARBY_PLAYER_NOTE	Puoi disattivare le sfide dei giocatori vicini dall'elenco amici.	
GLOBAL_FRIEND_CHALLENGE_OPPONENT_CANCELED	{0} ha annullato la sfida.	0=friend name
GLOBAL_FRIEND_CHALLENGE_OPPONENT_DECLINED	{0} ha rifiutato la sfida.	0=friend name
GLOBAL_FRIEND_CHALLENGE_OPPONENT_FRIEND_REMOVED	Sfida annullata poiché {0} non è più tuo amico.	0=friend name
GLOBAL_FRIEND_CHALLENGE_OPPONENT_WAITING_DECK	Sei in attesa che {0} selezioni un mazzo.	0=friend name
GLOBAL_FRIEND_CHALLENGE_OPPONENT_WAITING_RESPONSE	Sei in attesa che {0} risponda alla tua sfida.	0=friend name
GLOBAL_FRIEND_CHALLENGE_QUEUE_CANCELED	La sfida è stata annullata.	
GLOBAL_FRIEND_CHALLENGE_TAVERN_BRAWL_BODY1	Hai ricevuto un invito a partecipare a una Rissa da:	
GLOBAL_FRIEND_CHALLENGE_TAVERN_BRAWL_HEADER	Rissa	
GLOBAL_FRIEND_CHALLENGE_TAVERN_BRAWL_OPPONENT_WAITING_READY	Sei in attesa che {0} si unisca alla Rissa.	0=friend name
GLOBAL_FRIEND_CHALLENGE_TAVERN_BRAWL_RECIPIENT_NO_VALID_DECK_RECIPIENT	{0} vuole sfidarti a una Rissa! Crea un mazzo Rissa per accettare la sfida.	
GLOBAL_FRIEND_CHALLENGE_TAVERN_BRAWL_RECIPIENT_NO_VALID_DECK_SENDER	Il tuo amico non ha ancora un mazzo Rissa. Riprova quando lo avrà creato.	
GLOBAL_FRIEND_CHALLENGE_TAVERN_BRAWL_RECIPIENT_NOT_UNLOCKED_SENDER	Il tuo amico non ha ancora sbloccato la modalità Rissa. Riprova quando lo avrà fatto.	
GLOBAL_FRIEND_CHALLENGE_TITLE	Sfida	
GLOBAL_FRIENDLIST_ADD_FRIEND_BUTTON	Aggiungi	
GLOBAL_FRIENDLIST_BATTLEGROUNDS_TOOLTIP_INVITE_BODY	Invita {0} a giocare in Battaglia con te.	0=player name
GLOBAL_FRIENDLIST_BATTLEGROUNDS_TOOLTIP_INVITE_HEADER	Invita	
GLOBAL_FRIENDLIST_BATTLEGROUNDS_TOOLTIP_KICK_BODY	Rimuovi {0} dal tuo gruppo per la Battaglia.	0=player name
GLOBAL_FRIENDLIST_BATTLEGROUNDS_TOOLTIP_KICK_HEADER	Rimuovi	
GLOBAL_FRIENDLIST_BUSYSTATUS	Occupato	
GLOBAL_FRIENDLIST_CHALLENGE_BUTTON_AVAILABLE	Sfida {0} a una partita a Hearthstone.	0=player name
GLOBAL_FRIENDLIST_CHALLENGE_BUTTON_BATTLEGROUNDS_LOCKED	Completa il tutorial della Battaglia per sbloccare questa modalità.	
GLOBAL_FRIENDLIST_CHALLENGE_BUTTON_BATTLEGROUNDS_PARTY_MEMBER	Non puoi sfidare altri giocatori mentre sei in gruppo per la Battaglia.	
GLOBAL_FRIENDLIST_CHALLENGE_BUTTON_EARLY_ACCESS	Al momento questa modalità è in accesso anticipato.	
GLOBAL_FRIENDLIST_CHALLENGE_BUTTON_HEADER	Sfida	
GLOBAL_FRIENDLIST_CHALLENGE_BUTTON_IM_APPEARING_OFFLINE	Non puoi sfidare {0} in questo momento. Sei impostato come invisibile.	0=player name
GLOBAL_FRIENDLIST_CHALLENGE_BUTTON_IM_UNAVAILABLE	Non puoi sfidare {0} in questo momento. Ritorna al menu principale.	0=player name
GLOBAL_FRIENDLIST_CHALLENGE_BUTTON_MODE_UNAVAILABLE	Al momento non è possibile sfidare un amico in questa modalità.	
GLOBAL_FRIENDLIST_CHALLENGE_BUTTON_TAVERN_BRAWL_LOCKED	Completa il tutorial dell'Hearthstone tradizionale e porta una classe al livello 20 per sbloccare questa modalità.	
GLOBAL_FRIENDLIST_CHALLENGE_BUTTON_THEYRE_UNAVAILABLE	Non puoi sfidare {0} in questo momento. Aspetta che ritorni al menu principale.	0=player name
GLOBAL_FRIENDLIST_CHALLENGE_BUTTON_TRADITIONAL_LOCKED	Completa il tutorial dell'Hearthstone tradizionale per sbloccare questa modalità.	
GLOBAL_FRIENDLIST_CHALLENGE_CHALLENGEE_NO_BATTLEGROUNDS_EARLY_ACCESS	Questo giocatore non dispone dell'accesso anticipato alla Battaglia.	
GLOBAL_FRIENDLIST_CHALLENGE_CHALLENGEE_NO_CLASSIC_DECK	Questo giocatore non ha mazzi Classici.	
GLOBAL_FRIENDLIST_CHALLENGE_CHALLENGEE_NO_DECK	Questo giocatore non ha mazzi.	
GLOBAL_FRIENDLIST_CHALLENGE_CHALLENGEE_NO_STANDARD_DECK	Questo giocatore non ha mazzi Standard.	
GLOBAL_FRIENDLIST_CHALLENGE_CHALLENGEE_NO_TAVERN_BRAWL_DECK	Questo giocatore non ha ancora composto un mazzo per la Rissa.	
GLOBAL_FRIENDLIST_CHALLENGE_CHALLENGEE_NOT_SEEN_WILD	Questo giocatore non ha sbloccato il formato Selvaggio.	
GLOBAL_FRIENDLIST_CHALLENGE_CHALLENGEE_TAVERN_BRAWL_LOCKED	Questo giocatore non ha ancora sbloccato la Rissa.	
GLOBAL_FRIENDLIST_CHALLENGE_CHALLENGEE_USER_IS_BUSY	Questo giocatore al momento è occupato.	
GLOBAL_FRIENDLIST_CHALLENGE_CHALLENGER_NO_CLASSIC_DECK	Non possiedi alcun mazzo Classico.	
GLOBAL_FRIENDLIST_CHALLENGE_CHALLENGER_NO_DECK	Devi prima comporre un mazzo.	
GLOBAL_FRIENDLIST_CHALLENGE_CHALLENGER_NO_STANDARD_DECK	Non hai alcun mazzo Standard.	
GLOBAL_FRIENDLIST_CHALLENGE_CHALLENGER_NO_TAVERN_BRAWL_DECK	Per la Rissa di questa settimana, devi prima comporre un mazzo.	
GLOBAL_FRIENDLIST_CHALLENGE_CHALLENGER_TAVERN_BRAWL_LOCKED	Sblocca la Rissa raggiungendo il livello 20 con qualsiasi classe.	
GLOBAL_FRIENDLIST_CHALLENGE_MENU_CLASSIC_DUEL_BUTTON	Classico	
GLOBAL_FRIENDLIST_CHALLENGE_MENU_DUEL_BUTTON	Sfida	
GLOBAL_FRIENDLIST_CHALLENGE_MENU_STANDARD_DUEL_BUTTON	Standard	
GLOBAL_FRIENDLIST_CHALLENGE_MENU_WILD_DUEL_BUTTON	Selvaggio	
GLOBAL_FRIENDLIST_CHALLENGE_TOOLTIP_NO_TAVERN_BRAWL	La Rissa non è al momento disponibile. Riprova più tardi!	
GLOBAL_FRIENDLIST_CHALLENGE_TOOLTIP_TAVERN_BRAWL_NOT_CHALLENGEABLE	Non è possibile sfidare un amico durante questa Rissa.	
GLOBAL_FRIENDLIST_CURRENT_GAMES_HEADER	PARTITE IN CORSO - {0}	0=number of friends you have unfinished games with
GLOBAL_FRIENDLIST_FRIENDS_HEADER	AMICI - {0}/{1} online	0=number of online friends 1=number of offline friends
GLOBAL_FRIENDLIST_FRIENDS_HEADER_ALL_ONLINE	AMICI - {0} online	
GLOBAL_FRIENDLIST_LASTPLAYED	Ultima partita:	
GLOBAL_FRIENDLIST_MYSTATUS	ONLINE	
GLOBAL_FRIENDLIST_NEARBY_PLAYERS_DISABLED_HEADER	VICINI (Disattivato)	
GLOBAL_FRIENDLIST_NEARBY_PLAYERS_HEADER	VICINI - {0}	0=number of players
GLOBAL_FRIENDLIST_REMOVE_FRIEND_ALERT_MESSAGE	Vuoi davvero rimuovere {0}?	0=friend name
GLOBAL_FRIENDLIST_REMOVE_FRIEND_BUTTON	Rimuovi	
GLOBAL_FRIENDLIST_REQUEST_SENT_TIME	Inviata: {0}	0=one of the GLOBAL_DATETIME_ELAPSED_ strings
GLOBAL_FRIENDLIST_REQUESTS_HEADER	RICHIESTE D'AMICIZIA - {0}	0=number of received friend requests
GLOBAL_FRIENDLIST_SPECTATE_MENU_DESCRIPTION	{0} sta giocando una partita.	0=player name
GLOBAL_FRIENDLIST_SPECTATE_TOOLTIP_AVAILABLE_HEADER	Osserva questa partita	
GLOBAL_FRIENDLIST_SPECTATE_TOOLTIP_AVAILABLE_TEXT	Clicca qui per iniziare a osservare la partita di questo giocatore.	
GLOBAL_FRIENDLIST_SPECTATE_TOOLTIP_AVAILABLE_TEXT_TOUCH	Tocca qui per iniziare a osservare la partita di questo giocatore.	
GLOBAL_FRIENDLIST_SPECTATE_TOOLTIP_INVITE_HEADER	Invita a osservare	
GLOBAL_FRIENDLIST_SPECTATE_TOOLTIP_INVITE_OTHER_SIDE_HEADER	Sta osservando la partita dell'avversario	
GLOBAL_FRIENDLIST_SPECTATE_TOOLTIP_INVITE_OTHER_SIDE_TEXT	Clicca per mostrare le tue carte anche a {0}.	0=player name
GLOBAL_FRIENDLIST_SPECTATE_TOOLTIP_INVITE_OTHER_SIDE_TEXT_TOUCH	Tocca per mostrare le tue carte a {0}.	0=player name
GLOBAL_FRIENDLIST_SPECTATE_TOOLTIP_INVITE_TEXT	Invita {0} a osservarti.	0=player name
GLOBAL_FRIENDLIST_SPECTATE_TOOLTIP_INVITED_HEADER	Invitato a osservare	
GLOBAL_FRIENDLIST_SPECTATE_TOOLTIP_INVITED_TEXT	{0} è stato invitato a osservare.	0=player name
GLOBAL_FRIENDLIST_SPECTATE_TOOLTIP_KICK_HEADER	Rimuovi	
GLOBAL_FRIENDLIST_SPECTATE_TOOLTIP_KICK_TEXT	{0} ti sta osservando. Clicca qui per rimuovere questo spettatore.	
GLOBAL_FRIENDLIST_SPECTATE_TOOLTIP_KICK_TEXT_TOUCH	{0} ti sta osservando. Tocca qui per rimuovere questo spettatore.	
GLOBAL_FRIENDLIST_SPECTATE_TOOLTIP_PREVIOUSLY_KICKED_HEADER	Impossibile osservare	
GLOBAL_FRIENDLIST_SPECTATE_TOOLTIP_PREVIOUSLY_KICKED_TEXT	In precedenza ti è stato impedito di osservare questo giocatore. Non puoi provare a osservarlo nuovamente.	
GLOBAL_FRIENDLIST_SPECTATE_TOOLTIP_RECEIVED_INVITE_TEXT	{0} ti ha invitato a osservare. Clicca qui per iniziare.	
GLOBAL_FRIENDLIST_SPECTATE_TOOLTIP_RECEIVED_INVITE_TEXT_TOUCH	{0} ti ha invitato a osservare. Tocca qui per iniziare.	
GLOBAL_FRIENDLIST_SPECTATE_TOOLTIP_SPECTATING_HEADER	In modalità spettatore	
GLOBAL_FRIENDLIST_SPECTATE_TOOLTIP_SPECTATING_TEXT	Stai attualmente osservando la partita di questo giocatore.	
GLOBAL_FRIENDLYCHALLENGE_QUEST_REWARD_AT_LIMIT	Hai raggiunto il limite giornaliero di ricompense con le sfide tra amici.	
GLOBAL_FRIENDLYCHALLENGE_REWARD_CONCEDED_YOUR_OPPONENT	Il tuo avversario ha abbandonato la partita troppo presto. Non otterrai alcuna ricompensa.	
GLOBAL_FRIENDLYCHALLENGE_REWARD_CONCEDED_YOURSELF	Hai abbandonato la partita troppo presto. Non otterrai alcuna ricompensa.	
GLOBAL_GAME_MENU	Menu	
GLOBAL_GAME_QUEUE_TIME_IN_QUEUE	Tempo in coda	
GLOBAL_GAME_QUEUE_WAIT_TIME	Attesa	
GLOBAL_GOLD_REWARD_ALREADY_CAPPED	Hai già guadagnato {0} oro oggi.	
GLOBAL_GOLD_REWARD_BAD_RATING	Tu o il tuo avversario non avete raggiunto il livello minimo richiesto per guadagnare oro.	
GLOBAL_GOLD_REWARD_OVER_CAIS	Non puoi ottenere altro oro a causa del CAIS.	
GLOBAL_GOLD_REWARD_SHORT_GAME_BY_TIME	La tua partita non è durata abbastanza per farti guadagnare oro.	
GLOBAL_HEALTH	Salute	
GLOBAL_HEALTHY_GAMING_CHINA_CAIS_ACTIVE	CAIS attivo	
GLOBAL_HEALTHY_GAMING_CHINA_LESS_THAN_THREE_HOURS	您累计在线时间已满{0}小时。	
GLOBAL_HEALTHY_GAMING_CHINA_MORE_THAN_FIVE_HOURS	您已进入不健康游戏时间，为了您的健康，请您立即下线休息。如不下线，您的身体将受到损害，您的收益已降为零，直到您的累计下线时间满5小时后，才能恢复正常。	
GLOBAL_HEALTHY_GAMING_CHINA_MORE_THAN_FIVE_HOURS_PHONE	您已进入不健康游戏时间，为了您的健康，请您立即下线休息。如不下线，您的身体将受到损害，\n您的收益已降为零，直到您的累计下线时间满5小时后，才能恢复正常。	
GLOBAL_HEALTHY_GAMING_CHINA_STARTUP_MESSAGE	抵制不良游戏，拒绝盗版游戏。\n注意自我保护，谨防上当受骗。\n适度游戏益脑，沉迷游戏伤身。\n合理安排时间，享受健康生活。	
GLOBAL_HEALTHY_GAMING_CHINA_STARTUP_SUBTEXT	ISBN：978-7-900262-36-3 版署批号：新出审字[2013]1510号 沪网文[2017]9633-727号 文网进字[2013]029号 著作权：暴雪娱乐有限公司 出版单位：金报电子音像出版中心	
GLOBAL_HEALTHY_GAMING_CHINA_THREE_HOURS	您累计在线时间已满{0}小时，请您下线休息，做适当身体活动。	
GLOBAL_HEALTHY_GAMING_CHINA_THREE_TO_FIVE_HOURS	您已经进入疲劳游戏时间，您的游戏收益将降为正常值的0%，为了您的健康，请尽快下线休息，做适当身体活动，合理安排学习生活。	
GLOBAL_HEALTHY_GAMING_CHINA_THREE_TO_FIVE_HOURS_PHONE	您已经进入疲劳游戏时间，您的游戏收益将降为正常值的0%，为了您的健康，\n请尽快下线休息，做适当身体活动，合理安排学习生活。	
GLOBAL_HEALTHY_GAMING_KOREA_STARTUP_MESSAGE	본 게임물은 만 12세 이용가 게임으로서 해당 연령 미만의 청소년이 이용하기에 부적절합니다. 반드시 보호자의 지도 감독이 필요합니다.	
GLOBAL_HEALTHY_GAMING_TOAST	게임을 플레이한지 {0}시간 지났습니다. 과도한 게임이용은 정상적인 일상생활에 지장을 줄 수 있습니다	
GLOBAL_HEALTHY_GAMING_TOAST_OVER_THRESHOLD	Stai giocando da {0} |4(ora,ore). È davvero un sacco di tempo!	0=hours
GLOBAL_HELP	Aiuto	
GLOBAL_HERO_LEVEL_NEXT_REWARD_TITLE	Ricompensa al livello {0}	0=level
GLOBAL_HERO_LEVEL_REWARD_ARCANE_DUST	{0} Polvere Arcana	0=amount
GLOBAL_HERO_LEVEL_REWARD_BOOSTER	{0} |4(busta,buste)	0=booster type
GLOBAL_HERO_LEVEL_REWARD_GOLD	{0} oro	0=amount
GLOBAL_HERO_LEVEL_REWARD_GOLDEN_CARD	{1} {0}	0=flair 1=card name
GLOBAL_HERO_WINS	Vittorie: {0}/{1}	0=number of games this class has won 1=number of wins to get golden
GLOBAL_HERO_WINS_PAST_MAX	Vittorie: {0}	0=number of games this class has won
GLOBAL_HERO_WINS_PAST_MAX_PHONE	Vittorie\n{0}	0=number of games this class has won
GLOBAL_HERO_WINS_PHONE	Vittorie: {0}/{1}	0=number of games this class has won 1=number of wins to get golden
GLOBAL_HEROIC_BRAWL	Rissa Eroica	
GLOBAL_HIDE	Nascondi	
GLOBAL_IN_PROGRESS_REWARD_CHEST_INSTRUCTIONS	Vinci ancora {0} |4(partita,partite) per ottenere il forziere stagionale!\n(Verrà sbloccato il prossimo mese)	
GLOBAL_JOIN	Partecipa	
GLOBAL_KEYWORD_ADAPT	Adattamento	
GLOBAL_KEYWORD_ADAPT_TEXT	Scegli uno dei tre potenziamenti.	
GLOBAL_KEYWORD_AUTOATTACK	Azione Automatica	
GLOBAL_KEYWORD_AUTOATTACK_TEXT	Non può attaccare, ma attiva l'effetto alla fine del tuo turno.	
GLOBAL_KEYWORD_AUTOCAST	Lancio automatico	
GLOBAL_KEYWORD_AUTOCAST_TEXT	Questo Potere Eroe DEVE essere usato ogni turno.	
GLOBAL_KEYWORD_AVENGE	Vendetta (X)	
GLOBAL_KEYWORD_AVENGE_TEXT	Fa qualcosa dopo che X tuoi servitori sono morti.	
GLOBAL_KEYWORD_BATTLECRY	Grido di Battaglia	
GLOBAL_KEYWORD_BATTLECRY_TEXT	Attiva l'effetto quando la carta viene giocata dalla mano.	
GLOBAL_KEYWORD_BLOOD_GEM	Gemma del Sangue	
GLOBAL_KEYWORD_BLOOD_GEM_TEXT	Una Magia che fornisce +1/+1 a un tuo servitore.	
GLOBAL_KEYWORD_BOSS	Boss	
GLOBAL_KEYWORD_BOSS_TEXT	I giocatori stanno combattendo assieme per sconfiggere un Boss.	
GLOBAL_KEYWORD_CASTS_WHEN_DRAWN	Lancio Quando Pescata	
GLOBAL_KEYWORD_CASTS_WHEN_DRAWN_TEXT	Viene lanciata quando viene pescata, poi peschi un'altra carta.	
GLOBAL_KEYWORD_CHARGE	Carica	
GLOBAL_KEYWORD_CHARGE_TEXT	Può attaccare immediatamente.	
GLOBAL_KEYWORD_COMBO	Combo	
GLOBAL_KEYWORD_COMBO_TEXT	Un bonus che si ottiene quando è già stata giocata una carta nel turno.	
GLOBAL_KEYWORD_CORRUPT	Corruzione	
GLOBAL_KEYWORD_CORRUPT_TEXT	Potenzia la carta nella mano dopo che hai giocato una carta con costo superiore.	
GLOBAL_KEYWORD_CORRUPTEDCARD	Corrotta	
GLOBAL_KEYWORD_CORRUPTEDCARD_TEXT	Potenziata da una carta con costo superiore.	
GLOBAL_KEYWORD_COUNTER	Contrasto	
GLOBAL_KEYWORD_COUNTER_TEXT	Una carta che viene Contrastata non ha effetto.	
GLOBAL_KEYWORD_CTHUN	C'thun, Dio Antico	
GLOBAL_KEYWORD_CTHUN_TEXT	C'thun riceve i potenziamenti dovunque sia, anche se si trova ancora nel tuo mazzo!	
GLOBAL_KEYWORD_DEATHRATTLE	Rantolo di Morte	
GLOBAL_KEYWORD_DEATHRATTLE_TEXT	Attiva l'effetto quando muore.	
GLOBAL_KEYWORD_DISCOVER	Rinvenimento	
GLOBAL_KEYWORD_DISCOVER_TEXT	Scegli una delle tre carte e mettila nella tua mano.	
GLOBAL_KEYWORD_DIVINE_SHIELD	Scudo Divino	
GLOBAL_KEYWORD_DIVINE_SHIELD_REF_TEXT	La prima volta che un servitore protetto subisce danni, vengono ignorati.	
GLOBAL_KEYWORD_DIVINE_SHIELD_TEXT	La prima volta che questo servitore subisce danni, vengono ignorati.	
GLOBAL_KEYWORD_DORMANT	Dormiente	
GLOBAL_KEYWORD_DORMANT_TEXT	Intoccabile per entrambi i giocatori.	
GLOBAL_KEYWORD_ECHO	Eco	
GLOBAL_KEYWORD_ECHO_TEXT	Può essere giocata più volte nello stesso turno. Le copie non possono costare meno di (1).	
GLOBAL_KEYWORD_EMPOWER	Invocazione	
GLOBAL_KEYWORD_EMPOWER_PRIEST	Invocazione: Sacerdote	
GLOBAL_KEYWORD_EMPOWER_PRIEST_TEXT	Usa il potere di Galakrond. <i>(Mette un servitore casuale del Sacerdote nella tua mano.)</i>	
GLOBAL_KEYWORD_EMPOWER_ROGUE	Invocazione: Ladro	
GLOBAL_KEYWORD_EMPOWER_ROGUE_COLLECTION_TEXT	Usa il potere di Galakrond. <i>(Mette un Lacchè nella tua mano.)</i>	
GLOBAL_KEYWORD_EMPOWER_ROGUE_TEXT	Usa il potere di Galakrond. <i>(Mette un <b>Lacchè</b> nella tua mano.)</i>	
GLOBAL_KEYWORD_EMPOWER_SHAMAN	Invocazione: Sciamano	
GLOBAL_KEYWORD_EMPOWER_SHAMAN_COLLECTION_TEXT	Usa il potere di Galakrond. <i>(Evoca un Elementale 2/1 con Assalto.)</i>	
GLOBAL_KEYWORD_EMPOWER_SHAMAN_TEXT	Usa il potere di Galakrond. <i>(Evoca un Elementale 2/1 con <b>Assalto</b>.)</i>	
GLOBAL_KEYWORD_EMPOWER_TEXT	Usa il potere di Galakrond.	
GLOBAL_KEYWORD_EMPOWER_WARLOCK	Invocazione: Stregone	
GLOBAL_KEYWORD_EMPOWER_WARLOCK_TEXT	Usa il potere di Galakrond. <i>(Evoca due Imp 1/1.)</i>	
GLOBAL_KEYWORD_EMPOWER_WARRIOR	Invocazione: Guerriero	
GLOBAL_KEYWORD_EMPOWER_WARRIOR_TEXT	Usa il potere di Galakrond. <i>(+3 Attacco al tuo eroe per questo turno.)</i>	
GLOBAL_KEYWORD_ENRAGED_TOOLTIP	Rabbia	
GLOBAL_KEYWORD_ENRAGED_TOOLTIP_TEXT	Mentre è danneggiato, il servitore ottiene un nuovo potere.	
GLOBAL_KEYWORD_EVILZUG	Lacchè	
GLOBAL_KEYWORD_EVILZUG_TEXT	I Lacchè sono servitori da 1 Mana con Grido di Battaglia.	
GLOBAL_KEYWORD_FATIGUE	Fatica	
GLOBAL_KEYWORD_FATIGUE_TEXT	Danni subiti pescando da un mazzo vuoto.	
GLOBAL_KEYWORD_FLOOPY	Melmo il Melmoide	
GLOBAL_KEYWORD_FLOOPY_TEXT	Si trasforma quando giochi un servitore.	
GLOBAL_KEYWORD_FREEZE	Congelamento	
GLOBAL_KEYWORD_FREEZE_TEXT	I bersagli congelati saltano l'attacco successivo.	
GLOBAL_KEYWORD_FRENZY	Frenesia	
GLOBAL_KEYWORD_FRENZY_TEXT	Un effetto che si attiva una sola volta dopo che è sopravvissuto ai danni.	
GLOBAL_KEYWORD_FROZEN	Congelato	
GLOBAL_KEYWORD_FROZEN_TEXT	Salta l'attacco successivo.	
GLOBAL_KEYWORD_GALAKROND	Galakrond	
GLOBAL_KEYWORD_GALAKROND_COLLECTION_TEXT	Puoi usarlo nei mazzi Sacerdote, Ladro, Sciamano, Stregone o Guerriero.	
GLOBAL_KEYWORD_GRIMY_GOONS	Sgherri Torvi	
GLOBAL_KEYWORD_GRIMY_GOONS_COLLECTION_TEXT	Puoi usarla nei mazzi Cacciatore, Paladino o Guerriero.	
GLOBAL_KEYWORD_IMMUNE	Immune	
GLOBAL_KEYWORD_IMMUNE_REF_TEXT	I personaggi Immuni non possono essere danneggiati.	
GLOBAL_KEYWORD_IMMUNE_TEXT	Non può essere danneggiato.	
GLOBAL_KEYWORD_INSPIRE	Ispirazione	
GLOBAL_KEYWORD_INSPIRE_TEXT	Attiva l'effetto dopo che viene utilizzato il tuo Potere Eroe.	
GLOBAL_KEYWORD_JADE_GOLEM	Golem di Giada	
GLOBAL_KEYWORD_JADE_GOLEM_COLLECTION_TEXT	Il primo Golem di Giada che evochi è un 1/1. Quelli successivi ottengono +1/+1 rispetto al precedente.	
GLOBAL_KEYWORD_JADE_GOLEM_TEXT	Ogni Golem di Giada ottiene +1/+1 rispetto a quello precedente.	
GLOBAL_KEYWORD_JADE_LOTUS	Loto di Giada	
GLOBAL_KEYWORD_JADE_LOTUS_COLLECTION_TEXT	Puoi usarla nei mazzi Druido, Ladro o Sciamano.	
GLOBAL_KEYWORD_KABAL	Kabala	
GLOBAL_KEYWORD_KABAL_COLLECTION_TEXT	Puoi usarla nei mazzi Sacerdote, Mago o Stregone.	
GLOBAL_KEYWORD_LIFESTEAL	Furto Vitale	
GLOBAL_KEYWORD_LIFESTEAL_TEXT	Rigenera Salute al tuo eroe pari ai danni inflitti.	
GLOBAL_KEYWORD_MEGAWINDFURY	Super Furia del Vento	
GLOBAL_KEYWORD_MEGAWINDFURY_TEXT	Permette di attaccare quattro volte ogni turno.	
GLOBAL_KEYWORD_MINION_TYPE_REFERENCE	Tipo di servitore	
GLOBAL_KEYWORD_MINION_TYPE_REFERENCE_TEXT	Bestia, Demone, Drago, Robot, Murloc, Pirata e Totem.	
GLOBAL_KEYWORD_MODULAR	Magnetismo	
GLOBAL_KEYWORD_MODULAR_TEXT	Gioca questa carta alla sinistra di un Robot per fonderli assieme!	
GLOBAL_KEYWORD_OFFHAND	Mano Secondaria	
GLOBAL_KEYWORD_OFFHAND_TEXT	Indistruttibile. Non può essere potenziata.	
GLOBAL_KEYWORD_OUTCAST	Ripudio	
GLOBAL_KEYWORD_OUTCAST_TEXT	Bonus ottenuto se la carta giocata si trovava all'estrema sinistra o destra della mano.	
GLOBAL_KEYWORD_OVERKILL	Annientamento	
GLOBAL_KEYWORD_OVERKILL_TEXT	Attiva un effetto aggiuntivo se infligge danni in eccesso nel tuo turno.	
GLOBAL_KEYWORD_OVERLOAD	Sovraccarico: (X)	
GLOBAL_KEYWORD_OVERLOAD_REF_TEXT	Le carte con Sovraccarico limitano il tuo Mana disponibile nel turno successivo.	
GLOBAL_KEYWORD_OVERLOAD_TEXT	Nel turno successivo, avrai X Cristalli di Mana in meno.	
GLOBAL_KEYWORD_PASSIVE	Passivo	
GLOBAL_KEYWORD_PASSIVE_TEXT	Un effetto permanente che dura fino alla fine di questa spedizione.	
GLOBAL_KEYWORD_POISONOUS	Veleno	
GLOBAL_KEYWORD_POISONOUS_TEXT	Distrugge qualsiasi servitore a cui infligge danni.	
GLOBAL_KEYWORD_QUEST	Missione	
GLOBAL_KEYWORD_QUEST_TEXT	Inizia nella tua mano. Completala per ottenere una ricompensa.	
GLOBAL_KEYWORD_QUESTLINE	Serie di Missioni	
GLOBAL_KEYWORD_QUESTLINE_TEXT	Inizia nella tua mano. Completala per ottenere una ricompensa... fino a tre volte!	
GLOBAL_KEYWORD_REBORN	Rinascita	
GLOBAL_KEYWORD_REBORN_TEXT	Ritorna in vita con 1 Salute la prima volta che muore.	
GLOBAL_KEYWORD_RECRUIT	Reclutamento	
GLOBAL_KEYWORD_RECRUIT_TEXT	Evoca un servitore dal tuo mazzo.	
GLOBAL_KEYWORD_REFRESH	Ricarica	
GLOBAL_KEYWORD_REFRESH_TEXT	Rimpiazza i servitori nella Locanda di Bob.	
GLOBAL_KEYWORD_RUSH	Assalto	
GLOBAL_KEYWORD_RUSH_TEXT	Può attaccare immediatamente i servitori.	
GLOBAL_KEYWORD_SECRET	Segreto	
GLOBAL_KEYWORD_SECRET_TEXT	Nascosto finché non si verifica un'azione specifica nel turno dell'avversario.	
GLOBAL_KEYWORD_SHIFTING_MINION_TEXT	Si trasforma in un nuovo servitore all'inizio del tuo turno.	
GLOBAL_KEYWORD_SHIFTING_SPELL_TEXT	Si trasforma in una nuova Magia all'inizio del tuo turno.	
GLOBAL_KEYWORD_SHIFTING_TEXT	Si trasforma in una nuova carta all'inizio del tuo turno.	
GLOBAL_KEYWORD_SHIFTING_WEAPON_TEXT	Si trasforma in una nuova Arma all'inizio del tuo turno.	
GLOBAL_KEYWORD_SHRINE	Santuario	
GLOBAL_KEYWORD_SHRINE_TEXT	Torna in vita 3 turni dopo essere stato distrutto.	
GLOBAL_KEYWORD_SIDEQUEST	Missione Secondaria	
GLOBAL_KEYWORD_SIDEQUEST_TEXT	Completala per ottenere una ricompensa.	
GLOBAL_KEYWORD_SILENCE	Silenzio	
GLOBAL_KEYWORD_SILENCE_TEXT	Disattiva le capacità elencate sulla carta e rimuove gli incantamenti.	
GLOBAL_KEYWORD_SPAREPART	Gadget	
GLOBAL_KEYWORD_SPAREPART_TEXT	Le carte Gadget sono Magie da 1 Mana con effetti minori.	
GLOBAL_KEYWORD_SPELLBURST	Impulso Magico	
GLOBAL_KEYWORD_SPELLBURST_TEXT	Un effetto che si attiva una sola volta dopo aver lanciato una Magia.	
GLOBAL_KEYWORD_SPELLPOWER	Danni Magici	
GLOBAL_KEYWORD_SPELLPOWER_ARCANE	Danni Magici da Arcano	
GLOBAL_KEYWORD_SPELLPOWER_ARCANE_REF_TEXT	Le tue Magie Arcane infliggono danni aggiuntivi.	
GLOBAL_KEYWORD_SPELLPOWER_ARCANE_TEXT	Le tue Magie Arcane infliggono {0} danni aggiuntivi.	0=amount of spell damage
GLOBAL_KEYWORD_SPELLPOWER_FEL	Danni Magici da Vile	
GLOBAL_KEYWORD_SPELLPOWER_FEL_REF_TEXT	Le tue Magie Vili infliggono danni aggiuntivi.	
GLOBAL_KEYWORD_SPELLPOWER_FEL_TEXT	Le tue Magie Vili infliggono {0} danni aggiuntivi.	0=amount of spell damage
GLOBAL_KEYWORD_SPELLPOWER_FIRE	Danni Magici da Fuoco	
GLOBAL_KEYWORD_SPELLPOWER_FIRE_REF_TEXT	Le tue Magie di Fuoco infliggono danni aggiuntivi.	
GLOBAL_KEYWORD_SPELLPOWER_FIRE_TEXT	Le tue Magie di Fuoco infliggono {0} danni aggiuntivi.	0=amount of spell damage
GLOBAL_KEYWORD_SPELLPOWER_FROST	Danni Magici da Gelo	
GLOBAL_KEYWORD_SPELLPOWER_FROST_REF_TEXT	Le tue Magie di Gelo infliggono danni aggiuntivi.	
GLOBAL_KEYWORD_SPELLPOWER_FROST_TEXT	Le tue Magie di Gelo infliggono {0} danni aggiuntivi.	0=amount of spell damage
GLOBAL_KEYWORD_SPELLPOWER_HOLY	Danni Magici da Sacro	
GLOBAL_KEYWORD_SPELLPOWER_HOLY_REF_TEXT	Le tue Magie Sacre infliggono danni aggiuntivi.	
GLOBAL_KEYWORD_SPELLPOWER_HOLY_TEXT	Le tue Magie Sacre infliggono {0} danni aggiuntivi.	0=amount of spell damage
GLOBAL_KEYWORD_SPELLPOWER_NATURE	Danni Magici da Natura	
GLOBAL_KEYWORD_SPELLPOWER_NATURE_REF_TEXT	Le tue Magie da Natura infliggono danni aggiuntivi.	
GLOBAL_KEYWORD_SPELLPOWER_NATURE_TEXT	Le tue Magie da Natura infliggono {0} danni aggiuntivi.	0=amount of spell damage
GLOBAL_KEYWORD_SPELLPOWER_PHYSICAL	Danni Magici da Combattimento	
GLOBAL_KEYWORD_SPELLPOWER_PHYSICAL_REF_TEXT	Le tue Magie da Combattimento infliggono danni aggiuntivi.	
GLOBAL_KEYWORD_SPELLPOWER_PHYSICAL_TEXT	Le tue Magie da Combattimento infliggono {0} danni aggiuntivi.	0=amount of spell damage
GLOBAL_KEYWORD_SPELLPOWER_REF_TEXT	Aumenta i danni inflitti dalle Magie.	
GLOBAL_KEYWORD_SPELLPOWER_SHADOW	Danni Magici da Ombra	
GLOBAL_KEYWORD_SPELLPOWER_SHADOW_REF_TEXT	Le tue Magie d'Ombra infliggono danni aggiuntivi.	
GLOBAL_KEYWORD_SPELLPOWER_SHADOW_TEXT	Le tue Magie d'Ombra infliggono {0} danni aggiuntivi.	0=amount of spell damage
GLOBAL_KEYWORD_SPELLPOWER_TEXT	Aumenta di {0} i danni inflitti dalle tue carte Magia.	0=amount of spell damage
GLOBAL_KEYWORD_START_OF_COMBAT	Inizio Combattimento	
GLOBAL_KEYWORD_START_OF_COMBAT_TEXT	Compie un'azione all'inizio della fase di combattimento.	
GLOBAL_KEYWORD_START_OF_GAME	Inizio Partita	
GLOBAL_KEYWORD_START_OF_GAME_TEXT	Attiva l'effetto prima del primo turno.	
GLOBAL_KEYWORD_STEALTH	Furtività	
GLOBAL_KEYWORD_STEALTH_REF_TEXT	Non può essere attaccato o scelto come bersaglio finché non attacca.	
GLOBAL_KEYWORD_STEALTH_TEXT	Non può essere attaccato o scelto come bersaglio finché non attacca.	
GLOBAL_KEYWORD_TAUNT	Provocazione	
GLOBAL_KEYWORD_TAUNT_REF_TEXT	I nemici devono attaccare i servitori con Provocazione.	
GLOBAL_KEYWORD_TAUNT_TEXT	I nemici devono attaccare questo servitore.	
GLOBAL_KEYWORD_TOOL	Ferri del Mestiere	
GLOBAL_KEYWORD_TOOL_TEXT	Un oggetto con un'abilità attiva.	
GLOBAL_KEYWORD_TRADE	Scambio	
GLOBAL_KEYWORD_TRADE_TEXT	Trascina questa carta nel tuo mazzo per consumare 1 Mana e pescare una nuova carta.	
GLOBAL_KEYWORD_TWINSPELL	Magia Gemella	
GLOBAL_KEYWORD_TWINSPELL_TEXT	Può essere lanciata due volte.	
GLOBAL_KEYWORD_WILD	Selvagge	
GLOBAL_KEYWORD_WILD_TEXT	Le carte Selvagge appartengono al passato di Hearthstone e non possono più essere usate in formato Standard.	
GLOBAL_KEYWORD_WINDFURY	Furia del Vento	
GLOBAL_KEYWORD_WINDFURY_TEXT	Permette di attaccare due volte ogni turno.	
GLOBAL_LANGUAGE_CHANGE_CONFIRM_MESSAGE	Così facendo interromperai l'attività in corso. Vuoi davvero procedere?	
GLOBAL_LANGUAGE_CHANGE_CONFIRM_TITLE	Cambio della lingua	
GLOBAL_LANGUAGE_CHANGE_OUT_OF_SPACE_MESSAGE	Sono necessari {0} di spazio libero sul dispositivo per continuare.	
GLOBAL_LANGUAGE_CHANGE_OUT_OF_SPACE_TITLE	Spazio insufficiente!	
GLOBAL_LANGUAGE_DOWNLOAD_VOICE_PACK	(DEV) Lingue audio scaricate	
GLOBAL_LANGUAGE_DROPDOWN	Lingua	
GLOBAL_LANGUAGE_NATIVE_DEDE	Deutsch	The name of the language IN THAT LANGUAGE.
GLOBAL_LANGUAGE_NATIVE_ENGB	English (UK)	The name of the language IN THAT LANGUAGE.
GLOBAL_LANGUAGE_NATIVE_ENUS	English	The name of the language IN THAT LANGUAGE.
GLOBAL_LANGUAGE_NATIVE_ESES	Español (España)	The name of the language IN THAT LANGUAGE.
GLOBAL_LANGUAGE_NATIVE_ESMX	Español (Latinoamérica)	The name of the language IN THAT LANGUAGE.
GLOBAL_LANGUAGE_NATIVE_FRFR	Français	The name of the language IN THAT LANGUAGE.
GLOBAL_LANGUAGE_NATIVE_ITIT	Italiano	The name of the language IN THAT LANGUAGE.
GLOBAL_LANGUAGE_NATIVE_JAJP	日本語	The name of the language IN THAT LANGUAGE.
GLOBAL_LANGUAGE_NATIVE_KOKR	한국어	The name of the language IN THAT LANGUAGE.
GLOBAL_LANGUAGE_NATIVE_PLPL	Polski	The name of the language IN THAT LANGUAGE.
GLOBAL_LANGUAGE_NATIVE_PTBR	Português (Brasil)	The name of the language IN THAT LANGUAGE.
GLOBAL_LANGUAGE_NATIVE_RURU	Русский	The name of the language IN THAT LANGUAGE.
GLOBAL_LANGUAGE_NATIVE_THTH	ภาษาไทย	The name of the laugnage IN THAT LANGUAGE.
GLOBAL_LANGUAGE_NATIVE_ZHCN	中文（简体）	The name of the language IN THAT LANGUAGE.
GLOBAL_LANGUAGE_NATIVE_ZHTW	繁體中文(台灣)	The name of the language IN THAT LANGUAGE.
GLOBAL_LEAVE	Abbandona	
GLOBAL_LEAVE_SPECTATOR_MODE	Abbandona	
GLOBAL_LOCATIONS	Informazioni	
GLOBAL_LOGIN	Connettiti	
GLOBAL_LOGIN_CONFIRM_MESSAGE	Tutti i progressi in corso andranno persi. Vuoi davvero procedere?	
GLOBAL_LOGIN_CONFIRM_TITLE	Connetti?	
GLOBAL_LOGO_COPYRIGHT	炉石传说 - 魔兽英雄传 ©2016 暴雪娱乐股份有限公司版权所有 由上海网之易网络科技发展有限公司运营	
GLOBAL_LOGOUT	Disconnettiti	
GLOBAL_LOGOUT_CONFIRM_MESSAGE	Confermi?	
GLOBAL_LOGOUT_CONFIRM_TITLE	Disconnetti?	
GLOBAL_LOSSES	Sconfitte	
GLOBAL_MEDAL_0	Leggenda	
GLOBAL_MEDAL_1	Locandiere	
GLOBAL_MEDAL_10	Magus Ogre	
GLOBAL_MEDAL_11	Esperto di Caccia	
GLOBAL_MEDAL_12	Capitano Cantaguerra	
GLOBAL_MEDAL_13	Corsaro del Terrore	
GLOBAL_MEDAL_14	Capoincursione	
GLOBAL_MEDAL_15	Guardia di Lunargenta	
GLOBAL_MEDAL_16	Avventuriero Risoluto	
GLOBAL_MEDAL_17	Guerriero Tauren	
GLOBAL_MEDAL_18	Apprendista Occultista	
GLOBAL_MEDAL_19	Ingegnera Novizia	
GLOBAL_MEDAL_2	Cavaliere Nero	
GLOBAL_MEDAL_20	Portascudi	
GLOBAL_MEDAL_21	Tagliagole Acquanera	
GLOBAL_MEDAL_22	Murloc Incursore	
GLOBAL_MEDAL_23	Guardiana d'Argento	
GLOBAL_MEDAL_24	Gnomo Contaminato	
GLOBAL_MEDAL_25	Gallina Arrabbiata	
GLOBAL_MEDAL_3	Gigante di Magma	
GLOBAL_MEDAL_4	Gigante di Montagna	
GLOBAL_MEDAL_5	Gigante di Mare	
GLOBAL_MEDAL_6	Antico della Guerra	
GLOBAL_MEDAL_7	Campionessa del Sole	
GLOBAL_MEDAL_8	Signore dei Lupi Bianchi	
GLOBAL_MEDAL_9	Cavaliere Mano d'Argento	
GLOBAL_MEDAL_ARENA_TOOLTIP_BODY	Questo è il tuo miglior risultato nell'Arena.\nVittorie: {0}	0=num wins
GLOBAL_MEDAL_REWARD_CONGRATULATIONS	Congratulazioni!	
GLOBAL_MEDAL_REWARD_DESCRIPTION	Medaglia ottenuta la settimana scorsa	
GLOBAL_MEDAL_TOOLTIP_BEST_RANK_CLASSIC	Grado Classico: {0}	
GLOBAL_MEDAL_TOOLTIP_BEST_RANK_STANDARD	Grado Standard: {0}	
GLOBAL_MEDAL_TOOLTIP_BEST_RANK_WILD	Grado Selvaggio: {0}	
GLOBAL_MEDAL_TOOLTIP_BODY_ARENA_GRAND_MASTER	Sei un campione dell'Arena!	
GLOBAL_MEDAL_TOOLTIP_BODY_CLASSIC	Vinci delle partite Classiche per avanzare al prossimo grado!	
GLOBAL_MEDAL_TOOLTIP_BODY_LEGEND	Sei una Leggenda! La tua posizione in questo grado cambierà a ogni partita.	
GLOBAL_MEDAL_TOOLTIP_BODY_STANDARD	Vinci delle partite Standard per avanzare al prossimo grado!	
GLOBAL_MEDAL_TOOLTIP_BODY_WILD	Vinci delle partite Selvagge per avanzare al prossimo grado!	
GLOBAL_MEDAL_TOOLTIP_HEADER	Medaglia {0}	0=medal name
GLOBAL_MEDAL_TOURNAMENT_TOOLTIP_BODY	Nel miglior {0}% della stagione classificata.	0=rank percentile
GLOBAL_MINI_SET_BAR	Caverna dei Lamenti	
GLOBAL_MINI_SET_DMF	Corse di Lunacupa	
GLOBAL_MOBILE_ERROR_ANDROID_PHONE_DETECTED	Spiacenti, Hearthstone attualmente funziona solo su tablet Android con uno schermo da 6 pollici o superiore.	
GLOBAL_MOBILE_ERROR_BREAKING_NEWS	Ultime novità:\n\n{0}	
GLOBAL_MOBILE_ERROR_LOGON_WEB_TIMEOUT	È passato molto tempo dalla tua ultima azione su Hearthstone e sei stato disconnesso dal server.	
GLOBAL_MOBILE_ERROR_NETWORK_DISCONNECT	Sei stato disconnesso.	
GLOBAL_MOBILE_ERROR_NETWORK_SPAM	Sei stato disconnesso per aver inviato troppe richieste in breve tempo.	
GLOBAL_MOBILE_ERROR_NETWORK_UTIL_TIMEOUT	Richiesta di connessione scaduta durante la ricezione di dati dal servizio di Hearthstone.	
GLOBAL_MOBILE_ERROR_UNSUPPORTED_IOS_PHONE_DETECTED	Spiacenti, Hearthstone richiede iPhone 6s, iPod Touch 7 o modelli più recenti.	
GLOBAL_MOBILE_ERROR_UNSUPPORTED_IOS_TABLET_DETECTED	Spiacenti, Hearthstone richiede iPad 5, iPad Air 2, iPad mini 4 o modelli più recenti.	
GLOBAL_MOBILE_LOG_IN_TOOLTIP	Connettiti se possiedi un account!	
GLOBAL_MOBILE_LOGIN_POINTER	Connettiti da qui	
GLOBAL_MOBILE_RESTART_APPLICATION	Riavvia l'applicazione	
GLOBAL_MOBILE_TAP_TO_RECONNECT	Tocca per riconnetterti	
GLOBAL_MOBILE_TAP_TO_UPDATE	Tocca per aggiornare	
GLOBAL_MOBILECHAT_NOTIFICATION_MULLIGAIN	Partita iniziata!	
GLOBAL_MOBILECHAT_NOTIFICATION_TURN_COUNTDOWN	Il tempo sta per scadere!	
GLOBAL_MOBILECHAT_NOTIFICATION_YOUR_TURN	Tocca a te!	
GLOBAL_MOBILECHAT_RETURN_TO_GAME	Chiudi	
GLOBAL_MOBILECHAT_RETURN_TO_MENU	Torna al menu	
GLOBAL_MORE	Altro	
GLOBAL_MY_NUM_WINS	{0}	0=number of games this player has won
GLOBAL_NOT_AVAILABLE	Non disponibile	
GLOBAL_OFF	No	
GLOBAL_OFFLINE	Offline	
GLOBAL_OKAY	OK	
GLOBAL_ON	Sì	
GLOBAL_OPTIONS	Opzioni	
GLOBAL_OPTIONS_CARDBACK_LABEL	Scegli il dorso delle carte	
GLOBAL_OPTIONS_CHOOSE_CARD_BACK	Scegli il dorso delle carte	
GLOBAL_OPTIONS_CINEMATIC	Filmato	
GLOBAL_OPTIONS_CREDITS	Riconoscimenti	
GLOBAL_OPTIONS_GRAPHICS_FULLSCREEN_LABEL	Schermo intero	
GLOBAL_OPTIONS_GRAPHICS_LABEL	Grafica	
GLOBAL_OPTIONS_GRAPHICS_QUALITY_HIGH	Alta	
GLOBAL_OPTIONS_GRAPHICS_QUALITY_LABEL	Qualità	
GLOBAL_OPTIONS_GRAPHICS_QUALITY_LOW	Bassa	
GLOBAL_OPTIONS_GRAPHICS_QUALITY_MEDIUM	Media	
GLOBAL_OPTIONS_GRAPHICS_RESOLUTION_CUSTOM	Personalizzata	
GLOBAL_OPTIONS_GRAPHICS_RESOLUTION_LABEL	Risoluzione	
GLOBAL_OPTIONS_MISCELLANEOUS_LABEL	Varie	
GLOBAL_OPTIONS_NEARBY_PLAYERS	Abilita sfide con giocatori vicini e amici	
GLOBAL_OPTIONS_OTHER_LABEL	Altro	
GLOBAL_OPTIONS_PREFERENCES_LABEL	Preferenze	
GLOBAL_OPTIONS_PRIVACY_POLICY	Gestione della privacy	
GLOBAL_OPTIONS_PUBLIC_CHAT_ENABLED	Chat pubblica	
GLOBAL_OPTIONS_RESTORE_PURCHASES	Ripristina acquisti	
GLOBAL_OPTIONS_RESTORE_PURCHASES_POPUP_TEXT	Non trovi qualcosa che avevi acquistato? Assicurati di essere connesso con l'account corretto.	
GLOBAL_OPTIONS_SCREEN_SHAKE	Attiva movimento schermo	
GLOBAL_OPTIONS_SKIP_NPR	Salta l'Addestramento	
GLOBAL_OPTIONS_SKIP_TO_RANK_25	Salta al Grado 25	
GLOBAL_OPTIONS_SOUND_IN_BACKGROUND	Suoni in background	
GLOBAL_OPTIONS_SOUND_LABEL	Audio	
GLOBAL_OPTIONS_SOUND_MASTER_VOLUME_LABEL	Volume principale	
GLOBAL_OPTIONS_SOUND_MUSIC_VOLUME_LABEL	Volume musica	
GLOBAL_OPTIONS_SPECTATOR_OPEN_JOIN	Permetti agli amici di osservare le mie partite	
GLOBAL_PLAY	Gioca	
GLOBAL_PLAY_RANKED	Partita\nclassificata	
GLOBAL_PLAY_STANDARD	Gioca in Standard	
GLOBAL_PLAY_WAITING	In attesa	
GLOBAL_PLAY_WILD	Gioca in Selvaggio	
GLOBAL_PLAYER_MIGRATION_RESTART_BODY	Il tuo account dev'essere aggiornato.\nRiavvia il gioco.	
GLOBAL_PLAYER_MIGRATION_RESTART_HEADER	L'account deve essere aggiornato	
GLOBAL_PLAYER_PLAYER	Giocatore	this is the word for generic "Player" - this will be used when there a player's name is unknown at the time.
GLOBAL_PRACTICE_MAX_LEVEL_REACHED	Massimo livello contro IA	
GLOBAL_PROGRAMNAME_BLACKOPS4	Black Ops 4	
GLOBAL_PROGRAMNAME_BLACKOPSCOLDWAR	Black Ops Cold War	
GLOBAL_PROGRAMNAME_CRASHBANDICOOT4	Crash Bandicoot 4	
GLOBAL_PROGRAMNAME_DESTINY2	Destiny 2	
GLOBAL_PROGRAMNAME_DIABLO2R	Diablo II: Resurrected	
GLOBAL_PROGRAMNAME_DIABLO3	Diablo III	
GLOBAL_PROGRAMNAME_HEARTHSTONE	Hearthstone	
GLOBAL_PROGRAMNAME_HEROES	Heroes of the Storm	
GLOBAL_PROGRAMNAME_MODERNWARFARE	Modern Warfare	
GLOBAL_PROGRAMNAME_MODERNWARFARE2_REMASTER	MW2CR	
GLOBAL_PROGRAMNAME_OVERWATCH	Overwatch	
GLOBAL_PROGRAMNAME_PHOENIX	Online	
GLOBAL_PROGRAMNAME_STARCRAFT	StarCraft	
GLOBAL_PROGRAMNAME_STARCRAFT2	StarCraft II	
GLOBAL_PROGRAMNAME_WARCRAFT3	Warcraft III: Reforged	
GLOBAL_PROGRAMNAME_WOW	World of Warcraft	
GLOBAL_PROGRESSION_ACHIEVEMENT_COMPLETION	Completata il {0}	
GLOBAL_PROGRESSION_ACHIEVEMENT_COMPLETION_DATE	{0:dd/MM/yyyy}	see http://msdn.microsoft.com/en-us/library/8kb3ddd4.aspx
GLOBAL_PROGRESSION_ACHIEVEMENT_COMPLETION_PERCENTAGE	{0}%	
GLOBAL_PROGRESSION_ACHIEVEMENT_SUBCATEGORY_NAME	{0} - {1}	
GLOBAL_PROGRESSION_DAILY_QUESTS_POPUP_TITLE	Le tue missioni	
GLOBAL_PROGRESSION_POINTS	{0} punti impresa	
GLOBAL_PROGRESSION_PROFILE_ARENA_STAT_TOOLTIP	Maggior numero di vittorie in Arena.	
GLOBAL_PROGRESSION_PROFILE_ARENA_STAT_TOOLTIP_TITLE	Arena	
GLOBAL_PROGRESSION_PROFILE_ARENA_WINS	{0} |4(vittoria,vittorie)	
GLOBAL_PROGRESSION_PROFILE_BATTLEGROUNDS_STAT_TOOLTIP	Aumenta il tuo punteggio vincendo partite. Un piazzamento nella Top 4 conta come una vittoria per le missioni!	
GLOBAL_PROGRESSION_PROFILE_BATTLEGROUNDS_STAT_TOOLTIP_TITLE	Battaglia	
GLOBAL_PROGRESSION_PROFILE_BATTLEGROUNDS_TOP4	{0} |4(piazzamento,piazzamenti) nella Top 4	
GLOBAL_PROGRESSION_PROFILE_GAME_MODES	Modalità	
GLOBAL_PROGRESSION_PROFILE_PLAY_MODE	Modalità Gioco	
GLOBAL_PROGRESSION_PROFILE_PVPDR_CASUAL_STAT_TITLE	Duelli Amichevoli	
GLOBAL_PROGRESSION_PROFILE_PVPDR_CASUAL_STAT_TOOLTIP	Mostra il tuo punteggio migliore nei Duelli Amichevoli o Eroici.	
GLOBAL_PROGRESSION_PROFILE_PVPDR_CASUAL_STAT_TOOLTIP_TITLE	Duelli (Amichevoli)	
GLOBAL_PROGRESSION_PROFILE_PVPDR_HEROIC_STAT_TITLE	Duelli Eroici	
GLOBAL_PROGRESSION_PROFILE_PVPDR_HEROIC_STAT_TOOLTIP	Mostra il tuo punteggio migliore nei Duelli Amichevoli o Eroici.	
GLOBAL_PROGRESSION_PROFILE_PVPDR_HEROIC_STAT_TOOLTIP_TITLE	Duelli (Eroici)	
GLOBAL_PROGRESSION_PROFILE_RANKED_STAT_TOOLTIP	Il numero totale di vittorie in modalità Classificata.	
GLOBAL_PROGRESSION_PROFILE_TOTAL_WINS	{0} |4(vittoria,vittorie totali)	
GLOBAL_PROGRESSION_PROGRESS_MESSAGE	{0} / {1}	
GLOBAL_PROGRESSION_QUEST_TIME_UNTIL_NEXT	Nuova missione tra {0}	
GLOBAL_PROGRESSION_RANKED_REWARDS_TOOLTIP	Ottieni ricompense in ogni stagione per il miglior grado raggiunto in formato Standard, Selvaggio o Classico.	
GLOBAL_PROGRESSION_RANKED_REWARDS_TOOLTIP_TITLE	Ricompense modalità Classificata	
GLOBAL_PROGRESSION_REWARD_SUMMARY	{0}\n{1}	
GLOBAL_PROGRESSION_REWARD_TRACK_XP	{0} PE Ricompensa	
GLOBAL_PROGRESSION_TIER_MESSAGE	{0}/{1}	
GLOBAL_PROGRESSION_TOOLTIP_CLASS_DEFAULT_DESC	Livello {0}	
GLOBAL_PROGRESSION_TOOLTIP_GOLDEN_WINS_DESC	Vinci {0} partite in Classificata, Arena o Duelli con la classe {1} per ottenere la versione Dorata dell'eroe classico!	{0}=win count {1}=class name
GLOBAL_PROGRESSION_TOOLTIP_PREMIUM_WINS_DESC	Vinci {0} partite in Classificata, Arena o Duelli con la classe {1} per ottenere {2}!	{0}=win count {1}=class name {2}=hero card name
GLOBAL_PROGRESSION_TOOLTIP_PREMIUM_WINS_DONE_DESC	Vincendo {0} partite in Classificata, Arena o Duelli con la classe {1} hai ottenuto {2}!	{0}=win count {1}=class name {2}=hero card name
GLOBAL_PROGRESSION_TOOLTIP_TOTAL_CLASS_WINS	Vittorie totali con la classe {0}	{0}=class name
GLOBAL_PROGRESSION_WEEKLY_QUESTS_POPUP_TITLE	Le tue missioni settimanali	
GLOBAL_PVPDR_SEASON_ERROR_NOT_ACTIVE	Spiacenti, la stagione dei Duelli richiesta non è più disponibile. Riprova più tardi.	
GLOBAL_QUEST_PROGRESS_COUNT	{0}/{1}	0=progress,1=max progress
GLOBAL_QUIT	Esci	
GLOBAL_RACE_ALL	Tutti	
GLOBAL_RACE_ALL_BATTLEGROUNDS	Amalgami	This should be the plural of DAL_087t
GLOBAL_RACE_BLOODELF	Elfo del Sangue	
GLOBAL_RACE_BLOODELF_BATTLEGROUNDS	Elfi del Sangue	
GLOBAL_RACE_DEMON	Demone	
GLOBAL_RACE_DEMON_BATTLEGROUNDS	Demoni	
GLOBAL_RACE_DRAENEI	Fuoco	
GLOBAL_RACE_DRAENEI_BATTLEGROUNDS	Fuoco	
GLOBAL_RACE_DRAGON	Drago	
GLOBAL_RACE_DRAGON_BATTLEGROUNDS	Draghi	
GLOBAL_RACE_DWARF	Nano	
GLOBAL_RACE_DWARF_BATTLEGROUNDS	Nani	
GLOBAL_RACE_EGG	Uovo	
GLOBAL_RACE_EGG_BATTLEGROUNDS	Uova	
GLOBAL_RACE_ELEMENTAL	Elementale	
GLOBAL_RACE_ELEMENTAL_BATTLEGROUNDS	Elementali	
GLOBAL_RACE_GNOME	Gnomo	
GLOBAL_RACE_GNOME_BATTLEGROUNDS	Gnomi	
GLOBAL_RACE_GOBLIN	Goblin	
GLOBAL_RACE_GOBLIN_BATTLEGROUNDS	Goblin	
GLOBAL_RACE_HUMAN	Umano	
GLOBAL_RACE_HUMAN_BATTLEGROUNDS	Umani	
GLOBAL_RACE_MECHANICAL	Robot	
GLOBAL_RACE_MECHANICAL_BATTLEGROUNDS	Robot	
GLOBAL_RACE_MIXED_BATTLEGROUNDS	Servitori Misti	
GLOBAL_RACE_MURLOC	Murloc	
GLOBAL_RACE_MURLOC_BATTLEGROUNDS	Murloc	
GLOBAL_RACE_NERUBIAN	Nerubiano	
GLOBAL_RACE_NERUBIAN_BATTLEGROUNDS	Nerubiani	
GLOBAL_RACE_NIGHTELF	Elfo della Notte	
GLOBAL_RACE_NIGHTELF_BATTLEGROUNDS	Elfi della Notte	
GLOBAL_RACE_OGRE	Ogre	
GLOBAL_RACE_OGRE_BATTLEGROUNDS	Ogre	
GLOBAL_RACE_ORC	Orco	
GLOBAL_RACE_ORC_BATTLEGROUNDS	Orchi	
GLOBAL_RACE_PET	Bestia	
GLOBAL_RACE_PET_BATTLEGROUNDS	Bestie	
GLOBAL_RACE_PIRATE	Pirata	
GLOBAL_RACE_PIRATE_BATTLEGROUNDS	Pirati	
GLOBAL_RACE_QUILBOAR	Verrospino	
GLOBAL_RACE_QUILBOARS_BATTLEGROUNDS	Verrospino	
GLOBAL_RACE_SCOURGE	Flagello	
GLOBAL_RACE_SCOURGE_BATTLEGROUNDS	Flagello	
GLOBAL_RACE_TAUREN	Cultista	
GLOBAL_RACE_TAUREN_BATTLEGROUNDS	Tauren	
GLOBAL_RACE_TOTEM	Totem	
GLOBAL_RACE_TOTEM_BATTLEGROUNDS	Totem	
GLOBAL_RACE_TROLL	Troll	
GLOBAL_RACE_TROLL_BATTLEGROUNDS	Troll	
GLOBAL_RACE_UNDEAD	Non Morto	
GLOBAL_RACE_UNDEAD_BATTLEGROUNDS	Non Morti	
GLOBAL_RACE_WORGEN	Worgen	
GLOBAL_RACE_WORGEN_BATTLEGROUNDS	Worgen	
GLOBAL_RANK_CANT_LOSE_LEVEL	Non puoi scendere al di sotto di questo grado.	
GLOBAL_RANK_PROMOTION_DESC	Hai ottenuto una promozione al Grado 25!	
GLOBAL_RANK_SCRUB_RANK_DESC	Non puoi perdere Stelle a questo grado.	
GLOBAL_RANK_STAR_MULT	Bonus stelle! x{0}	
GLOBAL_RANK_STAR_MULT_STREAK	Bonus serie di vittorie! x2	
GLOBAL_RANK_WIN_STREAK	Serie di vittorie: Stella aggiuntiva!	
GLOBAL_RANKED	Classificata	
GLOBAL_RARITY_COMMON	Comune	
GLOBAL_RARITY_EPIC	Epica	
GLOBAL_RARITY_FREE	Gratuita	
GLOBAL_RARITY_LEGENDARY	Leggendaria	
GLOBAL_RARITY_RARE	Rara	
GLOBAL_RECONNECT_EXIT_BUTTON	Esci	
GLOBAL_RECONNECT_RECONNECTED	Sei stato riconnesso alla partita. Ripresa in corso...	
GLOBAL_RECONNECT_RECONNECTED_HEADER	Riconnesso	
GLOBAL_RECONNECT_RECONNECTED_LOGIN	Sei stato riconnesso all'ultima partita. Ripresa in corso...	
GLOBAL_RECONNECT_RECONNECTING	Sei stato disconnesso dalla partita. Riconnessione in corso...	
GLOBAL_RECONNECT_RECONNECTING_HEADER	Riconnessione	
GLOBAL_RECONNECT_RECONNECTING_LOGIN	Sei stato disconnesso dall'ultima partita. Riconnessione in corso...	
GLOBAL_RECONNECT_TIMEOUT	Impossibile riconnettersi alla partita.	
GLOBAL_RECONNECT_TIMEOUT_HEADER	Errore	
GLOBAL_REFRESH	Aggiorna	
GLOBAL_REGION_AMERICAS	Americhe e Sud-est asiatico	
GLOBAL_REGION_ASIA	Asia	
GLOBAL_REGION_CHINA	Cina	
GLOBAL_REGION_EUROPE	Europa	
GLOBAL_RELAUNCH_APPLICATION_AFTER_INSTALLAPK	Stiamo cercando di installare il nuovo client. Riavvia Hearthstone se il client non è stato installato.	
GLOBAL_REMAINING_DATETIME	{0} |4(rimanente,rimanenti)	0=time string
GLOBAL_REMINDER_CARDBACK_SEASON_END_DIALOG	Vinci {0} |4(partita,partite) per ottenere il dorso delle carte stagionale.	
GLOBAL_REMINDER_CHEST_QUESTION_MARK	?	Label for unearned chest, assuming "?" universally means unknown, it doesn't need to be localized
GLOBAL_REMINDER_CHEST_SEASON_END_DIALOG	Vinci 5 partite per ottenere\nil forziere stagionale.	
GLOBAL_RESTART	Ricomincia	
GLOBAL_RESUME_GAME	Riprendi	
GLOBAL_RETRY	Riprova	
GLOBAL_RETURNING_PLAYER_GENERATED_DECK	Mazzo del Locandiere	
GLOBAL_REWARD_ARCANE_DUST_HEADLINE	Polvere Arcana ottenuta!	
GLOBAL_REWARD_ARCANE_ORBS_HEADLINE	Globi Arcani ottenuti!	
GLOBAL_REWARD_ARENA_TICKET_ADMIT	ACCESSO	the word 'admit' in capital letters - displayed like "Admit 1" and looks like a movie/fair ticket. this is the Arena Ticket reward visual.
GLOBAL_REWARD_ARENA_TICKET_AUTHORIZED_BY	Autorizzato da	a label that shows up in the Arena Ticket under the Player's name indicating this ticket reward was granted by some guy.
GLOBAL_REWARD_ARENA_TICKET_ENTRANT	Beneficiario	a label that shows up in the Arena Ticket under the Player's name to say this person is allowed entrance into the Arena.
GLOBAL_REWARD_ARENA_TICKET_HEADLINE	Biglietto gratis!	
GLOBAL_REWARD_ARENA_TICKET_LABEL	Arena	
GLOBAL_REWARD_ARENA_TICKET_STORE_COUNT_1	1	
GLOBAL_REWARD_ARENA_TICKET_TITLE	Locanda	
GLOBAL_REWARD_BATTLEGROUNDS_GUIDE_HEADLINE	Barista della Battaglia sbloccato	
GLOBAL_REWARD_BATTLEGROUNDS_HERO_HEADLINE	Eroe della Battaglia sbloccato	
GLOBAL_REWARD_BONUS_CHALLENGE_HEADLINE	Sfida Finale sbloccata	
GLOBAL_REWARD_BOOSTER_DETAILS_OUT_OF_BAND	{0} |4(busta è stata aggiunta,buste sono state aggiunte) al tuo account da una sorgente esterna al gioco.	0=count
GLOBAL_REWARD_BOOSTER_DETAILS_PRESALE_OUT_OF_BAND	Il tuo acquisto sul web di {0} |4(busta,buste) sarà presto disponibile!	0=count
GLOBAL_REWARD_BOOSTER_HEADLINE_GENERIC	Busta ottenuta!	
GLOBAL_REWARD_BOOSTER_HEADLINE_MULTIPLE	{0} |4(busta ottenuta,buste ottenute)!	
GLOBAL_REWARD_BOOSTER_HEADLINE_OUT_OF_BAND	Hai ottenuto una busta!	
GLOBAL_REWARD_BOOSTER_HEADLINE_OUT_OF_BAND_MULTI	Hai ottenuto delle buste!	
GLOBAL_REWARD_CARD_BACK_HEADLINE	Dorso ottenuto!	
GLOBAL_REWARD_CARD_COUNT_MULTIPLIER	x	
GLOBAL_REWARD_CARD_DETAILS_TUTORIAL01	Oh sì!	
GLOBAL_REWARD_CARD_DETAILS_TUTORIAL02	Davvero impressionante.	
GLOBAL_REWARD_CARD_DETAILS_TUTORIAL03	Ottimo risultato!	
GLOBAL_REWARD_CARD_DETAILS_TUTORIAL04	Incredibile.	
GLOBAL_REWARD_CARD_DETAILS_TUTORIAL05	Magnifico!	
GLOBAL_REWARD_CARD_DETAILS_TUTORIAL06	Ben fatto!	
GLOBAL_REWARD_CARD_HEADLINE	Ricompensa!	
GLOBAL_REWARD_CARD_LEVEL_UP	Sbloccata raggiungendo il livello {0} come {1}	0=# level, 1=class
GLOBAL_REWARD_CHEST_HEADER	Hai ottenuto ricompense della modalità Classificata!	
GLOBAL_REWARD_CHEST_INSTRUCTIONS	Apri il forziere alla fine della stagione.\nPotenzialo raggiungendo un grado maggiore!	
GLOBAL_REWARD_CHEST_TIER1	Tesoro del Gigante di Mare	
GLOBAL_REWARD_CHEST_TIER1_EARNED	Hai ottenuto il Tesoro del Gigante di Mare!	
GLOBAL_REWARD_CHEST_TIER2	Scrigno del Magus Ogre	
GLOBAL_REWARD_CHEST_TIER2_EARNED	Hai ottenuto lo Scrigno del Magus Ogre!	
GLOBAL_REWARD_CHEST_TIER3	Baule della Guardia	
GLOBAL_REWARD_CHEST_TIER3_EARNED	Hai ottenuto il Baule della Guardia!	
GLOBAL_REWARD_CHEST_TIER4	Cassa del Portascudi	
GLOBAL_REWARD_CHEST_TIER4_EARNED	Hai ottenuto la Cassa del Portascudi!	
GLOBAL_REWARD_CHEST_TIER5	Forziere Gallina Arrabbiata	
GLOBAL_REWARD_CHEST_TIER5_EARNED	Hai ottenuto il forziere Gallina Arrabbiata!	
GLOBAL_REWARD_CHEST_TIER6	Cassa dell'Avventore	
GLOBAL_REWARD_CHEST_TIER6_EARNED	Hai ottenuto la Cassa dell'Avventore!	
GLOBAL_REWARD_CLASS_CHALLENGE_DETAIL	{0}	0=first class
GLOBAL_REWARD_CLASS_CHALLENGE_DETAIL_DOUBLE	{0} e {1}	0=first class, 1=second class
GLOBAL_REWARD_CLASS_CHALLENGE_HEADLINE	|4(Sfida di Classe sbloccata,Sfide di Classe sbloccate)	
GLOBAL_REWARD_CORE_CARD_DETAILS	{0}/{1} carte {2} sbloccate	0=# cards unlocked, 1=# cards possible to unlock, 2=class
GLOBAL_REWARD_FORGE_DETAILS_OUT_OF_BAND	{0} |4(ammissione all'Arena è stata aggiunta,ammissioni all'Arena sono state aggiunte) al tuo account da una sorgente esterna al gioco.	0=count
GLOBAL_REWARD_FORGE_HEADLINE	Hai ottenuto un accesso all'Arena!	
GLOBAL_REWARD_FORGE_UNLOCKED_HEADLINE	Arena sbloccata!	
GLOBAL_REWARD_FORGE_UNLOCKED_SOURCE	Ricompensa per essere entrato nell'Arena	
GLOBAL_REWARD_GOLD_HEADLINE	Oro ottenuto!	
GLOBAL_REWARD_GOLD_SOURCE_IGR	Ricompensa per esserti connesso da una IGR	
GLOBAL_REWARD_GOLD_SOURCE_IGR_DATED	Ricompensa per esserti connesso da una IGR il {0}	0=GLOBAL_CURRENT_DATE
GLOBAL_REWARD_GOLD_SOURCE_TOURNEY	Ricompensa per aver vinto {0} |4(partita,partite) in modalità Rissa, Battaglia o Gioco	
GLOBAL_REWARD_GOLDEN_HERO_HEADLINE	Eroe Dorato sbloccato	
GLOBAL_REWARD_HEARTHSTEED_HEADLINE	Destriero di Hearthstone	
GLOBAL_REWARD_HERO_DETAILS	{0}/{1} eroi sbloccati	
GLOBAL_REWARD_HERO_HEADLINE	Eroe sbloccato: {0}	
GLOBAL_REWARD_HEROES_CARD_MOUNT_HEADLINE	Cavalcatura Carta di Hearthstone	
GLOBAL_REWARD_PROGRESS	{0}/{1} vittorie	0=current wins,1=required wins
GLOBAL_SCAN	Ricerca	
GLOBAL_SCREENSHOT_COMPLETE	Immagine salvata sul desktop.	
GLOBAL_SCREENSHOT_COMPLETE_SPECIFIC_DIRECTORY	Immagine salvata in {0}	0=The directory that the file was saved to
GLOBAL_SEASON_CHEST_BANNER	Forziere stagionale	Default label for the banner in the end game screen that is placed above the in progress chest
GLOBAL_SEASON_END_BEST_EVER_ABOVE_MAX	In base ai tuoi risultati passati, partirai sempre dal Grado {0} o superiore.	0=rank
GLOBAL_SEASON_END_BONUS_STAR_BOOST	Il tuo Bonus Stelle ti porta a	
GLOBAL_SEASON_END_BONUS_STAR_TITLE	Il tuo grado nella scorsa stagione dà diritto a	
GLOBAL_SEASON_END_BONUS_STARS_LABEL	|4(Stella bonus,Stelle bonus)	
GLOBAL_SEASON_END_CHEST_INSTRUCTIONS	Clicca per aprire.	
GLOBAL_SEASON_END_CHEST_INSTRUCTIONS_TOUCH	Tocca per aprire.	
GLOBAL_SEASON_END_NEW_CARD_BACK	Hai ottenuto un nuovo dorso delle carte	
GLOBAL_SEASON_END_NEW_CARDBACK_TITLE	Nuovo dorso della stagione!	
GLOBAL_SEASON_END_NEW_CARDBACK_TITLE_PHONE	Nuovo dorso\ndella stagione!	
GLOBAL_SEASON_END_NEW_SEASON	La {0} è cominciata!	0=season name
GLOBAL_SEASON_END_PERCENTILE_LABEL	Sei nel miglior {0}% dei giocatori della modalità Classificata!	0=rank percentile
GLOBAL_SEASON_END_RANK_LABEL	Hai ottenuto il grado	
GLOBAL_SEASON_END_STAR_MULTIPLIER_LABEL	Bonus Stelle	
GLOBAL_SEASON_END_STAR_MULTIPLIER_TITLE	Con le prestazioni della scorsa stagione in Classificata hai ottenuto	
GLOBAL_SEASON_END_WELCOME	Benvenuto	
GLOBAL_SET_BASIC	Set Base	
GLOBAL_SET_EXPERT1	Set Classico	
GLOBAL_SET_ROTATION_ROLLOVER_BODY_DESKTOP	È cominciato un anno nuovo su Hearthstone!\nRiavvia per partecipare ai festeggiamenti.	
GLOBAL_SET_ROTATION_ROLLOVER_BODY_MOBILE	È cominciato un anno nuovo su Hearthstone!\nRiavvio per partecipare ai festeggiamenti in corso.	
GLOBAL_SET_ROTATION_ROLLOVER_HEADER	Felice anno nuovo!	
GLOBAL_SHOW	Mostra	
GLOBAL_SHUTDOWN_TOAST	<color=#{0}>Il servizio di gioco Blizzard verrà chiuso in {1} |4(minuto,minuti)</color>	0=color, 1=minutes
GLOBAL_SKIP	Salta	
GLOBAL_SKIP_TUTORIAL	Salta Tutorial	
GLOBAL_SOCIAL_TOAST_FRIEND_ACHIEVEMENT	<color=#{0}>{1}</color> ha compiuto <color=#FFD451>{2}</color>	0=name color,1=player name,2=achievement name
GLOBAL_SOCIAL_TOAST_FRIEND_ACHIEVEMENT_TIER	<color=#{0}>{1}</color> ha compiuto <color=#FFD451>{2} (Fase {3})</color>	0=name color,1=player name,2=achievement name,3=tier
GLOBAL_SOCIAL_TOAST_FRIEND_ARENA_COMPLETE	<color=#{0}>{1}</color> ha appena finito una competizione nell'Arena. ({2}-{3})	0=name color,1=player name,2=Arena Wins,3=Arena Losses
GLOBAL_SOCIAL_TOAST_FRIEND_ARENA_START	<color=#{0}>{1}</color> ha iniziato una competizione nell'Arena.	0=name color,1=player name
GLOBAL_SOCIAL_TOAST_FRIEND_ARENA_START_WITH_MANY_WINS	<color=#{0}>{1}</color> ha appena iniziato una partita nell'Arena. Ha già ottenuto {2} |4(vittoria,vittorie)!	0=name color,1=player name,2=Arena Wins
GLOBAL_SOCIAL_TOAST_FRIEND_BRAWLISEUM_COMPLETE	<color=#{0}>{1}</color> ha appena finito una sessione al Rissodromo. ({2}-{3})	0=name color,1=player name,2=Brawl Wins,3=Brawl Losses
GLOBAL_SOCIAL_TOAST_FRIEND_BRAWLISEUM_START	<color=#{0}>{1}</color> ha iniziato una sessione al Rissodromo.	0=name color,1=player name
GLOBAL_SOCIAL_TOAST_FRIEND_BRAWLISEUM_START_WITH_MANY_WINS	<color=#{0}>{1}</color> ha appena iniziato una sessione al Rissodromo. Ha già ottenuto {2} |4(vittoria,vittorie)!	0=name color,1=player name,2=Brawl Wins
GLOBAL_SOCIAL_TOAST_FRIEND_DRUID_LEVEL	<color=#{0}>{1}</color> ha raggiunto il livello {2} con il Druido.	0=name color,1=player name,2=level
GLOBAL_SOCIAL_TOAST_FRIEND_DUEL_START	<color=#{0}>{1}</color> ha iniziato una nuova sessione nei Duelli.	0=name color,1=player name
GLOBAL_SOCIAL_TOAST_FRIEND_GOLDEN_LEGENDARY	<color=#{0}>{1}</color> ha ottenuto la carta <color=#{3}>{2} Dorata</color>!	0=name color,1=player name,2=card name,3=Golden Color
GLOBAL_SOCIAL_TOAST_FRIEND_HEROIC_BRAWL_COMPLETE	<color=#{0}>{1}</color> ha appena finito una Rissa Eroica. ({2}-{3})	0=name color,1=player name,2=Heroic brawl Wins,3=Heroic brawl Losses
GLOBAL_SOCIAL_TOAST_FRIEND_HEROIC_BRAWL_START	<color=#{0}>{1}</color> ha iniziato una Rissa Eroica.	0=name color,1=player name
GLOBAL_SOCIAL_TOAST_FRIEND_HEROIC_BRAWL_START_WITH_MANY_WINS	<color=#{0}>{1}</color> ha appena iniziato una Rissa Eroica. Ha già ottenuto {2} |4(vittoria,vittorie)!	0=name color,1=player name,2=Heroic brawl Wins
GLOBAL_SOCIAL_TOAST_FRIEND_HUNTER_LEVEL	<color=#{0}>{1}</color> ha raggiunto il livello {2} con il Cacciatore.	0=name color,1=player name,2=level
GLOBAL_SOCIAL_TOAST_FRIEND_ILLIDAN_COMPLETE	<color=#{0}>{1}</color> ha sconfitto Illidan Grantempesta!	0=name color,1=player name
GLOBAL_SOCIAL_TOAST_FRIEND_LEGENDARY	<color=#{0}>{1}</color> ha ottenuto la carta <color=#{3}>{2}</color>!	0=name color,1=player name,2=card name
GLOBAL_SOCIAL_TOAST_FRIEND_MAGE_LEVEL	<color=#{0}>{1}</color> ha raggiunto il livello {2} con il Mago.	0=name color,1=player name,2=level
GLOBAL_SOCIAL_TOAST_FRIEND_OFFLINE	<color=#{0}>{1}</color> è offline.	0=name color,1=player name
GLOBAL_SOCIAL_TOAST_FRIEND_ONLINE	<color=#{0}>{1}</color> è online.	0=name color,1=player name
GLOBAL_SOCIAL_TOAST_FRIEND_PALADIN_LEVEL	<color=#{0}>{1}</color> ha raggiunto il livello {2} con il Paladino.	0=name color,1=player name,2=level
GLOBAL_SOCIAL_TOAST_FRIEND_PRIEST_LEVEL	<color=#{0}>{1}</color> ha raggiunto il livello {2} con il Sacerdote.	0=name color,1=player name,2=level
GLOBAL_SOCIAL_TOAST_FRIEND_RANK_EARNED	<color=#{0}>{1}</color> ha appena raggiunto {2}!	0=name color,1=player name,2=medal name
GLOBAL_SOCIAL_TOAST_FRIEND_RANK_EARNED_CLASSIC	<color=#{0}>{1}</color> ha appena raggiunto {2} in formato Classico!	0=name color,1=player name,2=medal name
GLOBAL_SOCIAL_TOAST_FRIEND_RANK_EARNED_WILD	<color=#{0}>{1}</color> ha appena raggiunto {2} in formato Selvaggio!	0=name color,1=player name,2=medal name
GLOBAL_SOCIAL_TOAST_FRIEND_RANK_LEGEND	<color=#{0}>{1}</color> ha ottenuto il grado Leggenda!	0=name color,1=player name
GLOBAL_SOCIAL_TOAST_FRIEND_RANK_LEGEND_CLASSIC	<color=#{0}>{1}</color> ha ottenuto il grado Leggenda in formato Classico!	0=name color,1=player name
GLOBAL_SOCIAL_TOAST_FRIEND_RANK_LEGEND_WILD	<color=#{0}>{1}</color> ha ottenuto il grado Leggenda in formato Selvaggio!	0=name color,1=player name
GLOBAL_SOCIAL_TOAST_FRIEND_REQUEST	<color=#{0}>{1}</color> ti ha inviato una richiesta d'amicizia.	0=name color,1=player name
GLOBAL_SOCIAL_TOAST_FRIEND_ROGUE_LEVEL	<color=#{0}>{1}</color> ha raggiunto il livello {2} con il Ladro.	0=name color,1=player name,2=level
GLOBAL_SOCIAL_TOAST_FRIEND_SHAMAN_LEVEL	<color=#{0}>{1}</color> ha raggiunto il livello {2} con lo Sciamano.	0=name color,1=player name,2=level
GLOBAL_SOCIAL_TOAST_FRIEND_WARLOCK_LEVEL	<color=#{0}>{1}</color> ha raggiunto il livello {2} con lo Stregone.	0=name color,1=player name,2=level
GLOBAL_SOCIAL_TOAST_FRIEND_WARRIOR_LEVEL	<color=#{0}>{1}</color> ha raggiunto il livello {2} con il Guerriero.	0=name color,1=player name,2=level
GLOBAL_SOCIAL_TOAST_RECENT_OPPONENT_FRIEND_REQUEST	Un avversario affrontato di recente vuole diventare tuo amico!	
GLOBAL_SOCIAL_TOAST_SPECTATOR_ADDED	<color=#{0}>{1}</color> sta osservando la tua partita.	0=name color,1=player name
GLOBAL_SOCIAL_TOAST_SPECTATOR_INVITE_RECEIVED	<color=#{0}>{1}</color> ti ha invitato a osservare la sua partita!	0=name color,1=player name
GLOBAL_SOCIAL_TOAST_SPECTATOR_INVITE_SENT	Invito a osservare inviato a <color=#{0}>{1}</color>.	0=name color,1=player name
GLOBAL_SOCIAL_TOAST_SPECTATOR_REMOVED	<color=#{0}>{1}</color> non sta più osservando la tua partita.	0=name color,1=player name
GLOBAL_SPECTATE	Osserva	
GLOBAL_SPECTATOR_COUNT_PANEL_HEADER	Osservatori presenti	
GLOBAL_SPECTATOR_COUNT_PANEL_TEXT_ONE	{0} ti sta osservando.	0=player name, this is shown when there's only 1 person spectating you.
GLOBAL_SPECTATOR_ERROR_CANNOT_SPECTATE_2_GAMES	Impossibile osservare due partite diverse contemporaneamente.	
GLOBAL_SPECTATOR_ERROR_CREATE_PARTY_TEXT	Errore durante la creazione del gruppo di osservazione.	
GLOBAL_SPECTATOR_ERROR_LEAVE_FOR_SPECTATE_PLAYER_TEXT	Errore durante l'uscita dal gruppo precedente per iniziare a osservare {0}.	0=player name
GLOBAL_SPECTATOR_KICK_PROMPT_HEADER	Rimuovi spettatore	
GLOBAL_SPECTATOR_KICK_PROMPT_TEXT	Vuoi davvero impedire a {0} di osservarti? Disattivando l'opzione "Permetti agli amici di osservare le mie partite" dal menu, puoi impedire che altri assistano alle tue partite.	0=player name
GLOBAL_SPECTATOR_LEAVE_PROMPT_HEADER	Modalità spettatore	
GLOBAL_SPECTATOR_LEAVE_PROMPT_TEXT	Vuoi davvero smettere di osservare?	
GLOBAL_SPECTATOR_MODE_INDICATOR_TEXT	Modalità spettatore	text that shows up on the bottom left of screen showing that you're currently in Spectator Mode.
GLOBAL_SPECTATOR_REMOVED_PROMPT_APPEAR_OFFLINE_TEXT	Impostarsi come invisibile disattiva la modalità spettatore.	
GLOBAL_SPECTATOR_REMOVED_PROMPT_HEADER	Rimosso	
GLOBAL_SPECTATOR_REMOVED_PROMPT_TEXT	Sei stato rimosso dalla partita che stavi osservando.	
GLOBAL_SPECTATOR_SERVER_REJECTED_HEADER	Disconnessione	
GLOBAL_SPECTATOR_SERVER_REJECTED_TEXT	La partita che volevi osservare potrebbe essere piena, terminata o preclusa agli spettatori.	
GLOBAL_SPECTATOR_WAITING_FOR_NEXT_GAME_HEADER	Modalità spettatore	
GLOBAL_SPECTATOR_WAITING_FOR_NEXT_GAME_TEXT	In attesa della prossima partita.\n\n{0}: {1}	0=player name, 1=player's current activity -- will be filled in with values PRESENCE_STATUS_* and PRESENCE_SCENARIO_*_NORMAL_SCENARIO_* from PRESENCE.txt (e.g. "Jane Doe is Heading into Play Mode")
GLOBAL_SPECTATOR_WAITING_FOR_NEXT_GAME_TEXT_BATTLING	In attesa della prossima partita.\n\n{0} sta affrontando {1}	0=player name, 1=player's current activity -- will be filled in with values PRESENCE_SCENARIO_*_HEROIC_* from PRESENCE.txt (e.g. "Jane Doe is Battling Heroic Gothik the Harvester")
GLOBAL_SPECTATOR_WAITING_FOR_NEXT_GAME_TEXT_ENTERING	In attesa della prossima partita.\n\n{0} sta entrando a: {1}	0=player name, 1=player's current activity -- will be filled in with values PRESENCE_ADVENTURE_MODE_* from PRESENCE.txt (e.g. "Jane Doe is entering Naxxramas")
GLOBAL_SPECTATOR_WAITING_FOR_NEXT_GAME_TEXT_OFFLINE	In attesa della prossima partita.\n\n{0} è offline	0=player name; shown when player is offline.
GLOBAL_SPECTATOR_WAITING_FOR_NEXT_GAME_TEXT_ONLINE	In attesa della prossima partita.\n\n{0} è online	0=player name; shown when there is no current activity string available.
GLOBAL_SPECTATOR_WAITING_FOR_NEXT_GAME_TEXT_PLAYING	In attesa della prossima partita.\n\n{0} sta affrontando la {1}	0=player name, 1=player's current activity -- will be filled in with values PRESENCE_SCENARIO_*_CLASS_CHALLENGE_* from PRESENCE.txt (e.g. "Jane Doe is playing Naxxramas Paladin Challenge")
GLOBAL_SPECTATOR_WAITING_FOR_NEXT_GAME_TIMEOUT	Il giocatore che stavi osservando ha impiegato troppo tempo ad avviare la partita. La modalità spettatore è stata annullata.	
GLOBAL_SPELL_SCHOOL_ARCANE	Arcano	
GLOBAL_SPELL_SCHOOL_FEL	Vile	
GLOBAL_SPELL_SCHOOL_FIRE	Fuoco	
GLOBAL_SPELL_SCHOOL_FROST	Gelo	
GLOBAL_SPELL_SCHOOL_HOLY	Sacro	
GLOBAL_SPELL_SCHOOL_NATURE	Natura	
GLOBAL_SPELL_SCHOOL_PHYSICAL_COMBAT	Combattimento	
GLOBAL_SPELL_SCHOOL_SHADOW	Ombra	
GLOBAL_SPLASH_CLOSED_RECONNECTING	Riconnessione in corso...	
GLOBAL_SPLASH_CLOSED_SIGN_TITLE	Chiuso	
GLOBAL_STANDARD	Standard	
GLOBAL_STORE_MOBILE_NAME_AMAZON	sull'App-Shop Amazon	
GLOBAL_STORE_MOBILE_NAME_APPLE	sull'App Store Apple	
GLOBAL_STORE_MOBILE_NAME_DEFAULT	nel negozio Blizzard	
GLOBAL_STORE_MOBILE_NAME_GOOGLE	su Google Play	
GLOBAL_SUPPORT	Assistenza	
GLOBAL_SWITCH_ACCOUNT	Cambia account	
GLOBAL_TAVERN_BRAWL	Rissa	
GLOBAL_TAVERN_BRAWL_ERROR_NOT_ACTIVE	Spiacenti, questa Rissa non è attualmente attiva. Attendi qualche minuto e riprova.	
GLOBAL_TAVERN_BRAWL_ERROR_SEASON_INCREMENTED	Spiacenti, questa Rissa è terminata. Un'altra sarà disponibile molto presto!	
GLOBAL_TOOLTIP_FRIEND_BUTTON_DESC	Sfida i tuoi amici o parla con loro.	
GLOBAL_TOOLTIP_FRIEND_BUTTON_HEADER	Amici	
GLOBAL_TOOLTIP_MENU_DESC	Accedi alle opzioni, esci dal gioco e altro ancora.	
GLOBAL_TOOLTIP_MENU_HEADER	Menu di gioco	
GLOBAL_TOOLTIP_MENU_OFFLINE_DESC	Sei attualmente offline. Clicca qui per riconnetterti.	
GLOBAL_TOOLTIP_MENU_OFFLINE_HEADER	Offline	
GLOBAL_TUTORIAL_ATTACK	Attacco	
GLOBAL_TUTORIAL_ATTACKER	Attaccante	
GLOBAL_TUTORIAL_COST	Costo	
GLOBAL_TUTORIAL_DEFENDER	Difensore	
GLOBAL_TUTORIAL_HEALTH	Salute	
GLOBAL_TUTORIAL_HERO_POWER	Potere Eroe	
GLOBAL_TUTORIAL_MINION	Servitore	
GLOBAL_TUTORIAL_TAUNT	Provocazione	
GLOBAL_TUTORIAL_TAUNT_DESCRIPTION	I nemici devono attaccare questo servitore.	
GLOBAL_TUTORIAL_USED	Usato	
GLOBAL_TUTORIAL_YOUR_MANA	Il tuo Mana	
GLOBAL_TUTORIAL_YOUR_TURN	Tocca a te!	
GLOBAL_UPDATE	Aggiorna	
GLOBAL_VERSION	Versione	
GLOBAL_WAIT_FOR_OPPONENT_RECONNECT	In attesa della riconnessione dell'avversario... ({0}m{1}s)\nPotrebbe essere necessario accedere al menu di gioco per terminare la partita.	
GLOBAL_WAIT_FOR_OPPONENT_RECONNECT_HEADER	Partita in pausa	
GLOBAL_WAIT_FOR_OPPONENT_RECONNECT_SPECTATOR	In attesa della riconnessione dell'avversario... ({0}m{1}s)	
GLOBAL_WILD	Selvaggio	
GLOBAL_WINS	Vittorie	
