TAG	TEXT	COMMENT
ChromaggusBoss_Death_1	Roaaaaarr!	
ChromaggusBoss_EmoteResponse_1	ROAR!	
ChromaggusBoss_Start_1	Roar!	
LOE_07_MINE_CART_EMOTES	CLUNK	
OnyxiaBoss_Death_1	Roaaaaarr!	
OnyxiaBoss_EmoteResponse_1	ROAR!	
OnyxiaBoss_Start_1	Roar!	
VO_Aran_Male_Shade_AranCrackle_01	Umpf. Ai miei tempi, Crepitio infliggeva sempre sei danni.	
VO_Aran_Male_Shade_AranDeath_02	Non di nuovo...	
VO_Aran_Male_Shade_AranEmoteResponse_01	Fuori! Fuori!	
VO_Aran_Male_Shade_AranHeroPower_01	Bruciate, vandali!	
VO_Aran_Male_Shade_AranMedivhSkin_01	Medivh? No, no... non stavo importunando gli ospiti...	
VO_Aran_Male_Shade_AranOpen_01	T'insegnerò il rispetto!	
VO_Aran_Male_Shade_AranSpell_03	Torna nella gelida oscurità!	
VO_Aran_Male_Shade_AranSpell_04	Il padrone è potente, ma anche io ho dei poteri!	
VO_Aran_Male_Shade_AranTrons_02	NO! NO! Quell'orrido frastuono! Quei terribili "ciao"!	
VO_Aran_Male_Shade_AranTurn1_01	Niente musica alta nella mia torre!	
VO_Aran_Male_Shade_AranTurn5_01	Non sono un giullare qualunque! Io sono Nielas Aran!	
VO_Barnes_Male_Human_FinalNazraTurn5_02	Aiuto! Abbiamo finito le banane! Mukla sta devastando la dispensa!	
VO_Barnes_Male_Human_JulianneTurn5_01	Che festa sarebbe senza uno spettacolo? E che spettacolo sarebbe senza pubblico?	
VO_Barnes_Male_Human_JulianneWin_01	Un atto è concluso! Ne restano due.	
VO_Barnes_Male_Human_Wing2Intro_02	Ti porgo il benvenuto al teatro! Sono Barnes, il direttore di scena. I portali per salvare Medivh sono di sopra, ma prima devi assolutamente assistere al nostro spettacolo!	
VO_Barnes_Male_Human_WolfBigMinion_01	Oh, nonna, che servitori grandi che hai!	
VO_Barnes_Male_Human_WolfClaws_01	Non preoccuparti! Quei grandi artigli servono solo... a far scena!	
VO_Barnes_Male_Human_WolfTurn5_01	Adoro la partecipazione del pubblico! Corri, gentile ospite, corri!	
VO_Barnes_Male_Human_WolfTurn9_01	Ahah! Che spettacolo! Meglio ancora dell'Ogre che abbiamo inseguito la settimana scorsa!	
VO_Barnes_Male_Human_WolfWin_01	Ah ah! Arriva il gran finale!	
VO_BigBadWolf_Male_Worgen_WolfBigMinion_01	È per squartarti meglio!	
VO_BigBadWolf_Male_Worgen_WolfDeath_01	Cacciato? Nooo...	
VO_BigBadWolf_Male_Worgen_WolfDireWolfAlpha_01	ROAR!!!	
VO_BigBadWolf_Male_Worgen_WolfDireWolfAlpha_02	UUUUUUHHH...	
VO_BigBadWolf_Male_Worgen_WolfEmoteResponse_01	Mmm...\nChe delizia...	
VO_BigBadWolf_Male_Worgen_WolfOpen_01	Scappa, ragazzina, scappa!	
VO_BigBadWolf_Male_Worgen_WolfScarletCrusader_01	Oh, Cappuccetto Rosso, dove te ne vai?	
VO_BigBadWolf_Male_Worgen_WolfTurn1_01	Guarda i tuoi servitori. Vedi come si fanno piccoli davanti a me?	
VO_BlackKing_Male_ChessPiece_ChessEmoteGreetings_01	Sempre.	
VO_BlackKing_Male_ChessPiece_ChessEmoteOops_01	O una trappola?	
VO_BlackKing_Male_ChessPiece_ChessEmoteSorry_01	Un sacrificio necessario.	
VO_BlackKing_Male_ChessPiece_ChessEmoteThanks	Quando vuoi.	
VO_BlackKing_Male_ChessPiece_ChessEmoteThanks_01	Quando vuoi.	
VO_BlackKing_Male_ChessPiece_ChessEmoteThreaten_01	Matto in 3 turni.	
VO_BlackKing_Male_ChessPiece_ChessEmoteWellPlayed_01	Non ancora.	
VO_BlackKing_Male_ChessPiece_ChessEmoteWow_01	Naturalmente.	
VO_BlackKing_Male_ChessPiece_ChessOpen_01	Nessuno passerà!	
VO_BOSS_AYA_Female_Pandaren_BC_0_Jade_Golem_02	Altri golem? Spettacolo!!!	
VO_BOSS_AYA_Female_Pandaren_BC_0_Jade_Golem_03	Sììì! IN MARCIA!	
VO_BOSS_AYA_Female_Pandaren_BC_0_Jade_Golem_04	Ancora! ANCORA!	
VO_BOSS_AYA_Female_Pandaren_BC_2_1st_Turn_Start_01	Niente affatto... Voglio Meccania tutta per me!	
VO_BOSS_AYA_Female_Pandaren_BC_2_2nd_Turn_Start_01	Meccania appartiene al Loto di Giada, e il Loto appartiene a me!	
VO_BOSS_AYA_Female_Pandaren_BC_2_Arms_Dealing1_01	Altre armi... molto originale!	
VO_BOSS_AYA_Female_Pandaren_BC_2_Fill1_01	Oooh, vedrai, questo ti piacerà...	
VO_BOSS_AYA_Female_Pandaren_BC_2_Fill2_01	Nah, mi piace qui! Credo che resterò!	
VO_BOSS_AYA_Female_Pandaren_BC_2_Goons_Win_01	No no no no no! Così NON va bene!	
VO_BOSS_AYA_Female_Pandaren_BC_2_Goons_Winning_02	Forse dovresti TACERE!	
VO_BOSS_AYA_Female_Pandaren_BC_2_Jade_Win_01	Il Loto di Giada vince ancora! Sono la migliore!	
VO_BOSS_AYA_Female_Pandaren_BC_2_Lotus_Winning_01	Eheheh, continua pure a giocare!	
VO_BOSS_AYA_Female_Pandaren_BC_3_1st_Turn_Start_01	Meccania è MERAVIGLIOSA! La voglio!	
VO_BOSS_AYA_Female_Pandaren_BC_3_1st_Turn_Start_02	Eheheh, volentieri...	
VO_BOSS_AYA_Female_Pandaren_BC_3_2nd_Turn_Start_01	Accidenti, come siete noiosi voi della Kabala...	
VO_BOSS_AYA_Female_Pandaren_BC_3_Fill1_01	Che bella giornata, eh, Kaz?	
VO_BOSS_AYA_Female_Pandaren_BC_3_Fill2_01	Forza, Kaz, lasciati andare. Prova a divertirti un po'.	
VO_BOSS_AYA_Female_Pandaren_BC_3_Jade_Golem3_01	Eheheheheh!	
VO_BOSS_AYA_Female_Pandaren_BC_3_Kabal_Winning_01	È perché sei una noia mortale.	
VO_BOSS_AYA_Female_Pandaren_BC_3_Kabal_Wins_01	Non ci posso credere! NO NO NO NO!	
VO_BOSS_AYA_Female_Pandaren_BC_3_Lotus_Winning_01	Oh, che succede, Kaz? Mi sembri un po' giù!	
VO_BOSS_AYA_Female_Pandaren_BC_3_Lotus_Wins_01	Be', è stato divertente. Grazie per la partita, Kaz!	
VO_BOSS_AYA_Female_Pandaren_BC_3_Potion1_02	Bla bla bla pozioni bla bla bla... Vieni qui e COMBATTI come un vero Troll!	
VO_BOSS_AYA_Female_Pandaren_BC_3_Potion3_01	Bleah! Questa roba è disgustosa!	
VO_BOSS_AYA_Female_Pandaren_Concede_01	Oh, non sei affatto divertente.	
VO_BOSS_AYA_Female_Pandaren_Greetings_01	Ehilà!	
VO_BOSS_AYA_Female_Pandaren_Oops_01	Ops!	
VO_BOSS_AYA_Female_Pandaren_START_01	Preparate i golem!	
VO_BOSS_AYA_Female_Pandaren_Thanks_02	Grazie!	
VO_BOSS_AYA_Female_Pandaren_Threaten_02	Mmm, credo che ora morirai.	
VO_BOSS_AYA_Female_Pandaren_Well_Played_01	Davvero spettacolare!	
VO_BOSS_AYA_Female_Pandaren_Wow_02	Accidenti!	
VO_BOSS_CHO_Male_Ogre_BC_1_1st_Turn_Start_01	SGHERRI TORVI FANNO PERICOLOSE!	
VO_BOSS_CHO_Male_Ogre_BC_1_Fill2_01	ADDOSSO, RAGAZZI!	
VO_BOSS_CHO_Male_Ogre_BC_2_Fill1_01	RAGAZZA HA OCCHI PAZZI!	
VO_BOSS_CHO_Male_Ogre_Concede_01	GIÀ! NO ASPETTA, È TUA!	
VO_BOSS_CHO_Male_Ogre_Oops_02	ERRORE FATTO!	
VO_BOSS_CHO_Male_Ogre_Thanks_01	GRAZIE.	
VO_BOSS_HAN_Male_Ogre_BC_0_Arms_Dealing_01	Qualcosa è caduto dal retro di un carro, eheheh...	
VO_BOSS_HAN_Male_Ogre_BC_0_Arms_Dealing_02	A me, Sgherri!	
VO_BOSS_HAN_Male_Ogre_BC_0_Arms_Dealing_03	Potenzia bene quello Sgherro e mettilo in gioco!	
VO_BOSS_HAN_Male_Ogre_BC_0_Arms_Dealing_04	Gli Sgherri Torvi si guardano le spalle a vicenda!	
VO_BOSS_HAN_Male_Ogre_BC_1_1st_Turn_Start_01	Queste sono strade pericolose, Kazakus.	
VO_BOSS_HAN_Male_Ogre_BC_1_2nd_Turn_Start_01	Meccania appartiene agli Sgherri.	
VO_BOSS_HAN_Male_Ogre_BC_1_2nd_Turn_Start_02	Tutto molto bello, ma Meccania appartiene agli Sgherri.	
VO_BOSS_HAN_Male_Ogre_BC_1_Fill1_01	Prendi le tue pozioni e vattene.	
VO_BOSS_HAN_Male_Ogre_BC_1_Fill2_01	Ehi, Cho, chiama gli Sgherri. Questo Troll ha bisogno di una lezione.	test
VO_BOSS_HAN_Male_Ogre_BC_1_Goons_Win_01	Mi spiace, Kazakus. Niente di personale.	
VO_BOSS_HAN_Male_Ogre_BC_1_Goons_Winning_01	Oh, sembra che tu abbia avuto un... incidente, Kazakus...	
VO_BOSS_HAN_Male_Ogre_BC_1_Kabal_Win_02	Non abbiamo... ancora finito... Kazakus.	
VO_BOSS_HAN_Male_Ogre_BC_1_Kabal_Winning_02	Eh. Non male, vecchietto.	
VO_BOSS_HAN_Male_Ogre_BC_1_Potion1_01	Sai, non mi sono mai piaciute le pozioni...	
VO_BOSS_HAN_Male_Ogre_BC_1_Potion2_01	Oh! Guarda dove lanci quella roba!	
VO_BOSS_HAN_Male_Ogre_BC_2_1st_Turn_Start_01	Meccania è nostra! Vattene, ragazzina!	
VO_BOSS_HAN_Male_Ogre_BC_2_1st_Turn_Start_04	Sì, be'... Noi Sgherri Torvi avremmo qualcosa da ridire al riguardo...	
VO_BOSS_HAN_Male_Ogre_BC_2_Fill1_01	Non mi piace il tuo sguardo, Aya.	
VO_BOSS_HAN_Male_Ogre_BC_2_Goons_Win_01	Prenditi una pausa, Aya. Eheheh! Ti farà bene.	
VO_BOSS_HAN_Male_Ogre_BC_2_Goons_Winning_01	Forse dovresti rivalutare la tua posizione.	
VO_BOSS_HAN_Male_Ogre_BC_2_Jade_Golem2_01	Mi sto davvero stancando di questi affari di giada.	
VO_BOSS_HAN_Male_Ogre_BC_2_Lotus_Win_01	Agh. Meccania... Sarà... Nostra...	
VO_BOSS_HAN_Male_Ogre_BC_2_Lotus_Winning_01	Agh, qualcuno mandi via questa ragazzina.	
VO_BOSS_HAN_Male_Ogre_Concede_01	È tutta colpa tua.	
VO_BOSS_HAN_Male_Ogre_Greetings_01	Ti do il benvenuto a Meccania.	
VO_BOSS_HAN_Male_Ogre_INTRO_PACK_OPEN_7	Ehi, ehi, ehi... Chi è quel gran bel tipo? Eheheh!	
VO_BOSS_HAN_Male_Ogre_Oops_01	Brutta storia.	
VO_BOSS_HAN_Male_Ogre_START_01	Ora sei nel nostro territorio!	
VO_BOSS_HAN_Male_Ogre_Thanks_01	Ti sono davvero grato.	test
VO_BOSS_HAN_Male_Ogre_Threaten_01	Non puoi rifiutare.	
VO_BOSS_HAN_Male_Ogre_Well_Played_02	Te lo devo dire, mi hai impressionato.	
VO_BOSS_HAN_Male_Ogre_WOW_01	Non male!	
VO_BOSS_KAZAKUS_Male_Troll_BC_0_Potion_01	Ah. Ci voleva proprio!	
VO_BOSS_KAZAKUS_Male_Troll_BC_0_Potion_02	Piglia chisto!	
VO_BOSS_KAZAKUS_Male_Troll_BC_0_Potion_04	Bevi a fondo... Muahahah!	
VO_BOSS_KAZAKUS_Male_Troll_BC_0_Potion_05	Che gusto tiene?!?	
VO_BOSS_KAZAKUS_Male_Troll_BC_1_1st_Turn_Start_01	Meccania sarà mia, Han'cho!	
VO_BOSS_KAZAKUS_Male_Troll_BC_1_2nd_Turn_Start_01	La Kabala sta dappertutto. Meccania è nuostr'.	
VO_BOSS_KAZAKUS_Male_Troll_BC_1_Arms_Dealing1_01	Umpf... che codardi chesti Sgherri. BASTA NASCONDERSI NELLA MANO!	
VO_BOSS_KAZAKUS_Male_Troll_BC_1_Fill1_01	I seguaci miei controllano nu potere infinito.	
VO_BOSS_KAZAKUS_Male_Troll_BC_1_Goons_Win_01	Tornerò, più potente che mai!	
VO_BOSS_KAZAKUS_Male_Troll_BC_1_Goons_Winning_01	GRRR… Soffrirai, Han'cho...	
VO_BOSS_KAZAKUS_Male_Troll_BC_1_Kabal_Win_01	E invece sì.	
VO_BOSS_KAZAKUS_Male_Troll_BC_1_Kabal_Winning_01	La fine tua si avvicina, Han'cho!	
VO_BOSS_KAZAKUS_Male_Troll_BC_3_1st_Turn_Start_01	Ahahah! Dovrai passare sul cadavere mio per ottenerla.	
VO_BOSS_KAZAKUS_Male_Troll_BC_3_Fill1_01	NUN CHIAMARMI ACCUSSÌ, RAGAZZINA ARROGANTE!	
VO_BOSS_KAZAKUS_Male_Troll_BC_3_Fill2_01	Inchinati al potere della Kabala!	
VO_BOSS_KAZAKUS_Male_Troll_BC_3_Jade_Golem2_01	Arrogante ragazzina, osi prendere in giro il più potente capo di Meccania?!?	
VO_BOSS_KAZAKUS_Male_Troll_BC_3_Jade_Golem3_01	Ragazzina insolente! Mo' basta con chesti golem!	
VO_BOSS_KAZAKUS_Male_Troll_BC_3_Kabal_Winning_01	Eheh! Mi sembri nu poco affaticata, ragazzina. Eheheh!	
VO_BOSS_KAZAKUS_Male_Troll_BC_3_Kabal_Winning_02	Ma che...? Bambina insolente! Sarò la FINE tua!	test
VO_BOSS_KAZAKUS_Male_Troll_BC_3_Kabal_Wins_01	Ahahah! Un'altra vittima del grande potere della Kabala!	
VO_BOSS_KAZAKUS_Male_Troll_BC_3_Lotus_Winning_01	Ragazzina impertinente...	
VO_BOSS_KAZAKUS_Male_Troll_BC_3_Lotus_Wins_01	Stupida ragazzina, nun è ancora finita!	
VO_BOSS_KAZAKUS_Male_Troll_BC_3_Potion1_01	Assaggia la furia delle pozioni della Kabala!	
VO_BOSS_KAZAKUS_Male_Troll_Concede_01	Cheste strade sono mie!	
VO_BOSS_KAZAKUS_Male_Troll_Greetings_02	Salve, ignoranti.	test
VO_BOSS_KAZAKUS_Male_Troll_Mirror_Start_01	Allora tieni delle abilità...	
VO_BOSS_KAZAKUS_Male_Troll_Oops_01	Nu sbaglio piccirillo.	
VO_BOSS_KAZAKUS_Male_Troll_START_01	Il mana chiama.	
VO_BOSS_KAZAKUS_Male_Troll_Thanks_01	Lo apprezzo assai, pezzente.	
VO_BOSS_KAZAKUS_Male_Troll_Threaten_01	MECCANIA È MIA!	
VO_BOSS_KAZAKUS_Male_Troll_Well_Played_02	Tieni molto potenziale...	
VO_BOSS_KAZAKUS_Male_Troll_Wow_01	Quanto potere!	
VO_BRANN_MITHRIL_ALT_02	Affascinante. Queste rune di mithril contengono il Codice dei Guardiani. Risalgono al tempo dei Titani.	
VO_BRANN_WIN_07_ALT_07	Li abbiamo seminati! Il pomo è nella prossima sala.	
VO_BRM_027h_Death_63	Agh! AGH! NOOOOOOOOOOOO!!!	
VO_BRMA01_1_CARD_05	Bene, fate sentire il vostro "caloroso benvenuto"!	
VO_BRMA01_1_DEATH_09	Uooo, oh, oh. Ma che...? AH! Oh, che batosta, ma che ci posso fare?	
VO_BRMA01_1_ETC_06	È ora di un po' di musica dal vivo! Diamo il benvenuto a Elite Tauren Chieftain!	
VO_BRMA01_1_HERO_POWER_04	Ahahah! Ammucchiata!	
VO_BRMA01_1_RESPONSE_03	Ahahah... oh, hic! Oops, scusatemi!	
VO_BRMA01_1_START_01	Ti do il benvenuto al Torvo Beone!	
VO_BRMA01_1_SUCCUBUS_08	Signora Nagmara! Credo che l'ospite voglia qualcosa da "bere".	
VO_BRMA01_1_TURN1_02	Amici! Ah ah, guardate un po'... abbiamo un ospite.	
VO_BRMA01_1_WARGOLEM_07	Oh oh oh! Adesso arrivano i guai! Falange! Tocca a te!	
VO_BRMA02_1_ALAKIR_34	Ecco il Signore Elementale che adora spiaccicare insetti: Al'Akir!	
VO_BRMA02_1_ALEXSTRAZA_32	Protettrice della Vita, Regina dei Draghi, per voi nell'Arena dei Ferroscuro... Alexstrasza!	
VO_BRMA02_1_BEAST_22	Adora sgranocchiare Gnomi, ma è pronta a fare un'eccezione: ecco a voi La Bestia!	
VO_BRMA02_1_BOOM_28	Fate attenzione voi in prima fila, perché il prossimo sfidante è il Dott. Boom!	
VO_BRMA02_1_CAIRNE_20	Il suo coraggio ha condotto suo figlio a seguirne le orme: salutiamo Cairne!	
VO_BRMA02_1_CHO_07	E ora una storia dal più logorroico dei Pandaren: il Ramingo Cho!	
VO_BRMA02_1_DEATH_38	Ugh... Oh! Ohi! Ahi! Agh agh agh! Urgh...	
VO_BRMA02_1_DEATHWING_35	Oooh! Signore e signori... l'unico, l'inimitabile... Alamorte!	
VO_BRMA02_1_ETC_18	E adesso, il Tauren, il mito, la leggenda: Elite Tauren Chieftain!	
VO_BRMA02_1_FEUGEN_15	Un bell'applauso per Feugen!	
VO_BRMA02_1_FOEREAPER_29	È stato programmato per la distruzione totale: ecco a voi il Mietinemici 4000!	
VO_BRMA02_1_GEDDON_13	Oh oh, l'Arena si sta scaldando! Diamo il benvenuto al Barone Geddon!	
VO_BRMA02_1_GELBIN_21	Direttamente da Nuova Rabberciopoli, diamo il benvenuto al capo degli Gnomi: Gelbin Meccatork!	
VO_BRMA02_1_GRUUL_31	Non lo chiamano l'Ammazzadraghi per nulla! Accogliamo con un bell'applauso... Gruul!	
VO_BRMA02_1_HERO_POWER_05	Il pubblico sta diventando impaziente! Ahahah!	
VO_BRMA02_1_HOGGER_27	Diamo il benvenuto allo Gnoll di livello 11 che è diventato una leggenda del suo tempo: Boccalarga!	
VO_BRMA02_1_ILLIDAN_23	Chi ha bisogno degli occhi quando si possiedono due lame da guerra? Di certo non Illidan Grantempesta!	
VO_BRMA02_1_LEVIATHAN_12	Recentemente riparato e pronto a distruggere, ecco il Leviatano delle Fiamme!	
VO_BRMA02_1_LOATHEB_16	Turiamoci il naso, copriamoci la bocca e accogliamo quel puzzone di Loatheb!	
VO_BRMA02_1_MAEXXNA_24	È il ragno gigante per eccellenza! E qual è il suo nome? Ma certo, Maexxna!	
VO_BRMA02_1_MILLHOUSE_09	Oh, ma insomma. Chi l'ha fatto entrare nell'Arena?	
VO_BRMA02_1_MOGOR_25	Il suo vocabolario sarà anche limitato, ma la sua furia no! Salutiamo Mogor l'Ogre!	
VO_BRMA02_1_MUKLA_10	E ora, il signore delle banane in persona: Re Mukla!	
VO_BRMA02_1_NOZDORMU_36	Signore e sig... ooops! Tempo scaduto!	
VO_BRMA02_1_ONYXIA_33	Direttamente da Acquemorte e dal castello di Roccavento, preparatevi per... Onyxia!	
VO_BRMA02_1_PAGLE_08	Di ritorno dalla sua ultima battuta di pesca, quella lenza di Nat Pagle!	
VO_BRMA02_1_RESPONSE_04	Nessuno può sopravvivere contro tutte queste leggende!	
VO_BRMA02_1_SNEED_30	Il prossimo sfidante si nasconde dentro un vecchio Segatronchi! Chi sarà mai?	
VO_BRMA02_1_STALAGG_14	Riuscirà Stalagg a sopravvivere nell'Arena? Ah, scopriamolo!	
VO_BRMA02_1_START_01	Un nuovo sfidante!	
VO_BRMA02_1_SYLVANAS_19	Il suo odio eterno arde soltanto per voi: diamo il benvenuto a Sylvanas Ventolesto!	
VO_BRMA02_1_THALNOS_06	Tiriamo fuori gli scheletri, anzi lo scheletro, dall'armadio: ecco che arriva Thalnos!	
VO_BRMA02_1_THAURISSAN_37	Qui per noi direttamente dalla prossima missione: l'Imperatore Thaurissan!	
VO_BRMA02_1_TINKMASTER_11	Un applauso per il più grande inventore di tutti: il Meccanista Granfavilla!	
VO_BRMA02_1_TOSHLEY_26	Abbiamo tra noi un vero gentilgnomo: un bell'applauso per Toshley!	
VO_BRMA02_1_TURN1_02	Signore e signori! Che grande spettacolo abbiamo in serbo per voi!	
VO_BRMA02_1_TURN1_PT2_03	Le più grandi leggende di Azeroth contro un audace sfidante!	
VO_BRMA02_1_VOLJIN_17	Silenzio, per favore! Abbiamo un ospite speciale. Il Capoguerra Vol'jin in persona!	
VO_BRMA03_1_CARD_04	Per la forza di Ragnaros, la grande forza è con me!	
VO_BRMA03_1_DEATH_09	Aaaaaaaaaah!	
VO_BRMA03_1_HERO_POWER_06	MUOOORI!!!	
VO_BRMA03_1_MOIRA_DEATH_05	No!!! Moira!!! La PAGHERAI!!!	
VO_BRMA03_1_RESPONSE_03	Chiudi il becco o te lo chiudo io!	
VO_BRMA03_1_START_01	I Nani Ferroscuro non cadranno mai!	
VO_BRMA03_1_TURN1_02	Ehi! Giù le mani da mia moglie!	
VO_BRMA03_1_VS_RAG_07	Ragnaros! No! Di nuovo?!?	
VO_BRMA04_1_CARD_04	Fedeli del Fuoco, all'attacco!	
VO_BRMA04_1_DEATH_06	Rrrrrrrrrrrrh!	
VO_BRMA04_1_HERO_POWER_05	Magma!	
VO_BRMA04_1_RESPONSE_03	Io ti sgretolo!	
VO_BRMA04_1_START_01	Sono duro come la roccia!	
VO_BRMA04_1_TURN1_02	Sei proprio una frana...	
VO_BRMA05_1_CARD_05	Il tempo scorre, mortale!	
VO_BRMA05_1_DEATH_04	Un ultimo servigio...	
VO_BRMA05_1_HERO_POWER_06	Brucia!	
VO_BRMA05_1_RESPONSE_03	Armageddon!	
VO_BRMA05_1_START_01	Brucerai!	
VO_BRMA05_1_TURN1_02	Ragnaros ti consumerà!	
VO_BRMA06_1_DEATH_04	Mi arrendo! Mi arrendo!	
VO_BRMA06_1_RESPONSE_03	Pensi di aver già vinto? Forse hai bisogno di un'altra dolorosa lezione!	
VO_BRMA06_1_START_01	Nessuno può sfidare la Fiamma Vivente!	
VO_BRMA06_1_SUMMON_RAG_05	Ammirate Ragnaros, già antico quando il mondo era giovane!	
VO_BRMA06_1_TURN1_02_ALT	Addosso!	
VO_BRMA06_3_INTRO_01	TROPPO PRESTO! MI HAI SVEGLIATO TROPPO PRESTO, EXECUTUS!	
VO_BRMA06_3_RESPONSE_03	COSA SIGNIFICA QUESTA INTRUSIONE?	
VO_BRMA06_3_TURN1_02	INSETTI MORTALI! OSATE INTRODURVI NEL MIO DOMINIO?	
VO_BRMA07_1_CARD_04	Tempo di schiacciare!	
VO_BRMA07_1_DEATH_06	Rrrnoooooo!	
VO_BRMA07_1_HERO_POWER_05	Io schiacciare, tu morire!	
VO_BRMA07_1_RESPONSE_03	Raaar!!! Io schiacciare!	
VO_BRMA07_1_START_01	Io schiacciare te!	
VO_BRMA07_1_TURN1_02	Nnng. Schiacciare o spaccare? Scelta difficile!	
VO_BRMA08_1_CARD_05	Proteggerò i Bastioni!	
VO_BRMA08_1_DEATH_06	Rrrh. Aaah!	
VO_BRMA08_1_RESPONSE_04	Perché? Perché??? Credevo che fossimo amici...	
VO_BRMA08_1_START_01	E tu che cosa ci fai qui?	
VO_BRMA08_1_TURN1_03	Sire Nefarius! Credevo che l'insetto che ci ha liberati di Ragnaros fosse dei nostri...	
VO_BRMA08_1_TURN1_ALT_02	Sei qui per aiutarmi ad annientare i mortali di questo mondo?	
VO_BRMA09_1_CARD_05	I Bastioni... sono nostri!	
VO_BRMA09_1_DEATH_11	Rrraaagh!	
VO_BRMA09_1_HERO_POWER1_06	Aprite i cancelli!	
VO_BRMA09_1_HERO_POWER2_07	Uccidete chi li controlla, là in fondo!	
VO_BRMA09_1_HERO_POWER3_08	Concentratevi su quell'infame, idioti!	
VO_BRMA09_1_HERO_POWER4_09	Insieme siamo IMBATTIBILI!	
VO_BRMA09_1_RESPONSE_04	Muahahahah.	
VO_BRMA09_1_START_01	Noi siamo la Vera Orda!	
VO_BRMA09_1_TURN1_03	Hai scelto di scalare la montagna sbagliata!	
VO_BRMA09_1_TURN1_ALT_02	Nessuno può ostacolarci! MUORI!!!	
VO_BRMA10_1_DEATH_08	Rrrrrrrrrrrh!	
VO_BRMA10_1_EGG_DEATH_1_05	Pazzi! Quelle uova valgono più di quanto immaginate!	
VO_BRMA10_1_EGG_DEATH_2_06	No! Un'altra! Ti staccherò la testa per quest'oltraggio!	
VO_BRMA10_1_EGG_DEATH_3_07	La pagherai per questo!	
VO_BRMA10_1_HERO_POWER_04	Che nessuno tocchi le mie uova!	
VO_BRMA10_1_RESPONSE_03	Ti strapazzerò come un uovo!	
VO_BRMA10_1_START_01	Ammira, le uova corrotte del nostro nuovo Stormo dei Draghi!	
VO_BRMA10_1_TURN1_02	Queste uova saranno la tua fine!	
VO_BRMA11_1_ALEXSTRAZA_07	Aiutami, Protettrice della Vita!!! Ti prego!	
VO_BRMA11_1_CARD_04	La furia di Roccianera scorre nelle mie vene!	
VO_BRMA11_1_DEATH_ALT_08	Finalmente, l'agonia ha fine...	
VO_BRMA11_1_HERO_POWER_05	AAAAH! DISTRUZIONE!	
VO_BRMA11_1_KILL_PLAYER_06	Ti prego, perdonami... Ho fallito.	
VO_BRMA11_1_RESPONSE_03	Saresti dovuto fuggire finché potevi, mortale.	
VO_BRMA11_1_START_01	Fuggi prima che perda del tutto il controllo!	
VO_BRMA11_1_TURN1_02	Troppo tardi... La corruzione di Nefarian si è impadronita di me!	
VO_BRMA13_1_DEATH_ALT_23	No! NOOO! IO TORNERÒ!	
VO_BRMA13_1_DEATHWING_19	Ma... padre?!?	
VO_BRMA13_1_HP_DRUID_14	Druido, la natura è sotto il mio controllo!	
VO_BRMA13_1_HP_GENERIC_18	La tua magia è mia!	
VO_BRMA13_1_HP_HUNTER_12	Il Cacciatore diventa la preda!	
VO_BRMA13_1_HP_MAGE_11	Mago, dovresti fare più attenzione quando giochi con gli incantesimi...	
VO_BRMA13_1_HP_PALADIN_07	Paladino, la Luce ti ha abbandonato?	
VO_BRMA13_1_HP_PRIEST_08	Sacerdote, la Luce adesso serve me!	
VO_BRMA13_1_HP_ROGUE_15	Ladro, smettila di nasconderti e affrontami!	
VO_BRMA13_1_HP_SHAMAN_13	Sciamano, ora gli elementi obbediscono a ME.	
VO_BRMA13_1_HP_WARLOCK_10	Stregone, giochi con un potere al di là della tua comprensione!	
VO_BRMA13_1_HP_WARRIOR_09	Guerriero, la tua forza diventa il tuo punto debole!	
VO_BRMA13_1_RESPONSE_05	Qui sono io il padrone!	
VO_BRMA13_1_START_01	Ti do il benvenuto nel mio santuario personale.	
VO_BRMA13_1_TURN1_PT1_02	Ahahaha! Contempla il vero potere di NEFARIAN!	
VO_BRMA13_1_TURN1_PT2_03	Mana infinito! Scaglie di drago!	
VO_BRMA14_1_CARD_09	Reindirizzamento energia in eccesso.	
VO_BRMA14_1_DEATH_08	Sistemi di difesa distrutti. Spegnimento in corso.	
VO_BRMA14_1_HP1_03	Unità Electron attivata.	
VO_BRMA14_1_HP2_04	Unità Toxitron attivata.	
VO_BRMA14_1_HP3_05	Unità Arcanotron attivata.	
VO_BRMA14_1_HP4_06	Unità Magmatron attivata.	
VO_BRMA14_1_HP5_07	Unità Difensiva attiva.	
VO_BRMA14_1_RESPONSE1_10	Biip. Boop. Biip.	
VO_BRMA14_1_RESPONSE2_11	Tentativo di connessione.	
VO_BRMA14_1_RESPONSE3_12	Connessione riuscita. Scaricamento aggiornamento del sistema operativo.	
VO_BRMA14_1_RESPONSE4_13	Aggiornamento installato. Ciao! Ciao! Ciao!	
VO_BRMA14_1_RESPONSE5_14	Ciao! Ciao! Ciao!	
VO_BRMA14_1_START_01	Intrusi rilevati.	
VO_BRMA14_1_TURN1_02	Matrice di difesa primaria inizializzata.	
VO_BRMA15_1_CARD_05	I miei errori saranno la tua rovina!	
VO_BRMA15_1_DEATH_04	Aaaaaaaahhhhh!	
VO_BRMA15_1_HERO_POWER_06	Mescola, amalgama, riscalda!	
VO_BRMA15_1_RESPONSE_03	Non si butta via niente!	
VO_BRMA15_1_START_01	Non sono permesse interruzioni!	
VO_BRMA15_1_TURN1_02	Oh, il padrone non può aspettare! Non posso fallire ancora!	
VO_BRMA16_1_CARD_04	Non puoi nasconderti.	
VO_BRMA16_1_DEATH_06	Rrrraaaaaaaah!	
VO_BRMA16_1_GONG1_10	AH! QUEL SUONO!	
VO_BRMA16_1_GONG2_11	NOOO! C'ERO QUASI!	
VO_BRMA16_1_GONG3_12	LE MIE ORECCHIE!	
VO_BRMA16_1_HERO_POWER_05	Sono sufficienti i tuoi passi maldestri e il tanfo che emani!	
VO_BRMA16_1_RESPONSE_03	Sì, parla, mi sto avvicinando.	
VO_BRMA16_1_START_01	Sento il battito del tuo cuore!	
VO_BRMA16_1_TRIGGER1_07	Ah! Ti ho sentito...	
VO_BRMA16_1_TRIGGER2_08	Odo dei passi.	
VO_BRMA16_1_TRIGGER3_09	Sento battere il tuo cuore... Non puoi sfuggirmi!	
VO_BRMA16_1_TURN1_02	La morte attende nell'oscurità!	
VO_BRMA17_1_CARD_86	Spero che tu sappia nuotare... nella lava fusa!	
VO_BRMA17_1_DEATH_97	Agh! Aaagh! Aaaaaaaaaaagh!	
VO_BRMA17_1_DEATH_HEROIC_98	Agh! Aaagh! NOOOOOOOOOO!	
VO_BRMA17_1_DEATHWING_88	Papà?!?	
VO_BRMA17_1_HERO_POWER_87	Il mio ombrofuoco anima le loro ossa.	
VO_BRMA17_1_NEF_AIR1_89	Osserva mentre sputo fuoco dall'alto! Un danno è solo l'inizio!	
VO_BRMA17_1_NEF_AIR2_90	Due Palle di Fuoco! Te le lancio dall'alto!	
VO_BRMA17_1_NEF_AIR3_91	Questa volta lancerò una sola Palla di Fuoco, poiché mi sto preparando per un turno GRANDIOSO.	
VO_BRMA17_1_NEF_AIR4_92	OH OH! TRE PALLE DI FUOCO! BECCATI QUESTO! DALL'ALTO!	
VO_BRMA17_1_NEF_AIR5_93	D'ora in poi sputerò solo una Palla di Fuoco!	
VO_BRMA17_1_NEF_AIR6_94	SCHERZAVO!!! *QUATTRO* PALLE DI FUOCO! AHAHAHAH!	
VO_BRMA17_1_NEF_AIR7_95	Non lancerò Palle di Fuoco in questo turno. Ma preparati...	
VO_BRMA17_1_NEF_AIR8_96	VENTI PALLE DI FUOCO! AHAHAHAH!	
VO_BRMA17_1_RESPONSE_85	Le menti dei mortali... così facili da manipolare.	
VO_BRMA17_1_RESURRECT1_82	Ti farò piovere addosso la distruzione!	
VO_BRMA17_1_RESURRECT2_83	Già che sono qui, ho una sorpresa per te là sotto!	
VO_BRMA17_1_RESURRECT3_84	Ammira la mia creazione definitiva! Risorgi, sorella! Risorgi, Onyxia!	
VO_BRMA17_1_START_78	Ahahah! Hai raggiunto il gran finale!	
VO_BRMA17_1_TRANSFORM1_80	Ho cercato di essere un ospite affabile, ma non vuoi deciderti a morire!	
VO_BRMA17_1_TRANSFORM2_81	È ora di abbandonare ogni formalità e... UCCIDERTI!	
VO_BRMA17_1_TURN1_79	La mia ultima creazione ti attende, mortale.	
VO_COOP02_00	Vi libererò entrambi dalla Maledizione della Carne!	
VO_COOP02_02	Sconfiggete insieme il Mastro Meccanico Mecazod per vincere!	
VO_COOP02_ABILITY_05	Sovralimentazione in corso!	
VO_COOP02_ABILITY_06	La carta stampata è morta, Ramingo della Sapienza Cho!	
VO_COOP03_01	Qui sono io il padrone!	
VO_COOP03_02	No! NO! TI DISTRUGGERÒ!	
VO_COOP03_03	Le menti dei mortali... così facili da manipolare.	
VO_COOP03_04	Ho cercato di essere un ospite affabile, ma non vuoi deciderti a morire!	
VO_COOP03_05	È ora di abbandonare ogni formalità e... UCCIDERTI!	
VO_COOP03_06	Sacerdote, la Luce adesso serve me!	
VO_COOP03_07	Sciamano, ora gli elementi obbediscono a ME.	
VO_COOP03_08	Ahahaha! Contempla il vero potere di NEFARIAN!	
VO_COOP03_09	Ahahah! Hai raggiunto il gran finale!	
VO_Crone_Female_Troll_CroneDeath_02	No! Ti prenderò! Ti...	
VO_Crone_Female_Troll_CroneEmoteResponse_02	Eheheh!	
VO_Crone_Female_Troll_CroneFlyingMonkeys_01	Portatemi chella bambina!	
VO_Crone_Female_Troll_CroneHeroPower_02	Eheheh!	
VO_Crone_Female_Troll_CroneOpen_01	Ahahah! Correte, piccirilli miei!	
VO_Curator_Male_ArcaneGolem_CuratorArcaneGolem_01	Curioso. Una somiglianza notevole.	
VO_Curator_Male_ArcaneGolem_CuratorBeasts_01	Il Curatore è allergico alle bestie.	
VO_Curator_Male_ArcaneGolem_CuratorDemons_01	I demoni non appartengono al serraglio.	
VO_Curator_Male_ArcaneGolem_CuratorDragons_01	Basta sterco di drago.	
VO_Curator_Male_ArcaneGolem_CuratorEmoteResponse_01	La richiesta non può essere elaborata.	
VO_Curator_Male_ArcaneGolem_CuratorHarrison_02	Furfante individuato! Harrison Jones non è ammesso.	
VO_Curator_Male_ArcaneGolem_CuratorMechs_01	Riprogrammazione degli assistenti.	
VO_Curator_Male_ArcaneGolem_CuratorMedivhSkin_01	Medivh impostore. Mancanza di occhi folli rilevata.	
VO_Curator_Male_ArcaneGolem_CuratorMurlocs_01	Piccoli cosi-pesce, siete liberi.	
VO_Curator_Male_ArcaneGolem_CuratorPirates_01	I pirati dovrebbero piratare.	
VO_Curator_Male_ArcaneGolem_CuratorReno_02	Furfante individuato! Reno Jackson non è ammesso.	
VO_Curator_Male_ArcaneGolem_CuratorTurn1_01	Il Curatore ha i mezzi per gestire il serraglio.	
VO_Curator_Male_ArcaneGolem_CuratorTurn5_01	Si prega di rispettare tutti i protocolli della galleria.	
VO_Curator_Male_ArcaneGolem_CuratorTurn9_01	Gli ospiti devono rimanere all'interno del serraglio.	
VO_Curator_Male_ArcaneGolem_IllhoofKilrekResponse_01	Al Curatore non importa. L'evocazione è proibita.	
VO_Curator_Male_ArcaneGolem_IllhoofSenseDemons_01	Molti demoni individuati.	
VO_Curator_Male_ArcaneGolem_IllhoofTurn1_01	I rituali d'evocazione non sono ammessi.	
VO_Curator_Male_ArcaneGolem_IllhoofTurn5_01	I rituali nuocciono agli animali. Il demone non deve continuare.	
VO_Curator_Male_ArcaneGolem_IllhoofWin_01	Il Curatore ringrazia. Il serraglio verrà ripristinato.	
VO_Curator_Male_ArcaneGolem_NightbaneCorruption_01	No! Il serraglio non dev'essere corrotto!	
VO_Curator_Male_ArcaneGolem_NightbaneTour_01	Il drago Noctumor, un tempo chiamato Arcanagos. La magia incontrollata ha corrotto la sua mente.	
VO_Curator_Male_ArcaneGolem_NightbaneTour_02	Alla nostra sinistra, un busto di Aran. A destra, la Lanterna del Potere.	
VO_Curator_Male_ArcaneGolem_NightbaneTurn1_01	Gli esemplari in fuga possono essere pericolosi. Devono tornare nel serraglio.	
VO_Curator_Male_ArcaneGolem_NightbaneTurn3_01	Le creature devono essere salvate. Poi potrai procedere.	
VO_Curator_Male_ArcaneGolem_NightbaneUnstablePortal_01	L'ospite deve essere gentile. Questo drago ha paura della magia instabile.	
VO_Curator_Male_ArcaneGolem_NightbaneWin_01	È richiesta assistenza aggiuntiva.	
VO_Curator_Neither_ArcaneGolem_CuratorDeath_04	Spegnimento in cor...	
VO_Curator_Neither_ArcaneGolem_CuratorOpen_01	Non si toccano le esposizioni.	
VO_ELISE_LOE16_ALT_1_FIRST_HALF_02	Rafaam è invulnerabile mentre il suo Bastone si ricarica.	
VO_ELISE_LOE16_ALT_1_SECOND_HALF_03	Quando avrà finito potremo contrattaccare, ma dovremo occuparci delle creature che evoca!	
VO_ELISE_WEIRD_DECK_05	Mi dispiace per questo mazzo. Lo abbiamo creato un anno fa per un torneo e non lo abbiamo più aggiornato.	
VO_EMOTE_HERO_TBKTRAF_KT_DRAWING_BOARD	Mi tocca tornare alla fase di progettazione...	
VO_EMOTE_HERO_TBKTRAF_KT_GLOAT	Implora misericordia!	
VO_EMOTE_HERO_TBKTRAF_KT_MINIONS_SERVANTS	Servi, schiavi, soldati della fredda oscurità!	
VO_FP1_014t_EnterPlay_01	Ora conoscerai il dolore...	
VO_FP1_031_Attack_07	Come agnelli al macello!	
VO_FP1_031_EnterPlay_06	Il Flagello vi consumerà!	
VO_HRW_DEBUG_01	1	
VO_HRW_DEBUG_02	2	
VO_HRW_DEBUG_03	3	
VO_HRW_DEBUG_04	4	
VO_HRW_DEBUG_05	5	
VO_HRW_TEST_00	Vi libererò entrambi dalla Maledizione della Carne!	
VO_HRW_TEST_01	Ben fatto! Avete sconfitto il boss insieme.\n\nVittoria per entrambi i giocatori!	
VO_HRW_TEST_02	Sconfiggete insieme il Mastro Meccanico Mecazod per vincere!	
VO_HRW_TEST_ABILITY_00	Infligge danni a un eroe.	
VO_HRW_TEST_ABILITY_01	Distrugge il servitore con l'Attacco più alto.	
VO_HRW_TEST_ABILITY_02	Lancia 3 bombe.	
VO_HRW_TEST_ABILITY_03	Infligge danni a tutti gli altri personaggi.	
VO_HRW_TEST_ABILITY_04	Ottiene +2 Attacco.	
VO_HRW_TEST_ABILITY_05	Infligge danni a entrambi gli eroi.	
VO_HRW_TEST_ABILITY_06	Silenzia il Ramingo della Sapienza Cho. Permanentemente.	
VO_HRW_TEST_ABILITY_98	Lato del campo di battaglia nemico pieno. Epurazione in corso.	
VO_Illhoof_Male_Demon_IlhoofKilrek_01	Vieni, Kil'rek. Adesso finiamo l'evocazione!	
VO_Illhoof_Male_Demon_IllhoofDeath_02	No! C'ero quasi! Sarger...	
VO_Illhoof_Male_Demon_IllhoofEmoteResponse_01	La tua essenza alimenta il rituale!	
VO_Illhoof_Male_Demon_IllhoofOpen_01	Ah, giusto in tempo!	
VO_Illhoof_Male_Demon_IllhoofSummonImps_01	Venite, creature delle tenebre! Udite il mio richiamo!	
VO_Illhoof_Male_Demon_IllhoofSummoningPortal_01	Un portale senza rituale? Più facile del previsto...	
VO_Illhoof_Male_Demon_IllhoofTurn1_01	Il rituale sta iniziando!	
VO_Illhoof_Male_Demon_IllhoofWounded_01	Venite, miei servitori! Il rituale deve essere completato!	
VO_Jaraxxus_Male_Demon_FinalMalchezaarJaraxxus_01	Sciocco principe. Allenati al karaoke come Jaraxxus!	
VO_Jaraxxus_Male_Demon_FinalMalchezaarJaraxxus_02	Eccoci qui... Unitevi a noi... Cerchiamo sempre nuovi eroi...	
VO_Julianne_Female_Human_JulianneDeath_01	Romulo! Lo bevo a te...	
VO_Julianne_Female_Human_JulianneEmoteResponse_01	Per noi ti mordi il pollice?	
VO_Julianne_Female_Human_JulianneFeignDeath_03	E poi risvegliarsi come da un sonno placido...	
VO_Julianne_Female_Human_JulianneHeroPower_01	Vieni, amorosa ed accigliata notte, e ridammi il mio Romulo!	
VO_Julianne_Female_Human_JulianneOpen_01	Ma che demonio sei?	
VO_KAR03_MOROES_MALE_HUMAN_CHESS_TURN_1	Ecco, i pezzi attaccheranno automaticamente al termine del vostro turno.	
VO_KAR03_MOROES_MALE_HUMAN_CHESS_TURN_3	Se un pezzo si trova tra due nemici, colpirà entrambi.	
VO_KAR03_MOROES_MALE_HUMAN_CHESS_TURN_5	Un attento posizionamento è la chiave della vittoria. Forza con quei doppi attacchi!	
VO_KARA_04_01_Female_Human_CroneHuffer_01	Oh, Huffer, mi sa che non siamo più nelle Marche Occidentali...	
VO_KARA_04_01_Female_Human_CroneLionTigerBear_02	Oh! Leoni, draghi, orsi! Oh, cielo!	
VO_KARA_04_01_Female_Human_CroneTurn1_01	Oh, non lasciare che mi faccia del male!	
VO_KARA_04_01_Female_Human_CroneTurn3_01	Su, incrociamo le braccia! Insieme siamo più forti!	
VO_KARA_06_01_Male_Human_JulianneDeadlyPoison_02	Ah, una dose di veleno.	
VO_KARA_06_01_Male_Human_JulianneTurn1_01	Vuoi proprio provocarmi? In guardia, ordunque!	
VO_KT_ANTI_CHEESE1_65	Questa è Naxxramas Eroica. Pensi che basti ricorrere a questi mezzucci?	
VO_KT_ANTI_CHEESE2_66	Vate della Rovina... Ti sembra una mossa saggia?	
VO_KT_ANTI_CHEESE3_67	Eguaglianza? Non a casa mia!	
VO_KT_ANUB2_43	NOOO!!! O meglio, non importa. Non sconfiggerai mai la Vedova Nera.	
VO_KT_BARON2_64	L'Ala dei Combattenti ha ceduto! Non è facile trovare servitori in gamba al giorno d'oggi.	
VO_KT_FAERLINA2_45	Faerlina non conta nulla. La Regina Ragno ti batterà facilmente.	
VO_KT_GLUTH2_73	Ho chiesto agli zombi se volevano mangiare il tuo cervello e hanno risposto: "Noi non mangiamo schifezze!"	
VO_KT_GLUTH2_ALT_74	Credo ci sia un'impresa in cui devi perdere contro Gluth...	
VO_KT_GLUTH3_75	AHAHAH! Non c'è nessuna impresa per aver perso contro Gluth!	
VO_KT_GLUTH4_76	No! E adesso chi si mangia gli zombi avanzati?	
VO_KT_GLUTH5_77	Adoro Decimazione. No, aspetta, gelare il sangue nelle vene resta la mia preferita.	
VO_KT_GLUTH6_78	Bravo cucciolo! Vai così piccolino!	
VO_KT_GOTHIK2_62	Ma perché Gothik non risorge come Gothik Spettrale? Non vale!	
VO_KT_GROBBULUS2_71	Mi tocca tornare alla fase di progettazione...	
VO_KT_HEIGAN2_55	Sto fumando di rabbia. FUMANDO!	
VO_KT_LOATHEB2_57	Continui a UCCIDERE I MIEI SERVITORI! Smettila! Smettila subito!	
VO_KT_MAEXXNA2_47	Il suo veleno renderà la tua morte quasi indolore.	
VO_KT_MAEXXNA3_48	Un Gigante di Mare? Maexxna, questa carta non è nell'elenco che ho approvato!	
VO_KT_MAEXXNA4_49	Impossibile! Non è ancora finita, MORTALE!	
VO_KT_MAEXXNA6_51	Come si chiama un giocatore il cui servitore è stato intrappolato? SPACCIATO!	
VO_KT_NOTH2_53	Povero Noth. È decisamente la sua giornata Noth...	
VO_KT_PATCHWERK2_69	Il mio avatar della guerra! Avrei dovuto cucirlo usando giocatori migliori...	
VO_KT_RAZUVIOUS2_59	Adesso chi addestrerà i miei Cavalieri della Morte? Non posso occuparmene io, ho troppo da fare.	
VO_KT_SAPPHIRON2_84	Guarda quel piccolo Gnomo. Era un intruso, PROPRIO COME TE!	
VO_KT_SAPPHIRON3_85	Piantala di nasconderti dietro al blocco di ghiaccio!	
VO_KT_SAPPHIRON4_ALT_87	Zaffirion, esegui il piano: "GELA IL SANGUE NELLE SUE VENE"!	
VO_KT_SAPPHIRON5_88	Il mio drago! TU NON MI PIACI!	
VO_KT_THADDIUS2_81	Intruso! Preparati all'ultimo scontro!	
VO_LOE_01_DEATH_2	Orsis! Vendicami!	
VO_LOE_01_RESPONSE	Subisci l'ira del sole!	
VO_LOE_01_STAFF	Ah ah! È mia!	
VO_LOE_01_STAFF_2	Brucerete! 	
VO_LOE_01_STAFF_2_RENO	Tieniti stretta quella Verga. Ha un grande valore.	
VO_LOE_01_START	Sono INVINCIBILE!	
VO_LOE_01_WIN	Ah ah! Ho la Verga... Se solo Harrison potesse vedermi! 	
VO_LOE_01_WIN_2	Prendi la Verga!	
VO_LOE_01_WIN_2_ALT_2	È normale che il suolo tremi così tanto?	
VO_LOE_01_WOUNDED	Ah ah, l'ho messo con le spalle al muro! Ehm, finiscilo tu!	
VO_LOE_02_DEATH	Di nuovo nella lampada... Nooooooo!	
VO_LOE_02_INTRO	La Verga del Sole è MIA!	
VO_LOE_02_MORE_WISHES	Accidenti, non credevo che avrebbe funzionato.	
VO_LOE_02_PHAERIX_STAFF_RECOVER	Non potete comprendere i poteri della Verga!	
VO_LOE_02_RESPONSE	Fenomenali poteri cosmici!	
VO_LOE_02_START	Finalmente libero! La vostra ricompensa sarà una rapida morte!	
VO_LOE_02_START2	Avventuriero, sono Reno Jackson: archeologo, esploratore e cacciatore di tesori di fama mondiale. 	
VO_LOE_02_START3	Con l'autocontrollo di una gazza ladra.	
VO_LOE_02_TURN_10	Immagina, avventuriero, la Verga del Sole. Ha un valore sconfinato!	
VO_LOE_02_TURN_6	Allora, ti ho mai raccontato della volta in cui mi sono camuffato da Ogre per entrare a Maglio Infausto?	
VO_LOE_02_TURN_6_2	E cosa ne dici di entrare di nascosto nel Liceo di Roccianera per recuperare...	
VO_LOE_02_WIN	Avanti! La Verga ci attende alla fine di quella sala.	
VO_LOE_02_WISH	È gentile a esaudire i nostri desideri mentre cerca di ucciderci.	
VO_LOE_03_RESPONSE	Sbrigati!	
VO_LOE_03_TURN_1	Il soffitto sta crollando e ci sono mostri dappertutto! Muoviti!	
VO_LOE_03_TURN_10	Ci siamo quasi! Riesco a vedere il sole!	
VO_LOE_03_TURN_2	Ehi, una pozza luminosa. Ti va di dare un'occhiata?	
VO_LOE_03_TURN_2_2	Non c'è tempo per farlo!	
VO_LOE_03_TURN_3	Mmm... Destra o sinistra? 	
VO_LOE_03_TURN_3_BOULDER	Quel masso è immenso, meglio levarsi di torno!	
VO_LOE_03_TURN_3_WARNING	OK, le vibrazioni stanno diventando più forti. Temo che il soffitto crollerà al prossimo turno!	
VO_LOE_03_TURN_4	Ehi, una fossa con spuntoni!	
VO_LOE_03_TURN_4_BAD	Oh oh oh! Non mi è sembrata una cosa divertente.	
VO_LOE_03_TURN_4_GOOD	Ehi, ottimo! Quasi con la mia stessa classe.	
VO_LOE_03_TURN_4_NEITHER	Bene, stai strisciando tra gli spuntoni? Potresti darti una mossa?	
VO_LOE_03_TURN_5	Che bella statua. E che rubino scintillante...	
VO_LOE_03_TURN_5_4	Oh oh, non mi sembra contento. Credo che voglia indietro la sua gemma!	
VO_LOE_03_TURN_6	Attenzione! Il soffitto sta crollando!	
VO_LOE_03_TURN_6_2	Accidenti, ci siamo andati vicini! Per fortuna sono riuscito a toglierti da lì. Non ringraziarmi.	
VO_LOE_03_TURN_7	Mmm, è davvero buio qui, ma sono certo che questa ci aiuterà a uscire. Andiamo!	
VO_LOE_03_TURN_7_2	La mia mappa dice solo "NON ENTRATE QUI DENTRO".	
VO_LOE_03_TURN_8	Accidenti, inizia a far caldo. Dobbiamo muoverci.	
VO_LOE_03_TURN_9	Ugh. Insetti. Proprio gli insetti dovevo trovarci.	
VO_LOE_03_WIN	Ce l'abbiamo fatta! Non credevo sarei stato così felice di vedere questo deserto... deserto! Mi sta venendo sete...	
VO_LOE_04_RESPONSE	Trogg spacca stupido!	
VO_LOE_04_SCARVASH_TURN_2	Trogg no stupido! Trogg fa te stupido!	
VO_LOE_04_START	Uldaman SOLO di Trogg!	
VO_LOE_04_WIN	Ce ne sono altri! Da questa parte, eroe, salta nel carrello minerario!	
VO_LOE_07_RESPONSE	Hai davvero tempo per farlo?	
VO_LOE_07_START	Attenzione, ci stanno seguendo!	
VO_LOE_07_WIN	Ahahah! Guidare carrelli e lanciare bombe! Che divertimento esplosivo!	
VO_LOE_08_ANIMATE_STONE	Terra e pietra, risvegliatevi!	
VO_LOE_08_LANDSLIDE	Vi seppellirò!	
VO_LOE_08_RESPONSE	Sei polvere.	
VO_LOE_08_START	Chi osa affrontare l'ira dei Creatori?	
VO_LOE_08_WIN	Il pomo è nostro! Ora manca solo un pezzo!	
VO_LOE_092_Attack_02	Osserva!	
VO_LOE_10_NYAH	Mrrrglmrrrgl! Gné!	
VO_LOE_10_RESPONSE	Mrglmrrglrmrrgl.	
VO_LOE_10_RESPONSE_ALT_read	Pinnamedia, cosa ci fai qui?	
VO_LOE_10_START	Mrglmrglmrgl	
VO_LOE_10_START_2	Ma tu senti! Quanta scortesia. 	
VO_LOE_10_TURN_2_GIANTFIN	MRRRGL! MRRRGLMRGL!	
VO_LOE_10_TURN1	Mrrrgl! Mrrglrrglmrgl.	
VO_LOE_10_WIN	Che peccato. Se solo avesse ricevuto un'educazione migliore in tenera età...	
VO_LOE_12_NAZJAR_PEARL	Notevole. La Perla delle Maree supera tutte le mie aspettative.	
VO_LOE_12_NAZJAR_TURN_1	Sssono la lama di Azshara. Come osssate sssfidarmi?	
VO_LOE_12_NAZJAR_TURN_1_FINLEY	Sono Ser Pinnus Mrrgglton. Onoratissimo.	
VO_LOE_12_NAZJAR_TURN_3_FINLEY	Elise, come se la cavano gli altri?	
VO_LOE_12_NAZJAR_TURN_5	Armate del profondo, travolgete i nemici come una marea di morte!	
VO_LOE_12_NAZJAR_TURN_5_FINLEY	Mi sembra un tantino esagerato.	
VO_LOE_12_NAZJAR_TURN_7_FINLEY	Mrgggl! MRRGLMRRGL!	
VO_LOE_12_NAZJAR_TURN_7_FINLEY_2	Scusami, collega, ogni tanto mi lascio prendere dall'emozione.	
VO_LOE_12_RESPONSE	Io impugno il potere della Perla!	
VO_LOE_12_START	Il potere delle maree vi consssumerà!	
VO_LOE_12_WIN	Ottimo! La Perla è nostra! Accompagnami al Salone degli Esploratori e ricostruiremo il manufatto!	
VO_LOE_13_RESPONSE	ROOOAAAR!	
VO_LOE_13_START_2	Roar!	
VO_LOE_13_TURN_1	Il Bastone era maledetto! Ha evocato l'Etereo aggirando le nostre protezioni. Sta rubando tutto quanto!	
VO_LOE_13_TURN_1_2	Non tutto. Solo la roba migliore.	
VO_LOE_13_TURN_5	Ohhh, quello è l'Anello con Sigillo di Arthas. E sembra anche in buone condizioni.	
VO_LOE_13_TURN_5_2	Reno, Brann, nascondete i manufatti!	
VO_LOE_13_TURN_9	Sta animando un esercito! Elise, fermalo!	
VO_LOE_13_TURN_9_2	Toz'axtas Nolore! Il Bastone è troppo forte, ma posso rallentarlo!	
VO_LOE_13_WIN	Noi ci occuperemo del museo. Avventuriero, tu pensa a Rafaam!	
VO_LOE_14_RESPONSE	CLANK	
VO_LOE_14_START	Oh, l'armatura di Lothar! Per trovarla ho passato mesi a Roccianera setacciando sterco di drago...	
VO_LOE_14_TURN_13	Brann, sta animando i libri della biblioteca! Io mi occupo dei martelli volanti nella mostra di Lordaeron.	
VO_LOE_14_TURN_5	Ho sbaragliato le spade animate nel salone orientale. Elise, chi devo aiutare?	
VO_LOE_14_TURN_5_2	Raggiungi Reno nel magazzino principale! È circondato da Robobombe!	
VO_LOE_14_TURN_9	Sembrate tutti occupati. Penserò io a questa bellissima spilla.	
VO_LOE_14_WIN	Abbiamo messo in sicurezza il museo. Avventuriero, occupati di Rafaam!	
VO_LOE_15_RESPONSE	Che carte meravigliose!	
VO_LOE_15_SPARE	Avventuriero! Abbiamo un altro mazzo disponibile, usa questo!	
VO_LOE_16_BOOM_BOT	Sì, ce ne sono rimaste a volontà. Fallo fuori!	
VO_LOE_16_CROWN	La magia manifesta di un folle Mago.	
VO_LOE_16_EYE	Che buffo. Ce l'avevo ancora in tasca: puoi averlo in prestito.	
VO_LOE_16_FIRST_ITEM	Stiamo setacciando il museo alla ricerca di qualcosa di utile. Chiama se hai bisogno di aiuto!	
VO_LOE_16_GOBLET	Io odio i serpenti!	
VO_LOE_16_GREAVE	Un pezzo dell'Armatura di Lothar è rimasto integro dopo lo scontro.	
VO_LOE_16_LOCKET	I fantasmi di Karazhan infestano questo medaglione.	
VO_LOE_16_PIPE	Prendi! Ma non dirlo a Brann, adora questa pipa!	
VO_LOE_16_RAFAAM_DEATH2	NO! NON POSSO ESSERE SCONFITTO!	
VO_LOE_16_SHARD	Questo era in una cassa con scritto "NON APRIRE". Quindi... buona fortuna.	
VO_LOE_16_SPLINTER	L'ho trovata nel Nucleo Ardente. Il Maggiordomo la usava come stuzzicadenti.	
VO_LOE_16_START_2	Il Bastone si sta caricando. Fai attenzione!	
VO_LOE_16_TEAR	È una reliquia sacra per la mia gente. Bevila in fretta.	
VO_LOE_16_TURN_2	Il Bastone è quasi al massimo, preparati!	
VO_LOE_16_TURN_2_2	AHAHAH! POTERE TRAVOLGENTE!	
VO_LOE_16_TURN_2_3	Il Bastone è sovraccarico! Questa è la tua occasione!	
VO_LOE_16_TURN_3	Sono invincibile! Non mi sconfiggerete mai!	
VO_LOE_16_TURN_3_2	Il Bastone si sta ricaricando. Fra poco avremo un'altra opportunità.	
VO_LOE_16_TURN_4	Il Bastone è quasi pronto, preparati!	
VO_LOE_16_TURN_5	AHAHAH! POTERE TRAVOLGENTE!	
VO_LOE_16_TURN_5_2	I suoi scudi sono abbassati! Colpisci ora!	
VO_LOE_16_TURN_6	Lo scudo è nuovamente attivo, fai attenzione!	
VO_LOE_16_VIAL	Dice "BEVIMI", ma visto che l'abbiamo trovata a Naxxramas, nessuno ha voluto provarla.	
VO_LOE_ARCHAEDAS_TURN_1_CARTOGRAPHER	Se solo non fosse occupato a seppellirci sotto le macerie.	
VO_LOE_GIANTFIN_TIDEHUNTER_2	No, Pinnus! Tu sei sempre stato diverso.	
VO_LOE_NAZJAR_TURN_3_CARTOGRAPHER	Reno è tornato con la Verga del Sole e Brann sta arrivando.	
VO_LOE_SCARVASH_TURN_6_CARTOGRAPHER	Concentrati, Brann!	
VO_LOE_ZINAAR_TURN_10_CARTOGRAPHER_2	Tanto non la vendiamo.	
VO_LOE_ZINAAR_TURN_6_CARTOGRAPHER_2	Sì.	
VO_LOE_ZINAAR_TURN_6_CARTOGRAPHER_2_ALT	Sì.	
VO_LOE10_DEAD_MURLOCS	Quante morti... che tristezza.	
VO_LOE10_NYAH_FINLEY	Oh, dai. Non essere infantile.	
VO_LOE10_TIDEHUNTER	E se Elise non mi avesse trovato? Sarei forse diventato come loro?	
VO_LOE10_TURN_2_FINLEY	Fratelli, collaboriamo! Non è necessario combattere!	
VO_LOE10_TURN_2_FINLEY_2	Suppongo fosse inevitabile.	
VO_LOEA04_BRANN_TURN_1	Scarvash era un piccolo Trogg l'ultima volta che l'ho visto. Ora è più grande, più stupido e più brutto.	
VO_LOEA04_BRANN_TURN_6	Affascinante. Queste rune di mithril contengono il Codice dei Guardiani. Risalgono al tempo dei Titani.	
VO_LOEA07_MINE_ALMOST_DONE	Ci siamo quasi! Mi chiedo a cosa serva questo pulsante...	
VO_LOEA07_MINE_ARCHAEDAS	PER LA BARBA DI MAGNI! QUELLO È ARCHAEDAS???	
VO_LOEA07_MINE_BARREL_FORWARD	Massima velocità!	
VO_LOEA07_MINE_BOOM	Bombe in arrivo! Così imparano!	
VO_LOEA07_MINE_BOOMZOOKA	BUM! Ora lo ricarico per un altro colpo!	
VO_LOEA07_MINE_DETONATE	Vuoi far saltare la galleria? STAI DANDO I NUMERI?!?	
VO_LOEA07_MINE_DYNAMITE	Fai attenzione con quella roba, hai fatto saltare parte del tracciato!	
VO_LOEA07_MINE_HUNKER_DOWN	Giù!	
VO_LOEA07_MINE_PARROT	Vola, Ginny!	
VO_LOEA07_MINE_RAMMING	Ahahah! Levatevi di mezzo!	
VO_LOEA07_MINE_REPAIRS	Un po' di Cicca alla Trippa ed è come nuovo!	
VO_LOEA07_MINE_SPIKED_DECOY	Ehi, stupidi Trogg! Provate a prendermi!	
VO_LOEA08_TURN_1_BRANN	Un servitore degli antichi Titani. Quante storie potrebbe raccontarci...	
VO_LOEA09_1_RESPONSE	Altro cibo per la cena!	
VO_LOEA09_1_TURN1	Osi invadere la Città Fatiscente?	
VO_LOEA09_FINLEY_DEATH	Mi serve solo un momento. Collega, finisci quel Naga!	
VO_LOEA09_HERO_POWER	È ora di cena! Stasera abbiamo zuppa di Murloc!	
VO_LOEA09_HERO_POWER1	Salve, collega. Temo di essere nei pasticci. Saresti così cortese da aiutarmi?	
VO_LOEA09_HERO_POWER2	Ohibò, è terribilmente buio qui dentro.	
VO_LOEA09_HERO_POWER3	Oh, cielo. Sbaglio o si sta scaldando?	
VO_LOEA09_HERO_POWER4	Tutto questo è assai poco piacevole.	
VO_LOEA09_HERO_POWER5	Ehm, fa decisamente caldo qua dentro.	
VO_LOEA09_HERO_POWER6	Apprezzerei vivamente un po' di aiuto.	
VO_LOEA09_QUOTE1	Grazie! Ci sono andato fin troppo vicino!	
VO_LOEA09_UNSTABLE	Torna nel calderone!	
VO_LOEA09_WIN	Hai la mia gratitudine, gentile collega. Vuoi che ti conduca all'ultimo pezzo?	
VO_LOEA10_1_MIDDLEFIN	<Pinnamedia,\ncosa ci fai qui?>	
VO_LOEA15_1_LOSS_11	Il tuo mazzo è pessimo. Ora userò il mio.	
VO_LOEA15_1_LOW_HEALTH_10	Forse ho fatto un errore a prendere il tuo mazzo.	
VO_LOEA15_1_MAGMA_RAGER_09	Furia di Magma? Perché dovresti voler giocare questa carta?!?	
VO_LOEA15_1_START_07	Mi piace il tuo mazzo, credo proprio che me lo PRENDERÒ.	
VO_LOEA15_1_TURN1_08	Oh, sì. Questa mano di carte è INCREDIBILE.	
VO_LOEA15_1_WIN_12	Il tuo mazzo è MERAVIGLIOSO. Ahahah!	
VO_LOEA15_GOLDEN	Questo mazzo è TUTTO DORATO? La tua collezione è quasi all'altezza della mia!	
VO_LOEA16_1_CARD_04	Ho collezionato manufatti provenienti da CENTINAIA di mondi!	
VO_LOEA16_1_RESPONSE_03	Sì! SÌ!	
VO_LOEA16_1_START_01	Ammirate la MASSIMA POTENZA del Bastone!	
VO_LOEA16_1_TURN1_02	Sono invincibile! Brandisco il potere stesso dei Titani!	
VO_Maiden_Female_Titan_FinalMaidenEmoteResponse_01	Il tuo comportamento non sarà tollerato.	
VO_Maiden_Female_Titan_FinalMaidenEyeForAnEye_01	La giustizia è servita.	
VO_Maiden_Female_Titan_FinalMaidenHeroPower_01	Abbandona i pensieri depravati.	
VO_Maiden_Female_Titan_FinalMaidenHumility_01	Sì! Inginocchiati e potrei risparmiarti!	
VO_Maiden_Female_Titan_FinalMaidenOpen_01	Hai evocato un agente dei Titani?	
VO_Maiden_Female_Titan_FinalMaidenTurn5_01	Noi siamo eterni. Tu non sei meritevole!	
VO_Malchezaar_Male_Demon_Brawl_06	Non avrai pensato di poter vincere.	
VO_Malchezaar_Male_Demon_EmoteParty_01	Anche a Malchezaar piace divertirsi!	
VO_Malchezaar_Male_Demon_FinalAltOpening_01	Stupidi sciocchi!	
VO_Malchezaar_Male_Demon_FinalMalchezaarDeath_01	No! No! Non di nuovo!	
VO_Malchezaar_Male_Demon_FinalMalchezaarEmoteResponse_01	Io sarò la tua fine!	
VO_Malchezaar_Male_Demon_FinalMalchezaarHeroPower_01	Non affronti solo Malchezaar, ma tutte le legioni al mio comando!	
VO_Malchezaar_Male_Demon_FinalMalchezaarJaraxxus_01	Tu! Quello è il mio invito!	
VO_Malchezaar_Male_Demon_FinalMalchezaarMedivhSkin_01	Sei in costume? Mmm... potrebbe farmi comodo...	
VO_Malchezaar_Male_Demon_FinalMalchezaarSacrificialPact_03	Ahahah! Un trucco che non funziona su un vero Signore Eredar!	
VO_Malchezaar_Male_Demon_FinalMalchezaarTurn1_01	Il Magus è potente, ma come puoi sperare di resistere a un potere così devastante?	
VO_Malchezaar_Male_Demon_FinalMalchezaarTurn7_01	Sento la musica!\nI Me-divi! La festa! Stasera è la mia notte!	
VO_Malchezaar_Male_Demon_FinalThirdSequence_01	Rievocato a Karazhan? Giusto in tempo per la festa!	
VO_Malchezaar_Male_Demon_FinalThirdSequence_04	Togliti di mezzo, folle!	
VO_Malchezaar_Male_Demon_PrologueEmoteResponse_01	Inutile mortale.	
VO_Malchezaar_Male_Demon_PrologueHeroPower_01	Vedo tutte le realtà, tutte le dimensioni!	
VO_Malchezaar_Male_Demon_PrologueOpen_01	Dov'è il mio invito?	
VO_Malchezaar_Male_Demon_PrologueTurn1_04	Non mi hai invitato? Sono un principe degli Eredar!	
VO_Malchezaar_Male_Demon_PrologueTurn11_02	Hai invitato Jaraxxus? Quel mollaccione?	
VO_Malchezaar_Male_Demon_PrologueWin_01	Ti porterò con me!	
VO_Mediva_01_Female_Blood Elf_AranSpell_04	Oooh... brrrr!	
VO_Mediva_01_Female_Blood Elf_ChessEmoteOops_06	Uh oh.	
VO_Mediva_01_Female_Blood Elf_PrologueTurn5_06	Me-divi!	
VO_Mediva_02_Female_Draenei_JulianneDeadlyPoison_02	Che tragedia.	
VO_Mediva_02_Female_Draenei_PrologueTurn5_05	Sì?	
VO_Mediva_03_Male_Night Elf_AranHeroPower_01	Brucia, baby, brucia!	
VO_Mediva_03_Male_Night Elf_CuratorBeasts_04	Ecciù, baby.	
VO_Mediva_03_Male_Night Elf_PrologueTurn5_01	Avete chiamato?	
VO_Medivas_Multiple_Multiple_CroneLionTigerBear_01	Oh, cielo!	
VO_Medivas_Multiple_Multiple_IllhoofWounded_01	Mmm, ho tanta paura...	
VO_Medivas_Multiple_Multiple_NetherspiteTurn1_01	Raggi!	
VO_Medivh_Male_Human_EmoteGreetings_01	E tu che ci fai qui?	
VO_Medivh_Male_Human_EmoteOops_01	Era quello il tuo piano?	
VO_Medivh_Male_Human_EmoteSorry_01	Oh, non ha funzionato...	
VO_Medivh_Male_Human_EmoteThanks_01	Sei troppo gentile.	
VO_Medivh_Male_Human_EmoteThreaten_01	Non hai mai avuto speranze!	
VO_Medivh_Male_Human_EmoteWellPlayed_01	Bel tentativo, demone.	
VO_Medivh_Male_Human_EmoteWow_01	Ahahah! È stato magnifico!	
VO_Medivh_Male_Human_FinalMalchezaarTurn5_01	Magnifico lavoro, Moroes. La festa sta andando alla grande!	
VO_Medivh_Male_Human_FinalMalchezaarWin_01	Ben fatto! Forza, è tempo di festeggiare!	
VO_Medivh_Male_Human_FinalMedivhMedivhSkin_01	Oh, aspetta! Tu sei me? Dal futuro? Dimmi... che ne pensi della festa? Straordinaria, non è vero?	
VO_Medivh_Male_Human_FinalThirdSequence_01	Ah, un ospite! Occupati del demone, per favore. Ho una festa da seguire!	
VO_Medivh_Male_Human_FinalThirdSequence_02	Oh, ti ha lasciato senza carte? Usa pure i portali.	
VO_Medivh_Male_Human_FinalThirdSequence_03	Ecco, tieni il mio bastone: controlla i portali. Non rovinarlo, mi raccomando.	
VO_Medivh_Male_Human_PrologueDeath_02	Cosa? Impossibile...	
VO_Medivh_Male_Human_PrologueHeroPower_01	Ma non vedrai questa festa.	
VO_Medivh_Male_Human_PrologueOpen_01	Ugh, ancora tu?	
VO_Medivh_Male_Human_PrologueTurn1_02	Dopo l'ultima volta? Stiamo ancora riparando il buco sul tetto!	
VO_Medivh_Male_Human_PrologueTurn11_01	L'hai mai sentito cantare al karaoke? È bravissimo!	
VO_Medivh_Male_Human_PrologueTurn3_02	Moroes, controlla gli scacchi. I veri ospiti arriveranno presto.	
VO_Medivh_Male_Human_PrologueTurn9_01	Moroes, ci siamo scordati i palloncini!	
VO_Medivh_Male_Human_PrologueWin_01	Tornatene a casa, demone!	
VO_Medivh_Male_Human_Wing0Intro_01	Abbiamo animato l'argenteria, provato le commedie e preparato il serraglio. Questa sarà una serata indimenticabile!	
VO_Medivh_Male_Human_Wing4Win_01	Avanti, vieni! Unisciti alla festa!	
VO_Mirror_Male_Mirror_MirrorDeath_01	Ehi! Hai barato! Voglio la rivincita!	
VO_Mirror_Male_Mirror_MirrorEmoteResponse_01	No, te!	
VO_Mirror_Male_Mirror_MirrorFirstCard_01	Oh oh, hai quella nel mazzo?	
VO_Mirror_Male_Mirror_MirrorMedivhSkin_01	Oh! Medivh, signore! Mi sembrate in for... cosa?!? Ehi! Tu non sei Medivh!	
VO_Mirror_Male_Mirror_MirrorMirrorImage_01	Ehi, quella è la mia carta preferita! La tua qual è? Furia di Magma?	
VO_Mirror_Male_Mirror_MirrorOpen_02	COME VA?!?	
VO_Mirror_Male_Mirror_MirrorTurn1_01	Accidenti, quanto siete brutti!	
VO_Mirror_Male_Mirror_MirrorTurn3_01	Specchio, specchio delle mie brame, chi è il più bello del reame?	
VO_Mirror_Male_Mirror_MirrorTurn3_03	Tu no di certo, nonno!	
VO_Mirror_Male_Mirror_MirrorTurn5_02	Nefarius? Direi più Nefandus! Uhuhuhuh!	
VO_Mirror_Male_Mirror_MirrorWellPlayedResponse_01	Vorrei poter dire lo stesso! TIE'!	
VO_Moroes_Male_Human_AranTurn1_01	Ah... Ecco Aran, il bisbetico fantasma.	
VO_Moroes_Male_Human_AranTurn9_04	I draghi hanno divorato l'intero buffet e ora stanno adocchiando i Murloc.	
VO_Moroes_Male_Human_AranWin_01	Il portale è nella prossima sala! Giusto in tempo!	
VO_Moroes_Male_Human_ChessForfeit_02	Ah, avete esaurito i pezzi. La partita è perduta.	
VO_Moroes_Male_Human_ChessTurn1_03	Ecco, i pezzi attaccheranno automaticamente al termine del vostro turno.	
VO_Moroes_Male_Human_ChessTurn3_01	Se un pezzo si trova tra due nemici, colpirà entrambi.	
VO_Moroes_Male_Human_ChessTurn5_01	Un attento posizionamento è la chiave della vittoria. Forza con quei doppi attacchi!	
VO_Moroes_Male_Human_ChessTurn7_01	Gli altri ospiti si stanno assembrando all'esterno. Siamo quasi al teatro, ma dobbiamo sbrigarci.	
VO_Moroes_Male_Human_ChessTurn7_02	Non avete molti pezzi. Se li esaurite, perderete.	
VO_Moroes_Male_Human_ChessWin_01	Eccellente! Ora raggiungiamo il teatro!	
VO_Moroes_Male_Human_CroneTurn5_02	Il Maggiordomo Executus è di sotto. Devo dirgli che è arrivato troppo presto?	
VO_Moroes_Male_Human_CroneWin_01	Finalmente. Andiamo a liberare il Mago.	
VO_Moroes_Male_Human_CuratorTurn3_01	Il Curatore è confuso. Dovrete fermarlo prima che sguinzagli tutte le creature.	
VO_Moroes_Male_Human_CuratorWin_01	Dunque... un'aggiustatina qui... e... è come nuovo.	
VO_Moroes_Male_Human_EndWing1_01	Eccellente! Il teatro è proprio in cima a quelle scale. Sono certo che Barnes ci farà passare in fretta.	
VO_Moroes_Male_Human_FinalAltTurn5_01	Mmm... Quanti portali... Chissà che cosa c'è in questo...	
VO_Moroes_Male_Human_FinalMaidenTurn1_01	Mi dispiace, occupatevi di lei e sono certo che troverò il comando giusto.	
VO_Moroes_Male_Human_FinalMaidenTurn7_03	Oh, il mondo dei tentacoli. Meglio non averci niente a che fare.	
VO_Moroes_Male_Human_FinalNazraTurn7_02	Respingete l'Orchessa, così potremo aprire un altro portale.	
VO_Moroes_Male_Human_FinalSecondSequence_01	Ottimo! Adesso vediamo se questo funziona...	
VO_Moroes_Male_Human_FInalStartSequence_01	Mmm... Vediamo. Magari questo?	
VO_Moroes_Male_Human_FinalThirdSequence_01	Ci siamo!	
VO_Moroes_Male_Human_FinalTurn1_02	Ops, portale sbagliato. Sconfiggete l'Orchessa, così potrò tentare di nuovo.	
VO_Moroes_Male_Human_IllhoofKilrekResponse_01	Che cosa stanno cercando di evocare?	
VO_Moroes_Male_Human_JulianneTurn5_01	Barnes, lasciaci passare! Dobbiamo raggiungere Medivh o la festa sarà rovinata.	
VO_Moroes_Male_Human_JulianneTurn9_02	Illidan è arrivato. E noi non siamo pronti.	
VO_Moroes_Male_Human_MedivhSkinResponse_01	Un costume da Medivh? Be', la somiglianza è impressionante!	
VO_Moroes_Male_Human_MirrorTurn3_01	Mmm...	
VO_Moroes_Male_Human_MirrorTurn5_01	Sire Nefarius dovrebbe arrivare presto. Tremo al pensiero di come reagirà.	
VO_Moroes_Male_Human_MirrorWin_02	Eccellente! Le scale per il teatro sono poco più avanti.	
VO_Moroes_Male_Human_NetherspiteTurn1_01	Quei raggi potenziano il drago. Usate i servitori per bloccarli!	
VO_Moroes_Male_Human_NetherspiteTurn5_01	Dicci solo in quale si trova Medivh!	
VO_Moroes_Male_Human_NetherspiteTurn7_01	Abbiamo bisogno di quei portali! Gli ospiti stanno gettando i tomi nella pozza di mana!	
VO_Moroes_Male_Human_NetherspiteWin_01	Ben fatto! Ora, se solo riuscissi a ricordarmi come funziona...	
VO_Moroes_Male_Human_NightbaneTurn3_01	Curatore, dobbiamo salvare Medivh...	
VO_Moroes_Male_Human_NightbaneTurn7_01	È arrivata la Lega degli Esploratori. RENO, POSA SUBITO L'ARGENTERIA!	
VO_Moroes_Male_Human_PrologueTurn11_01	Ahem... E non ha dato fuoco alla biblioteca...	
VO_Moroes_Male_Human_PrologueTurn5_03	Signore, i Me-divi si sono sistemati. Barnes sta provando con loro.	
VO_Moroes_Male_Human_PrologueTurn7_01	Avete guardato all'esterno, signore? È pieno di boss che litigano per un invito.	
VO_Moroes_Male_Human_PrologueTurn9_02	Signore, i palloncini terrorizzano i Murloc. Ricordate la settimana scorsa?	
VO_Moroes_Male_Human_PrologueWin_02	Non va bene... non va bene per niente.	
VO_Moroes_Male_Human_SilverwareResponse_01	Argh. Quello era un pezzo raro.	
VO_Moroes_Male_Human_SilverwareTurn3_02	L'argenteria si sta coalizzando. Siamo circondati!	
VO_Moroes_Male_Human_SilverwareWin_01	Ah, che disastro.	
VO_Moroes_Male_Human_Wing1Intro_02	Sono Moroes, il castellano di Karazhan, e ho bisogno del vostro aiuto. Medivh è sparito. Ci serviranno i portali in cima alla torre per salvare lui e la festa.	
VO_Moroes_Male_Human_Wing1Win_01	Ben fatto! Di questo passo raggiungeremo la cima della torre in tempo per salvare la festa.	
VO_Moroes_Male_Human_Wing2Win_01	Avanti! Oltre quelle scale, il Curatore protegge il serraglio. Speriamo non sia malfunzionante...	
VO_Moroes_Male_Human_Wing3Open_02	Il Curatore protegge il serraglio, dimora delle creature più esotiche di Azeroth. Oltre, si trovano le sale del padrone e il portale per salvare Medivh.	
VO_Moroes_Male_Human_Wing3Win_02	Siamo quasi in cima. Dobbiamo salvare Medivh prima che la festa finisca in rissa!	
VO_Moroes_Male_Human_Wing4Intro_01	Finalmente! La cima della torre! Trovate il portale giusto e riportate indietro Medivh!	
VO_Moroes_Male_Human_Wing4Win_01	Ce l'avete fatta! Non posso credere che la festa sia iniziata in orario. Vi dispiace tornare la prossima settimana? È il compleanno di Medivh e, be'... mi servirà una mano.	
VO_Moroes_Male_Human_WolfClaws_03	Non credo sia vero...	
VO_NAX1_01_CARD_02	Solo un assaggino...	
VO_NAX1_01_DEATH_05	Perché? Perché?	
VO_NAX1_01_EMOTE_04	Come? Parla!	
VO_NAX1_01_HP_03	Più vicini, adesso. Bocconi gustosi.	
VO_NAX1_01_START_01	Ti do il benvenuto.	
VO_NAX10_01_DEATH_LINE_03	Cosa succede a... Pezzaca...	
VO_NAX10_01_EMOTE1_04	Vuoi giocare?	
VO_NAX10_01_EMOTE2_05	Sì! Giocare! Giocare!	
VO_NAX10_01_HP_02	Non giochi più?	
VO_NAX10_01_START_01	Pezzacarne vuole giocare!	
VO_NAX11_01_CARD_03	Melma.	
VO_NAX11_01_DEATH_05	ARGH GAH GRRRLAAARGH...	
VO_NAX11_01_EMOTE_04	Niente parole.	
VO_NAX11_01_HP_02	Puzza.	
VO_NAX11_01_START_01	Carne.	
VO_NAX12_01_CARD_01	ROAR!!!	
VO_NAX12_01_DEATH_01	GRRRL...	
VO_NAX12_01_EMOTE_01	GRRRLR...	
VO_NAX12_01_EMOTE_02	GRRR...	
VO_NAX12_01_EMOTE_03	GRRRAAARRR...	
VO_NAX12_01_HP_01	ROOOAAARRR!!!	
VO_NAX12_01_START_01	GRRRLRRR...	
VO_NAX13_01_DEATH_LINE_03	Grazie...	
VO_NAX13_01_EMOTE_04	Uccidere...	
VO_NAX13_01_HP_02	Ora... muori!	
VO_NAX13_01_START_01	Devo... obbedire!	
VO_NAX14_01_CARD_01	RRRAAAHHH!!!	
VO_NAX14_01_DEATH_01	ROAAARRR...	
VO_NAX14_01_EMOTE_01	RRR... RRRAAAH!	
VO_NAX14_01_EMOTE_02	GRRRAAAH!	
VO_NAX14_01_EMOTE_03	ROOOAAARRR!	
VO_NAX14_01_HP_01	ROARRR!!!	
VO_NAX14_01_START_01	ROOOARRR!!!	
VO_NAX15_01_BIGGLES_32	No!!! Che tu sia maledetto, intruso!	
VO_NAX15_01_DEATH_LINE_08	Questa non è la fine! C'è ancora la modalità Eroica.	
VO_NAX15_01_DEATH_LINE2_09	NOOOOOOoooooo!!!	
VO_NAX15_01_EMOTE_HELLO_26	Saluti spesso la gente che ti vuole uccidere?	
VO_NAX15_01_EMOTE_OOPS_29	Invero.	
VO_NAX15_01_EMOTE_SORRY_28	Non preoccuparti, tutti commettiamo errori.	
VO_NAX15_01_EMOTE_THANKS_27	Mmm... Prego?	
VO_NAX15_01_EMOTE_THREATEN_30	Oh, che paura!	
VO_NAX15_01_EMOTE_WP_25	Certo, non faccio mai errori, io. Sono Kel'tispacco-zad.	
VO_NAX15_01_HP_07	Ti gelerò il sangue nelle vene!	
VO_NAX15_01_HP2_05	Ora la tua anima è legata a me!	
VO_NAX15_01_HP3_06	Non c'è modo di fuggire!	
VO_NAX15_01_HURRY_31	La mia pazienza ha un limite.	
VO_NAX15_01_PHASE2_10	Folle! Hai chiesto troppo ai tuoi poteri.	
VO_NAX15_01_PHASE2_ALT_11	No! Il tuo turno è finito! Ora tocca a ME.	
VO_NAX15_01_RESPOND_ANDUIN_24	Interessante! Non ricordi cosa è successo a Uther?	
VO_NAX15_01_RESPOND_GARROSH_15	Davvero? E morte sia, allora!	
VO_NAX15_01_RESPOND_GARROSH_ALT_16	È una domanda a trabocchetto? Credo sarà la tua morte!	
VO_NAX15_01_RESPOND_GULDAN_22	Diciamo che l'anima di qualcuno sarà di qualcun altro...	
VO_NAX15_01_RESPOND_JAINA_23	Direi proprio di no. Non sono stato io a entrare nella tua necropoli!	
VO_NAX15_01_RESPOND_MALFURION_ALT_21	La natura? E allora che cosa ci fai a Naxxramas?	
VO_NAX15_01_RESPOND_REXXAR_19	Sarai tu la preda!	
VO_NAX15_01_RESPOND_THRALL_17	Combatti per un martello? Contento tu...	
VO_NAX15_01_RESPOND_UTHER_14	...e io con servitori immensi e incantesimi letali. Buona fortuna!	
VO_NAX15_01_RESPOND_VALEERA_18	Oh... Non dubitarne.	
VO_NAX15_01_START_13	Finalmente ci incontriamo.	
VO_NAX15_01_SUMMON_ADDS_12	Andate, miei servitori!	
VO_NAX2_01_CARD_02	Uccideteli nel nome del padrone!	
VO_NAX2_01_CUSTOM_03	Hai fallito!	
VO_NAX2_01_DEATH_LINE_05	Il padrone mi vendicherà!	
VO_NAX2_01_EMOTE_06	Ahahahah!	
VO_NAX2_01_HP_04	Inchinati di fronte a me, verme!	
VO_NAX2_01_START_01	I miei accoliti obbediscono senza discutere!	
VO_NAX3_01_CARD_01	GRGHHHGHGH	
VO_NAX3_01_DEATH_01	GRLLLBRRRL...	
VO_NAX3_01_EMOTE_01	GRBBBLRRRL...	
VO_NAX3_01_EMOTE_02	GRRRLBBBL...	
VO_NAX3_01_EMOTE_03	GRLLLBRRRL...	
VO_NAX3_01_EMOTE_04	GRBBBLRRRL...	
VO_NAX3_01_EMOTE_05	GRRRLBBBL...	
VO_NAX3_01_HP_01	GRLLLBBBL...	
VO_NAX3_01_START_01	GRLLLBRRRL...	
VO_NAX4_01_CARD_03	Non respirerai più.	
VO_NAX4_01_DEATH_LINE_04	Servirò il mio padrone... nella morte!	
VO_NAX4_01_EMOTE_06	Muori, trasgressore!	
VO_NAX4_01_HP_02	Sorgete, miei soldati! Levatevi per combattere ancora!	
VO_NAX4_01_START_01	Un'altra anima per la mia collezione.	
VO_NAX5_01_CARD_03	La tua mente vacillerà!	
VO_NAX5_01_DEATH_LINE_04	Avrei dovuto fare una doccia...	
VO_NAX5_01_EMOTE_05	Non ho tempo per queste sciocchezze.	
VO_NAX5_01_HP_02	Ballate, stolti!	
VO_NAX5_01_START_01	Credi di essere al sicuro?	
VO_NAX6_01_CARD_03	La fine si avvicina.	
VO_NAX6_01_DEATH_LINE_04	RRRAAAHHH!!!	
VO_NAX6_01_EMOTE_05	Stai sprecando il fiato.	
VO_NAX6_01_HP_02	Sei in mio potere.	
VO_NAX6_01_START_01	Ti vedo.	
VO_NAX7_01_CARD_03	Dovevi restartene a casa!	
VO_NAX7_01_DEATH_LINE_04	Agh! Una morte... onorevole.	
VO_NAX7_01_EMOTE_05	Ah! Mi sto appena riscaldando!	
VO_NAX7_01_HP_02	Sììì!	
VO_NAX7_01_START_01	No... No! I miei allievi! Li rivoglio!	
VO_NAX8_01_CARD_02	Uccidi pure i miei servitori... le loro anime verranno a trovarti!	
VO_NAX8_01_CUSTOM_03	Ahahah! Folle! Sono il Falciatore d'anime!	
VO_NAX8_01_CUSTOM2_04	La morte ritorna!	
VO_NAX8_01_DEATH_LINE_05	Io... sono... finito.	
VO_NAX8_01_EMOTE1_06	Follemente persegui la tua stessa rovina.	
VO_NAX8_01_EMOTE2_07	Spudoratamente ignori un potere che va al di là della tua comprensione.	
VO_NAX8_01_EMOTE3_08	Hai combattuto duramente per invadere il regno del Falciatore.	
VO_NAX8_01_EMOTE4_09	Ora hai una sola via d'uscita...	
VO_NAX8_01_EMOTE5_10	...accedere al menu di gioco e scegliere Resa!	
VO_NAX8_01_START_01	I miei servitori non muoiono mai davvero.	
VO_NAX9_01_CUSTOM_02	Basta con le chiacchiere. Che vengano.	
VO_NAX9_01_DEATH_LINE_03	Nooo! Mi serve più tempo!	
VO_NAX9_01_EMOTE_04	Vuoi morire?	
VO_NAX9_01_START_01	Ridurremo in polvere le tue ossa.	
VO_NAX9_02_CUSTOM_01	Intruso! Torna indietro, finché puoi!	
VO_NAX9_03_CUSTOM_01	Vieni Zeliek, è ora di divertirci.	
VO_NAX9_04_CUSTOM_01	Fatti sotto, mezza calzetta!	
VO_Nazra_Female_Orc_FinalNazraChogall_02	Il Martello del Crepuscolo? Qui?	
VO_Nazra_Female_Orc_FinalNazraDeath_01	Ugh... Per l'Orda...	
VO_Nazra_Female_Orc_FinalNazraEmoteResponse_01	Nazra ti schiaccerà!	
VO_Nazra_Female_Orc_FinalNazraGrom_01	Grommash?!? Quanto tempo!	
VO_Nazra_Female_Orc_FinalNazraHeroPower_01	Nazra dominerà questo ridicolo mondo!	
VO_Nazra_Female_Orc_FInalStartSequence_01	Tremate di fronte all'Orda!	
VO_NEFARIAN_ATRAMEDES_DEATH_76	Hai ucciso un drago cieco. Oh, dovresti vergognarti.	
VO_NEFARIAN_BARON_GEDDON_DEAD_40	Siamo vicini. Sì. SÌ!	
VO_NEFARIAN_CHROMAGGUS_DEAD_63	In realtà, Cromaggus era il mio servitore più debole. Non montarti la testa.	
VO_NEFARIAN_CHROMAGGUS1_59	Gli ho dato due teste perché possa azzannare il doppio del normale!	
VO_NEFARIAN_CHROMAGGUS2_60	L'ho infuso con i poteri di tutti gli Stormi dei Draghi! È semplicemente perfetto!	
VO_NEFARIAN_CHROMAGGUS3_61	Ottimo lavoro, Cromaggus. Bravo cucciolo.	
VO_NEFARIAN_CHROMAGGUS4_62	La tua mano si è intasata? Ahahah! Bravo il mio cagnetto.	
VO_NEFARIAN_COREN_DEAD_28	Il Torvo Beone. Ah, spassoso.	
VO_NEFARIAN_DRAKKISATH_DEAD_50	Sto per perdere la PAZIENZA!	
VO_NEFARIAN_DRAKKISATH_RESPOND_48	Sì, Drakkisath. Avventuriero, sei ancora nella parte sbagliata della montagna!	
VO_NEFARIAN_DRAKKISATH1_49	Senti, vai a giocare in modalità Classificata. Questa avventura non fa per te...	
VO_NEFARIAN_GARR_DEAD1_38	Dovresti portare con te un pezzo di Garr e farlo rimbalzare nella pozza di lava di Ragnaros. Sono certo che apprezzerebbe.	
VO_NEFARIAN_GARR2_35	Fai attenzione a quelle cosette rocciose, d'accordo?	
VO_NEFARIAN_GARR3_36	Cerca di non esplodere. Hai ancora un Signore Elementale da esiliare.	
VO_NEFARIAN_GARR4_37	Sai, mi piace vederti all'opera.	
VO_NEFARIAN_GRIMSTONE_DEAD1_30	Continua così e ben presto Ragnaros verrà spazzato via da questa montagna!	
VO_NEFARIAN_HEROIC_BLOCK_77	Non in modalità Eroica. Ahahahahah.	
VO_NEFARIAN_MALORIAK_DEATH_PT1_72	Congratulazioni! Che incredibile impresa!	
VO_NEFARIAN_MALORIAK_DEATH_PT2_73	Credo che ti darò un nuovo appellativo per commemorare questo momento.	
VO_NEFARIAN_MALORIAK_DEATH_PT3_74	"Sterminatore di Servitori Deludenti, Stupidi e Incompetenti". Sì, è perfetto.	
VO_NEFARIAN_MALORIAK_TURN2_71	Maloriak... cerca di non perdere con questo mortale.	
VO_NEFARIAN_NEF_MISSION_66	QUESTO È BARARE! NON POSSO TOLLERARLO!	
VO_NEFARIAN_NEF2_65	No! NO! TI DISTRUGGERÒ!	
VO_NEFARIAN_OMNOTRON_DEAD_69	Mi hai fatto risparmiare un sacco di costi di manutenzione. Grazie.	
VO_NEFARIAN_OMOKK_DEAD_46	TUTTO QUESTO NON HA SENSO!	
VO_NEFARIAN_OMOKK1_44	Come mai sei qui? Ragnaros è morto. Dovresti essere a festeggiare con i tuoi amici.	
VO_NEFARIAN_OMOKK2_45	Ehm... Sono confuso. Qui non c'è alcun Ragnaros. La tua missione è finita. Vattene a casa.	
VO_NEFARIAN_RAZORGORE_DEAD_55	Quelle uova servivano per dei grandiosi esperimenti!	
VO_NEFARIAN_REND_DEAD_53	Ora basta, mortale. Stai provocando il drago sbagliato.	
VO_NEFARIAN_REND1_52	Persino quest'Orco sa che stai sbagliando!	
VO_NEFARIAN_THAURISSAN_DEAD_32	Avresti dovuto eliminare anche la Nana! Devono morire tutti!	
VO_NEFARIAN_THAURISSAN_DEAD2_33	Hai ucciso entrambi i Nani? Davvero notevole.	
VO_NEFARIAN_VAEL_DEAD_57	Ah! Hai ucciso uno dei buoni! La cosa ti turba?	
VO_Netherspite_Male_Dragon_NetherspiteAngryChicken_01	Ancora tu! Perché sei sempre nei miei portali?!?	
VO_Netherspite_Male_Dragon_NetherspiteDeath_01	Il mio lavoro...	
VO_Netherspite_Male_Dragon_NetherspiteEmoteResponse_01	Osate sfidare un dragone nel suo laboratorio?	
VO_Netherspite_Male_Dragon_NetherspiteEmpowerment_01	Così tanti mondi! Così tanto da imparare!	
VO_Netherspite_Male_Dragon_NetherspiteOpen_01	Chi è che disturba la mia ricerca?	
VO_Netherspite_Male_Dragon_NetherspiteShadowBreath_01	Via! Sciò!	
VO_Netherspite_Male_Dragon_NetherspiteTurn12_01	Mmm... Se 12 Murloc lasciano il portale alle 4 e C'thun arriva alle 5... Mmm, devo rifletterci...	
VO_Netherspite_Male_Dragon_NetherspiteTurn3_02	I miei esperimenti! Lasciateli stare!	
VO_Netherspite_Male_Dragon_NetherspiteTurn5_01	Non toccate i portali! I modulatori di flusso sono regolati con precisione.	
VO_Netherspite_Male_Dragon_NetherspiteTurn7_01	Oh, la festa sembra divertente. Raggiungetela e lasciate stare i miei portali!	
VO_Netherspite_Male_Dragon_NetherspiteUnstablePortal_01	Interessante. Instabilità fondamentali.	
VO_Netherspite_Male_Dragon_NetherspiteUnstablePortal_02	Interessante. Instabilità fondamentali.	
VO_Nightbane_Roar	ROAR!!!	
VO_RAGNAROS_GRIMSTONE_DEAD2_66	SARÒ IO A SPAZZARTI VIA, LUCERTOLINA INSIGNIFICANTE!	
VO_RAGNAROS_NEF1_71	SEMBRA CHE TU ABBIA BISOGNO D'AIUTO, MORTALE.	
VO_RAGNAROS_NEF3_72	LA VENDETTA SARÀ MIA! CHE IL FUOCO TI PURIFICHI!!!	
VO_RAGNAROS_NEF4_73	MANDERÒ I MIEI SERVITORI A DISTRUGGERTI, ALA NERA.	
VO_RAGNAROS_NEF5_74	TRASFORMA QUESTO BORIOSO DRAGO IN CENERE!	
VO_RAGNAROS_NEF6_75	UN REGALO DALLE TERRE DEL FUOCO!	
VO_RAGNAROS_NEF7_76	NON PUOI ESTINGUERE LE FIAMME DEL SIGNORE DEL FUOCO!	
VO_RAGNAROS_NEF8_77	AVRÒ LA MIA VENDETTA, DRAGO!	
VO_SilverwareGolem_Male_SilverwareGolem_SilverwareDeath_02	I piatti sono pronti...	
VO_SilverwareGolem_Male_SilverwareGolem_SilverwareEmoteResponse_01	È ora di lucidare!	
VO_SilverwareGolem_Male_SilverwareGolem_SilverwareForkedLightning_01	Ti piacciono le forchette? Ecco le forchette!	
VO_SilverwareGolem_Male_SilverwareGolem_SilverwareHeroPower_01	Apparecchiate la tavola! Preparate la pista!	
VO_SilverwareGolem_Male_SilverwareGolem_SilverwareKnifeJuggler_01	Oooh, lancio di coltelli!	
VO_SilverwareGolem_Male_SilverwareGolem_SilverwareOpen_01	Ballare è divertente!	
VO_SilverwareGolem_Male_SilverwareGolem_SilverwarePlateTossing_01	Un piatto a te! Un piatto a te! Un piatto a tutti!	
VO_TB_MEDIVA1_001	Brucia!	
VO_TB_MEDIVA1_002	Attenzione.	
VO_TB_MEDIVA1_003	Oh, Tito!	
VO_TB_MEDIVA1_004	Salute.	
VO_TB_MEDIVA1_005	Bestiale!	
VO_TB_MEDIVA1_006	Che belle creaturine.	
VO_TB_MEDIVA1_007	No! Il veleno no.	
VO_TB_MEDIVA1_008	Luccica!	
VO_TB_MEDIVA1_009	Avete suonato?	
VO_TB_MEDIVA2_001	Caldo!	
VO_TB_MEDIVA2_002	Pauroso.	
VO_TB_MEDIVA2_003	Oh, che freddo.	
VO_TB_MEDIVA2_004	Oh, no! Una trappola!	
VO_TB_MEDIVA2_005	Oh, non posso guardare!	
VO_TB_MEDIVA2_006	Carino.	
VO_TB_MEDIVA2_007	Adoro gli Imp.	
VO_TB_MEDIVA2_008	Luccica!	
VO_TB_MEDIVA2_009	Ecciù. Bleah!	
VO_TB_MEDIVA2_010	Mi cercavi?	
VO_TB_MEDIVA3_001	Caldo!	
VO_TB_MEDIVA3_002	Davvero raggelante.	
VO_TB_MEDIVA3_003	Terribilmente oscuro!	
VO_TB_MEDIVA3_004	Una trappola!	
VO_TB_MEDIVA3_005	Che bestie!	
VO_TB_MEDIVA3_006	Il mio uomo adora i cuccioli!	
VO_TB_MEDIVA3_007	Oh, no, un momentaccio!	
VO_TB_MEDIVA3_008	Accidenti, che veleno.	
VO_TB_MEDIVA3_009	E adesso, i Me-divi!	
VO_TB_MEDIVA3_010	Sììì!	
VO_TIRION_INTRO_03	Quale dei nostri valorosi cavalieri verrà dichiarato campione, quest'oggi?	
VO_WhiteKing_Male_ChessPiece_ChessDeath_01	Scacco matto.	
VO_WhiteKing_Male_ChessPiece_ChessEmoteGreetings_01	Ti va di giocare?	
VO_WhiteKing_Male_ChessPiece_ChessEmoteOops_01	Una cantonata.	
VO_WhiteKing_Male_ChessPiece_ChessEmoteSorry_01	Uno sviluppo increscioso.	
VO_WhiteKing_Male_ChessPiece_ChessEmoteThanks_01	Che gentile.	
VO_WhiteKing_Male_ChessPiece_ChessEmoteThinking_01	Mmm... Torre in A3...	
VO_WhiteKing_Male_ChessPiece_ChessEmoteThinking_02	Cavallo in F6...	
VO_WhiteKing_Male_ChessPiece_ChessEmoteThinking_03	Regina in E5... Oh, no, no, no...	
VO_WhiteKing_Male_ChessPiece_ChessEmoteThreaten_01	Prevedo matto in 4 turni.	
VO_WhiteKing_Male_ChessPiece_ChessEmoteWellPlayed_01	Scacco matto.	
VO_WhiteKing_Male_ChessPiece_ChessEmoteWow_01	Ah, splendido!	
VO_WhiteKing_Male_ChessPiece_ChessOpen_02	En garde!	
VOX_Nightbane_Start_01	Roar!	
