TAG	TEXT	COMMENT
GAMEPLAY_EMOTE_EX1_323h_CONCEDE	Você venceu... MAS SEU MUNDO CONTINUA CONDENADO!	
GAMEPLAY_EMOTE_EX1_323h_ERROR_FULL_MINIONS	LACAIOS DEMAIS.	
GAMEPLAY_EMOTE_EX1_323h_ERROR_GENERIC	NÃO É POSSÍVEL FAZER ISSO.	
GAMEPLAY_EMOTE_EX1_323h_ERROR_HAND_FULL	CARDS DEMAIS!	
GAMEPLAY_EMOTE_EX1_323h_ERROR_I_ATTACKED	EU JÁ ATAQUEI.	
GAMEPLAY_EMOTE_EX1_323h_ERROR_JUST_PLAYED	ISSO ACABOU DE CHEGAR!	
GAMEPLAY_EMOTE_EX1_323h_ERROR_MINION_ATTACKED	ESSA COISA JÁ ATACOU.	
GAMEPLAY_EMOTE_EX1_323h_ERROR_NEED_MANA	MANA INSUFICIENTE!	
GAMEPLAY_EMOTE_EX1_323h_ERROR_NEED_WEAPON	ONDE FOI PARAR MINHA ARMA?	
GAMEPLAY_EMOTE_EX1_323h_ERROR_PLAY	NÃO É POSSÍVEL JOGAR ISSO.	
GAMEPLAY_EMOTE_EX1_323h_ERROR_STEALTH	TÁ FURTIVO.	
GAMEPLAY_EMOTE_EX1_323h_ERROR_TARGET	INVÁLIDO.	
GAMEPLAY_EMOTE_EX1_323h_ERROR_TAUNT	AQUELE LACAIO COM PROVOCAR ESTÁ NO MEU CAMINHO!	
GAMEPLAY_EMOTE_EX1_323h_FIRE_FESTIVAL	ACENDAM AS CHAMAS!	
GAMEPLAY_EMOTE_EX1_323h_GOOD_GAME	BOM JOGO!	
GAMEPLAY_EMOTE_EX1_323h_GREETINGS	Você está enfrentando Jaraxxus, lorde eredar da Legião Ardente!	
GAMEPLAY_EMOTE_EX1_323h_HALLOWS_END	APROVEITE A ÚLTIMA NOTURNÁLIA!	
GAMEPLAY_EMOTE_EX1_323h_LOW_CARDS	Meu deck! ESTOU FICANDO SEM CARDS!	
GAMEPLAY_EMOTE_EX1_323h_LUNAR_NEW_YEAR	FELIZ ANO NOVO!	
GAMEPLAY_EMOTE_EX1_323h_NO_CARDS	NÃÃÃÃO! ESTOU SEM CARDS!	
GAMEPLAY_EMOTE_EX1_323h_NOBLEGARDEN	FELIZ JARDINOVA!	
GAMEPLAY_EMOTE_EX1_323h_OOPS	ERRO!	
GAMEPLAY_EMOTE_EX1_323h_PIRATE_DAY	EU SOU JAAAAARRRRAAAAXXUS!	
GAMEPLAY_EMOTE_EX1_323h_SORRY	JARAXXUS SE... desculpa.	
GAMEPLAY_EMOTE_EX1_323h_THANKS	OBRIGADO.	
GAMEPLAY_EMOTE_EX1_323h_THINK1	Huum...	
GAMEPLAY_EMOTE_EX1_323h_THINK2	Estou pensando...	
GAMEPLAY_EMOTE_EX1_323h_THINK3	Como vou destruir você...	
GAMEPLAY_EMOTE_EX1_323h_THREATEN	ANIQUILAÇÃO!!!	
GAMEPLAY_EMOTE_EX1_323h_TIMER	O TEMPO ACABOU!	
GAMEPLAY_EMOTE_EX1_323h_WELL_PLAYED	BEM JOGADO!	
GAMEPLAY_EMOTE_EX1_323h_WINTERVEIL_GREETINGS	VOU ME REFESTELAR COM SUA ALMA NESTE VÉU DE INVERNO!	
GAMEPLAY_EMOTE_EX1_323h_WOW_04	NÃO É POSSÍVEL!	
GAMEPLAY_EMOTE_HERO_01_CONCEDE	Eu escolho a morte!	
GAMEPLAY_EMOTE_HERO_01_ERROR_FULL_MINIONS	Eu tenho lacaios demais.	
GAMEPLAY_EMOTE_HERO_01_ERROR_GENERIC	Não posso fazer isso.	
GAMEPLAY_EMOTE_HERO_01_ERROR_HAND_FULL	Minha mão está cheia!	
GAMEPLAY_EMOTE_HERO_01_ERROR_I_ATTACKED	Eu já ataquei.	
GAMEPLAY_EMOTE_HERO_01_ERROR_JUST_PLAYED	Espere um turno para o lacaio se preparar.	
GAMEPLAY_EMOTE_HERO_01_ERROR_MINION_ATTACKED	Esse lacaio já atacou.	
GAMEPLAY_EMOTE_HERO_01_ERROR_NEED_MANA	Não tenho mana suficiente.	
GAMEPLAY_EMOTE_HERO_01_ERROR_NEED_WEAPON	Preciso de uma arma.	
GAMEPLAY_EMOTE_HERO_01_ERROR_PLAY	Eu não posso jogar isso.	
GAMEPLAY_EMOTE_HERO_01_ERROR_STEALTH	Não consigo mirar em lacaios Furtivos.	
GAMEPLAY_EMOTE_HERO_01_ERROR_TARGET	Esse não é um alvo válido.	
GAMEPLAY_EMOTE_HERO_01_ERROR_TAUNT	Há um lacaio com Provocar no meio do caminho.	
GAMEPLAY_EMOTE_HERO_01_EVENT_FIRE_FESTIVAL	Acendam as piras!	
GAMEPLAY_EMOTE_HERO_01_EVENT_LUNAR_NEW_YEAR	Feliz Ano Novo!	
GAMEPLAY_EMOTE_HERO_01_GOOD_GAME	Bom jogo.	
GAMEPLAY_EMOTE_HERO_01_GREETINGS	Hah, saudações.	
GAMEPLAY_EMOTE_HERO_01_GREETINGS_RESPONSE	Haha... Olá!	
GAMEPLAY_EMOTE_HERO_01_HALLOWS_END	Feliz Noturnália.	
GAMEPLAY_EMOTE_HERO_01_LOW_CARDS	Estou quase sem cards!	
GAMEPLAY_EMOTE_HERO_01_MIRROR_START	Haha! Pode vir!	
GAMEPLAY_EMOTE_HERO_01_NO_CARDS	Estou sem cards!	
GAMEPLAY_EMOTE_HERO_01_NOBLEGARDEN	Feliz Jardinova!	
GAMEPLAY_EMOTE_HERO_01_OOPS	Isso foi um erro.	
GAMEPLAY_EMOTE_HERO_01_PIRATE_DAY	SERÁ QUE EU DEVIA USAR UM TAPA-OLHO HOJE?	
GAMEPLAY_EMOTE_HERO_01_SORRY	Sinto muito por isso.	
GAMEPLAY_EMOTE_HERO_01_START	Vitória ou Morte!	
GAMEPLAY_EMOTE_HERO_01_THANKS	Obrigado.	
GAMEPLAY_EMOTE_HERO_01_THINK1	Huum...	
GAMEPLAY_EMOTE_HERO_01_THINK2	Huum... Será que...	
GAMEPLAY_EMOTE_HERO_01_THINK3	E agora...	
GAMEPLAY_EMOTE_HERO_01_THREATEN	Vou esmagar você!	
GAMEPLAY_EMOTE_HERO_01_TIMER	Tenho que escolher!	
GAMEPLAY_EMOTE_HERO_01_WELL_PLAYED	Bem jogado.	
GAMEPLAY_EMOTE_HERO_01_WINTERVEIL_GREETINGS	Feliz Festa do Véu de Inverno!	
GAMEPLAY_EMOTE_HERO_01_WOW	Impressionante!	
GAMEPLAY_EMOTE_HERO_01A_CELEBRATE	Hip, hip, hurra!	
GAMEPLAY_EMOTE_HERO_01A_CONCEDE	Bah! Tu me pegou dessa vez.	
GAMEPLAY_EMOTE_HERO_01A_ERROR_FULL_MINIONS	Eu tenho lacaios demais.	
GAMEPLAY_EMOTE_HERO_01A_ERROR_GENERIC	Eu não posso fazer isso.	
GAMEPLAY_EMOTE_HERO_01A_ERROR_HAND_FULL	Minha mão está cheia!	
GAMEPLAY_EMOTE_HERO_01A_ERROR_I_ATTACKED	Eu já ataquei.	
GAMEPLAY_EMOTE_HERO_01A_ERROR_JUST_PLAYED	Espere um turno para o lacaio se preparar.	
GAMEPLAY_EMOTE_HERO_01A_ERROR_MINION_ATTACKED	Esse lacaio já atacou.	
GAMEPLAY_EMOTE_HERO_01A_ERROR_NEED_MANA	Não tenho mana suficiente.	
GAMEPLAY_EMOTE_HERO_01A_ERROR_NEED_WEAPON	Preciso de uma arma.	
GAMEPLAY_EMOTE_HERO_01A_ERROR_PLAY	Eu não posso jogar isso.	
GAMEPLAY_EMOTE_HERO_01A_ERROR_STEALTH	Não consigo mirar em lacaios Furtivos.	
GAMEPLAY_EMOTE_HERO_01A_ERROR_TARGET	Este não é um alvo válido.	
GAMEPLAY_EMOTE_HERO_01A_ERROR_TAUNT	Preciso atacar o lacaio com Provocar.	
GAMEPLAY_EMOTE_HERO_01A_EVENT_LUNAR_NEW_YEAR	Feliz Ano Novo!	
GAMEPLAY_EMOTE_HERO_01A_FIRE_FESTIVAL	Feliz Festival do Fogo do Solstício!	
GAMEPLAY_EMOTE_HERO_01A_GOOD_GAME	Bom jogo.	
GAMEPLAY_EMOTE_HERO_01A_GREETINGS	Buenas.	
GAMEPLAY_EMOTE_HERO_01A_GREETINGS_RESPONSE	Alô, você!	
GAMEPLAY_EMOTE_HERO_01A_HALLOWS_END	Feliz Noturnália.	
GAMEPLAY_EMOTE_HERO_01A_LOW_CARDS	Estou quase sem cards.	
GAMEPLAY_EMOTE_HERO_01A_MIRROR_START	É isso aí! Khaz Modan!	
GAMEPLAY_EMOTE_HERO_01A_NO_CARDS	Estou sem cards!	
GAMEPLAY_EMOTE_HERO_01A_NOBLEGARDEN	Feliz Jardinova!	
GAMEPLAY_EMOTE_HERO_01A_OOPS	Não está certo.	
GAMEPLAY_EMOTE_HERO_01A_PIRATE_DAY	Iarrr! Eu sou o rei do alto-mar!	
GAMEPLAY_EMOTE_HERO_01A_SORRY	Eu sinto muito.	
GAMEPLAY_EMOTE_HERO_01A_START	Por Khaz Modan!	
GAMEPLAY_EMOTE_HERO_01A_THANKS	Bah! Te agradeço.	
GAMEPLAY_EMOTE_HERO_01A_THINK1	Hmm...	
GAMEPLAY_EMOTE_HERO_01A_THINK2	Talvez isso aqui?.... Não, não, não...	
GAMEPLAY_EMOTE_HERO_01A_THINK3	São tantas opções...	
GAMEPLAY_EMOTE_HERO_01A_THREATEN	Sintam a fúria da montanha!	
GAMEPLAY_EMOTE_HERO_01A_TIMER	Bah! O tempo tá curto!	
GAMEPLAY_EMOTE_HERO_01A_WELL_PLAYED	Bem jogado.	
GAMEPLAY_EMOTE_HERO_01A_WINTERVEIL_GREETINGS	Feliz Festa do Véu de Inverno!	
GAMEPLAY_EMOTE_HERO_01A_WOW	Pela minha barba!	
GAMEPLAY_EMOTE_HERO_02_CONCEDE	Você venceu dessa vez, camarada.	
GAMEPLAY_EMOTE_HERO_02_ERROR_FULL_MINIONS	Eu tenho lacaios demais.	
GAMEPLAY_EMOTE_HERO_02_ERROR_GENERIC	Não posso fazer isso.	
GAMEPLAY_EMOTE_HERO_02_ERROR_HAND_FULL	Minha mão está cheia demais.	
GAMEPLAY_EMOTE_HERO_02_ERROR_I_ATTACKED	Já ataquei.	
GAMEPLAY_EMOTE_HERO_02_ERROR_JUST_PLAYED	Espere um turno para o lacaio se preparar.	
GAMEPLAY_EMOTE_HERO_02_ERROR_MINION_ATTACKED	Esse lacaio já atacou.	
GAMEPLAY_EMOTE_HERO_02_ERROR_NEED_MANA	Não tenho mana suficiente.	
GAMEPLAY_EMOTE_HERO_02_ERROR_NEED_WEAPON	Preciso de uma arma.	
GAMEPLAY_EMOTE_HERO_02_ERROR_PLAY	Eu não posso jogar isso.	
GAMEPLAY_EMOTE_HERO_02_ERROR_STEALTH	Não consigo mirar em lacaios Furtivos.	
GAMEPLAY_EMOTE_HERO_02_ERROR_TARGET	Esse não é um alvo válido.	
GAMEPLAY_EMOTE_HERO_02_ERROR_TAUNT	Há um lacaio com Provocar no meio do caminho.	
GAMEPLAY_EMOTE_HERO_02_EVENT_FIRE_FESTIVAL	Um festival para os elementos!	
GAMEPLAY_EMOTE_HERO_02_EVENT_LUNAR_NEW_YEAR	Feliz Ano Novo, camarada!	
GAMEPLAY_EMOTE_HERO_02_GOOD_GAME	Bom jogo.	
GAMEPLAY_EMOTE_HERO_02_GREETINGS	Saudações, camarada.	
GAMEPLAY_EMOTE_HERO_02_GREETINGS_RESPONSE	Que bom ver você.	
GAMEPLAY_EMOTE_HERO_02_HALLOWS_END	Feliz Noturnália.	
GAMEPLAY_EMOTE_HERO_02_LOW_CARDS	Estou quase sem cards!	
GAMEPLAY_EMOTE_HERO_02_MIRROR_START	Pelo Lobo do Gelo!	
GAMEPLAY_EMOTE_HERO_02_NO_CARDS	Estou sem cards!	
GAMEPLAY_EMOTE_HERO_02_NOBLEGARDEN	Feliz Jardinova.	
GAMEPLAY_EMOTE_HERO_02_OOPS	Isso foi um erro.	
GAMEPLAY_EMOTE_HERO_02_PIRATE_DAY	Iarrr, marujo! É dia do pirata!	
GAMEPLAY_EMOTE_HERO_02_SORRY	Sinto muito por isso.	
GAMEPLAY_EMOTE_HERO_02_START	Pelo Martelo da Perdição!	
GAMEPLAY_EMOTE_HERO_02_THANKS	Agradeço.	
GAMEPLAY_EMOTE_HERO_02_THINK1	Huum...	
GAMEPLAY_EMOTE_HERO_02_THINK2	Estou pensando...	
GAMEPLAY_EMOTE_HERO_02_THINK3	Hum... O que fazer...	
GAMEPLAY_EMOTE_HERO_02_THREATEN	Os Elementos vão destruir você!	
GAMEPLAY_EMOTE_HERO_02_TIMER	Não resta muito tempo!	
GAMEPLAY_EMOTE_HERO_02_WELL_PLAYED	Bem jogado.	
GAMEPLAY_EMOTE_HERO_02_WINTERVEIL_GREETINGS	Feliz Festa do Véu de Inverno!	
GAMEPLAY_EMOTE_HERO_02_WOW	Incrível.	
GAMEPLAY_EMOTE_HERO_02A_CELEBRATE	<Comemorações!>	
GAMEPLAY_EMOTE_HERO_02A_CONCEDE	<Eu fui superado.>	
GAMEPLAY_EMOTE_HERO_02A_ERROR_FULL_MINIONS	<Eu tenho lacaios \ndemais.>	
GAMEPLAY_EMOTE_HERO_02A_ERROR_GENERIC	<Isso é\nimpossível.>	
GAMEPLAY_EMOTE_HERO_02A_ERROR_HAND_FULL	<Minha mão está\ncheia.>	
GAMEPLAY_EMOTE_HERO_02A_ERROR_I_ATTACKED	<Eu já \nataquei.>	VO_HERO_15_ERROR04_43.wav
GAMEPLAY_EMOTE_HERO_02A_ERROR_JUST_PLAYED	<Esse lacaio precisa esperar\num pouco.>	
GAMEPLAY_EMOTE_HERO_02A_ERROR_MINION_ATTACKED	<Esse lacaio já\natacou.>	
GAMEPLAY_EMOTE_HERO_02A_ERROR_NEED_MANA	<Eu preciso de mais mana.>	
GAMEPLAY_EMOTE_HERO_02A_ERROR_NEED_WEAPON	<Eu preciso de uma arma.>	
GAMEPLAY_EMOTE_HERO_02A_ERROR_PLAY	<Eu não posso jogar isso.>	
GAMEPLAY_EMOTE_HERO_02A_ERROR_STEALTH	<Eu não posso atacar um lacaio\nFurtivo!>	
GAMEPLAY_EMOTE_HERO_02A_ERROR_TARGET	<Esse alvo\né inválido.>	
GAMEPLAY_EMOTE_HERO_02A_ERROR_TAUNT	<Eu não consigo passar do\nlacaio com Provocar.>	
GAMEPLAY_EMOTE_HERO_02A_EVENT_LUNAR_NEW_YEAR	<Um próspero ano\nnovo para você!>	
GAMEPLAY_EMOTE_HERO_02A_FIRE_FESTIVAL	<Lá na minha terra\nnão tem Festival do Fogo.>	
GAMEPLAY_EMOTE_HERO_02A_GREETINGS	<Olá, amigo.>	
GAMEPLAY_EMOTE_HERO_02A_GREETINGS_RESPONSE	<Olá.>	
GAMEPLAY_EMOTE_HERO_02A_HALLOWS_END	<Que sua Noturnália \nseja assutadora.>	
GAMEPLAY_EMOTE_HERO_02A_LOW_CARDS	<Estou ficando\nsem cards!>	
GAMEPLAY_EMOTE_HERO_02A_MIRROR_START	<Jovem!? Você tem\nmuito a aprender.>	
GAMEPLAY_EMOTE_HERO_02A_NO_CARDS	<Estou sem cards!>	
GAMEPLAY_EMOTE_HERO_02A_NOBLEGARDEN	<Feliz Jardinova!>	
GAMEPLAY_EMOTE_HERO_02A_OOPS	<Maldição!>	
GAMEPLAY_EMOTE_HERO_02A_PIRATE_DAY	<Piratas? A gente tava\naqui antes!>	
GAMEPLAY_EMOTE_HERO_02A_SORRY	<Minhas desculpas, \njovem.>	
GAMEPLAY_EMOTE_HERO_02A_START	<Hora da lição, \njovem!>	
GAMEPLAY_EMOTE_HERO_02A_THANKS	<Minha sincera\ngratidão.>	
GAMEPLAY_EMOTE_HERO_02A_THINK1	<Será que eu devo...>	VO_HERO_15_Thinking1_13.wav
GAMEPLAY_EMOTE_HERO_02A_THINK2	<Uma ideia \ninteressante...>	
GAMEPLAY_EMOTE_HERO_02A_THINK3	<É uma possibilidade...>	
GAMEPLAY_EMOTE_HERO_02A_THREATEN	<Enfrente a sabedoria \ndos mares!>	
GAMEPLAY_EMOTE_HERO_02A_TIMER	<Rápido, \nrápido!>	
GAMEPLAY_EMOTE_HERO_02A_WELL_PLAYED	<Bom trabalho.>	
GAMEPLAY_EMOTE_HERO_02A_WINTERVEIL_GREETINGS	<Que você tenha um\nfeliz Véu de Inverno!>	
GAMEPLAY_EMOTE_HERO_02A_WOW	<Inconcebível!>	
GAMEPLAY_EMOTE_HERO_03_CONCEDE	Desisto.	
GAMEPLAY_EMOTE_HERO_03_ERROR_FULL_MINIONS	Eu tenho lacaios demais.	
GAMEPLAY_EMOTE_HERO_03_ERROR_GENERIC	Não posso fazer isso.	
GAMEPLAY_EMOTE_HERO_03_ERROR_HAND_FULL	Minha mão está cheia demais.	
GAMEPLAY_EMOTE_HERO_03_ERROR_I_ATTACKED	Eu já ataquei.	
GAMEPLAY_EMOTE_HERO_03_ERROR_JUST_PLAYED	Espere um turno para o lacaio se preparar.	
GAMEPLAY_EMOTE_HERO_03_ERROR_MINION_ATTACKED	Esse lacaio já atacou.	
GAMEPLAY_EMOTE_HERO_03_ERROR_NEED_MANA	Não tenho mana suficiente.	
GAMEPLAY_EMOTE_HERO_03_ERROR_NEED_WEAPON	Preciso de uma arma.	
GAMEPLAY_EMOTE_HERO_03_ERROR_PLAY	Eu não posso jogar isso.	
GAMEPLAY_EMOTE_HERO_03_ERROR_STEALTH	Não consigo mirar em lacaios Furtivos.	
GAMEPLAY_EMOTE_HERO_03_ERROR_TARGET	Esse não é um alvo válido.	
GAMEPLAY_EMOTE_HERO_03_ERROR_TAUNT	Há um lacaio com Provocar no meio do caminho.	
GAMEPLAY_EMOTE_HERO_03_EVENT_LUNAR_NEW_YEAR	Feliz Ano Novo!	
GAMEPLAY_EMOTE_HERO_03_FIRE_FESTIVAL	Feliz Solstício.	
GAMEPLAY_EMOTE_HERO_03_GOOD_GAME	Bom jogo.	
GAMEPLAY_EMOTE_HERO_03_GREETINGS	O prazer é todo meu.	
GAMEPLAY_EMOTE_HERO_03_GREETINGS_RESPONSE	É todo meu! Hum.	
GAMEPLAY_EMOTE_HERO_03_HALLOWS_END	Feliz Noturnália.	
GAMEPLAY_EMOTE_HERO_03_LOW_CARDS	Estou quase sem cards!	
GAMEPLAY_EMOTE_HERO_03_MIRROR_START	Meus olhos estão sempre abertos.	
GAMEPLAY_EMOTE_HERO_03_NO_CARDS	Estou sem cards!	
GAMEPLAY_EMOTE_HERO_03_NOBLEGARDEN	Feliz Jardinova.	
GAMEPLAY_EMOTE_HERO_03_OOPS	Erros foram cometidos.	
GAMEPLAY_EMOTE_HERO_03_PIRATE_DAY	Iaar!	
GAMEPLAY_EMOTE_HERO_03_SORRY	Desculpinha.	
GAMEPLAY_EMOTE_HERO_03_START	É melhor abrir o olho.	
GAMEPLAY_EMOTE_HERO_03_THANKS	Obrigada.	
GAMEPLAY_EMOTE_HERO_03_THINK1	Huum...	
GAMEPLAY_EMOTE_HERO_03_THINK2	Estou pensando...	
GAMEPLAY_EMOTE_HERO_03_THINK3	Tantas opções...	
GAMEPLAY_EMOTE_HERO_03_THREATEN	Eu serei a sua morte!	
GAMEPLAY_EMOTE_HERO_03_TIMER	Tenho que escolher logo!	
GAMEPLAY_EMOTE_HERO_03_WELL_PLAYED	Bem jogado.	
GAMEPLAY_EMOTE_HERO_03_WINTERVEIL_GREETINGS	Feliz Festa do Véu de Inverno.	
GAMEPLAY_EMOTE_HERO_03_WOW	Incrível.	
GAMEPLAY_EMOTE_HERO_04_CONCEDE	A vitória é sua.	
GAMEPLAY_EMOTE_HERO_04_ERROR_FULL_MINIONS	Eu tenho lacaios demais.	
GAMEPLAY_EMOTE_HERO_04_ERROR_GENERIC	Não posso fazer isso.	
GAMEPLAY_EMOTE_HERO_04_ERROR_HAND_FULL	Minha mão está cheia demais.	
GAMEPLAY_EMOTE_HERO_04_ERROR_I_ATTACKED	Já ataquei.	
GAMEPLAY_EMOTE_HERO_04_ERROR_JUST_PLAYED	Espere um turno para o lacaio se preparar.	
GAMEPLAY_EMOTE_HERO_04_ERROR_MINION_ATTACKED	Esse lacaio já atacou.	
GAMEPLAY_EMOTE_HERO_04_ERROR_NEED_MANA	Não tenho mana suficiente.	
GAMEPLAY_EMOTE_HERO_04_ERROR_NEED_WEAPON	Preciso de uma arma.	
GAMEPLAY_EMOTE_HERO_04_ERROR_PLAY	Eu não posso jogar isso.	
GAMEPLAY_EMOTE_HERO_04_ERROR_STEALTH	Não consigo mirar em lacaios Furtivos.	
GAMEPLAY_EMOTE_HERO_04_ERROR_TARGET	Esse não é um alvo válido.	
GAMEPLAY_EMOTE_HERO_04_ERROR_TAUNT	Há um lacaio com Provocar no meio do caminho.	
GAMEPLAY_EMOTE_HERO_04_EVENT_LUNAR_NEW_YEAR	Feliz Ano Novo!	
GAMEPLAY_EMOTE_HERO_04_FIRE_FESTIVAL	Feliz Festival do Fogo do Solstício!	
GAMEPLAY_EMOTE_HERO_04_GOOD_GAME	Bom jogo.	
GAMEPLAY_EMOTE_HERO_04_GREETINGS	Saudações!	
GAMEPLAY_EMOTE_HERO_04_GREETINGS_RESPONSE	Sim, sim... É uma honra!	
GAMEPLAY_EMOTE_HERO_04_HALLOWS_END	Feliz Noturnália!	VO_HERO_04_HAPPY_HALLOWEEN_13.wav
GAMEPLAY_EMOTE_HERO_04_LOW_CARDS	Estou quase sem cards!	
GAMEPLAY_EMOTE_HERO_04_MIRROR_START	Eu comandarei a Luz!	
GAMEPLAY_EMOTE_HERO_04_NO_CARDS	Estou sem cards!	
GAMEPLAY_EMOTE_HERO_04_NOBLEGARDEN	Feliz Jardinova!	VO_HERO_04_HAPPY_NOBLEGARDEN_17.wav
GAMEPLAY_EMOTE_HERO_04_OOPS	Isso foi um erro.	
GAMEPLAY_EMOTE_HERO_04_PIRATE_DAY	Alto lá, seus patifes de mar aberto!	VO_HERO_04_PIRATE_DAY_33.wav
GAMEPLAY_EMOTE_HERO_04_SORRY	Perdão.	
GAMEPLAY_EMOTE_HERO_04_START	Lutarei com honra!	
GAMEPLAY_EMOTE_HERO_04_THANKS	Obrigado.	
GAMEPLAY_EMOTE_HERO_04_THINK1	Huum...	
GAMEPLAY_EMOTE_HERO_04_THINK2	Estou pensando...	
GAMEPLAY_EMOTE_HERO_04_THINK3	Vamos ver...	
GAMEPLAY_EMOTE_HERO_04_THREATEN	A Justiça exige retaliação!	
GAMEPLAY_EMOTE_HERO_04_TIMER	Preciso agir rápido!	
GAMEPLAY_EMOTE_HERO_04_WELL_PLAYED	Bem jogado.	
GAMEPLAY_EMOTE_HERO_04_WINTERVEIL_GREETINGS	Feliz Festa do Véu de Inverno!	
GAMEPLAY_EMOTE_HERO_04_WOW	Pela Luz Sagrada!	
GAMEPLAY_EMOTE_HERO_04A_CELEBRATE	A Luz brilha hoje!	
GAMEPLAY_EMOTE_HERO_04A_CONCEDE	Você venceu, camarada. Eu me rendo.	
GAMEPLAY_EMOTE_HERO_04A_ERROR_FULL_MINIONS	Eu tenho lacaios demais.	
GAMEPLAY_EMOTE_HERO_04A_ERROR_GENERIC	Eu não posso fazer isso.	
GAMEPLAY_EMOTE_HERO_04A_ERROR_HAND_FULL	Minha mão está cheia!	
GAMEPLAY_EMOTE_HERO_04A_ERROR_I_ATTACKED	Eu já ataquei.	
GAMEPLAY_EMOTE_HERO_04A_ERROR_JUST_PLAYED	Espere um turno para o lacaio se preparar.	
GAMEPLAY_EMOTE_HERO_04A_ERROR_MINION_ATTACKED	Esse lacaio já atacou.	
GAMEPLAY_EMOTE_HERO_04A_ERROR_NEED_MANA	Não tenho mana suficiente.	
GAMEPLAY_EMOTE_HERO_04A_ERROR_NEED_WEAPON	Preciso de uma arma.	
GAMEPLAY_EMOTE_HERO_04A_ERROR_PLAY	Eu não posso jogar isso.	
GAMEPLAY_EMOTE_HERO_04A_ERROR_STEALTH	Não consigo mirar em lacaios Furtivos.	
GAMEPLAY_EMOTE_HERO_04A_ERROR_TARGET	Este não é um alvo válido.	
GAMEPLAY_EMOTE_HERO_04A_ERROR_TAUNT	Preciso atacar o lacaio com Provocar.	
GAMEPLAY_EMOTE_HERO_04A_FIRE_FESTIVAL	Feliz Festival do Fogo.	
GAMEPLAY_EMOTE_HERO_04A_GOOD_GAME	Bom jogo.	
GAMEPLAY_EMOTE_HERO_04A_GREETINGS	Olá, desafiante!	
GAMEPLAY_EMOTE_HERO_04A_GREETINGS_RESPONSE	Olá.	
GAMEPLAY_EMOTE_HERO_04A_HALLOWS_END	Feliz Noturnália.	
GAMEPLAY_EMOTE_HERO_04A_LOW_CARDS	Estou quase sem cards!	
GAMEPLAY_EMOTE_HERO_04A_LUNAR_NEW_YEAR	Feliz Ano Novo!	
GAMEPLAY_EMOTE_HERO_04A_MIRROR_START	Fogo Sagrado é meu apelido.	
GAMEPLAY_EMOTE_HERO_04A_NO_CARDS	Estou sem cards!	
GAMEPLAY_EMOTE_HERO_04A_NOBLEGARDEN	Feliz Jardinova.	
GAMEPLAY_EMOTE_HERO_04A_OOPS	Certamente foi um erro.	
GAMEPLAY_EMOTE_HERO_04A_PIRATE_DAY	Iar. Eu fico com esse tesouro.	
GAMEPLAY_EMOTE_HERO_04A_SORRY	Desculpe-me.	
GAMEPLAY_EMOTE_HERO_04A_START	Minha lâmina arde com fogo sagrado!	
GAMEPLAY_EMOTE_HERO_04A_THANKS	Meus sinceros agradecimentos.	
GAMEPLAY_EMOTE_HERO_04A_THINK1	Hmm...	
GAMEPLAY_EMOTE_HERO_04A_THINK2	Opções, opções...	
GAMEPLAY_EMOTE_HERO_04A_THINK3	Será que eu devo... Hmm...	
GAMEPLAY_EMOTE_HERO_04A_THREATEN	Você pagará por isso, vira-latas!	
GAMEPLAY_EMOTE_HERO_04A_TIMER	Anda com isso!	
GAMEPLAY_EMOTE_HERO_04A_WELL_PLAYED	Bem jogado.	
GAMEPLAY_EMOTE_HERO_04A_WINTERVEIL_GREETINGS	Feliz Festa do Véu de Inverno!	
GAMEPLAY_EMOTE_HERO_04A_WOW	Isso é incrível!	
GAMEPLAY_EMOTE_HERO_05_CONCEDE	Boa luta. Eu me rendo.	
GAMEPLAY_EMOTE_HERO_05_ERROR_FULL_MINIONS	Eu tenho lacaios demais.	
GAMEPLAY_EMOTE_HERO_05_ERROR_GENERIC	Não posso fazer isso.	
GAMEPLAY_EMOTE_HERO_05_ERROR_HAND_FULL	Minha mão está cheia demais.	
GAMEPLAY_EMOTE_HERO_05_ERROR_I_ATTACKED	Já ataquei.	
GAMEPLAY_EMOTE_HERO_05_ERROR_JUST_PLAYED	Espere um turno para o lacaio se preparar.	
GAMEPLAY_EMOTE_HERO_05_ERROR_MINION_ATTACKED	Esse lacaio já atacou.	
GAMEPLAY_EMOTE_HERO_05_ERROR_NEED_MANA	Não tenho mana suficiente.	
GAMEPLAY_EMOTE_HERO_05_ERROR_NEED_WEAPON	Preciso de uma arma.	
GAMEPLAY_EMOTE_HERO_05_ERROR_PLAY	Eu não posso jogar isso.	
GAMEPLAY_EMOTE_HERO_05_ERROR_STEALTH	Não consigo mirar em lacaios Furtivos.	
GAMEPLAY_EMOTE_HERO_05_ERROR_TARGET	Esse não é um alvo válido.	
GAMEPLAY_EMOTE_HERO_05_ERROR_TAUNT	Há um lacaio com Provocar no meio do caminho.	
GAMEPLAY_EMOTE_HERO_05_EVENT_LUNAR_NEW_YEAR	Feliz Ano Novo!	
GAMEPLAY_EMOTE_HERO_05_FIRE_FESTIVAL	Feliz Solstício.	
GAMEPLAY_EMOTE_HERO_05_GOOD_GAME	Bom jogo.	
GAMEPLAY_EMOTE_HERO_05_GREETINGS	Saudações, viajante.	
GAMEPLAY_EMOTE_HERO_05_GREETINGS_RESPONSE	Salve!	
GAMEPLAY_EMOTE_HERO_05_HALLOWS_END	Feliz Noturnália.	
GAMEPLAY_EMOTE_HERO_05_LOW_CARDS	Estou quase sem cards!	
GAMEPLAY_EMOTE_HERO_05_MIRROR_START	Pode vir com tudo!	
GAMEPLAY_EMOTE_HERO_05_NO_CARDS	Estou sem cards!	
GAMEPLAY_EMOTE_HERO_05_NOBLEGARDEN	Feliz Jardinova!	
GAMEPLAY_EMOTE_HERO_05_OOPS	Não passou nem perto.	
GAMEPLAY_EMOTE_HERO_05_PIRATE_DAY	Soltem os lobos do mar!	
GAMEPLAY_EMOTE_HERO_05_SORRY	Mil perdões.	
GAMEPLAY_EMOTE_HERO_05_START	Que a caçada comece!	
GAMEPLAY_EMOTE_HERO_05_THANKS	Obrigado.	
GAMEPLAY_EMOTE_HERO_05_THINK1	Huum...	
GAMEPLAY_EMOTE_HERO_05_THINK2	Estou pensando...	
GAMEPLAY_EMOTE_HERO_05_THINK3	Hrmmmmm...	
GAMEPLAY_EMOTE_HERO_05_THREATEN	Vou caçar você!	
GAMEPLAY_EMOTE_HERO_05_TIMER	O tempo passa depressa!	
GAMEPLAY_EMOTE_HERO_05_WELL_PLAYED	Bem jogado.	
GAMEPLAY_EMOTE_HERO_05_WINTERVEIL_GREETINGS	Feliz Festa do Véu de Inverno!	
GAMEPLAY_EMOTE_HERO_05_WOW	Fabuloso!	
GAMEPLAY_EMOTE_HERO_05A_CELEBRATE	Haha! Sim, SIM!	
GAMEPLAY_EMOTE_HERO_05A_CONCEDE	Magistral. Eu me rendo.	
GAMEPLAY_EMOTE_HERO_05A_ERROR_FULL_MINIONS	Eu tenho lacaios demais.	
GAMEPLAY_EMOTE_HERO_05A_ERROR_GENERIC	Eu não posso fazer isso.	
GAMEPLAY_EMOTE_HERO_05A_ERROR_HAND_FULL	Minha mão está cheia!	
GAMEPLAY_EMOTE_HERO_05A_ERROR_I_ATTACKED	Eu já ataquei.	
GAMEPLAY_EMOTE_HERO_05A_ERROR_JUST_PLAYED	Espere um turno para o lacaio se preparar.	
GAMEPLAY_EMOTE_HERO_05A_ERROR_MINION_ATTACKED	Este lacaio já atacou.	
GAMEPLAY_EMOTE_HERO_05A_ERROR_NEED_MANA	Não tenho mana suficiente.	
GAMEPLAY_EMOTE_HERO_05A_ERROR_NEED_WEAPON	Preciso de uma arma.	
GAMEPLAY_EMOTE_HERO_05A_ERROR_PLAY	Eu não posso jogar isso.	
GAMEPLAY_EMOTE_HERO_05A_ERROR_STEALTH	Não consigo mirar em lacaios Furtivos.	
GAMEPLAY_EMOTE_HERO_05A_ERROR_TARGET	Este não é um alvo válido.	
GAMEPLAY_EMOTE_HERO_05A_ERROR_TAUNT	Preciso atacar o lacaio com Provocar.	
GAMEPLAY_EMOTE_HERO_05A_EVENT_FIRE_FESTIVAL	Está na época do Festival do Fogo.	
GAMEPLAY_EMOTE_HERO_05A_EVENT_HALLOWS_END	Feliz Noturnália.	
GAMEPLAY_EMOTE_HERO_05A_EVENT_LUNAR_NEW_YEAR	Feliz Ano Novo!	
GAMEPLAY_EMOTE_HERO_05A_EVENT_NOBLEGARDEN	Feliz Jardinova.	
GAMEPLAY_EMOTE_HERO_05A_EVENT_PIRATE_DAY	Iarrr! Eu te faço andar na prancha!	
GAMEPLAY_EMOTE_HERO_05A_GOOD_GAME	Bom jogo.	
GAMEPLAY_EMOTE_HERO_05A_GREETINGS	Olá, caminhante.	
GAMEPLAY_EMOTE_HERO_05A_GREETINGS_RESPONSE	Olá pra você também.	
GAMEPLAY_EMOTE_HERO_05A_LOW_CARDS	Estou quase sem cards.	
GAMEPLAY_EMOTE_HERO_05A_MIRROR_START	Eu nunca estremeço.	
GAMEPLAY_EMOTE_HERO_05A_NO_CARDS	Estou sem cards!	
GAMEPLAY_EMOTE_HERO_05A_OOPS	Foi um erro.	
GAMEPLAY_EMOTE_HERO_05A_SORRY	Sinto muito.	
GAMEPLAY_EMOTE_HERO_05A_START	Estremeça diante do poder dos elfos!	
GAMEPLAY_EMOTE_HERO_05A_THANKS	Obrigada.	
GAMEPLAY_EMOTE_HERO_05A_THINK1	Hmm...	
GAMEPLAY_EMOTE_HERO_05A_THINK2	Em quem devo atirar...?	
GAMEPLAY_EMOTE_HERO_05A_THINK3	O que fazer...	
GAMEPLAY_EMOTE_HERO_05A_THREATEN	Logo eu me vingarei!	
GAMEPLAY_EMOTE_HERO_05A_TIMER	Anda! Vai!	
GAMEPLAY_EMOTE_HERO_05A_WELL_PLAYED	Bem jogado.	
GAMEPLAY_EMOTE_HERO_05A_WINTERVEIL_GREETING	Feliz Festa do Véu de Inverno.	
GAMEPLAY_EMOTE_HERO_05A_WOW	Incrível!	
GAMEPLAY_EMOTE_HERO_06_CONCEDE	Eu me rendo a você.	
GAMEPLAY_EMOTE_HERO_06_ERROR_FULL_MINIONS	Eu tenho lacaios demais.	
GAMEPLAY_EMOTE_HERO_06_ERROR_GENERIC	Não posso fazer isso.	
GAMEPLAY_EMOTE_HERO_06_ERROR_HAND_FULL	Minha mão está cheia demais.	
GAMEPLAY_EMOTE_HERO_06_ERROR_I_ATTACKED	Já ataquei.	
GAMEPLAY_EMOTE_HERO_06_ERROR_JUST_PLAYED	Espere um turno para o lacaio se preparar.	
GAMEPLAY_EMOTE_HERO_06_ERROR_MINION_ATTACKED	Esse lacaio já atacou.	
GAMEPLAY_EMOTE_HERO_06_ERROR_NEED_MANA	Não tenho mana suficiente.	
GAMEPLAY_EMOTE_HERO_06_ERROR_NEED_WEAPON	Preciso de uma arma.	
GAMEPLAY_EMOTE_HERO_06_ERROR_PLAY	Eu não posso jogar isso.	
GAMEPLAY_EMOTE_HERO_06_ERROR_STEALTH	Não consigo mirar em lacaios Furtivos.	
GAMEPLAY_EMOTE_HERO_06_ERROR_TARGET	Esse não é um alvo válido.	
GAMEPLAY_EMOTE_HERO_06_ERROR_TAUNT	Há um lacaio com Provocar no meio do caminho.	
GAMEPLAY_EMOTE_HERO_06_EVENT_LUNAR_NEW_YEAR	Feliz Ano Novo!	
GAMEPLAY_EMOTE_HERO_06_FIRE_FESTIVAL	Feliz Solstício! Cuidado ao acender fogueiras na floresta.	
GAMEPLAY_EMOTE_HERO_06_GOOD_GAME	Bom jogo.	
GAMEPLAY_EMOTE_HERO_06_GREETINGS	Minhas saudações.	
GAMEPLAY_EMOTE_HERO_06_GREETINGS_RESPONSE	Meus cumprimentos.	
GAMEPLAY_EMOTE_HERO_06_HALLOWS_END	Feliz Noturnália!	
GAMEPLAY_EMOTE_HERO_06_LOW_CARDS	Estou quase sem cards!	
GAMEPLAY_EMOTE_HERO_06_MIRROR_START	A natureza tem que ser preservada!	
GAMEPLAY_EMOTE_HERO_06_NO_CARDS	Estou sem cards!	
GAMEPLAY_EMOTE_HERO_06_NOBLEGARDEN	Feliz Jardinova!	
GAMEPLAY_EMOTE_HERO_06_OOPS	Um erro natural.	
GAMEPLAY_EMOTE_HERO_06_PIRATE_DAY	Iaaarrrrr!	
GAMEPLAY_EMOTE_HERO_06_SORRY	Desculpe.	
GAMEPLAY_EMOTE_HERO_06_START	Tenho que proteger a natureza!	
GAMEPLAY_EMOTE_HERO_06_START_TYRANDE	Minha amada Tyrande.	
GAMEPLAY_EMOTE_HERO_06_THANKS	Você tem minha gratidão.	
GAMEPLAY_EMOTE_HERO_06_THINK1	Huum...	
GAMEPLAY_EMOTE_HERO_06_THINK2	Huum... Estou pensando...	
GAMEPLAY_EMOTE_HERO_06_THINK3	O que fazer...	
GAMEPLAY_EMOTE_HERO_06_THREATEN	A natureza se levantará contra você!	
GAMEPLAY_EMOTE_HERO_06_TIMER	O tempo não espera ninguém!	
GAMEPLAY_EMOTE_HERO_06_WELL_PLAYED	Hum, bem jogado.	
GAMEPLAY_EMOTE_HERO_06_WINTERVEIL_GREETINGS	Feliz Festa do Véu de Inverno.	
GAMEPLAY_EMOTE_HERO_06_WOW	Espetacular!	
GAMEPLAY_EMOTE_HERO_07_CONCEDE	A vitória é sua... desta vez.	
GAMEPLAY_EMOTE_HERO_07_ERROR_FULL_MINIONS	Eu tenho lacaios demais.	
GAMEPLAY_EMOTE_HERO_07_ERROR_GENERIC	Não posso fazer isso.	
GAMEPLAY_EMOTE_HERO_07_ERROR_HAND_FULL	Minha mão está cheia demais.	
GAMEPLAY_EMOTE_HERO_07_ERROR_I_ATTACKED	Já ataquei.	
GAMEPLAY_EMOTE_HERO_07_ERROR_JUST_PLAYED	Espere um turno para o lacaio se preparar.	
GAMEPLAY_EMOTE_HERO_07_ERROR_MINION_ATTACKED	Esse lacaio já atacou.	
GAMEPLAY_EMOTE_HERO_07_ERROR_NEED_MANA	Não tenho mana suficiente.	
GAMEPLAY_EMOTE_HERO_07_ERROR_NEED_WEAPON	Preciso de uma arma.	
GAMEPLAY_EMOTE_HERO_07_ERROR_PLAY	Eu não posso jogar isso.	
GAMEPLAY_EMOTE_HERO_07_ERROR_STEALTH	Não consigo mirar em lacaios Furtivos.	
GAMEPLAY_EMOTE_HERO_07_ERROR_TARGET	Esse não é um alvo válido.	
GAMEPLAY_EMOTE_HERO_07_ERROR_TAUNT	Há um lacaio com Provocar no meio do caminho.	
GAMEPLAY_EMOTE_HERO_07_EVENT_LUNAR_NEW_YEAR	Feliz Ano Novo!	
GAMEPLAY_EMOTE_HERO_07_FIRE_FESTIVAL	Acendam as fogueiras!	
GAMEPLAY_EMOTE_HERO_07_GOOD_GAME	Bom jogo.	
GAMEPLAY_EMOTE_HERO_07_GREETINGS	Saudações.	
GAMEPLAY_EMOTE_HERO_07_GREETINGS_RESPONSE	Minhas saudações também.	
GAMEPLAY_EMOTE_HERO_07_HALLOWS_END	Uma Noturnália sinistra pra você.	
GAMEPLAY_EMOTE_HERO_07_LOW_CARDS	Estou quase sem cards!	
GAMEPLAY_EMOTE_HERO_07_MIRROR_START	Eu sou o seu pesadelo!	
GAMEPLAY_EMOTE_HERO_07_NO_CARDS	Estou sem cards!	
GAMEPLAY_EMOTE_HERO_07_NOBLEGARDEN	Feliz Jardinova.	
GAMEPLAY_EMOTE_HERO_07_OOPS	Isso foi um erro.	
GAMEPLAY_EMOTE_HERO_07_PIRATE_DAY	Dia do pirata? Não entendi essa.	
GAMEPLAY_EMOTE_HERO_07_SORRY	Desculpe.	
GAMEPLAY_EMOTE_HERO_07_START	Sua alma será minha!	
GAMEPLAY_EMOTE_HERO_07_THANKS	Obrigado.	
GAMEPLAY_EMOTE_HERO_07_THINK1	Huum...	
GAMEPLAY_EMOTE_HERO_07_THINK2	Estou pensando...	
GAMEPLAY_EMOTE_HERO_07_THINK3	Tantas possibilidades...	
GAMEPLAY_EMOTE_HERO_07_THREATEN	Sua alma sofrerá!	
GAMEPLAY_EMOTE_HERO_07_TIMER	Estou quase sem tempo!	
GAMEPLAY_EMOTE_HERO_07_WELL_PLAYED	Bem jogado.	
GAMEPLAY_EMOTE_HERO_07_WINTERVEIL_GREETINGS	Um Véu de Inverno agradável....	
GAMEPLAY_EMOTE_HERO_07_WOW	Extraordinário.	
GAMEPLAY_EMOTE_HERO_08_CONCEDE	Você venceu desta vez.	
GAMEPLAY_EMOTE_HERO_08_ERROR_FULL_MINIONS	Eu tenho lacaios demais.	
GAMEPLAY_EMOTE_HERO_08_ERROR_GENERIC	Não posso fazer isso.	
GAMEPLAY_EMOTE_HERO_08_ERROR_HAND_FULL	Minha mão está cheia demais.	
GAMEPLAY_EMOTE_HERO_08_ERROR_I_ATTACKED	Já ataquei.	
GAMEPLAY_EMOTE_HERO_08_ERROR_JUST_PLAYED	Espere um turno para o lacaio se preparar.	
GAMEPLAY_EMOTE_HERO_08_ERROR_MINION_ATTACKED	Esse lacaio já atacou.	
GAMEPLAY_EMOTE_HERO_08_ERROR_NEED_MANA	Não tenho mana suficiente.	
GAMEPLAY_EMOTE_HERO_08_ERROR_NEED_WEAPON	Preciso de uma arma.	
GAMEPLAY_EMOTE_HERO_08_ERROR_PLAY	Eu não posso jogar isso.	
GAMEPLAY_EMOTE_HERO_08_ERROR_STEALTH	Não consigo mirar em lacaios Furtivos.	
GAMEPLAY_EMOTE_HERO_08_ERROR_TARGET	Esse não é um alvo válido.	
GAMEPLAY_EMOTE_HERO_08_ERROR_TAUNT	Há um lacaio com Provocar no meio do caminho.	
GAMEPLAY_EMOTE_HERO_08_EVENT_LUNAR_NEW_YEAR	Feliz Ano Novo!	
GAMEPLAY_EMOTE_HERO_08_FIRE_FESTIVAL	Feliz Festival do Fogo do Solstício!	
GAMEPLAY_EMOTE_HERO_08_GOOD_GAME	Bom jogo.	
GAMEPLAY_EMOTE_HERO_08_GREETINGS	Olá.	
GAMEPLAY_EMOTE_HERO_08_GREETINGS_RESPONSE	Olá, viajante.	
GAMEPLAY_EMOTE_HERO_08_HALLOWS_END	Feliz Noturnália.	
GAMEPLAY_EMOTE_HERO_08_LOW_CARDS	Estou quase sem cards!	
GAMEPLAY_EMOTE_HERO_08_MIRROR_START	Ah, não tenha dúvida.	
GAMEPLAY_EMOTE_HERO_08_NO_CARDS	Estou sem cards!	
GAMEPLAY_EMOTE_HERO_08_NOBLEGARDEN	Feliz Jardinova.	
GAMEPLAY_EMOTE_HERO_08_OOPS	Opa.	
GAMEPLAY_EMOTE_HERO_08_PIRATE_DAY	Arrr! Ahah!	
GAMEPLAY_EMOTE_HERO_08_SORRY	Sinto muito.	
GAMEPLAY_EMOTE_HERO_08_START	Foi você que pediu!	
GAMEPLAY_EMOTE_HERO_08_THANKS	Obrigada.	
GAMEPLAY_EMOTE_HERO_08_THINK1	Huum...	
GAMEPLAY_EMOTE_HERO_08_THINK2	Estou pensando...	
GAMEPLAY_EMOTE_HERO_08_THINK3	O que fazer... O que fazer...	
GAMEPLAY_EMOTE_HERO_08_THREATEN	Minha magia despedaçará você!	
GAMEPLAY_EMOTE_HERO_08_TIMER	O tempo está se esgotando para mim!	
GAMEPLAY_EMOTE_HERO_08_WELL_PLAYED	Bem jogado.	
GAMEPLAY_EMOTE_HERO_08_WINTERVEIL_GREETINGS	Feliz Festa do Véu de Inverno!	
GAMEPLAY_EMOTE_HERO_08_WOW	Incrível.	
GAMEPLAY_EMOTE_HERO_08A_CELEBRATE	Isso! Isso! Haha!	
GAMEPLAY_EMOTE_HERO_08A_CONCEDE	Xeque-mate. Muito bem.	
GAMEPLAY_EMOTE_HERO_08A_ERROR_FULL_MINIONS	Eu tenho lacaios demais!	
GAMEPLAY_EMOTE_HERO_08A_ERROR_GENERIC	Eu não posso fazer isso.	
GAMEPLAY_EMOTE_HERO_08A_ERROR_HAND_FULL	Minha mão está cheia!	
GAMEPLAY_EMOTE_HERO_08A_ERROR_I_ATTACKED	Eu já ataquei.	
GAMEPLAY_EMOTE_HERO_08A_ERROR_JUST_PLAYED	Espere um turno para o lacaio se preparar.	
GAMEPLAY_EMOTE_HERO_08A_ERROR_MINION_ATTACKED	Esse lacaio já atacou.	
GAMEPLAY_EMOTE_HERO_08A_ERROR_NEED_MANA	Não tenho mana suficiente.	
GAMEPLAY_EMOTE_HERO_08A_ERROR_NEED_WEAPON	Preciso de uma arma.	
GAMEPLAY_EMOTE_HERO_08A_ERROR_PLAY	Eu não posso jogar isso.	
GAMEPLAY_EMOTE_HERO_08A_ERROR_STEALTH	Não consigo mirar em lacaios Furtivos.	
GAMEPLAY_EMOTE_HERO_08A_ERROR_TARGET	Isso não é um alvo válido.	
GAMEPLAY_EMOTE_HERO_08A_ERROR_TAUNT	Preciso atacar o lacaio com Provocar.	
GAMEPLAY_EMOTE_HERO_08A_FIRE_FESTIVAL	O Festival do Fogo do Solstício já chegou!	
GAMEPLAY_EMOTE_HERO_08A_GOOD_GAME	Bom jogo.	
GAMEPLAY_EMOTE_HERO_08A_GREETINGS	Ah, olá você.	
GAMEPLAY_EMOTE_HERO_08A_GREETINGS_RESPONSE	Olá, Guardião.	
GAMEPLAY_EMOTE_HERO_08A_HALLOWS_END	Feliz Noturnália.	
GAMEPLAY_EMOTE_HERO_08A_LOW_CARDS	Estou quase sem cards.	
GAMEPLAY_EMOTE_HERO_08A_LUNAR_NEW_YEAR	Feliz Ano Novo!	
GAMEPLAY_EMOTE_HERO_08A_MIRROR_START	Ah, já escolheram.	
GAMEPLAY_EMOTE_HERO_08A_NO_CARDS	Estou sem cards!	
GAMEPLAY_EMOTE_HERO_08A_NOBLEGARDEN	Feliz Jardinova!	
GAMEPLAY_EMOTE_HERO_08A_OOPS	Isso foi tolice.	
GAMEPLAY_EMOTE_HERO_08A_PIRATE_DAY	Eu sou Medivh, o Guarrrrrdião.	
GAMEPLAY_EMOTE_HERO_08A_SORRY	Minhas sinceras desculpas.	
GAMEPLAY_EMOTE_HERO_08A_START	Que comecem os jogos.	
GAMEPLAY_EMOTE_HERO_08A_THANKS	Eu gostei disso.	
GAMEPLAY_EMOTE_HERO_08A_THINK1	Hmm...	
GAMEPLAY_EMOTE_HERO_08A_THINK2	Interessante...	
GAMEPLAY_EMOTE_HERO_08A_THINK3	Talvez...	
GAMEPLAY_EMOTE_HERO_08A_THREATEN	Nada pode me deter. Nada!	
GAMEPLAY_EMOTE_HERO_08A_TIMER	Não serei complacente!	
GAMEPLAY_EMOTE_HERO_08A_WELL_PLAYED	Bem jogado.	
GAMEPLAY_EMOTE_HERO_08A_WINTERVEIL_GREETINGS	Feliz banquete, desafiante.	
GAMEPLAY_EMOTE_HERO_08A_WOW	Que incrível.	
GAMEPLAY_EMOTE_HERO_08B_CONCEDE	Muito bem. Você venceu.	
GAMEPLAY_EMOTE_HERO_08B_ERROR_FULL_MINIONS	Eu tenho lacaios demais.	
GAMEPLAY_EMOTE_HERO_08B_ERROR_GENERIC	Eu não posso fazer isso.	
GAMEPLAY_EMOTE_HERO_08B_ERROR_HAND_FULL	Minha mão está cheia!	
GAMEPLAY_EMOTE_HERO_08B_ERROR_I_ATTACKED	Eu já ataquei.	
GAMEPLAY_EMOTE_HERO_08B_ERROR_JUST_PLAYED	Espere um turno para o lacaio se preparar.	
GAMEPLAY_EMOTE_HERO_08B_ERROR_MINION_ATTACKED	Este lacaio já atacou.	
GAMEPLAY_EMOTE_HERO_08B_ERROR_NEED_MANA	Não tenho mana suficiente.	
GAMEPLAY_EMOTE_HERO_08B_ERROR_NEED_WEAPON	Preciso de uma arma.	
GAMEPLAY_EMOTE_HERO_08B_ERROR_PLAY	Não dá pra fazer essa jogada.	
GAMEPLAY_EMOTE_HERO_08B_ERROR_STEALTH	Não consigo mirar em lacaios Furtivos.	
GAMEPLAY_EMOTE_HERO_08B_ERROR_TARGET	Este não é um alvo válido.	
GAMEPLAY_EMOTE_HERO_08B_ERROR_TAUNT	Há um lacaio com Provocar no caminho.	
GAMEPLAY_EMOTE_HERO_08B_FIRE_FESTIVAL	Um belo Solstício pra você!	
GAMEPLAY_EMOTE_HERO_08B_GOOD_GAME	Então é isso aí. Essa partida foi boa!	
GAMEPLAY_EMOTE_HERO_08B_GREETINGS	Saudações, você que busca a verdade.	
GAMEPLAY_EMOTE_HERO_08B_GREETINGS_RESPONSE	Que possamos encontrar o que procuramos.	
GAMEPLAY_EMOTE_HERO_08B_HALLOWS_END	Feliz Noturnália.	
GAMEPLAY_EMOTE_HERO_08B_LOW_CARDS	Já estou quase sem cards.	
GAMEPLAY_EMOTE_HERO_08B_LUNAR_NEW_YEAR	Feliz Ano Novo!	
GAMEPLAY_EMOTE_HERO_08B_MIRROR_START	Que possamos aprender muito juntos.	
GAMEPLAY_EMOTE_HERO_08B_NO_CARDS	Estou sem cards!	
GAMEPLAY_EMOTE_HERO_08B_NOBLEGARDEN	Feliz Jardinova!	
GAMEPLAY_EMOTE_HERO_08B_OOPS	Opa. Poxa vida.	
GAMEPLAY_EMOTE_HERO_08B_PIRATE_DAY	Hoje homenageamos... criminosos do mar?	
GAMEPLAY_EMOTE_HERO_08B_SORRY	Oh, céus. Desculpe.	
GAMEPLAY_EMOTE_HERO_08B_START	Conhecimento é poder.	
GAMEPLAY_EMOTE_HERO_08B_THANKS	Obrigado, colega.	
GAMEPLAY_EMOTE_HERO_08B_THINK1	Hmm...	
GAMEPLAY_EMOTE_HERO_08B_THINK2	Observe e reflita...	
GAMEPLAY_EMOTE_HERO_08B_THINK3	Deve haver alguma forma...	
GAMEPLAY_EMOTE_HERO_08B_THREATEN	Hora de aprender uma lição, criança insolente!	
GAMEPLAY_EMOTE_HERO_08B_TIMER	Já está em cima da hora!	
GAMEPLAY_EMOTE_HERO_08B_WELL_PLAYED	Bem jogado.	
GAMEPLAY_EMOTE_HERO_08B_WINTERVEIL_GREETINGS	Feliz Festa do Véu de Inverno!	
GAMEPLAY_EMOTE_HERO_08B_WOW	Fantástico.	
GAMEPLAY_EMOTE_HERO_09_CONCEDE	Você me superou.	
GAMEPLAY_EMOTE_HERO_09_ERROR_FULL_MINIONS	Eu tenho lacaios demais.	
GAMEPLAY_EMOTE_HERO_09_ERROR_GENERIC	Não posso fazer isso.	
GAMEPLAY_EMOTE_HERO_09_ERROR_HAND_FULL	Minha mão está cheia demais.	
GAMEPLAY_EMOTE_HERO_09_ERROR_I_ATTACKED	Já ataquei.	
GAMEPLAY_EMOTE_HERO_09_ERROR_JUST_PLAYED	Espere um turno para o lacaio se preparar.	
GAMEPLAY_EMOTE_HERO_09_ERROR_MINION_ATTACKED	Esse lacaio já atacou.	
GAMEPLAY_EMOTE_HERO_09_ERROR_NEED_MANA	Não tenho mana suficiente.	
GAMEPLAY_EMOTE_HERO_09_ERROR_NEED_WEAPON	Preciso de uma arma.	
GAMEPLAY_EMOTE_HERO_09_ERROR_PLAY	Eu não posso jogar isso.	
GAMEPLAY_EMOTE_HERO_09_ERROR_STEALTH	Não consigo mirar em lacaios Furtivos.	
GAMEPLAY_EMOTE_HERO_09_ERROR_TARGET	Esse não é um alvo válido.	
GAMEPLAY_EMOTE_HERO_09_ERROR_TAUNT	Há um lacaio com Provocar no meio do caminho.	
GAMEPLAY_EMOTE_HERO_09_EVENT_LUNAR_NEW_YEAR	Feliz Ano Novo!	
GAMEPLAY_EMOTE_HERO_09_FIRE_FESTIVAL	Mal posso esperar para ver os fogos de artifício!	
GAMEPLAY_EMOTE_HERO_09_GOOD_GAME	Bom jogo.	
GAMEPLAY_EMOTE_HERO_09_GREETINGS	Saudações.	
GAMEPLAY_EMOTE_HERO_09_GREETINGS_DISABLED	Mmpphh!	
GAMEPLAY_EMOTE_HERO_09_GREETINGS_RESPONSE	Olá, colega!	
GAMEPLAY_EMOTE_HERO_09_HALLOWS_END	Feliz Noturnália!	
GAMEPLAY_EMOTE_HERO_09_LOW_CARDS	Estou quase sem cards!	
GAMEPLAY_EMOTE_HERO_09_MIRROR_START	A luz sorri para os justos!	
GAMEPLAY_EMOTE_HERO_09_NO_CARDS	Estou sem cards!	
GAMEPLAY_EMOTE_HERO_09_NOBLEGARDEN	Feliz Jardinova!	
GAMEPLAY_EMOTE_HERO_09_OOPS	Não era bem isso o que eu planejava.	
GAMEPLAY_EMOTE_HERO_09_OOPS_DISABLED	Mmpphh…	
GAMEPLAY_EMOTE_HERO_09_PIRATE_DAY	Iarrr hahaha! Vamos virar terríveis tripulantes!	
GAMEPLAY_EMOTE_HERO_09_SORRY	Minhas desculpas.	
GAMEPLAY_EMOTE_HERO_09_START	A Luz trará a vitória!	
GAMEPLAY_EMOTE_HERO_09_THANKS	Obrigado.	
GAMEPLAY_EMOTE_HERO_09_THANKS_DISABLED	Mmphmm.	
GAMEPLAY_EMOTE_HERO_09_THINK1	Huum...	
GAMEPLAY_EMOTE_HERO_09_THINK2	Estou pensando...	
GAMEPLAY_EMOTE_HERO_09_THINK3	Preciso pensar...	
GAMEPLAY_EMOTE_HERO_09_THREATEN	A Luz há de queimar você!	
GAMEPLAY_EMOTE_HERO_09_THREATEN_DISABLED	Mmpphhhhhh!!!	
GAMEPLAY_EMOTE_HERO_09_TIMER	Preciso decidir rápido!	
GAMEPLAY_EMOTE_HERO_09_WELL_PLAYED	Bem jogado.	
GAMEPLAY_EMOTE_HERO_09_WELL_PLAYED_DISABLED	Mmpphh…	
GAMEPLAY_EMOTE_HERO_09_WINTERVEIL_GREETINGS	Feliz Festa do Véu de Inverno!	
GAMEPLAY_EMOTE_HERO_09_WOW	Uau...	
GAMEPLAY_EMOTE_HERO_09_WOW_DISABLED	Mmpphhhhhh…!!	
GAMEPLAY_EMOTE_HERO_EVILBRM_START	Hunf!	
GAMEPLAY_EMOTE_HERO_EVILBRM_WOW	<risada maligna>	
GAMEPLAY_EMOTE_HERO_TBKTRAF_KT_CONCEDE	Eu... voltarei...	
GAMEPLAY_EMOTE_HERO_TBKTRAF_KT_GREETINGS	Finalmente nos encontramos!	
GAMEPLAY_EMOTE_HERO_TBKTRAF_KT_LOW_CARDS	Estou ficando sem cards!	
GAMEPLAY_EMOTE_HERO_TBKTRAF_KT_NO_CARDS	Não!! Maldito seja, invasor!	
GAMEPLAY_EMOTE_HERO_TBKTRAF_KT_OOPS	*suspiro* De volta à prancheta.	
GAMEPLAY_EMOTE_HERO_TBKTRAF_KT_SORRY	NÃO!! MALDITO SEJA, INVASOR!	
GAMEPLAY_EMOTE_HERO_TBKTRAF_KT_START	Venha me enfrentar, invasor!	
GAMEPLAY_EMOTE_HERO_TBKTRAF_KT_THANKS	Ahm... de nada?	
GAMEPLAY_EMOTE_HERO_TBKTRAF_KT_THINK1	Talvez? 	
GAMEPLAY_EMOTE_HERO_TBKTRAF_KT_THINK2	Sim... Sim!	
GAMEPLAY_EMOTE_HERO_TBKTRAF_KT_THINK3	O que você acha, Bigglesworth?	
GAMEPLAY_EMOTE_HERO_TBKTRAF_KT_THREATEN	Congelarei o sangue em suas veias!	
GAMEPLAY_EMOTE_HERO_TBKTRAF_KT_WELL_PLAYED	É claro que eu joguei bem. Eu sou Kel'Thuzad, em Naxx eu esculacho!	
GAMEPLAY_EMOTE_HERO_TBKTRAF_RAF_CONCEDE	NÃO! NINGUÉM PODE ME DERROTAR...	
GAMEPLAY_EMOTE_HERO_TBKTRAF_RAF_GREETINGS	Olá, explorador.	
GAMEPLAY_EMOTE_HERO_TBKTRAF_RAF_LOW_CARDS	Estou ficando sem cards!	
GAMEPLAY_EMOTE_HERO_TBKTRAF_RAF_NO_CARDS	Meus lindos tesouros!	
GAMEPLAY_EMOTE_HERO_TBKTRAF_RAF_OOPS	Fracassou!	
GAMEPLAY_EMOTE_HERO_TBKTRAF_RAF_SORRY	Tenho pena de você.	
GAMEPLAY_EMOTE_HERO_TBKTRAF_RAF_START	RAFAAM! O ARQUEÓLOGO SUPREMO!	
GAMEPLAY_EMOTE_HERO_TBKTRAF_RAF_THANKS	Ah, obrigado.	
GAMEPLAY_EMOTE_HERO_TBKTRAF_RAF_THINK1	Huum...	
GAMEPLAY_EMOTE_HERO_TBKTRAF_RAF_THINK2	O que escolher...	
GAMEPLAY_EMOTE_HERO_TBKTRAF_RAF_THINK3	Tentador...	
GAMEPLAY_EMOTE_HERO_TBKTRAF_RAF_THREATEN	PODER ESMAGADOR!	
GAMEPLAY_EMOTE_HERO_TBKTRAF_RAF_WELL_PLAYED	Muito bem...	
GAMEPLAY_EMOTE_HERO_TBMECHWAR01_CONCEDE	<Desistir>	The text is in brackets because the VO files is just Annoy-o-Tron's greeting
GAMEPLAY_EMOTE_HERO_TBMECHWAR01_ERROR_FULL_MINIONS	<Erro!>	The text is in brackets because the VO files is just Annoy-o-Tron's greeting
GAMEPLAY_EMOTE_HERO_TBMECHWAR01_ERROR_HAND_FULL	<Erro!>	The text is in brackets because the VO files is just Annoy-o-Tron's greeting
GAMEPLAY_EMOTE_HERO_TBMECHWAR01_ERROR_I_ATTACKED	<Erro!>	The text is in brackets because the VO files is just Annoy-o-Tron's greeting
GAMEPLAY_EMOTE_HERO_TBMECHWAR01_ERROR_JUST_PLAYED	<Erro!>	The text is in brackets because the VO files is just Annoy-o-Tron's greeting
GAMEPLAY_EMOTE_HERO_TBMECHWAR01_ERROR_MINION_ATTACKED	<Erro!>	The text is in brackets because the VO files is just Annoy-o-Tron's greeting
GAMEPLAY_EMOTE_HERO_TBMECHWAR01_ERROR_NEED_MANA	<Erro!>	The text is in brackets because the VO files is just Annoy-o-Tron's greeting
GAMEPLAY_EMOTE_HERO_TBMECHWAR01_ERROR_NEED_WEAPON	<Erro!>	The text is in brackets because the VO files is just Annoy-o-Tron's greeting
GAMEPLAY_EMOTE_HERO_TBMECHWAR01_ERROR_PLAY	<Erro!>	The text is in brackets because the VO files is just Annoy-o-Tron's greeting
GAMEPLAY_EMOTE_HERO_TBMECHWAR01_ERROR_STEALTH	<Erro!>	The text is in brackets because the VO files is just Annoy-o-Tron's greeting
GAMEPLAY_EMOTE_HERO_TBMECHWAR01_ERROR_TARGET	<Erro!>	The text is in brackets because the VO files is just Annoy-o-Tron's greeting
GAMEPLAY_EMOTE_HERO_TBMECHWAR01_ERROR_TAUNT	<Erro!>	The text is in brackets because the VO files is just Annoy-o-Tron's greeting
GAMEPLAY_EMOTE_HERO_TBMECHWAR01_GREETINGS	<Saudações>	The text is in brackets because the VO files is just Annoy-o-Tron's greeting
GAMEPLAY_EMOTE_HERO_TBMECHWAR01_LOW_CARDS	<Poucos cards>	The text is in brackets because the VO files is just Annoy-o-Tron's greeting
GAMEPLAY_EMOTE_HERO_TBMECHWAR01_NO_CARDS	<Sem cards>	The text is in brackets because the VO files is just Annoy-o-Tron's greeting
GAMEPLAY_EMOTE_HERO_TBMECHWAR01_OOPS	<Erro>	The text is in brackets because the VO files is just Annoy-o-Tron's greeting
GAMEPLAY_EMOTE_HERO_TBMECHWAR01_SORRY	<Desculpe>	The text is in brackets because the VO files is just Annoy-o-Tron's greeting
GAMEPLAY_EMOTE_HERO_TBMECHWAR01_START	<Começar>	The text is in brackets because the VO files is just Annoy-o-Tron's greeting
GAMEPLAY_EMOTE_HERO_TBMECHWAR01_THANKS	<Agradeço>	The text is in brackets because the VO files is just Annoy-o-Tron's greeting
GAMEPLAY_EMOTE_HERO_TBMECHWAR01_THINK1	<Processando...>	The text is in brackets because the VO files is just Annoy-o-Tron's greeting
GAMEPLAY_EMOTE_HERO_TBMECHWAR01_THINK2	<Obtendo alvo...>	The text is in brackets because the VO files is just Annoy-o-Tron's greeting
GAMEPLAY_EMOTE_HERO_TBMECHWAR01_THINK3	<Desperdiçando ciclos...>	The text is in brackets because the VO files is just Annoy-o-Tron's greeting
GAMEPLAY_EMOTE_HERO_TBMECHWAR01_THREATEN	<Ameaçar>	The text is in brackets because the VO files is just Annoy-o-Tron's attack
GAMEPLAY_EMOTE_HERO_TBMECHWAR01_TIMER	<Pouco tempo>	The text is in brackets because the VO files is just Annoy-o-Tron's greeting
GAMEPLAY_EMOTE_HERO_TBMECHWAR01_WELL_PLAYED	<Boa jogada>	The text is in brackets because the VO files is just Annoy-o-Tron's greeting
GAMEPLAY_EMOTE_HERO_TBMECHWAR01_WOW	<Incrível!>	The text is in brackets because the VO files is just Annoy-o-Tron's greeting
GAMEPLAY_EMOTE_HERO_TBMECHWAR02_CONCEDE	<Fim da linha>	The text is in brackets because the VO files is just Boom Bot's greeting
GAMEPLAY_EMOTE_HERO_TBMECHWAR02_ERROR_FULL_MINIONS	<Erro!>	The text is in brackets because the VO files is just Boom Bot's greeting
GAMEPLAY_EMOTE_HERO_TBMECHWAR02_ERROR_HAND_FULL	<Erro!>	The text is in brackets because the VO files is just Boom Bot's greeting
GAMEPLAY_EMOTE_HERO_TBMECHWAR02_ERROR_I_ATTACKED	<Erro!>	The text is in brackets because the VO files is just Boom Bot's greeting
GAMEPLAY_EMOTE_HERO_TBMECHWAR02_ERROR_JUST_PLAYED	<Erro!>	The text is in brackets because the VO files is just Boom Bot's greeting
GAMEPLAY_EMOTE_HERO_TBMECHWAR02_ERROR_MINION_ATTACKED	<Erro!>	The text is in brackets because the VO files is just Boom Bot's greeting
GAMEPLAY_EMOTE_HERO_TBMECHWAR02_ERROR_NEED_MANA	<Erro!>	The text is in brackets because the VO files is just Boom Bot's greeting
GAMEPLAY_EMOTE_HERO_TBMECHWAR02_ERROR_NEED_WEAPON	<Erro!>	The text is in brackets because the VO files is just Boom Bot's greeting
GAMEPLAY_EMOTE_HERO_TBMECHWAR02_ERROR_PLAY	<Erro!>	The text is in brackets because the VO files is just Boom Bot's greeting
GAMEPLAY_EMOTE_HERO_TBMECHWAR02_ERROR_STEALTH	<Erro!>	The text is in brackets because the VO files is just Boom Bot's greeting
GAMEPLAY_EMOTE_HERO_TBMECHWAR02_ERROR_TARGET	<Erro!>	The text is in brackets because the VO files is just Boom Bot's greeting
GAMEPLAY_EMOTE_HERO_TBMECHWAR02_ERROR_TAUNT	<Erro!>	The text is in brackets because the VO files is just Boom Bot's greeting
GAMEPLAY_EMOTE_HERO_TBMECHWAR02_GREETINGS	<Saudações>	The text is in brackets because the VO files is just Annoy-o-Tron's greeting
GAMEPLAY_EMOTE_HERO_TBMECHWAR02_LOW_CARDS	<Poucos cards>	The text is in brackets because the VO files is just Boom Bot's greeting
GAMEPLAY_EMOTE_HERO_TBMECHWAR02_NO_CARDS	<Sem cards!>	The text is in brackets because the VO files is just Boom Bot's greeting
GAMEPLAY_EMOTE_HERO_TBMECHWAR02_OOPS	<Erro!>	The text is in brackets because the VO files is just Boom Bot's greeting
GAMEPLAY_EMOTE_HERO_TBMECHWAR02_SORRY	<Mil perdões>	The text is in brackets because the VO files is just Boom Bot's greeting
GAMEPLAY_EMOTE_HERO_TBMECHWAR02_START	<Iniciar>	The text is in brackets because the VO files is just Boom Bot's greeting
GAMEPLAY_EMOTE_HERO_TBMECHWAR02_THANKS	<Obrigado>	The text is in brackets because the VO files is just Boom Bot's greeting
GAMEPLAY_EMOTE_HERO_TBMECHWAR02_THINK1	<Processando...>	The text is in brackets because the VO files is just Boom Bot's greeting
GAMEPLAY_EMOTE_HERO_TBMECHWAR02_THINK2	<Obtendo alvo...>	The text is in brackets because the VO files is just Boom Bot's greeting
GAMEPLAY_EMOTE_HERO_TBMECHWAR02_THINK3	<Desperdiçando ciclos...>	The text is in brackets because the VO files is just Boom Bot's greeting
GAMEPLAY_EMOTE_HERO_TBMECHWAR02_THREATEN	<Ameaça!>	The text is in brackets because the VO files is just Boom Bot's Attack sound
GAMEPLAY_EMOTE_HERO_TBMECHWAR02_TIMER	<Pouco tempo>	The text is in brackets because the VO files is just Boom Bot's greeting
GAMEPLAY_EMOTE_HERO_TBMECHWAR02_WELL_PLAYED	<Boa jogada>	The text is in brackets because the VO files is just Boom Bot's greeting
GAMEPLAY_EMOTE_HERO_TBMECHWAR02_WOW	<Fabuloso!>	The text is in brackets because the VO files is just Annoy-o-Tron's greeting
GAMEPLAY_EMOTE_ICC_481_CONCEDE	Desfrute do abraço frio da vitória.	
GAMEPLAY_EMOTE_ICC_481_GREETINGS	Aceite o frio abraço da morte.	
GAMEPLAY_EMOTE_ICC_481_LOW_CARDS	Estou quase sem cards!	
GAMEPLAY_EMOTE_ICC_481_NO_CARDS	Estou sem cards!	
GAMEPLAY_EMOTE_ICC_481_OOPS	Foi um grave erro.	
GAMEPLAY_EMOTE_ICC_481_START	Eu sou o coração congelado do Flagelo!	
GAMEPLAY_EMOTE_ICC_481_THANKS	Obrigado.	
GAMEPLAY_EMOTE_ICC_481_THINK1	Huum... 	
GAMEPLAY_EMOTE_ICC_481_THINK2	Hmmm, os elementos estão em silêncio.	
GAMEPLAY_EMOTE_ICC_481_THINK3	A escolha é minha e só minha.	
GAMEPLAY_EMOTE_ICC_481_THREATEN	Vou despedaçar você!	
GAMEPLAY_EMOTE_ICC_481_TIMER	É preciso escolher um caminho!	
GAMEPLAY_EMOTE_ICC_481_WELL_PLAYED	Bem jogado.	
GAMEPLAY_EMOTE_ICC_481_WOW	Tremendo!	
GAMEPLAY_EMOTE_ICC_827_CONCEDE	A vitória é sua.	
GAMEPLAY_EMOTE_ICC_827_GREETINGS	Onde você andou se escondendo?	
GAMEPLAY_EMOTE_ICC_827_LOW_CARDS	Estou quase sem cards!	
GAMEPLAY_EMOTE_ICC_827_NO_CARDS	Estou sem cards!	
GAMEPLAY_EMOTE_ICC_827_OOPS	Que trágico...	
GAMEPLAY_EMOTE_ICC_827_START	Você não pode escapar da sombra da morte!	
GAMEPLAY_EMOTE_ICC_827_THANKS	Obrigada.	
GAMEPLAY_EMOTE_ICC_827_THINK1	Huum...	
GAMEPLAY_EMOTE_ICC_827_THINK2	A sombra da morte cresce...	
GAMEPLAY_EMOTE_ICC_827_THINK3	O tempo corre...	
GAMEPLAY_EMOTE_ICC_827_THREATEN	Você aprenderá a temer sua sombra.	
GAMEPLAY_EMOTE_ICC_827_TIMER	Tenho que escolher logo...	
GAMEPLAY_EMOTE_ICC_827_WELL_PLAYED	Adorável.	
GAMEPLAY_EMOTE_ICC_827_WOW	Impensável!	
GAMEPLAY_EMOTE_ICC_828_CONCEDE	Essa caçada é sua.	
GAMEPLAY_EMOTE_ICC_828_GREETINGS	Comece a correr, presa!	
GAMEPLAY_EMOTE_ICC_828_LOW_CARDS	Estou quase sem cards!	
GAMEPLAY_EMOTE_ICC_828_MIRROR_START	Pode ir! Vou lhe dar uma vantagem.	
GAMEPLAY_EMOTE_ICC_828_NO_CARDS	Estou sem cards!	
GAMEPLAY_EMOTE_ICC_828_OOPS	Isso foi um engano.	
GAMEPLAY_EMOTE_ICC_828_START	Que a caçada comece!	
GAMEPLAY_EMOTE_ICC_828_THANKS	Obrigado.	
GAMEPLAY_EMOTE_ICC_828_THINK1	Huum...	
GAMEPLAY_EMOTE_ICC_828_THINK2	Que pegadas devo seguir...	
GAMEPLAY_EMOTE_ICC_828_THINK3	Será que…	
GAMEPLAY_EMOTE_ICC_828_THREATEN	Vou caçar você... PARA SEMPRE!	
GAMEPLAY_EMOTE_ICC_828_TIMER	O rastro está sumindo!	
GAMEPLAY_EMOTE_ICC_828_WELL_PLAYED	Bem jogado.	
GAMEPLAY_EMOTE_ICC_828_WOW	Impressionante!	
GAMEPLAY_EMOTE_ICC_829_CONCEDE	Você triunfou. Desta vez.	
GAMEPLAY_EMOTE_ICC_829_GREETINGS	Agora existe somente a minha justiça.	
GAMEPLAY_EMOTE_ICC_829_LOW_CARDS	Estou quase sem cards!	
GAMEPLAY_EMOTE_ICC_829_NO_CARDS	Estou sem cards!	
GAMEPLAY_EMOTE_ICC_829_OOPS	Decepcionante.	
GAMEPLAY_EMOTE_ICC_829_START	A justiça da Luz fracassou.	
GAMEPLAY_EMOTE_ICC_829_THANKS	Obrigado.	
GAMEPLAY_EMOTE_ICC_829_THINK1	Huum...	
GAMEPLAY_EMOTE_ICC_829_THINK2	Gélido Lamento chama.	
GAMEPLAY_EMOTE_ICC_829_THINK3	O Trono de Gelo chama...	
GAMEPLAY_EMOTE_ICC_829_THREATEN	Você vai implorar por misericórdia, e eu lhe negarei.	
GAMEPLAY_EMOTE_ICC_829_TIMER	O fim se aproxima!	
GAMEPLAY_EMOTE_ICC_829_WELL_PLAYED	Bem jogado.	
GAMEPLAY_EMOTE_ICC_829_WOW	Inacreditável!	
GAMEPLAY_EMOTE_ICC_830_CONCEDE	Não, essa vitória não prova nada!	
GAMEPLAY_EMOTE_ICC_830_GREETINGS	A escuridão total será minha vingança.	
GAMEPLAY_EMOTE_ICC_830_LOW_CARDS	Estou quase sem cards!	
GAMEPLAY_EMOTE_ICC_830_NO_CARDS	Estou sem cards!	
GAMEPLAY_EMOTE_ICC_830_OOPS	Errar é humano.	
GAMEPLAY_EMOTE_ICC_830_START	As trevas levam à vitória!	
GAMEPLAY_EMOTE_ICC_830_THANKS	Agradeço.	
GAMEPLAY_EMOTE_ICC_830_THINK1	Hmmm...	
GAMEPLAY_EMOTE_ICC_830_THINK2	As trevas falam comigo...	
GAMEPLAY_EMOTE_ICC_830_THINK3	Pensamentos sombrios...	
GAMEPLAY_EMOTE_ICC_830_THREATEN	A escuridão vai consumir você!	
GAMEPLAY_EMOTE_ICC_830_TIMER	As sombras estão acabando!	
GAMEPLAY_EMOTE_ICC_830_WELL_PLAYED	Bem jogado.	
GAMEPLAY_EMOTE_ICC_830_WOW	Inacreditável!	
GAMEPLAY_EMOTE_ICC_831_CONCEDE	Você venceu... desta vez.	
GAMEPLAY_EMOTE_ICC_831_GREETINGS	Tenha medo de mim.	
GAMEPLAY_EMOTE_ICC_831_LOW_CARDS	Estou quase sem cards!	
GAMEPLAY_EMOTE_ICC_831_NO_CARDS	Estou sem cards!	
GAMEPLAY_EMOTE_ICC_831_OOPS	Não serviu para nada.	
GAMEPLAY_EMOTE_ICC_831_START	Uma barganha forjada em sangue e sombras.	
GAMEPLAY_EMOTE_ICC_831_THANKS	Ahh, muito obrigado.	
GAMEPLAY_EMOTE_ICC_831_THINK1	Huum...	
GAMEPLAY_EMOTE_ICC_831_THINK2	Minha fome cresce...	
GAMEPLAY_EMOTE_ICC_831_THINK3	 Tantas decisões a tomar.	
GAMEPLAY_EMOTE_ICC_831_THREATEN	Seu sofrimento será... LENDÁRIO!	
GAMEPLAY_EMOTE_ICC_831_TIMER	Tenho que agir AGORA!	
GAMEPLAY_EMOTE_ICC_831_WELL_PLAYED	Muito bem.	
GAMEPLAY_EMOTE_ICC_831_WOW	Fogo do Inferno!	
GAMEPLAY_EMOTE_ICC_832_CONCEDE	Você venceu. Eu posso descansar agora.	
GAMEPLAY_EMOTE_ICC_832_GREETINGS	O ciclo da decomposição começa.	
GAMEPLAY_EMOTE_ICC_832_LOW_CARDS	Estou quase sem cards!	
GAMEPLAY_EMOTE_ICC_832_NO_CARDS	Estou sem cards!	
GAMEPLAY_EMOTE_ICC_832_OOPS	A teia se deslinda.	
GAMEPLAY_EMOTE_ICC_832_START	O ciclo da vida acabou. 	
GAMEPLAY_EMOTE_ICC_832_THANKS	Você tem minha gratidão.	
GAMEPLAY_EMOTE_ICC_832_THINK1	Huum...	
GAMEPLAY_EMOTE_ICC_832_THINK2	Uma teia emaranhada.	
GAMEPLAY_EMOTE_ICC_832_THINK3	Minha mente está infestada.	
GAMEPLAY_EMOTE_ICC_832_THREATEN	Você vai murchar e apodrecer!	
GAMEPLAY_EMOTE_ICC_832_TIMER	A morte é eterna... meu turno não é!	
GAMEPLAY_EMOTE_ICC_832_WELL_PLAYED	Primoroso.	
GAMEPLAY_EMOTE_ICC_832_WOW	Surpreendente!	
GAMEPLAY_EMOTE_ICC_833_CONCEDE	Eu me rendo ao seu poder.	
GAMEPLAY_EMOTE_ICC_833_GREETINGS	Você está tremendo... está com medo?	
GAMEPLAY_EMOTE_ICC_833_LOW_CARDS	Estou quase sem cards!	
GAMEPLAY_EMOTE_ICC_833_NO_CARDS	Estou sem cards!	
GAMEPLAY_EMOTE_ICC_833_OOPS	Um erro FATAL.	
GAMEPLAY_EMOTE_ICC_833_START	Não tema o poder, e sim aqueles que farão uso dele!	
GAMEPLAY_EMOTE_ICC_833_THANKS	Obrigada...	
GAMEPLAY_EMOTE_ICC_833_THINK1	Huum...	
GAMEPLAY_EMOTE_ICC_833_THINK2	O tempo derrete...	
GAMEPLAY_EMOTE_ICC_833_THINK3	Hmm. Tenho que decidir...	
GAMEPLAY_EMOTE_ICC_833_THREATEN	Curve-se ante sua rainha!	
GAMEPLAY_EMOTE_ICC_833_TIMER	A hora é agora!	
GAMEPLAY_EMOTE_ICC_833_WELL_PLAYED	Bem jogado.	
GAMEPLAY_EMOTE_ICC_833_WOW	Pelo meu coração gelado!	
GAMEPLAY_EMOTE_ICC_834_CONCEDE	Eu escolho a morte.	
GAMEPLAY_EMOTE_ICC_834_GREETINGS	Você será vítima da FÚRIA de Grito Infernal!	
GAMEPLAY_EMOTE_ICC_834_LOW_CARDS	Estou quase sem cards!	
GAMEPLAY_EMOTE_ICC_834_NO_CARDS	Estou sem cards!	
GAMEPLAY_EMOTE_ICC_834_OOPS	Fracasso.	
GAMEPLAY_EMOTE_ICC_834_START	Eu vou queimar este mundo e governar as cinzas.	
GAMEPLAY_EMOTE_ICC_834_THANKS	Obrigado.	
GAMEPLAY_EMOTE_ICC_834_THINK1	Huum...	
GAMEPLAY_EMOTE_ICC_834_THINK2	O tempo corre...	
GAMEPLAY_EMOTE_ICC_834_THINK3	E agora...	
GAMEPLAY_EMOTE_ICC_834_THREATEN	Você vai se curvar primeiro.	
GAMEPLAY_EMOTE_ICC_834_TIMER	Tenho que escolher!	
GAMEPLAY_EMOTE_ICC_834_WELL_PLAYED	Você lutou bem!	
GAMEPLAY_EMOTE_ICC_834_WOW	Espantoso!	
VO__Female_Naga_Concede_02	Você alcançou a vitória... desta vez.	
VO__Female_Naga_ERROR_FULL_MINIONS_01	Eu tenho lacaios demais.	
VO__Female_Naga_ERROR_GENERIC_04	Fora de questão.	
VO__Female_Naga_ERROR_HAND_FULL_01	Minha mão está cheia demais.	
VO__Female_Naga_ERROR_I_ATTACKED_01	Nossa, como estou EXAUSTA!	
VO__Female_Naga_ERROR_MINION_ATTACKED_01	Esse já atacou.	
VO__Female_Naga_ERROR_NEED_MANA_01	Preciso de mana.	
VO__Female_Naga_ERROR_NEED_WEAPON_01	Dê-me uma arma.	
VO__Female_Naga_ERROR_PLAY_01	Não posso jogar isso.	
VO__Female_Naga_ERROR_STEALTH_01	Esse está sob Furtividade.	
VO__Female_Naga_ERROR_SUMMON_SICKNESS_01	Não, não. Esse aí precisa descansar.	
VO__Female_Naga_ERROR_TARGET_01	Eu preciso de um alvo!	
VO__Female_Naga_ERROR_TAUNT_01	Está vendo esse paspalho me provocando?	
VO__Female_Naga_FIRE_FESTIVAL_01	Eu queria jogar um balde d'água fria nesse Festival do Fogo ridículo.	
VO__Female_Naga_Greetings_01	Saudações, ádvena.
VO__Female_Naga_HAPPY_HALLOWEEN_01	É Noturnália? Quando eu cheguei aqui, ainda era Diurnália.	
VO__Female_Naga_HAPPY_HOLIDAYS_01	Ninguém festeja como os Altaneiros!	
VO__Female_Naga_HAPPY_NEW_YEAR_01	Feliz ano novo!	
VO__Female_Naga_HAPPY_NEW_YEAR_LUNAR_01	Feliz ano novo!	
VO__Female_Naga_HAPPY_NOBLEGARDEN_01	ISSO é Jardinova? Há jardins mais belos nos corais do oceano!	
VO__Female_Naga_LowCards_01	Tô com poucos cards.	
VO__Female_Naga_MIRROR_GREETINGS_01	Eu? Ádvena? Que absurdo.	
VO__Female_Naga_MIRROR_START_01	Eu encontrarei um jeito de sobreviver.	
VO__Female_Naga_NoCards_01	Não tenho mais cards!	
VO__Female_Naga_Oops_02	Maldição!	
VO__Female_Naga_Picked_01	Atinja seu alvo!	
VO__Female_Naga_PIRATE_DAY_01	Cês todos são marinheiros d'água doce pra mim!	
VO__Female_Naga_Sorry_01	Foi uma... infelicidade.	
VO__Female_Naga_Start_01	Este é o seu fim!	
VO__Female_Naga_Start_Illidan_01	É uma honra, Lorde Illidan.	
VO__Female_Naga_Start_Maiev_01	Ah, a pequena guardiã.	
VO__Female_Naga_Start_Morgl_01	O mar está chamando você de volta ao lar, pequenino.	
VO__Female_Naga_Start_Tyrande_01	Dez mil anos, e você continua me aborrecendo.	
VO__Female_Naga_Thanks_02	Você tem minha gratidão.	
VO__Female_Naga_Thinking_01	Hm...	
VO__Female_Naga_Thinking_02	<suspiro exasperado>	
VO__Female_Naga_Thinking_03	Tantas escolhas...	
VO__Female_Naga_Threaten_01	 Eu os reduzirei a pó!	
VO__Female_Naga_Time_01	O tempo é curto.	
VO__Female_Naga_TRIGGER_ANCESTRAL_SPIRIT	Eu conheço as tradições.	
VO__Female_Naga_TRIGGER_EARTH_SHOCK	Isso vai acalmar você!	
VO__Female_Naga_TRIGGER_EVERYFIN_IS_AWESOME	Quanto maior a guelra, melhor a guerra.	
VO__Female_Naga_TRIGGER_FORKED_LIGHTNING	Não seja mal-educado!	
VO__Female_Naga_TRIGGER_LIGHTNING_STORM	Não deixem nada de pé!	
VO__Female_Naga_TRIGGER_MUTATE	Há poder na mudança.	
VO__Female_Naga_TRIGGER_SERPENT_WARD	<risada sombria>	
VO__Female_Naga_TRIGGER_UNSTABLE_EVOLUTION	Eu já fui uma elfa noturna, sabia?	
VO__Female_Naga_TRIGGER_WITCHS_BREW	Delícia.	
VO__Female_Naga_Well_Played_01	Impressionante.	
VO__Female_Naga_WOW_01	Estonteante!	
VO__Female_Night Elf_Concede_01	A vitória é sua!	
VO__Female_Night Elf_ERROR_FULL_MINIONS_01	Eu já atingi a cota de lacaios que posso controlar.	
VO__Female_Night Elf_ERROR_GENERIC_01	Absolutamente impossível.	
VO__Female_Night Elf_ERROR_HAND_FULL_02	Não posso segurar esses cards todos!	
VO__Female_Night Elf_ERROR_I_ATTACKED_01	Eu já ataquei!	
VO__Female_Night Elf_ERROR_MINION_ATTACKED_01	Esse aí está exausto.	
VO__Female_Night Elf_ERROR_NEED_MANA_02	Mana insuficiente.	
VO__Female_Night Elf_ERROR_NEED_WEAPON_01	Seria bom equipar uma arma antes.	
VO__Female_Night Elf_ERROR_PLAY_01	Não dá.	
VO__Female_Night Elf_ERROR_STEALTH_01	Ainda está sob Furtividade.	
VO__Female_Night Elf_ERROR_SUMMON_SICKNESS_01	É só uma sonequinha.	
VO__Female_Night Elf_ERROR_TARGET_01	Está fora do meu alcance.	
VO__Female_Night Elf_ERROR_TAUNT_01	Tem um ser com Provocar no caminho.	
VO__Female_Night Elf_FIRE_FESTIVAL_01	Tenha cuidado se for brincar com fogo hoje.	
VO__Female_Night Elf_Greetings_01	Ah, olá.	
VO__Female_Night Elf_HAPPY_HALLOWEEN_01	As origens da Noturnália são aterrorizantes!	
VO__Female_Night Elf_HAPPY_HOLIDAYS_01	Você se comportou bem para o Papai Inverno?	
VO__Female_Night Elf_HAPPY_NEW_YEAR_01	Feliz Ano Novo!	
VO__Female_Night Elf_HAPPY_NEW_YEAR_LUNAR_01	Feliz Ano Novo!	
VO__Female_Night Elf_HAPPY_NOBLEGARDEN_01	Ah, como eu adoro Jardinova!	
VO__Female_Night Elf_LowCards_01	Meus cards estão acabando? Que estranho.	
VO__Female_Night Elf_MIRROR_GREETINGS_01	O que vamos estudar hoje?	
VO__Female_Night Elf_MIRROR_START_01	Nosso tema será arqueologia?	
VO__Female_Night Elf_NoCards_01	Ah, não... minha reserva de cards se esgotou.	
VO__Female_Night Elf_Oops_01	Este é um... momento de aprendizado.	
VO__Female_Night Elf_Picked_01	Eu sou aprendiz da floresta e professora de muitos.	
VO__Female_Night Elf_PIRATE_DAY_01	Capitã Mirestela a seu dispor, marujo!	
VO__Female_Night Elf_Sorry_01	Aceite minhas desculpas!	
VO__Female_Night Elf_Start_01	De volta às aulas!	
VO__Female_Night Elf_Thanks_02	Fico muito grata por isso!	
VO__Female_Night Elf_Thinking_01	Hm...	
VO__Female_Night Elf_Thinking_03	Que intrigante...	
VO__Female_Night Elf_Thinking_04	Tantas contradições...	
VO__Female_Night Elf_Threaten_03	Vou lhe ensinar uma lição.	
VO__Female_Night Elf_Time_01	As areias do tempo vão se esgotando.	
VO__Female_Night Elf_Well_Played_01	Sua perícia é lendária!	
VO__Female_Night Elf_WOW_01	Fico feliz de ter testemunhado isso.	
VO__Female_Val'kyr_Attack_01	Renda-se ao esquecimento!	
VO__Female_Val'kyr_Concede_01	Sua bravura triunfou.	
VO__Female_Val'kyr_Death_02	Acabou...	
VO__Female_Val'kyr_ERROR_FULL_MINIONS_01	Há lacaios demais sob meu comando.	
VO__Female_Val'kyr_ERROR_GENERIC_03	Não pode ser.	
VO__Female_Val'kyr_ERROR_HAND_FULL_01	Minha mão está cheia.	
VO__Female_Val'kyr_ERROR_I_ATTACKED_01	Eu ataquei o inimigo.	
VO__Female_Val'kyr_ERROR_MINION_ATTACKED_01	Esse lacaio precisa descansar agora.	
VO__Female_Val'kyr_ERROR_NEED_MANA_01	Mana insuficiente.	
VO__Female_Val'kyr_ERROR_NEED_WEAPON_01	Preciso de uma arma para isso.	
VO__Female_Val'kyr_ERROR_PLAY_01	Não posso jogar isso.	
VO__Female_Val'kyr_ERROR_STEALTH_01	Esse está escondido.	
VO__Female_Val'kyr_ERROR_SUMMON_SICKNESS_01	Esse ainda está descansando.	
VO__Female_Val'kyr_ERROR_TARGET_01	Isso vai muito além do meu alcance.	
VO__Female_Val'kyr_ERROR_TAUNT_01	Tem outro provocando.	
VO__Female_Val'kyr_FIRE_FESTIVAL_01	Os honrados queimarão mais forte durante o Festival do Fogo!	
VO__Female_Val'kyr_Greetings_01	Salve, desafiante.	
VO__Female_Val'kyr_HAPPY_HALLOWEEN_01	Preste homenagem aos mortos em glória!	
VO__Female_Val'kyr_HAPPY_HOLIDAYS_01	Essa época de fato traz calor humano.	
VO__Female_Val'kyr_HAPPY_NEW_YEAR_01	Feliz ano novo!	
VO__Female_Val'kyr_HAPPY_NEW_YEAR_LUNAR_01	Feliz ano novo!	
VO__Female_Val'kyr_HAPPY_NOBLEGARDEN_01	Você coleciona ovos. Eu coleciono guerreiros.	
VO__Female_Val'kyr_LowCards_01	Meus cards estão acabando.	
VO__Female_Val'kyr_MIRROR_GREETINGS_01	Saudações, nobre oponente.	
VO__Female_Val'kyr_MIRROR_START_01	Justamente o que eu estava planejando!	
VO__Female_Val'kyr_NoCards_01	Estou sem cards.	
VO__Female_Val'kyr_Oops_01	Isto é deveras incomum.	
VO__Female_Val'kyr_Picked_01	Eu sempre sou digna!	
VO__Female_Val'kyr_PIRATE_DAY_01	Os mortos contam histórias, SIM! Se eu obrigá-los...	
VO__Female_Val'kyr_Sorry_01	Eu vou compensar você por isso.	
VO__Female_Val'kyr_Start_01	Ergam-se e executem a vontade da Grande Dama!	
VO__Female_Val'kyr_Start_Sylvanas_01	Eu NÃO tomarei seu lugar desta vez, Grande Dama.	
VO__Female_Val'kyr_Thanks_02	Você tem a minha gratidão.	
VO__Female_Val'kyr_Thinking_01	Hm...	
VO__Female_Val'kyr_Thinking_03	Digno ou indigno?	
VO__Female_Val'kyr_Thinking_04	E agora?	
VO__Female_Val'kyr_Threaten_01	Venha encarar seu destino!	
VO__Female_Val'kyr_Time_01	O tempo é fugaz.	
VO__Female_Val'kyr_TRIGGER_BRAWL_01	Quem triunfará?	
VO__Female_Val'kyr_TRIGGER_DEAD_MANS_HAND_01	A morte não me inquieta.	
VO__Female_Val'kyr_TRIGGER_DEADLY_ARSENAL_01	Quantas lâminas!	
VO__Female_Val'kyr_TRIGGER_DEVASTATE_01	Encare o seu glorioso fim!	
VO__Female_Val'kyr_TRIGGER_FORGE_OF_SOULS_01	A força é eterna.	
VO__Female_Val'kyr_TRIGGER_HEROIC_STRIKE_01	O destino chama!	
VO__Female_Val'kyr_TRIGGER_MORTAL_STRIKE_01	As trevas estão chamando!	
VO__Female_Val'kyr_TRIGGER_RAMPAGE_01	Ainda não chegou a sua hora.	
VO__Female_Val'kyr_TRIGGER_WARPATH_01	Apenas uma amostra do que está por vir!	
VO__Female_Val'kyr_Well_Played_01	Você merece... confiança.	
VO__Female_Val'kyr_WOW_01	Muito espantoso!	
VO__Male_Dragon_Attack_01	Destruição!	
VO__Male_Dragon_Concede_02	É O FIM DE TUDO QUE EXISTE!	
VO__Male_Dragon_ERROR_FULL_MINIONS_02	Eu não posso comandar mais desses inúteis.	
VO__Male_Dragon_ERROR_GENERIC_01	Não posso fazer isso.	
VO__Male_Dragon_ERROR_HAND_FULL_01	Não aceitarei mais!	
VO__Male_Dragon_ERROR_I_ATTACKED_01	Eu já exerci minha fúria!	
VO__Male_Dragon_ERROR_MINION_ATTACKED_01	Esse lacaio já atacou.	
VO__Male_Dragon_ERROR_NEED_MANA_02	Exijo que me concedam mana!	
VO__Male_Dragon_ERROR_NEED_WEAPON_02	Preciso de uma arma além da minha ira.	
VO__Male_Dragon_ERROR_PLAY_01	Impossível fazer isso!	
VO__Male_Dragon_ERROR_STEALTH_01	Patife! Covarde! Está escondido.	
VO__Male_Dragon_ERROR_SUMMON_SICKNESS_01	Esse lacaio tem que esperar antes de atacar.	
VO__Male_Dragon_ERROR_TARGET_01	Preciso de um alvo.	
VO__Male_Dragon_ERROR_TAUNT_01	Esse imundo está me provocando!	
VO__Male_Dragon_FIRE_FESTIVAL_01	TUDO QUEIMARÁ NO FESTIVAL DO FOGO!	
VO__Male_Dragon_Greetings_01	Erga os olhos para mim, o Aspecto da Morte!	
VO__Male_Dragon_HAPPY_BIRTHDAY_01	Então, foi NESTE dia que você nasceu? Hm.	
VO__Male_Dragon_HAPPY_BREWFEST_01	O que é uma CervaFest? E por que não tem nada em chamas aqui?	
VO__Male_Dragon_HAPPY_HALLOWEEN_01	Um dia de melancolia e morte? Maravilhoso.	
VO__Male_Dragon_HAPPY_HOLIDAYS_01	Festeje este dia. Enquanto pode...	
VO__Male_Dragon_HAPPY_NEW_YEAR_01	Feliz Ano Novo!	
VO__Male_Dragon_HAPPY_NEW_YEAR_LUNAR_01	Feliz Ano Novo!	
VO__Male_Dragon_HAPPY_NOBLEGARDEN_01	Pode roubar ovos se quiser, mas não da Revoada Dragônica Negra!	
VO__Male_Dragon_LowCards_01	Restam poucos cards!	
VO__Male_Dragon_MIRROR_GREETINGS_01	Você não passa de uma sombra pretérita.	
VO__Male_Dragon_MIRROR_START_01	Sim, é inevitável.	
VO__Male_Dragon_NoCards_01	Estou destituído de cards!	
VO__Male_Dragon_Oops_01	Eu nem sempre sou perfeito, mas quase sempre sou.	
VO__Male_Dragon_Picked_01	Eu destroçarei esse mundo!	
VO__Male_Dragon_PIRATE_DAY_01	Eu sou NelthAARRRRion!	
VO__Male_Dragon_Sorry_01	Nem mesmo o mar seria capaz de abarcar meu arrependimento.	
VO__Male_Dragon_Start_01	Venha! Abrace o caos!	
VO__Male_Dragon_Thanks_01	<rosnado> Obrigado.	
VO__Male_Dragon_Thinking_01	Hm...	
VO__Male_Dragon_Thinking_03	Muito enigmático...	
VO__Male_Dragon_Thinking_04	Todos hão de queimar...	
VO__Male_Dragon_Threaten_01	Não há como se defender da minha fúria!	
VO__Male_Dragon_Time_01	Depressa!	
VO__Male_Dragon_Well_Played_01	A sua tenacidade é admirável.	
VO__Male_Dragon_WOW_01	Cataclísmico!	
VO__Male_Mogu_Concede_01	A vitória é sua. Desta vez.	
VO__Male_Mogu_ERROR_FULL_MINIONS_02	Eu não posso recrutar mais.	
VO__Male_Mogu_ERROR_GENERIC_02	Isso é impossível.	
VO__Male_Mogu_ERROR_HAND_FULL_02	Já tenho cards demais.	
VO__Male_Mogu_ERROR_I_ATTACKED_01	O trovão só ressoa uma vez.	
VO__Male_Mogu_ERROR_MINION_ATTACKED_02	Esse lacaio já atacou.	
VO__Male_Mogu_ERROR_NEED_MANA_02	Eu desejo mais mana.	
VO__Male_Mogu_ERROR_NEED_WEAPON_01	Dê-me uma arma!	
VO__Male_Mogu_ERROR_PLAY_02	Não posso jogar isso.	
VO__Male_Mogu_ERROR_STEALTH_01	Está se escondendo... por enquanto.	
VO__Male_Mogu_ERROR_SUMMON_SICKNESS_01	Não pode lutar ainda.	
VO__Male_Mogu_ERROR_TARGET_01	Preciso de um alvo!	
VO__Male_Mogu_ERROR_TAUNT_01	Alguém ousa provocar o Rei Trovão!	
VO__Male_Mogu_FIRE_FESTIVAL_01	Toda honra ao fogo e aos raios que o trazem!	
VO__Male_Mogu_Greetings_01	Contemple o meu poder.	
VO__Male_Mogu_HAPPY_HALLOWEEN_01	Pode ficar se distraindo com doces e fantasias. Eu vou tramar.	
VO__Male_Mogu_HAPPY_HOLIDAYS_01	Celebre este dia festivo e respeite a tradição.	
VO__Male_Mogu_HAPPY_NEW_YEAR_01	Feliz Ano Novo!	
VO__Male_Mogu_HAPPY_NEW_YEAR_LUNAR_01	Feliz Ano Novo!	
VO__Male_Mogu_HAPPY_NOBLEGARDEN_01	Não deixe a beleza da primavera amolecer você.	
VO__Male_Mogu_LowCards_01	Estou com poucos cards.	
VO__Male_Mogu_MIRROR_GREETINGS_01	Eu já vi.	
VO__Male_Mogu_MIRROR_START_01	Então você é digno de minha atenção.	
VO__Male_Mogu_NoCards_01	Não tenho cards.	
VO__Male_Mogu_Oops_01	Talvez seja desatenção...	
VO__Male_Mogu_Picked_01	Meu poder não será contido!	
VO__Male_Mogu_PIRATE_DAY_01	Os piratas são livres para pilhar, desde que os espólios sejam para o rei.	
VO__Male_Mogu_Sorry_01	Eu incorri num equívoco.	
VO__Male_Mogu_Start_01	Eu sou o assassino dos reis e deuses!	
VO__Male_Mogu_Thanks_01	Você me serve bem.	
VO__Male_Mogu_Thinking_01	Hm...	
VO__Male_Mogu_Thinking_02	Tenho de refletir...	
VO__Male_Mogu_Thinking_03	Desconcertante...	
VO__Male_Mogu_Threaten_03	Ajoelhe-se diante de mim!	
VO__Male_Mogu_Time_01	Aja rápido!	
VO__Male_Mogu_Well_Played_01	Sua sede de vitória é formidável.	
VO__Male_Mogu_WOW_01	Você me surpreendeu. Coisa rara.	
VO_AnnoyO_Male_Mech_Attack_01	OLÁ!	
VO_AnnoyO_Male_Mech_Concede_02	Olá...	
VO_AnnoyO_Male_Mech_Death_01	O... lááá...	
VO_AnnoyO_Male_Mech_ERROR_FULL_MINIONS_01	Olá!	
VO_AnnoyO_Male_Mech_ERROR_GENERIC_04	Olá.	
VO_AnnoyO_Male_Mech_ERROR_HAND_FULL_02	Ah! OLÁ!!!	
VO_AnnoyO_Male_Mech_ERROR_I_ATTACKED_02	Heh... Olá.	
VO_AnnoyO_Male_Mech_ERROR_MINION_ATTACKED_01	Olá! Olá.	
VO_AnnoyO_Male_Mech_ERROR_NEED_MANA_01	Olá! Olá.	
VO_AnnoyO_Male_Mech_ERROR_NEED_WEAPON_01	Olá.	
VO_AnnoyO_Male_Mech_ERROR_PLAY_01	Olá!	
VO_AnnoyO_Male_Mech_ERROR_STEALTH_01	Oláááá...	
VO_AnnoyO_Male_Mech_ERROR_SUMMON_SICKNESS_01	Olá? Olá! Olá.	
VO_AnnoyO_Male_Mech_ERROR_TARGET_01	Olá.	
VO_AnnoyO_Male_Mech_ERROR_TAUNT_01	Olá!	
VO_AnnoyO_Male_Mech_FIRE_FESTIVAL_01	Olá? Olá! OLÁ!	
VO_AnnoyO_Male_Mech_GG_01	Olá!	
VO_AnnoyO_Male_Mech_Greetings_03	Olá! Olá! Olá!	
VO_AnnoyO_Male_Mech_HAPPY_HALLOWEEN_01	Noturnália! Noturnália! Noturnália!	
VO_AnnoyO_Male_Mech_HAPPY_HOLIDAYS_01	O-O-Olá!	
VO_AnnoyO_Male_Mech_HAPPY_NEW_YEAR_01	Olá. Olá. OLÁ!	
VO_AnnoyO_Male_Mech_HAPPY_NEW_YEAR_LUNAR_01	Olá. Olá. OLÁ!	
VO_AnnoyO_Male_Mech_HAPPY_NOBLEGARDEN_01	Oláááá!	
VO_AnnoyO_Male_Mech_LowCards_01	Olá?!	
VO_AnnoyO_Male_Mech_MIRROR_GREETINGS_02	Olá! Olá! Olá!	
VO_AnnoyO_Male_Mech_MIRROR_START_01	Olá? Olá! OLÁÁÁ!	
VO_AnnoyO_Male_Mech_NoCards_01	Olááá!!	
VO_AnnoyO_Male_Mech_Oops_01	Olááá.	
VO_AnnoyO_Male_Mech_Picked_01	Olá. Olá! Olá!	
VO_AnnoyO_Male_Mech_PIRATE_DAY_02	Ahoy! Ahoy! Ahoy!	
VO_AnnoyO_Male_Mech_Sorry_01	Olá...	
VO_AnnoyO_Male_Mech_Start_01	Olá! Olá! Olá!	
VO_AnnoyO_Male_Mech_Thanks_01	Olá!	
VO_AnnoyO_Male_Mech_Thinking_02	Olá? Oláááá!	
VO_AnnoyO_Male_Mech_Thinking_03	O... lááá?	
VO_AnnoyO_Male_Mech_Thinking_07	Olá. Olá. Olá?	
VO_AnnoyO_Male_Mech_Threaten_01	Olá!	
VO_AnnoyO_Male_Mech_Time_01	Olá. Olá! OLÁ!	
VO_AnnoyO_Male_Mech_Well_Played_01	Oláááá!	
VO_AnnoyO_Male_Mech_WOW_01	Oláááááááá!	
VO_Arthas_Male_Human_Attack_01	O mal será EXPURGADO!	
VO_Arthas_Male_Human_CONCEDE_01	Esta batalha acabou. Você venceu.	
VO_Arthas_Male_Human_ERROR_FULL_MINIONS_01	Eu tenho lacaios demais!	
VO_Arthas_Male_Human_ERROR_GENERIC_01	Eu não posso fazer isso.	
VO_Arthas_Male_Human_ERROR_HAND_FULL_01	Minha mão está cheia!	
VO_Arthas_Male_Human_ERROR_I_ATTACKED_01	Eu já ataquei.	
VO_Arthas_Male_Human_ERROR_JUST_PLAYED_01	Espere um turno para o lacaio se preparar.	
VO_Arthas_Male_Human_ERROR_MINION_ATTACKED_01	Esse lacaio já atacou.	
VO_Arthas_Male_Human_ERROR_NEED_MANA_01	Não tenho mana suficiente.	
VO_Arthas_Male_Human_ERROR_NEED_WEAPON_01	Preciso de uma arma.	
VO_Arthas_Male_Human_ERROR_PLAY_01	Eu não posso jogar isso.	
VO_Arthas_Male_Human_ERROR_STEALTH_01	Não consigo mirar em lacaios Furtivos.	
VO_Arthas_Male_Human_ERROR_TARGET_01	Esse não é um alvo válido.	
VO_Arthas_Male_Human_ERROR_TAUNT_01	Há um lacaio com Provocar no meio do caminho.	
VO_Arthas_Male_Human_FIRE_FESTIVAL_01	Acendam as fogueiras!	
VO_Arthas_Male_Human_GREETINGS_01	Salve! Minhas saudações.	
VO_Arthas_Male_Human_GREETINGS_RESPONSE	Sim, saudações.	
VO_Arthas_Male_Human_HAPPY_HALLOWEEN_01	Feliz Noturnália...	
VO_Arthas_Male_Human_HAPPY_HOLIDAYS_01	Feliz Festa do Véu de Inverno!	
VO_Arthas_Male_Human_HAPPY_NEW_YEAR_01	Feliz Ano Novo!	
VO_Arthas_Male_Human_HAPPY_NEW_YEAR_LUNAR_01	Hah! Feliz Ano Novo!	
VO_Arthas_Male_Human_HAPPY_NOBLEGARDEN	Feliz Jardinova.	
VO_Arthas_Male_Human_LOW_CARDS_01	Estou quase sem cards.	
VO_Arthas_Male_Human_MIRROR_GREETINGS_01	Sim, saudações!	
VO_Arthas_Male_Human_MIRROR_START_01	Pelo meu pai, o Rei!	
VO_Arthas_Male_Human_NO_CARDS_01	Estou sem cards!	
VO_Arthas_Male_Human_OOPS_01	Um equívoco.	
VO_Arthas_Male_Human_PIRATE_DAY_01	Como é bom ser Arrrrrthas.	
VO_Arthas_Male_Human_SORRY_01	Minhas mais nobres desculpas.	
VO_Arthas_Male_Human_START_01	Por Lordaeron!	
VO_Arthas_Male_Human_THANKS_01	Você tem minha gratidão.	
VO_Arthas_Male_Human_THINK1_01	Hmm…	
VO_Arthas_Male_Human_THINK2_01	Que caminho devo tomar...	
VO_Arthas_Male_Human_THINK3_01	O que Uther faria...	
VO_Arthas_Male_Human_THREATEN_01	Não há mais redenção para você!	
VO_Arthas_Male_Human_TIMER_01	Preciso agir!	
VO_Arthas_Male_Human_WELL_PLAYED_01	Bem jogado.	
VO_Arthas_Male_Human_WOW_01	Luz Sagrada!	
VO_BOT_238_Male_Goblin_Concede_01	Eu desisto. AUTODESTRUIÇÃO!	
VO_BOT_238_Male_Goblin_Greetings_02	Lá vem CABUM!	
VO_BOT_238_Male_Goblin_HAPPY_HALLOWEEN_01	Buu! Haha! Feliz Noturnália. 	
VO_BOT_238_Male_Goblin_LowCards_01	Tô quase sem cards...	
VO_BOT_238_Male_Goblin_NoCards_01	Já era! Acabaram os cards!	
VO_BOT_238_Male_Goblin_Oops_01	Hã. Fracassar é MESMO uma opção.	
VO_BOT_238_Male_Goblin_Thanks_01	Obrigado! Vou destruir você por último.	
VO_BOT_238_Male_Goblin_Thinking_01	Certo...	
VO_BOT_238_Male_Goblin_Thinking_02	Bem que eu poderia ter um plano agora...	
VO_BOT_238_Male_Goblin_Thinking_03	Hmmmmm...	
VO_BOT_238_Male_Goblin_Threaten_01	Não me obrigue a apertar uns botões!	
VO_BOT_238_Male_Goblin_Time_03	Ah, adoro esse pavio queimando.	
VO_BOT_238_Male_Goblin_Well_Played_02	Você sabe das coisas.	
VO_BOT_238_Male_Goblin_WOW_01	BOA!	
VO_BRM_027h__LUNAR_NEW_YEAR	ESSE ANO NOVO VAI SER UM INCÊNDIO!	
VO_BRM_027h_Attack_15	PROVE DAS CHAMAS DE SULFURON!	
VO_BRM_027h_Concede_11	VOCÊ VENCEU. BOM JOGO!	
VO_BRM_027h_Emote_Start	Eu terei minha vingança, Dragão!	
VO_BRM_027h_ERROR01_51	PRECISO DE UMA ARMA.	
VO_BRM_027h_ERROR02_52	MANA INSUFICIENTE.	
VO_BRM_027h_ERROR03_53	ELE JÁ ATACOU.	
VO_BRM_027h_ERROR04_54	EU JÁ ATAQUEI.	
VO_BRM_027h_ERROR05_55	MORTAIS PRECISAM DE UM TURNO PARA SE PREPARAR.	
VO_BRM_027h_ERROR06_56	CARDS DEMAIS.	
VO_BRM_027h_ERROR07_57	LACAIOS DEMAIS.	
VO_BRM_027h_ERROR08_58	ELE TEM FURTIVIDADE.	
VO_BRM_027h_ERROR09_59	NÃO DÁ PARA JOGAR ISSO.	
VO_BRM_027h_ERROR10_60	INVÁLIDO.	
VO_BRM_027h_ERROR11_61	AQUELE LACAIO COM PROVOCAR ESTÁ NO MEU CAMINHO.	
VO_BRM_027h_ERROR12_62	NÃO POSSO FAZER ISSO.	
VO_BRM_027h_FIRE_FESTIVAL	ESSE FESTIVAL É MEU!	
VO_BRM_027h_GG_16	BOM JOGO!	
VO_BRM_027h_Greetings_04	SEJA PURIFICADO PELO FOGO!	
VO_BRM_027h_GREETINGS_RESPONSE	PURIFICAÇÃO! PURIFICAÇÃO! PURIFICAÇÃO! PURIFICAÇÃÃÃO!	
VO_BRM_027h_HALLOWS_END	FELIZ NOTURNÁLIA!	
VO_BRM_027h_HAPPY_NEW_YEAR_38	ESSE ANO NOVO VAI SER UM INCÊNDIO!	
VO_BRM_027h_LowCards_49	EU QUEIMEI QUASE TODOS OS MEUS CARDS.	
VO_BRM_027h_NOBLEGARDEN	EU VOU COZINHAR VOCÊ COM CASCA E TUDO!	
VO_BRM_027h_NoCards_50	EU QUEIMEI TODOS OS MEUS CARDS.	
VO_BRM_027h_Oops_07	AH! ISSO FOI UM ERRO!	
VO_BRM_027h_PIRATE_DAY	EU SOU O SENHOR DO FOGOOOOOO!	
VO_BRM_027h_Sorry_10	DESCULPE.	
VO_BRM_027h_Thanks_09	UM CALOROSO "OBRIGADO".	
VO_BRM_027h_Thinking1_12	HMMM...	
VO_BRM_027h_Thinking2_13	SERÁ QUE...	
VO_BRM_027h_Thinking3_14	O QUE QUEIMAR PRIMEIRO…	
VO_BRM_027h_Threaten_08	VOCÊ VAI PERECER NO FOGO!	
VO_BRM_027h_Time_48	O TEMPO É UM PAVIO QUEIMANDO!	
VO_BRM_027h_Well_Played_06	BEM JOGADO.	
VO_BRM_027h_Winterveil_Greetings	O INVERNO DEVIA SER MAIS QUENTE!	
VO_BRM_027h_WOW_20	QUENTE! QUENTE!	
VO_DRG_600_Male_Dragon_Concede_01	Você derrotou meu exército. Parabéns.	
VO_DRG_600_Male_Dragon_Greetings_01	Queimem em fogo vil!	
VO_DRG_600_Male_Dragon_MIRROR_GREETINGS_01	Pode ter certeza!	
VO_DRG_600_Male_Dragon_MIRROR_START_01	... E você junto!	
VO_DRG_600_Male_Dragon_Oops_01	Essa... doeu.	
VO_DRG_600_Male_Dragon_Picked_01	Hora de colocar o mundo em chamas!	
VO_DRG_600_Male_Dragon_Sorry_01	Eu lamento, mas você vai lamentar mais.	
VO_DRG_600_Male_Dragon_Start_01	Queimem! Queimem tudo!	
VO_DRG_600_Male_Dragon_Thanks_01	Agradeço seus esforços inúteis.	
VO_DRG_600_Male_Dragon_Threaten_01	A eternidade não será gentil com sua alma.	
VO_DRG_600_Male_Dragon_Time_01	O tempo está se esgotando!	
VO_DRG_600_Male_Dragon_Well_Played_01	Impressionante para um mortal.	
VO_DRG_600_Male_Dragon_WOW_01	Isso foi maravilhosamente pérfido!	
VO_DRG_610_Male_Dragon_Concede_01	O pesadelo acabou. Você venceu.	
VO_DRG_610_Male_Dragon_Greetings_01	Seu medo... é saboroso.	
VO_DRG_610_Male_Dragon_MIRROR_GREETINGS_01	Só vai assustar a si mesmo.	
VO_DRG_610_Male_Dragon_MIRROR_START_01	Vou lhe mostrar o que é terror de verdade.	
VO_DRG_610_Male_Dragon_Oops_01	Assustador!	
VO_DRG_610_Male_Dragon_Picked_01	Hmm... Optando pelas trevas. Muito sábio.	
VO_DRG_610_Male_Dragon_Sorry_01	Desculpe, eu assustei você?	
VO_DRG_610_Male_Dragon_Start_01	Você jamais despertará deste pesadelo.	
VO_DRG_610_Male_Dragon_Thanks_01	Muito grato. Eu vou destruir você por último.	
VO_DRG_610_Male_Dragon_Threaten_01	Seus gritos são um prazer para mim.	
VO_DRG_610_Male_Dragon_Time_01	A escuridão fenece!	
VO_DRG_610_Male_Dragon_Well_Played_01	Sua compostura é... admirável.	
VO_DRG_610_Male_Dragon_WOW_01	Alarmante!	
VO_DRG_620_Male_Dragon_Concede_01	A tempestade se foi. Eu desisto.	
VO_DRG_620_Male_Dragon_Greetings_01	Será que você vai suportar a tempestade?	
VO_DRG_620_Male_Dragon_MIRROR_GREETINGS_01	A tempestade obedece aos MEUS desígnios!	
VO_DRG_620_Male_Dragon_MIRROR_START_01	Os céus se curvam somente a MIM!	
VO_DRG_620_Male_Dragon_Oops_01	Um desastre natural!	
VO_DRG_620_Male_Dragon_Picked_01	Tremam diante do poder da voragem!	
VO_DRG_620_Male_Dragon_Sorry_01	Lamento, é preciso fazer sacrifícios.	
VO_DRG_620_Male_Dragon_Start_01	Eu sou a tormenta! Eu sou a tempestade!	
VO_DRG_620_Male_Dragon_Thanks_01	Obrigado. Mais combustível para alimentar minhas chamas!	
VO_DRG_620_Male_Dragon_Threaten_02	Acha que VOCÊ é capaz de resistir a uma força da natureza?	
VO_DRG_620_Male_Dragon_Time_01	O olho da tormenta está perto!	
VO_DRG_620_Male_Dragon_Well_Played_01	Uma jogada arrasadora!	
VO_DRG_620_Male_Dragon_WOW_01	Que redemoinho!	
VO_DRG_650_Male_Dragon_Concede_01	Vocês me atrapalharam desta vez, mas eu voltarei.	
VO_DRG_650_Male_Dragon_Greetings_01	Curve-se diante do Inquebrantável!	
VO_DRG_650_Male_Dragon_MIRROR_GREETINGS_01	Vamos ver quem cede primeiro!	
VO_DRG_650_Male_Dragon_MIRROR_START_01	Duas forças implacáveis? Vai ser divertido!	
VO_DRG_650_Male_Dragon_Oops_02	Foi um erro grotesco!	
VO_DRG_650_Male_Dragon_Picked_01	Não há quem se iguale ao meu poder!	
VO_DRG_650_Male_Dragon_Sorry_01	Desculpe, eu mal me dei conta.	
VO_DRG_650_Male_Dragon_Start_01	Suas tentativas de vencer serão em vão!	
VO_DRG_650_Male_Dragon_Thanks_01	Obrigado pelo seu presentinho.	
VO_DRG_650_Male_Dragon_Threaten_01	Vocês são como mosquitos diante de um gigante!	
VO_DRG_650_Male_Dragon_Time_01	Eu sou inquebrantável, mas o tempo é fugaz!	
VO_DRG_650_Male_Dragon_Well_Played_01	Que jogada colossal!	
VO_DRG_650_Male_Dragon_WOW_02	Agora eu fiquei impressionado.	
VO_DRG_660_Male_Dragon_Concede_01	Desisto. Desfrute do silêncio.	
VO_DRG_660_Male_Dragon_Greetings_01	Estou vendo você...	
VO_DRG_660_Male_Dragon_MIRROR_GREETINGS_01	Quem disse que eu estava me escondendo?	
VO_DRG_660_Male_Dragon_MIRROR_START_01	... SÓ eu!	
VO_DRG_660_Male_Dragon_Oops_01	Ah, que horror.	
VO_DRG_660_Male_Dragon_Picked_01	Transforme o mundo deles em loucura!	
VO_DRG_660_Male_Dragon_Sorry_01	Desculpe. Onde eu estava com a cabeça?	
VO_DRG_660_Male_Dragon_Start_01	Os sussurros... estão falando comigo!	
VO_DRG_660_Male_Dragon_Thanks_01	Sua loucura é... um deleite.	
VO_DRG_660_Male_Dragon_Threaten_01	Sua mente está variando...	
VO_DRG_660_Male_Dragon_Time_01	O quê? O tempo está acabando!	
VO_DRG_660_Male_Dragon_Well_Played_01	Essa insanidade me agrada.	
VO_DRG_660_Male_Dragon_WOW_01	Quanta... imaginação!	
VO_DRG_6x_Male_Dragon_ERROR_FULL_MINIONS_01	O tabuleiro está cheio!	
VO_DRG_6x_Male_Dragon_ERROR_GENERIC_01	Isso é impossível.	
VO_DRG_6x_Male_Dragon_ERROR_HAND_FULL_01	Tenho cards demais.	
VO_DRG_6x_Male_Dragon_ERROR_I_ATTACKED_01	Não posso atacar de novo.	
VO_DRG_6x_Male_Dragon_ERROR_MINION_ATTACKED_01	Esse lacaio já atacou.	
VO_DRG_6x_Male_Dragon_ERROR_NEED_MANA_01	Preciso de mais mana para fazer isso.	
VO_DRG_6x_Male_Dragon_ERROR_NEED_WEAPON_01	Preciso de uma arma. Ou de garras.	
VO_DRG_6x_Male_Dragon_ERROR_PLAY_01	Eu não posso fazer isso.	
VO_DRG_6x_Male_Dragon_ERROR_STEALTH_01	Esse lacaio tem Furtividade.	
VO_DRG_6x_Male_Dragon_ERROR_SUMMON_SICKNESS_01	Espere um turno para esse fracote se preparar.	
VO_DRG_6x_Male_Dragon_ERROR_TARGET_01	Não consigo mirar nisso.	
VO_DRG_6x_Male_Dragon_ERROR_TAUNT_01	Preciso atacar o lacaio com Provocar.	
VO_DRG_6x_Male_Dragon_FIRE_FESTIVAL_01	Fogos de artifício. Eu adoro esse troço...	
VO_DRG_6x_Male_Dragon_HAPPY_HALLOWEEN_01	Noturnália... Minha festa favorita.	
VO_DRG_6x_Male_Dragon_HAPPY_HOLIDAYS_01	Feliz Festa do Véu de Inverno...	
VO_DRG_6x_Male_Dragon_HAPPY_NEW_YEAR_01	Feliz ano-novo.	
VO_DRG_6x_Male_Dragon_HAPPY_NEW_YEAR_LUNAR_01	Feliz ano-novo.	
VO_DRG_6x_Male_Dragon_HAPPY_NOBLEGARDEN_01	Jardinova... odeio.	
VO_DRG_6x_Male_Dragon_LowCards_01	Meus cards estão acabando.	
VO_DRG_6x_Male_Dragon_NoCards_01	Estou sem cards!	
VO_DRG_6x_Male_Dragon_PIRATE_DAY_01	Iarr! Galakrond vai assolar os céus.	
VO_DRG_6x_Male_Dragon_Thinking_01	Que tal...	
VO_DRG_6x_Male_Dragon_Thinking_02	E se...	
VO_DRG_6x_Male_Dragon_Thinking_03	Quem sabe...	
VO_EX1_323h_HAPPY_NEW_YEAR_13	FELIZ ANO NOVO!	
VO_GIL_504_Female_Orc_Concede_01	A vitória é sua desta vez.	
VO_GIL_504_Female_Orc_Greetings_02	Boas-vindas ao meu domínio.	
VO_GIL_504_Female_Orc_GREETINGS_RESPONSE	Sigamos então, tu e eu.	
VO_GIL_504_Female_Orc_LowCards_01	Estou quase sem cards!	
VO_GIL_504_Female_Orc_NoCards_01	Estou sem cards!	
VO_GIL_504_Female_Orc_Oops_01	Desaconselhável.	
VO_GIL_504_Female_Orc_Start_01	O bosque é perigoso durante a noite.	
VO_GIL_504_Female_Orc_Thanks_01	Obrigada.	
VO_GIL_504_Female_Orc_Thinking_01	Hmm…	
VO_GIL_504_Female_Orc_Thinking_02	Desconcertante...	
VO_GIL_504_Female_Orc_Thinking_03	Um caminho mal iluminado...	
VO_GIL_504_Female_Orc_Threaten_02	Que a maldição leve você!	
VO_GIL_504_Female_Orc_Time_01	Tenho que decidir!	
VO_GIL_504_Female_Orc_Well_Played_01	Bem jogado.	
VO_GIL_504_Female_Orc_Wow_01	Pela noite!	
VO_GILA_400h_Male_Human_Concede_01	Você é demais pra mim!	
VO_GILA_400h_Male_Human_Death_02	<Morte>	
VO_GILA_400h_Male_Human_ERROR_FULL_MINIONS_01	Não tem espaço pra mais um.	
VO_GILA_400h_Male_Human_ERROR_GENERIC_01	Não consigo.	
VO_GILA_400h_Male_Human_ERROR_GENERIC_04	Simplesmente não dá.	
VO_GILA_400h_Male_Human_ERROR_HAND_FULL_01	Tenho cards demais!	
VO_GILA_400h_Male_Human_ERROR_I_ATTACKED_01	Eu já ataquei.	
VO_GILA_400h_Male_Human_ERROR_MINION_ATTACKED_01	Esse daí já atacou.	
VO_GILA_400h_Male_Human_ERROR_NEED_MANA_02	Não tenho mais mana!	
VO_GILA_400h_Male_Human_ERROR_NEED_WEAPON_02	Eu preciso de uma arma!	
VO_GILA_400h_Male_Human_ERROR_STEALTH_01	É furtivo!	
VO_GILA_400h_Male_Human_ERROR_SUMMON_SICKNESS_01	Esse não está pronto.	
VO_GILA_400h_Male_Human_ERROR_TARGET_01	Não consigo mirar.	
VO_GILA_400h_Male_Human_ERROR_TAUNT_01	Tem um lacaio com Provocar no caminho.	
VO_GILA_400h_Male_Human_Greetings_01	Não gosto de você. Meus cães não gostam de você.	
VO_GILA_400h_Male_Human_GREETINGS_RESPONSE	Ninguém gosta de mim.	
VO_GILA_400h_Male_Human_LowCards_01	Estou quase sem cards...	
VO_GILA_400h_Male_Human_NoCards_01	Acabaram os cards!	
VO_GILA_400h_Male_Human_Oops_01	Que perda de tempo.	
VO_GILA_400h_Male_Human_Sorry_01	Desculpa.	
VO_GILA_400h_Male_Human_Start_01	Olha só o que os cães encontraram.	
VO_GILA_400h_Male_Human_Thanks_01	Agradecido.	
VO_GILA_400h_Male_Human_Thinking_01	Hmmm...	
VO_GILA_400h_Male_Human_Thinking_03	É melhor pensar bem...	
VO_GILA_400h_Male_Human_Thinking_04	Vamos lá, vamos lá...	
VO_GILA_400h_Male_Human_Threaten_04	É melhor se fingir de morto.	
VO_GILA_400h_Male_Human_Time_01	Falta pouco tempo.	
VO_GILA_400h_Male_Human_Well_Played_01	Bom truque!	
VO_GILA_400h_Male_Human_WOW_01	Soltando os cachorros!	
VO_GILA_500h3_Female_Human_Concede_01	Não consigo derrotar você!	
VO_GILA_500h3_Female_Human_ERROR_FULL_MINIONS_01	Não há espaço suficiente.	
VO_GILA_500h3_Female_Human_ERROR_GENERIC_04	Isso é contra as regras!	
VO_GILA_500h3_Female_Human_ERROR_HAND_FULL_02	Minha mão está cheia demais!	
VO_GILA_500h3_Female_Human_ERROR_I_ATTACKED_02	Não posso atacar duas vezes!	
VO_GILA_500h3_Female_Human_ERROR_MINION_ATTACKED_01	Esse lacaio já atacou.	
VO_GILA_500h3_Female_Human_ERROR_NEED_MANA_02	Não tenho mana suficiente.	
VO_GILA_500h3_Female_Human_ERROR_NEED_WEAPON_02	Vou precisar de uma arma.	
VO_GILA_500h3_Female_Human_ERROR_PLAY_01	Não posso quebrar as regras desse jeito.	
VO_GILA_500h3_Female_Human_ERROR_STEALTH_01	Não encontro ele!	
VO_GILA_500h3_Female_Human_ERROR_SUMMON_SICKNESS_01	Esse lacaio não está pronto.	
VO_GILA_500h3_Female_Human_ERROR_TARGET_01	Não consigo mirar.	
VO_GILA_500h3_Female_Human_ERROR_TAUNT_01	Tem um lacaio com Provocar no caminho!	
VO_GILA_500h3_Female_Human_Greetings_01	Com os cumprimentos dos Destronados.	
VO_GILA_500h3_Female_Human_GREETINGS_RESPONSE	Vou retribuir a gentileza.	
VO_GILA_500h3_Female_Human_LowCards_01	Não tenho muitos cards...	
VO_GILA_500h3_Female_Human_NoCards_01	Estou sem cards!	
VO_GILA_500h3_Female_Human_Oops_02	Isso... não foi de propósito.	
VO_GILA_500h3_Female_Human_Sorry_01	Desculpe.	
VO_GILA_500h3_Female_Human_Start_01	O rastro nos trouxe até aqui.	
VO_GILA_500h3_Female_Human_Thanks_01	Obrigada.	
VO_GILA_500h3_Female_Human_Thinking_02	Deve haver algum jeito...	
VO_GILA_500h3_Female_Human_Thinking_03	Pense, Tess. Pense.	
VO_GILA_500h3_Female_Human_Thinking_05	Ahhh... Hmm.	
VO_GILA_500h3_Female_Human_Threaten_03	Vou acabar com você!	
VO_GILA_500h3_Female_Human_Time_01	Preciso ser rápida.	
VO_GILA_500h3_Female_Human_Well_Played_01	Ótima tática. 	
VO_GILA_500h3_Female_Human_WOW_01	Absolutamente incrível.	
VO_GILA_600h_Male_Worgen_Concede_01	Você me superou!	
VO_GILA_600h_Male_Worgen_ERROR_FULL_MINIONS_02	Eu tenho muitos lacaios no campo.	
VO_GILA_600h_Male_Worgen_ERROR_GENERIC_01	Impossível.	
VO_GILA_600h_Male_Worgen_ERROR_GENERIC_02	Não posso fazer isso.	
VO_GILA_600h_Male_Worgen_ERROR_HAND_FULL_01	Cards demais!	
VO_GILA_600h_Male_Worgen_ERROR_I_ATTACKED_01	Eu já ataquei.	
VO_GILA_600h_Male_Worgen_ERROR_MINION_ATTACKED_01	Esse lacaio já atacou.	
VO_GILA_600h_Male_Worgen_ERROR_NEED_MANA_01	Estou sem mana. 	
VO_GILA_600h_Male_Worgen_ERROR_NEED_WEAPON_02	Preciso de uma arma.	
VO_GILA_600h_Male_Worgen_ERROR_STEALTH_01	Esse lacaio está escondido!	
VO_GILA_600h_Male_Worgen_ERROR_SUMMON_SICKNESS_01	Eles ainda não estão prontos.	
VO_GILA_600h_Male_Worgen_ERROR_TARGET_01	Não consigo mirar.	
VO_GILA_600h_Male_Worgen_ERROR_TAUNT_01	Tem um lacaio com Provocar no caminho!	
VO_GILA_600h_Male_Worgen_Greetings_01	Diga olá pro meu amigão.	
VO_GILA_600h_Male_Worgen_GREETINGS_RESPONSE	Olá, colega!	
VO_GILA_600h_Male_Worgen_LowCards_01	Estou quase sem cards.	
VO_GILA_600h_Male_Worgen_NoCards_01	Estou sem cards!	
VO_GILA_600h_Male_Worgen_Oops_01	Mas que falha!	
VO_GILA_600h_Male_Worgen_Sorry_01	Eu... sinto muito.	
VO_GILA_600h_Male_Worgen_Start_01	Estou na posição.	
VO_GILA_600h_Male_Worgen_Thanks_01	Obrigado.	
VO_GILA_600h_Male_Worgen_Thinking_01	Hmmm...	
VO_GILA_600h_Male_Worgen_Thinking_02	O que fazer agora...	
VO_GILA_600h_Male_Worgen_Thinking_04	Vou dar um jeito...	
VO_GILA_600h_Male_Worgen_Threaten_01	Vou despedaçar você!	
VO_GILA_600h_Male_Worgen_Time_01	Não me apresse!	
VO_GILA_600h_Male_Worgen_Well_Played_01	Uma excelente manobra.	
VO_GILA_600h_Male_Worgen_WOW_01	Inacreditável!	
VO_GILA_900h_Female_Gnome_Concede_01	Tentei de tudo. Você ganhou!	
VO_GILA_900h_Female_Gnome_ERROR_FULL_MINIONS_02	Não posso ter mais lacaios.	
VO_GILA_900h_Female_Gnome_ERROR_GENERIC_01	Não posso fazer isso.	
VO_GILA_900h_Female_Gnome_ERROR_HAND_FULL_01	Tenho cards demais!	
VO_GILA_900h_Female_Gnome_ERROR_I_ATTACKED_02	Não posso atacar de novo!	
VO_GILA_900h_Female_Gnome_ERROR_MINION_ATTACKED_01	Esse lacaio já atacou.	
VO_GILA_900h_Female_Gnome_ERROR_NEED_MANA_01	Mana insuficiente.	
VO_GILA_900h_Female_Gnome_ERROR_NEED_WEAPON_01	Não tenho arma.	
VO_GILA_900h_Female_Gnome_ERROR_PLAY_01	Nem eu consigo fazer isso. 	
VO_GILA_900h_Female_Gnome_ERROR_STEALTH_01	Esse alvo está furtivo.	
VO_GILA_900h_Female_Gnome_ERROR_SUMMON_SICKNESS_01	Esse lacaio precisa se preparar.	
VO_GILA_900h_Female_Gnome_ERROR_TARGET_01	Não é um alvo bom.	
VO_GILA_900h_Female_Gnome_ERROR_TAUNT_01	Um lacaio com Provocar tá no caminho!	
VO_GILA_900h_Female_Gnome_GG_01	Ótimo jogo!	
VO_GILA_900h_Female_Gnome_Greetings_01	Ah, olá. Você de novo.	
VO_GILA_900h_Female_Gnome_GREETINGS_RESPONSE	Eu baguncei mesmo a linha do tempo?	
VO_GILA_900h_Female_Gnome_LowCards_01	Restam poucos cards...	
VO_GILA_900h_Female_Gnome_NoCards_01	Estou sem cards!	
VO_GILA_900h_Female_Gnome_Oops_02	Acho que isso foi um erro.	
VO_GILA_900h_Female_Gnome_Sorry_01	Hã... Desculpa?	
VO_GILA_900h_Female_Gnome_Start_01	Seu tempo acabou!	
VO_GILA_900h_Female_Gnome_Thanks_01	Obrigada.	
VO_GILA_900h_Female_Gnome_Thinking_02	Huum...	
VO_GILA_900h_Female_Gnome_Thinking_03	... preciso pensar em 4 dimensões...	
VO_GILA_900h_Female_Gnome_Thinking_05	... as engrenagens estão em movimento...	
VO_GILA_900h_Female_Gnome_Threaten_01	Vou apagar você da linha do tempo!	
VO_GILA_900h_Female_Gnome_Time_01	Como o tempo pode estar acabando?	
VO_GILA_900h_Female_Gnome_Well_Played_01	Eu não teria feito melhor!	
VO_GILA_900h_Female_Gnome_WOW_02	Inconcebível!	
VO_HERO_01_HAPPY_NEW_YEAR_06	Feliz ano novo!	
VO_HERO_01_Male_Orc_Emote_01	Eu não sou mau, só não sou como Thrall.	
VO_HERO_01_Male_Orc_Emote_02	Tanto poder!	
VO_HERO_01_Male_Orc_Emote_03	Se eu pudesse resolver isso com uma viagem no tempo...	
VO_HERO_01_Male_Orc_Emote_05	Eu não fiz nada de errado!	
VO_HERO_01_Male_Orc_Emote_06	Salve o VERDADEIRO chefe guerreiro! 	
VO_HERO_01_Male_Orc_Emote_08	Sangue e trovão!	
VO_HERO_01_Male_Orc_Emote_09	Pela Horda!	
VO_HERO_01_Male_Orc_Emote_10	Lok'narosh!	
VO_HERO_01_Male_Orc_Emote_11	Os olhos do Grito Infernal estão sobre você!	
VO_HERO_01_Male_Orc_Emote_12	Eu não terei piedade!	
VO_HERO_01d_Male_Orc_Attack_01	Pelos Mag'har!	
VO_HERO_01d_Male_Orc_Greetings_01	Mok'rah.	
VO_HERO_01d_Male_Orc_MIRROR_GREETINGS_01	Vejo que é um dos meus...	
VO_HERO_01d_Male_Orc_MIRROR_START_01	Só se for a vitória.	
VO_HERO_01d_Male_Orc_Oops_01	Constrangedor.	
VO_HERO_01d_Male_Orc_Start_01	Aceite seu destino.	
VO_HERO_01d_Male_Orc_Thanks_01	Obrigado.	
VO_HERO_01d_Male_Orc_Threaten_01	Eu não obedeço a NINGUÉM!	
VO_HERO_01d_Male_Orc_Well_Played_01	Você possui honra de verdade.	
VO_HERO_01d_Male_Orc_Wow_01	Estou impressionado.	
VO_HERO_01f_Male_Orc_Greetings_01	Salve.	
VO_HERO_01f_Male_Orc_MIRROR_START_01	E sobre você também.	
VO_HERO_01f_Male_Orc_Oops_01	Não há margem para erro.	
VO_HERO_01f_Male_Orc_Thanks_01	Fico grato.	
VO_HERO_01f_Male_Orc_Wow_01	Impressionante!	
VO_HERO_01g_Male_Orc_Attack_01	Contemple minha força!	
VO_HERO_01g_Male_Orc_Greetings_01	Força sempre.	
VO_HERO_01g_Male_Orc_IntroValeera_01	De fato!	
VO_HERO_01g_Male_Orc_MIRROR_GREETINGS_01	Sim, força e bravura.	
VO_HERO_01g_Male_Orc_MIRROR_START_01	Tem certeza?	
VO_HERO_01g_Male_Orc_Oops_01	Até grandes guerreiros se equivocam às vezes.	
VO_HERO_01g_Male_Orc_Start_01	Ninguém triunfará sobre mim!	
VO_HERO_01g_Male_Orc_Thanks_01	Aceite minha gratidão. 	
VO_HERO_01g_Male_Orc_Threaten_01	Você tem muito a aprender...	
VO_HERO_01g_Male_Orc_Well_Played_01	Você demonstrou seu valor.	
VO_HERO_01g_Male_Orc_Wow_01	Incrível!	
VO_HERO_01i_Female_Orc_Attack_01	Lobo do Gelo!	
VO_HERO_01i_Female_Orc_Greetings_01	Olá.	
VO_HERO_01i_Female_Orc_MIRROR_GREETINGS_01	Alô, você.	
VO_HERO_01i_Female_Orc_MIRROR_START_01	Então aja de acordo!	
VO_HERO_01i_Female_Orc_Oops_01	Ops!	
VO_HERO_01i_Female_Orc_Picked_01	Um dia eu vou ser uma grande heroína.	
VO_HERO_01i_Female_Orc_Start_01	Quero ser uma guerreira!	
VO_HERO_01i_Female_Orc_Thanks_01	Fico muito contente com isso.	
VO_HERO_01i_Female_Orc_Threaten_01	Covarde!	
VO_HERO_01i_Female_Orc_Well_Played_01	Boa luta.	
VO_HERO_01i_Female_Orc_Wow_01	Eu não acredito.	
VO_HERO_01j_Female_Orc_Attack_01	Os fortes sobrevivem!	
VO_HERO_01j_Female_Orc_Greetings_01	Eu sou Rokara, do clã Lobo do Gelo.	
VO_HERO_01j_Female_Orc_MIRROR_GREETINGS_01	Eu sei, bobona.	
VO_HERO_01j_Female_Orc_MIRROR_START_01	E a qualquer hora.	
VO_HERO_01j_Female_Orc_Oops_01	Isso não foi de propósito.	
VO_HERO_01j_Female_Orc_Picked_01	Temos que devolver a vida às terras da Horda.	
VO_HERO_01j_Female_Orc_Start_01	Eu luto em qualquer lugar!	
VO_HERO_01j_Female_Orc_Thanks_01	Estou em dívida para com você.	
VO_HERO_01j_Female_Orc_Threaten_01	Vou te ensinar o que é "dizimar".	
VO_HERO_01j_Female_Orc_Well_Played_01	Corra com a matilha.	
VO_HERO_01j_Female_Orc_Wow_01	Isso é MUITO incrível!	
VO_HERO_01k_Female_Orc_Attack_01	Pela Horda!	
VO_HERO_01k_Female_Orc_Greetings_01	Nossa batalha será gloriosa.	
VO_HERO_01k_Female_Orc_MIRROR_GREETINGS_01	Ficará para a história.	
VO_HERO_01k_Female_Orc_MIRROR_START_01	Já cheguei, já cheguei.	
VO_HERO_01k_Female_Orc_Oops_01	Erros estragam nossas lâminas, mas afiam nossa perícia.	
VO_HERO_01k_Female_Orc_Picked_01	Eu já tenho idade pra lutar!	
VO_HERO_01k_Female_Orc_Start_01	Vem cá brincar!	
VO_HERO_01k_Female_Orc_Thanks_01	Você é muito gentil.	
VO_HERO_01k_Female_Orc_Threaten_01	Você parece um wendigo e tem cheiro de fera da neve!	
VO_HERO_01k_Female_Orc_Well_Played_01	Essas são as lutas dos meus sonhos.	
VO_HERO_01k_Female_Orc_Wow_01	Por Azeroth, o que foi aquilo?!	
VO_HERO_01l_Female_Orc_Attack_02	<Esforço de ataque>	
VO_HERO_01l_Female_Orc_Attack_03	<Esforço de ataque>	
VO_HERO_01l_Female_Orc_BRB_01	Só um segundo!	
VO_HERO_01l_Female_Orc_CELEBRATE_01	Devemos celebrar este triunfo!	
VO_HERO_01l_Female_Orc_CHEER_01	Lok'tar!	
VO_HERO_01l_Female_Orc_Concede_01	Impossível!	
VO_HERO_01l_Female_Orc_CONGRATULATIONS_01	Você fez por merecer.	
VO_HERO_01l_Female_Orc_CRY_01	<chorando>	
VO_HERO_01l_Female_Orc_DAY_OF_THE_DEAD_01	Hoje homenageamos aqueles que pereceram.	
VO_HERO_01l_Female_Orc_Death_01	<estertor de morte>	
VO_HERO_01l_Female_Orc_END_OF_SEASON_01	No final de cada temporada, eu conto os entalhes do meu machado.	
VO_HERO_01l_Female_Orc_ERROR_FULL_MINIONS_01	Não tem espaço para mais lacaios.	
VO_HERO_01l_Female_Orc_ERROR_GENERIC_01	Não vai funcionar.	
VO_HERO_01l_Female_Orc_ERROR_GENERIC_02	Se eu pudesse...	
VO_HERO_01l_Female_Orc_ERROR_HAND_FULL_01	Minha mão está lotada!	
VO_HERO_01l_Female_Orc_ERROR_I_ATTACKED_01	Eu já ataquei!	
VO_HERO_01l_Female_Orc_ERROR_MINION_ATTACKED_01	Esse lacaio tá exausto.	
VO_HERO_01l_Female_Orc_ERROR_NEED_MANA_01	Preciso de mais mana.	
VO_HERO_01l_Female_Orc_ERROR_NEED_WEAPON_01	Preciso de uma arma.	
VO_HERO_01l_Female_Orc_ERROR_PLAY_01	Eu não posso jogar isso!	
VO_HERO_01l_Female_Orc_ERROR_STEALTH_01	Lacaio maldito. Apareça!	
VO_HERO_01l_Female_Orc_ERROR_SUMMON_SICKNESS_01	Espere um turno para o lacaio se preparar.	
VO_HERO_01l_Female_Orc_ERROR_TARGET_01	Não consigo mirar.	
VO_HERO_01l_Female_Orc_ERROR_TAUNT_01	Tem que matar o lacaio com Provocar antes.	
VO_HERO_01l_Female_Orc_FACTION_CRY_01	Pela Horda!	
VO_HERO_01l_Female_Orc_FIDGET_01	Não tenho tanta certeza.	
VO_HERO_01l_Female_Orc_FIRE_FESTIVAL_01	Aproveite o Festival do Fogo!	
VO_HERO_01l_Female_Orc_GG_01	Vou me lembrar disso para sempre.	
VO_HERO_01l_Female_Orc_Greetings_01	Força e honra.	
VO_HERO_01l_Female_Orc_HAPPY_BIRTHDAY_01	Feliz aniversário! Eu sempre passo o meu afiando minhas armas.	
VO_HERO_01l_Female_Orc_HAPPY_BREWFEST_01	CervaFest? Vamos brindar em homenagem a Durotan!	
VO_HERO_01l_Female_Orc_HAPPY_EVENT_01	Fico feliz de celebrar ocasiões assim.	
VO_HERO_01l_Female_Orc_HAPPY_HALLOWEEN_01	Feliz Noturnália! Guff comeu todos os meus doces.	
VO_HERO_01l_Female_Orc_HAPPY_HOLIDAYS_01	Feliz Festa do Véu de Inverno!	
VO_HERO_01l_Female_Orc_HAPPY_NEW_YEAR_01	Feliz ano novo!	
VO_HERO_01l_Female_Orc_HAPPY_NEW_YEAR_LUNAR_01	Feliz ano novo!	
VO_HERO_01l_Female_Orc_HAPPY_NOBLEGARDEN_01	Jardinova? Eu caçava coelho quando morava no Vale Alterac.	
VO_HERO_01l_Female_Orc_HUNGRY_01	Tô morrendo de fome. Tem costela de javali? Até um biscoito de mana eu aceito.	
VO_HERO_01l_Female_Orc_INDEED_01	De fato.	
VO_HERO_01l_Female_Orc_KIDS_WEEK_01	Não vejo a hora de conhecer os brutos novatos no campo de treinamento.	
VO_HERO_01l_Female_Orc_KISS_01	<som de beijo>	
VO_HERO_01l_Female_Orc_LAUGH_01	<risada>	
VO_HERO_01l_Female_Orc_LowCards_01	Não tenho muitas opções.	
VO_HERO_01l_Female_Orc_MIRROR_GREETINGS_04	Pelo Lobo do Gelo!	
VO_HERO_01l_Female_Orc_MIRROR_START_01	Desde que todo mundo faça sua parte.	
VO_HERO_01l_Female_Orc_NICE_CARD_BACK_01	Adorei o verso do card.	
VO_HERO_01l_Female_Orc_NoCards_01	Meu deck se foi. É agora ou nunca.	
VO_HERO_01l_Female_Orc_Oops_01	Oh-oh!	
VO_HERO_01l_Female_Orc_PARTY_01	Vai rolar a festa no melhor estilo Alterac!	
VO_HERO_01l_Female_Orc_Picked_01	Resistiremos juntos!	
VO_HERO_01l_Female_Orc_PIRATE_DAY_01	Iuhuu! Quero içar velas e trazer os tesouros pro convés!	
VO_HERO_01l_Female_Orc_SALUTE_01	Como diziam meus ancestrais, zug-zug.	
VO_HERO_01l_Female_Orc_Sorry_01	Foi mau!	
VO_HERO_01l_Female_Orc_Start_01	Um ótimo dia pra uma luta.	
VO_HERO_01l_Female_Orc_Start_Brukan_01	Vou te mostrar o que aprendi.	
VO_HERO_01l_Female_Orc_Start_Guff_01	Não se contenha, Guff.	
VO_HERO_01l_Female_Orc_START_OF_SEASON_01	Começa uma nova temporada! Mal posso esperar para continuar melhorando. 	
VO_HERO_01l_Female_Orc_Start_Tavish_01	O clã Lobo do Gelo não se deixará intimidar.	
VO_HERO_01l_Female_Orc_Thanks_01	Valeu.	
VO_HERO_01l_Female_Orc_Thinking_01	Vejamos...	
VO_HERO_01l_Female_Orc_Thinking_02	Hm.	
VO_HERO_01l_Female_Orc_Thinking_03	Deve haver alguma forma.	
VO_HERO_01l_Female_Orc_Thinking_04	O que Garrosh faria?	
VO_HERO_01l_Female_Orc_Threaten_01	Eu posso ser jovem, mas derrotarei você!	
VO_HERO_01l_Female_Orc_Time_01	Tenho que ir mais rápido.	
VO_HERO_01l_Female_Orc_TRIGGER_BRAWL_01	Luta! Luta! Luta! Luta!	
VO_HERO_01l_Female_Orc_TRIGGER_CONDITIONING_01	Eu vou ser a melhor!	
VO_HERO_01l_Female_Orc_TRIGGER_EXECUTE_01	Hora de executar você!	
VO_HERO_01l_Female_Orc_TRIGGER_GOREHOWL_01	Ahhh, sim!	
VO_HERO_01l_Female_Orc_TRIGGER_GOREHOWL_02	Não contem que peguei emprestado.	
VO_HERO_01l_Female_Orc_TRIGGER_HEAVYPLATE_01	Hora do show!	
VO_HERO_01l_Female_Orc_TRIGGER_RAIDTHEDOCKS_01	Alto lá, marujos!	
VO_HERO_01l_Female_Orc_TRIGGER_RANCOR_01	Já chega!	
VO_HERO_01l_Female_Orc_TRIGGER_SHIELDSLAM_01	Bong!	
VO_HERO_01l_Female_Orc_TRIGGER_WARCACHE_01	É isso aí! Saque!	
VO_HERO_01l_Female_Orc_VALENTINES_01	Feliz dia dos namorados. Eu tenho uma queda por destruir lacaios.	
VO_HERO_01l_Female_Orc_WELCOME_01	Boas-vindas, camarada.	
VO_HERO_01l_Female_Orc_Well_Played_01	Que sua lâmina nunca perca o fio.	
VO_HERO_01l_Female_Orc_WOW_01	Sem chance!	
VO_HERO_02_HAPPY_NEW_YEAR_07	Feliz ano novo, camarada!	
VO_HERO_02b_Male_Troll_Concede_01	Você luta bem. Para mim, termina aqui!	
VO_HERO_02b_Male_Troll_ERROR_FULL_MINIONS_02	Eu tenho lacaios demais.	
VO_HERO_02b_Male_Troll_ERROR_GENERIC_02	Não. Não tem como.	
VO_HERO_02b_Male_Troll_ERROR_HAND_FULL_01	Minha mão está cheia!	
VO_HERO_02b_Male_Troll_ERROR_I_ATTACKED_02	Eu já ataquei.	
VO_HERO_02b_Male_Troll_ERROR_MINION_ATTACKED_01	Esse lacaio já atacou.	
VO_HERO_02b_Male_Troll_ERROR_NEED_MANA_01	Preciso de mana.	
VO_HERO_02b_Male_Troll_ERROR_NEED_WEAPON_01	Preciso de uma arma.	
VO_HERO_02b_Male_Troll_ERROR_PLAY_01	Eu não posso fazer isso.	
VO_HERO_02b_Male_Troll_ERROR_STEALTH_01	Esse está se escondendo de mim!	
VO_HERO_02b_Male_Troll_ERROR_SUMMON_SICKNESS_01	Esse aí precisa se preparar.	
VO_HERO_02b_Male_Troll_ERROR_TARGET_01	Não tenho alvo.	
VO_HERO_02b_Male_Troll_ERROR_TAUNT_02	Preciso atacar o lacaio com Provocar.	
VO_HERO_02b_Male_Troll_FIRE_FESTIVAL_01	O Festival do Fogo COMEÇOU!	
VO_HERO_02b_Male_Troll_Greetings_01	Boas-vindas! Pode se curvar perante mim.	
VO_HERO_02b_Male_Troll_HAPPY_HALLOWEEN_01	Heh, heh, heh. É Noturnália.	
VO_HERO_02b_Male_Troll_HAPPY_HOLIDAYS_01	Boas festas para você.	
VO_HERO_02b_Male_Troll_HAPPY_NEW_YEAR_01	Que todos prosperem no Ano Novo.	
VO_HERO_02b_Male_Troll_HAPPY_NEW_YEAR_LUNAR_01	Que todos prosperem no Ano Novo.	
VO_HERO_02b_Male_Troll_HAPPY_NOBLEGARDEN_01	Pela última vez... Não tem ovo no meu chapéu!	
VO_HERO_02b_Male_Troll_LowCards_01	Meus cards estão acabando!	
VO_HERO_02b_Male_Troll_MIRROR_GREETINGS_01	Não corta a minha onda.	
VO_HERO_02b_Male_Troll_MIRROR_START_01	E logo um de nós estará de joelhos.	
VO_HERO_02b_Male_Troll_NoCards_01	Estou\nsem cards!	
VO_HERO_02b_Male_Troll_Oops_02	Acontece.	
VO_HERO_02b_Male_Troll_Picked_01	Como é bom ser rei.	
VO_HERO_02b_Male_Troll_PIRATE_DAY_01	Quando o rei contrata, chama-se...\n"Corsário".	
VO_HERO_02b_Male_Troll_Sorry_01	Perdão.	
VO_HERO_02b_Male_Troll_Start_02	Você está diante do Rei Rastakhan!	
VO_HERO_02b_Male_Troll_Thanks_01	Agradeço.	
VO_HERO_02b_Male_Troll_Thinking_05	Ah... Hmmm.	
VO_HERO_02b_Male_Troll_Thinking_11	Pela minha glória...	
VO_HERO_02b_Male_Troll_Thinking_15	Os loas falam comigo...	
VO_HERO_02b_Male_Troll_Threaten_04	Tremam diante de mim!	
VO_HERO_02b_Male_Troll_Time_01	Ninguém vai me apressar!	
VO_HERO_02b_Male_Troll_Well_Played_01	Impressionante.	
VO_HERO_02b_Male_Troll_WOW_01	Como é\npossível?	
VO_HERO_02f_Male_Orc_Attack_01	Pela honra e a glória!	
VO_HERO_02f_Male_Orc_Greetings_01	Estou te ouvindo...	
VO_HERO_02f_Male_Orc_MIRROR_GREETINGS_01	Eu falei alguma coisa errada?	
VO_HERO_02f_Male_Orc_MIRROR_START_01	Que isso ressoe por toda a face da terra!	
VO_HERO_02f_Male_Orc_Oops_01	Não foi muito bem pensado.	
VO_HERO_02f_Male_Orc_Picked_01	O fogo foi o primeiro a atender ao meu chamado.	
VO_HERO_02f_Male_Orc_Start_01	Eu trago a fúria dos elementos!	
VO_HERO_02f_Male_Orc_Thanks_01	Você tem minha gratidão.	
VO_HERO_02f_Male_Orc_Threaten_01	Você não me deu escolha.	
VO_HERO_02f_Male_Orc_Well_Played_01	É uma honra para mim.	
VO_HERO_02f_Male_Orc_Wow_01	Estou em estupor!	
VO_HERO_02g_Male_Orc_Attack_01	Basta!	
VO_HERO_02g_Male_Orc_Greetings_01	Reconheço a sua presença.	
VO_HERO_02g_Male_Orc_MIRROR_GREETINGS_01	Estou certo disso.	
VO_HERO_02g_Male_Orc_MIRROR_START_01	Então a sua também.	
VO_HERO_02g_Male_Orc_Oops_01	O que foi isso?	
VO_HERO_02g_Male_Orc_Picked_01	Onde está o inimigo?	
VO_HERO_02g_Male_Orc_Start_01	Chegou a sua hora.	
VO_HERO_02g_Male_Orc_Thanks_01	Você me mostrou a verdadeira gratidão.	
VO_HERO_02g_Male_Orc_Threaten_01	Eu fui criado por humanos, mas não sou tolo.	
VO_HERO_02g_Male_Orc_Well_Played_01	Sua força é admirável.	
VO_HERO_02g_Male_Orc_Wow_01	Realmente espantoso.	
VO_HERO_02h_Male_Orc_Attack_01	Trema de medo!	
VO_HERO_02h_Male_Orc_Greetings_01	Os espíritos estão inquietos!	
VO_HERO_02h_Male_Orc_MIRROR_GREETINGS_01	Então eu também estou.	
VO_HERO_02h_Male_Orc_MIRROR_START_01	Nosso clã nunca titubeou!	
VO_HERO_02h_Male_Orc_Oops_01	Foi um grave erro.	
VO_HERO_02h_Male_Orc_Picked_01	Eu defenderei o vale a qualquer custo.	
VO_HERO_02h_Male_Orc_Start_01	Você vai encarar o poder do clã Lobo do Gelo!	
VO_HERO_02h_Male_Orc_Thanks_01	Os Lobo do Gelo agradecem.	
VO_HERO_02h_Male_Orc_Threaten_01	A terra vai consumir você.	
VO_HERO_02h_Male_Orc_Well_Played_01	Eu vejo sua bravura.	
VO_HERO_02h_Male_Orc_Wow_01	Ancestrais abençoados!	
VO_HERO_02i_Male_Orc_Attack_01	Poder da Horda!	
VO_HERO_02i_Male_Orc_Greetings_01	Throm-ka.	
VO_HERO_02i_Male_Orc_MIRROR_GREETINGS_01	Lok-regar ogull.	
VO_HERO_02i_Male_Orc_MIRROR_START_01	Não se ela for minha...	
VO_HERO_02i_Male_Orc_Oops_01	Um erro de cálculo?	
VO_HERO_02i_Male_Orc_Picked_01	Hoje, cavalgamos para a vitória.	
VO_HERO_02i_Male_Orc_Start_01	A própria terra é minha aliada!	
VO_HERO_02i_Male_Orc_Thanks_01	O Chefe Guerreiro sorri para você.	
VO_HERO_02i_Male_Orc_Threaten_01	Eu sou a fúria da Horda.	
VO_HERO_02i_Male_Orc_Well_Played_01	Você luta com determinação.	
VO_HERO_02i_Male_Orc_Wow_01	Pelos espíritos!	
VO_HERO_02j_Male_Orc_Attack_01	Lok-Narash!	
VO_HERO_02j_Male_Orc_Greetings_01	Força e honra.	
VO_HERO_02j_Male_Orc_MIRROR_GREETINGS_01	Eles sempre nos guiarão.	
VO_HERO_02j_Male_Orc_MIRROR_START_01	Uma causa nobre.	
VO_HERO_02j_Male_Orc_Oops_01	Hm… Foi um erro.	
VO_HERO_02j_Male_Orc_Picked_01	Encontrei meu povo. 	
VO_HERO_02j_Male_Orc_Start_01	Eu trago liberdade à Horda!	
VO_HERO_02j_Male_Orc_Thanks_01	Minha gratidão.	
VO_HERO_02j_Male_Orc_Threaten_01	Você se recusa a reconhecer a força da Horda?	
VO_HERO_02j_Male_Orc_Well_Played_01	Você fez uma luta digna.	
VO_HERO_02j_Male_Orc_Wow_01	Pelos elementos!	
VO_HERO_02k_Male_Orc_Attack_01	Isso acaba agora!	
VO_HERO_02k_Male_Orc_Greetings_01	Glória à Horda.	
VO_HERO_02k_Male_Orc_MIRROR_GREETINGS_01	Que permaneça nobre.	
VO_HERO_02k_Male_Orc_MIRROR_START_01	Não tenho medo. Eu controlo a tempestade!	
VO_HERO_02k_Male_Orc_Oops_01	Que infelicidade...	
VO_HERO_02k_Male_Orc_Picked_01	Toda tempestade chega ao fim.	
VO_HERO_02k_Male_Orc_Start_01	Trema diante da tempestade que se aproxima!	
VO_HERO_02k_Male_Orc_Thanks_01	Que os ancestrais abençoem você.	
VO_HERO_02k_Male_Orc_Threaten_01	As tempestades engolirão meus inimigos!	
VO_HERO_02k_Male_Orc_Well_Played_01	Você luta bem, colega.	
VO_HERO_02k_Male_Orc_Wow_01	Não acredito no que vejo!	
VO_HERO_03_Female_BloodElf_Emote_01	Eu que faço a minha sorte.	
VO_HERO_03_Female_BloodElf_Emote_02	Fique nas sombras!	
VO_HERO_03_Female_BloodElf_Emote_03	Ninguém passa por mim.	
VO_HERO_03_Female_BloodElf_Emote_04	O que é mais aguçado: sua mente ou sua lâmina?	
VO_HERO_03_Female_BloodElf_Emote_05	Quem, eu? Suspeita?	
VO_HERO_03_Female_BloodElf_Emote_06	Desculpa, não quis lhe fazer sombra.	
VO_HERO_03_Female_BloodElf_Emote_07	Nada para ver aqui...	
VO_HERO_03_Female_BloodElf_Emote_08	Vai levar um combo na promoção?	
VO_HERO_03_Female_BloodElf_Emote_09	Sem deixar vestígios.	
VO_HERO_03_Female_BloodElf_Emote_10	Sou leal somente a mim. 	
VO_HERO_03_Female_BloodElf_Emote_11	Eu não ousaria me contrariar se fosse você. 	
VO_HERO_03_Female_BloodElf_Emote_12	Eu trago à tona o melhor de você. 	
VO_HERO_03_HAPPY_NEW_YEAR_06	Feliz ano novo!	
VO_HERO_03a_Attack_15	A justiça é minha!	
VO_HERO_03a_CONCEDE_06	Boas jogadas. Eu desisto.	
VO_HERO_03a_ERROR_FULL_MINIONS_25	Eu tenho lacaios demais!	
VO_HERO_03a_ERROR_GENERIC_30	Não posso fazer isso.	
VO_HERO_03a_ERROR_HAND_FULL_24	Minha mão está cheia!	
VO_HERO_03a_ERROR_I_ATTACKED_22	Eu já ataquei.	
VO_HERO_03a_ERROR_JUST_PLAYED_23	Espere um turno para o lacaio se preparar.	
VO_HERO_03a_ERROR_MINION_ATTACKED_21	Esse lacaio já atacou.	
VO_HERO_03a_ERROR_NEED_MANA_20	Não tenho mana suficiente.	
VO_HERO_03a_ERROR_NEED_WEAPON_19	Preciso de uma arma.	
VO_HERO_03a_ERROR_PLAY_27	Não dá pra fazer essa jogada.	
VO_HERO_03a_ERROR_STEALTH_26	Não posso mirar em lacaios furtivos.	
VO_HERO_03a_ERROR_TARGET_28	Esse não é um alvo válido.	
VO_HERO_03a_ERROR_TAUNT_29	Há um lacaio com Provocar no caminho.	
VO_Hero_03a_Female_NightElf_Start_Illidan_01	Eu encontrei minha presa.	
VO_HERO_03a_FIRE_FESTIVAL	Feliz Festival do Solstício!	
VO_HERO_03a_GREETINGS_03	Salve.	
VO_HERO_03a_GREETINGS_RESPONSE	Que surpresa agradável. Saudações.	
VO_HERO_03a_HALLOWS_END	Feliz Noturnália.	
VO_HERO_03a_HAPPY_HOLIDAYS_52	Feliz Festa do Véu de Inverno!	
VO_HERO_03a_HAPPY_NEW_YEAR_53	Feliz ano novo!	
VO_HERO_03a_HAPPY_NEW_YEAR_LUNAR_16	Feliz Ano Novo!	
VO_HERO_03a_LOW_CARDS_17	Estou quase sem cards.	
VO_HERO_03a_MIRROR_GREETINGS_04	Que surpresa agradável! Saudações.	
VO_HERO_03a_MIRROR_START_02	Eu sou a mão da justiça.	
VO_HERO_03a_NO_CARDS_18	Estou sem cards!	
VO_HERO_03a_NOBLEGARDEN	Feliz Jardinova! Onde estão os ovos?	
VO_HERO_03a_OOPS_08	Um erro estratégico.	
VO_HERO_03a_PICKED_11	A hora é agora!	
VO_HERO_03a_PIRATE_DAY	Iaarrrr, marujo!	
VO_HERO_03a_SORRY_10	Desculpe.	
VO_HERO_03a_START_01	Ninguém pode escapar da minha fúria.	
VO_HERO_03a_THANKS_09	Obrigada.	
VO_HERO_03a_THINK1_12	Hmm…	
VO_HERO_03a_THINK2_13	Hmm... Estou pensando...	
VO_HERO_03a_THINK3_14	Pense…	
VO_HERO_03a_THREATEN_05	Você será alvo da minha ira!	
VO_HERO_03a_TIMER_16	Depressa!	
VO_HERO_03a_WELL_PLAYED_07	Bem jogado.	
VO_HERO_03a_WOW_35	Incrível!	
VO_HERO_03d_Female_BloodElf_Greetings_01	Veio bater um papo?	
VO_HERO_03d_Female_BloodElf_MIRROR_GREETINGS_01	Você me conhece tão bem...	
VO_HERO_03d_Female_BloodElf_MIRROR_START_01	Eu também. 	
VO_HERO_03d_Female_BloodElf_Thanks_01	Agradeço demais.	
VO_HERO_03d_Female_BloodElf_Wow_01	Maravilhoso!	
VO_HERO_03e_Female_BloodElf_Attack_01	Hah!	
VO_HERO_03e_Female_BloodElf_Greetings_01	Ah, olá!	
VO_HERO_03e_Female_BloodElf_IntroGarrosh_01	Isso, sim, vai ser divertido!	
VO_HERO_03e_Female_BloodElf_MIRROR_GREETINGS_01	Um rosto conhecido.	
VO_HERO_03e_Female_BloodElf_MIRROR_START_01	Quando duas pessoas querem...	
VO_HERO_03e_Female_BloodElf_Oops_01	Foi um erro?	
VO_HERO_03e_Female_BloodElf_Start_01	Vamos dançar?	
VO_HERO_03e_Female_BloodElf_Thanks_01	Agradeço muito.	
VO_HERO_03e_Female_BloodElf_Threaten_01	Até as flores têm espinhos.	
VO_HERO_03e_Female_BloodElf_Well_Played_01	Boa luta.	
VO_HERO_03e_Female_BloodElf_Wow_01	Intrigante.	
VO_HERO_03f_Female_BloodElf_Attack_01	Aço frio e cortante!	
VO_HERO_03f_Female_BloodElf_Greetings_01	O dia está bom para uma luta!	
VO_HERO_03f_Female_BloodElf_MIRROR_GREETINGS_01	Não diga.	
VO_HERO_03f_Female_BloodElf_MIRROR_START_01	Difícil esquecer.	
VO_HERO_03f_Female_BloodElf_Oops_01	Ops.	
VO_HERO_03f_Female_BloodElf_Start_01	Lembre-se das minhas lâminas!	
VO_HERO_03f_Female_BloodElf_Thanks_01	Estou em dívida com você.	
VO_HERO_03f_Female_BloodElf_Threaten_01	Isso vai ser rápido... e fácil.	
VO_HERO_03f_Female_BloodElf_Well_Played_01	Você tem um certo talento!	
VO_HERO_03f_Female_BloodElf_Wow_01	Que... coisa linda!	
VO_HERO_03g_Female_BloodElf_Picked_01	Você não vai se arrepender.	
VO_HERO_04_HAPPY_NEW_YEAR_15	Feliz ano novo!	
VO_HERO_04b_Male_Human_START_Illidan_01	Parece que somos páreo um para o outro.	
VO_HERO_04b_Male_Human_START_Jaina_01	Eu sinto muito, Jaina.	
VO_HERO_04b_Male_Human_START_Sylvanas_01	Um destino cruel está à nossa espera, Correventos.	
VO_HERO_04b_Male_Human_START_Uther_01	Vou dar tudo de mim na luta, como você me ensinou!	
VO_HERO_04e_Male_Human_Attack_01	Por Lordaeron!	
VO_HERO_04e_Male_Human_Greetings_01	Salve.	
VO_HERO_04e_Male_Human_MIRROR_GREETINGS_01	Que a Luz abençoe você.	
VO_HERO_04e_Male_Human_MIRROR_START_01	Não mais do que eu.	
VO_HERO_04e_Male_Human_Oops_01	Um equívoco...	
VO_HERO_04e_Male_Human_PICKED_01	Em memória de Lothar!	
VO_HERO_04e_Male_Human_Start_01	O Punho de Prata viverá com honra!	
VO_HERO_04e_Male_Human_Thanks_01	Você tem a minha gratidão.	
VO_HERO_04e_Male_Human_Threaten_01	Sua vida já não lhe pertence.	
VO_HERO_04e_Male_Human_Well_Played_01	Você me impressiona.	
VO_HERO_04e_Male_Human_Wow_01	Esplêndido!	
VO_HERO_04f_Male_Human_Attack_01	Silêncio, animal!	
VO_HERO_04f_Male_Human_Greetings_01	Hoje eu trabalho para mostrar o que valho!	
VO_HERO_04f_Male_Human_MIRROR_GREETINGS_01	Adversários indignos, saiam do caminho!	
VO_HERO_04f_Male_Human_MIRROR_START_01	HAHA, HA!	
VO_HERO_04f_Male_Human_Oops_01	Foi falha? Não espalha!	
VO_HERO_04f_Male_Human_Picked_01	HAHA, HA!	
VO_HERO_04f_Male_Human_Start_01	AHAHAHAHAAA!	
VO_HERO_04f_Male_Human_Thanks_01	Agradeço, de verdade.	
VO_HERO_04f_Male_Human_Threaten_01	Como sempre digo: vai se ver comigo!	
VO_HERO_04f_Male_Human_Well_Played_01	Terminado! Bem jogado. 	
VO_HERO_04f_Male_Human_Wow_01	Assombrado e espantado!	
VO_HERO_04g_Male_Human_Attack_01	Você há de obedecer!	
VO_HERO_04g_Male_Human_Greetings_01	Apresente seus argumentos!	
VO_HERO_04g_Male_Human_MIRROR_GREETINGS_01	Vai demorar um pouco...	
VO_HERO_04g_Male_Human_MIRROR_START_01	Objeção!	
VO_HERO_04g_Male_Human_Oops_01	Eu abomino erros.	
VO_HERO_04g_Male_Human_Start_01	Eu restaurarei a ordem!	
VO_HERO_04g_Male_Human_Thanks_01	Você merece meu agradecimento.	
VO_HERO_04g_Male_Human_Threaten_01	Aqueles que desprezam a Luz devem ficar nas trevas para sempre.	
VO_HERO_04g_Male_Human_Well_Played_01	Muito bem.	
VO_HERO_04g_Male_Human_Wow_01	Meus olhos veem, mas não creio!	
VO_HERO_04h_Male_Human_Attack_01	Pela bravura!	
VO_HERO_04h_Male_Human_Greetings_01	Siga com honra.	
VO_HERO_04h_Male_Human_MIRROR_GREETINGS_01	Esse é o único caminho.	
VO_HERO_04h_Male_Human_MIRROR_START_01	Esse é o único caminho a seguir.	
VO_HERO_04h_Male_Human_Oops_01	Patético!	
VO_HERO_04h_Male_Human_Picked_01	Com honra!	
VO_HERO_04h_Male_Human_Start_01	A Justiça decidirá!	
VO_HERO_04h_Male_Human_Thanks_01	Minha gratidão a você.	
VO_HERO_04h_Male_Human_Threaten_01	Eu luto pelo que é certo. Acha que pode dizer o mesmo?	
VO_HERO_04h_Male_Human_Well_Played_01	Você lutou com dignidade.	
VO_HERO_04h_Male_Human_Wow_01	Magnífico!	
VO_HERO_05_FACTION_CRY_24	Pela Horda!	
VO_HERO_05_FIDGET_09	O tempo passa...	
VO_HERO_05_HAPPY_NEW_YEAR_15	Feliz ano novo!	
VO_HERO_05_INDEED_05	Foi mesmo.	
VO_HERO_05_SALUTE_07	Impressionante.	
VO_HERO_05b_Female_Undead_Concede_01	Eu já suportei demais...	
VO_HERO_05b_Female_Undead_ERROR_FULL_MINIONS_02	Eu já tenho lacaios demais.	
VO_HERO_05b_Female_Undead_ERROR_GENERIC_02	Não posso fazer isso. 	
VO_HERO_05b_Female_Undead_ERROR_HAND_FULL_01	Minha mão está cheia!	
VO_HERO_05b_Female_Undead_ERROR_I_ATTACKED_01	Eu já ataquei.	
VO_HERO_05b_Female_Undead_ERROR_MINION_ATTACKED_01	Esse lacaio já atacou.	
VO_HERO_05b_Female_Undead_ERROR_NEED_MANA_01	Preciso de mana.	
VO_HERO_05b_Female_Undead_ERROR_NEED_WEAPON_01	Preciso de uma arma.	
VO_HERO_05b_Female_Undead_ERROR_PLAY_01	Não posso jogar isso.	
VO_HERO_05b_Female_Undead_ERROR_STEALTH_01	Esse lacaio é furtivo.	
VO_HERO_05b_Female_Undead_ERROR_SUMMON_SICKNESS_01	Esse lacaio ainda não pode lutar.	
VO_HERO_05b_Female_Undead_ERROR_TARGET_01	Não tenho alvo.	
VO_HERO_05b_Female_Undead_ERROR_TAUNT_01	Há um lacaio com Provocar no meio do caminho.	
VO_HERO_05b_Female_Undead_FIRE_FESTIVAL_01	Queima!	
VO_HERO_05b_Female_Undead_Greetings_01	Saudações. Espero que não desperdice meu tempo.	
VO_HERO_05b_Female_Undead_HAPPY_HALLOWEEN_01	Noturnália! A mais reverenciada de todas as noites.	
VO_HERO_05b_Female_Undead_HAPPY_HOLIDAYS_01	Boas festas.	
VO_HERO_05b_Female_Undead_HAPPY_NEW_YEAR_01	Feliz ano novo.	
VO_HERO_05b_Female_Undead_HAPPY_NEW_YEAR_LUNAR_01	Feliz ano novo.	
VO_HERO_05b_Female_Undead_HAPPY_NOBLEGARDEN_01	Feliz Jardinova.	
VO_HERO_05b_Female_Undead_LowCards_01	Estou com poucos cards.	
VO_HERO_05b_Female_Undead_MIRROR_GREETINGS_01	Afinal, QUANTAS irmãs Correventos existem?	
VO_HERO_05b_Female_Undead_MIRROR_START_01	A vitória é... MINHA!	
VO_HERO_05b_Female_Undead_NoCards_01	Estou sem cards!	
VO_HERO_05b_Female_Undead_Oops_02	Um erro.	
VO_HERO_05b_Female_Undead_Picked_01	Que minha mira não falhe...	
VO_HERO_05b_Female_Undead_PIRATE_DAY_02	Tubarões me... hã, sei lá.	
VO_HERO_05b_Female_Undead_Sorry_01	Perdão.	
VO_HERO_05b_Female_Undead_Start_01	Vitória para os Renegados!	
VO_HERO_05b_Female_Undead_Thanks_02	Você tem a minha gratidão.	
VO_HERO_05b_Female_Undead_Thinking_02	A vingança está próxima...	
VO_HERO_05b_Female_Undead_Thinking_03	... que ninguém sobreviva...	
VO_HERO_05b_Female_Undead_Thinking_04	A vitória já está ao meu alcance...	
VO_HERO_05b_Female_Undead_Threaten_02	Você também vai sofrer.	
VO_HERO_05b_Female_Undead_Time_01	Não tenho tempo para brincadeiras!	
VO_HERO_05b_Female_Undead_Well_Played_01	Muito bem jogado.	
VO_HERO_05b_Female_Undead_WOW_01	Muito inteligente!	
VO_HERO_05e_Male_OrcOgre_Attack_01	Minha presa se aproxima.	
VO_HERO_05e_Male_OrcOgre_Greetings_01	Nossos caminhos convergem.	
VO_HERO_05e_Male_OrcOgre_MIRROR_GREETINGS_01	Mas aonde eles levam?	
VO_HERO_05e_Male_OrcOgre_MIRROR_START_01	Naturalmente.	
VO_HERO_05e_Male_OrcOgre_Oops_01	Todo mundo erra de vez em quando.	
VO_HERO_05e_Male_OrcOgre_Picked_01	Nós vamos seguir em frente a qualquer custo.	
VO_HERO_05e_Male_OrcOgre_Start_01	Eu ajo por instinto!	
VO_HERO_05e_Male_OrcOgre_Thanks_01	Obrigado, camarada.	
VO_HERO_05e_Male_OrcOgre_Threaten_01	Seus pedaços servirão de alimento às feras...	
VO_HERO_05e_Male_OrcOgre_Well_Played_01	Você caça bem.	
VO_HERO_05e_Male_OrcOgre_Wow_01	Meus olhos veem, mas não creio!	
VO_HERO_05f_Male_OrcOgre_Attack_01	Heh, bem na cara!	
VO_HERO_05f_Male_OrcOgre_Greetings_01	Lok'tar ogar!	
VO_HERO_05f_Male_OrcOgre_MIRROR_GREETINGS_01	Sim, vitória ou morte!	
VO_HERO_05f_Male_OrcOgre_MIRROR_START_01	Ele ecoa em tudo que é selvagem e livre!	
VO_HERO_05f_Male_OrcOgre_Oops_01	Isso foi um erro.	
VO_HERO_05f_Male_OrcOgre_Picked_01	Seja qual for o desafio, eu vou triunfar.	
VO_HERO_05f_Male_OrcOgre_Start_01	Eu ouço o chamado da natureza.	
VO_HERO_05f_Male_OrcOgre_Thanks_01	Aceite meus humildes agradecimentos.	
VO_HERO_05f_Male_OrcOgre_Threaten_01	Vou caçar você.	
VO_HERO_05f_Male_OrcOgre_Well_Played_01	Você nunca erra o alvo.	
VO_HERO_05f_Male_OrcOgre_Wow_01	Estonteante!	
VO_HERO_05g_Male_OrcOgre_Attack_01	Pelos Mok'Nathal!	
VO_HERO_05g_Male_OrcOgre_Greetings_01	Estou de olho em você.	
VO_HERO_05g_Male_OrcOgre_MIRROR_GREETINGS_01	Aprecie a vista.	
VO_HERO_05g_Male_OrcOgre_MIRROR_START_01	Ou dente e cauda!	
VO_HERO_05g_Male_OrcOgre_Oops_01	Um erro lamentável.	
VO_HERO_05g_Male_OrcOgre_Picked_01	É da nossa natureza lutar.	
VO_HERO_05g_Male_OrcOgre_Start_01	Com garras e presas!	
VO_HERO_05g_Male_OrcOgre_Thanks_01	A natureza agradece.	
VO_HERO_05g_Male_OrcOgre_Threaten_01	Eu lhe darei um fim apropriado.	
VO_HERO_05g_Male_OrcOgre_Well_Played_01	Suas ações falam por você.	
VO_HERO_05g_Male_OrcOgre_Wow_01	Que espetáculo!	
VO_HERO_06_HAPPY_NEW_YEAR_15	Feliz ano novo!	
VO_Hero_06_Male_NightElf_Start_Illidan_01	Você tem muito pelo que responder.	
VO_HERO_06e_Male_NightElf_Attack_01	Inimigos da natureza, cuidado!	
VO_HERO_06e_Male_NightElf_Greetings_01	Estou ouvindo.	
VO_HERO_06e_Male_NightElf_MIRROR_GREETINGS_01	Você sabe o que faz.	
VO_HERO_06e_Male_NightElf_MIRROR_START_01	Ele só pode auxiliar um de nós!	
VO_HERO_06e_Male_NightElf_Oops_01	Um pequeno erro.	
VO_HERO_06e_Male_NightElf_Picked_01	Eu zelo pela vida selvagem.	
VO_HERO_06e_Male_NightElf_Start_01	Cenarius me guia para a vitória.	
VO_HERO_06e_Male_NightElf_Thanks_01	Nem sei como agradecer.	
VO_HERO_06e_Male_NightElf_Threaten_01	Ninguém supera os ventos da guerra.	
VO_HERO_06e_Male_NightElf_Well_Played_01	Pode se orgulhar de sua perícia.	
VO_HERO_06e_Male_NightElf_Wow_01	Por Eluna!	
VO_Hero_06e_Male_Tauren_Attack_01	A natureza é resiliente!	
VO_Hero_06e_Male_Tauren_Concede_01	Eu me rendo.	
VO_Hero_06e_Male_Tauren_ERROR_FULL_MINIONS_01	Eu tenho lacaios demais.	
VO_Hero_06e_Male_Tauren_ERROR_GENERIC_01	Eu não consigo.	
VO_Hero_06e_Male_Tauren_ERROR_GENERIC_02	Impossível.	
VO_Hero_06e_Male_Tauren_ERROR_HAND_FULL_01	Minha mão está cheia!	
VO_Hero_06e_Male_Tauren_ERROR_I_ATTACKED_01	Não posso golpear ainda.	
VO_Hero_06e_Male_Tauren_ERROR_MINION_ATTACKED_01	Esse já atacou.	
VO_Hero_06e_Male_Tauren_ERROR_NEED_MANA_01	Eu não tenho mana suficiente.	
VO_Hero_06e_Male_Tauren_ERROR_NEED_WEAPON_01	Preciso de uma arma!	
VO_Hero_06e_Male_Tauren_ERROR_PLAY_01	Vai além dos meus poderes.	
VO_Hero_06e_Male_Tauren_ERROR_STEALTH_01	Esse está se escondendo de mim.	
VO_Hero_06e_Male_Tauren_ERROR_SUMMON_SICKNESS_01	Não está pronto.	
VO_Hero_06e_Male_Tauren_ERROR_TARGET_01	Eu não consigo chegar lá.	
VO_Hero_06e_Male_Tauren_ERROR_TAUNT_01	Há um inimigo me provocando.	
VO_Hero_06e_Male_Tauren_FIRE_FESTIVAL_01	O fogo é a fonte de renovação e mudança para a floresta... e para nós!	
VO_Hero_06e_Male_Tauren_Greetings_01	Que os ventos guiem você.	
VO_Hero_06e_Male_Tauren_HAPPY_HALLOWEEN_01	Cuide-se! Há espíritos assombrando nossos salões nesta Noturnália...	
VO_Hero_06e_Male_Tauren_HAPPY_HOLIDAYS_01	Hora de deixar tudo alegre e luminoso!	
VO_Hero_06e_Male_Tauren_HAPPY_NEW_YEAR_01	Feliz Ano Novo!	
VO_Hero_06e_Male_Tauren_HAPPY_NEW_YEAR_LUNAR_01	Feliz Ano Novo!	
VO_Hero_06e_Male_Tauren_HAPPY_NOBLEGARDEN_01	Que a natureza abençoe sua Jardinova este ano.	
VO_Hero_06e_Male_Tauren_LowCards_01	Restam poucos cards.	
VO_Hero_06e_Male_Tauren_MIRROR_GREETINGS_01	E você também.	
VO_Hero_06e_Male_Tauren_MIRROR_START_01	De fato. Nós nos complementamos bem!	
VO_Hero_06e_Male_Tauren_NoCards_01	Estou sem cards!	
VO_Hero_06e_Male_Tauren_Oops_01	Um equívoco?	
VO_Hero_06e_Male_Tauren_Picked_01	Eu sirvo à terra!	
VO_Hero_06e_Male_Tauren_PIRATE_DAY_01	Hamuul Dobrão Totem ao seu serviço, cães sarnentos!	
VO_Hero_06e_Male_Tauren_Sorry_01	Perdão.	
VO_Hero_06e_Male_Tauren_Start_01	A natureza busca equilíbrio em todas as coisas.	
VO_Hero_06e_Male_Tauren_Start_Malfurion_01	Fico feliz em ver você, shan'do.	
VO_Hero_06e_Male_Tauren_Thanks_01	Eu agradeço.	
VO_Hero_06e_Male_Tauren_Thinking_01	Hm...	
VO_Hero_06e_Male_Tauren_Thinking_02	Intrigante...	
VO_Hero_06e_Male_Tauren_Thinking_03	Preciso pensar...	
VO_Hero_06e_Male_Tauren_Threaten_02	Aprenda a temperar sua força com sabedoria!	
VO_Hero_06e_Male_Tauren_Time_01	O tempo escorre depressa!	
VO_Hero_06e_Male_Tauren_TRIGGER_FORCE_OF_NATURE_01	Eu aprendi com o melhor... 	
VO_Hero_06e_Male_Tauren_TRIGGER_GIFT_OF_THE_WILD_01	Sejam fortes, meus amigos! 	
VO_Hero_06e_Male_Tauren_TRIGGER_LUNAR_VISIONS_01	Entre em comunhão com a natureza...	
VO_Hero_06e_Male_Tauren_TRIGGER_MOONGLADE_PORTAL_01	Sabedoria da Clareira da Lua!	
VO_Hero_06e_Male_Tauren_TRIGGER_MULCH_01	Todos retornam à terra... 	
VO_Hero_06e_Male_Tauren_TRIGGER_WISPERING_WOODS_01	A floresta fala comigo... 	
VO_Hero_06e_Male_Tauren_Well_Played_01	Muito bem.	
VO_Hero_06e_Male_Tauren_WOW_01	Incrível!	
VO_HERO_06g_Male_NightElf_Attack_01	Anu'dorini Talah!	
VO_HERO_06g_Male_NightElf_Greetings_01	Ishnu'alah.	
VO_HERO_06g_Male_NightElf_MIRROR_GREETINGS_01	Eluna-Adore.	
VO_HERO_06g_Male_NightElf_MIRROR_START_01	Ele está sempre comigo.	
VO_HERO_06g_Male_NightElf_Oops_01	Um erro inocente.	
VO_HERO_06g_Male_NightElf_Picked_01	Se for preciso, eu estarei lá.	
VO_HERO_06g_Male_NightElf_Start_01	Sinta o poder do mundo selvagem!	
VO_HERO_06g_Male_NightElf_Thanks_01	Shaha lor'ma.	
VO_HERO_06g_Male_NightElf_Threaten_01	Tudo que floresce também pode murchar.	
VO_HERO_06g_Male_NightElf_Well_Played_01	Você tem muita sabedoria.	
VO_HERO_06g_Male_NightElf_Wow_01	Magnífico!	
VO_HERO_07_HAPPY_NEW_YEAR_15	Feliz ano novo!	
VO_Hero_07d_Male_OldGod_Attack_02	<estertor de ataque>	
VO_Hero_07d_Male_OldGod_Concede_01	Voltando... a... dormir...	
VO_Hero_07d_Male_OldGod_Death_02	Assim termina...	
VO_Hero_07d_Male_OldGod_ERROR_FULL_MINIONS_02	Há lacaios demais aqui.	
VO_Hero_07d_Male_OldGod_ERROR_GENERIC_04	Não é possível fazer isso.	
VO_Hero_07d_Male_OldGod_ERROR_HAND_FULL_01	Minha mão está cheia.	
VO_Hero_07d_Male_OldGod_ERROR_I_ATTACKED_01	Não posso atacar.	
VO_Hero_07d_Male_OldGod_ERROR_MINION_ATTACKED_01	Esse lacaio está exausto.	
VO_Hero_07d_Male_OldGod_ERROR_NEED_MANA_02	Mana insuficiente.	
VO_Hero_07d_Male_OldGod_ERROR_NEED_WEAPON_01	Preciso de uma arma.	
VO_Hero_07d_Male_OldGod_ERROR_PLAY_01	Não posso jogar isso.	
VO_Hero_07d_Male_OldGod_ERROR_STEALTH_01	Esse lacaio tem furtividade.	
VO_Hero_07d_Male_OldGod_ERROR_STEALTH_02	Eu não posso ver o que está oculto.	
VO_Hero_07d_Male_OldGod_ERROR_SUMMON_SICKNESS_02	Conceda-lhe tempo para que se prepare.	
VO_Hero_07d_Male_OldGod_ERROR_TARGET_01	Não tenho alvo.	
VO_Hero_07d_Male_OldGod_ERROR_TAUNT_01	Preciso atacar o lacaio com Provocar.	
VO_Hero_07d_Male_OldGod_FIRE_FESTIVAL_01	O fogo devora, mas as chamas purificam. 	
VO_Hero_07d_Male_OldGod_Greetings_01	Boas-vindas, serviçal de N'zoth.	
VO_Hero_07d_Male_OldGod_HAPPY_BIRTHDAY_01	As velas tremulam sobre o bolo. Faça um desejo!	
VO_Hero_07d_Male_OldGod_HAPPY_BIRTHDAY_02	Parabéns. Para... Você.	
VO_Hero_07d_Male_OldGod_HAPPY_HALLOWEEN_01	Na Noturnália, o véu é rasgado...	
VO_Hero_07d_Male_OldGod_HAPPY_HOLIDAYS_01	É chegada a época das suas festas.	
VO_Hero_07d_Male_OldGod_HAPPY_NEW_YEAR_01	Outro ano, a aurora do fim.	
VO_Hero_07d_Male_OldGod_HAPPY_NEW_YEAR_LUNAR_01	Outro ano, a aurora do fim.	
VO_Hero_07d_Male_OldGod_HAPPY_NOBLEGARDEN_01	Incontáveis ovos escondidos nas profundezas...	
VO_Hero_07d_Male_OldGod_LowCards_01	O fim do meu deck se aproxima...	
VO_Hero_07d_Male_OldGod_MIRROR_GREETINGS_01	Juntos, nós sonhamos. Somente um acordará.	
VO_Hero_07d_Male_OldGod_MIRROR_START_01	E a cidade adormecida despertará.	
VO_Hero_07d_Male_OldGod_NoCards_01	Meu deck está vazio!	
VO_Hero_07d_Male_OldGod_Oops_02	Com um sussurro, vem o caos.	
VO_Hero_07d_Male_OldGod_Picked_01	Eu posso poupar você do que virá.	
VO_Hero_07d_Male_OldGod_PIRATE_DAY_01	Io... ho... ho...	
VO_Hero_07d_Male_OldGod_Sorry_01	Vou compensar.	
VO_Hero_07d_Male_OldGod_Start_01	Todos os olhos se abrirão!	
VO_Hero_07d_Male_OldGod_START_ARTHAS_01	Seu futuro se desvela, príncipe. Sua coroa abrirá caminho.	
VO_Hero_07d_Male_OldGod_START_AZSHARA_01	Vaidade. Tudo vaidade.	
VO_Hero_07d_Male_OldGod_START_DEATHWING_01	Quebramundo. Você ouviu meu chamado das profundezas.	
VO_Hero_07d_Male_OldGod_START_DRUID_01	Eu sinto suas raízes nas profundezas, despertando o pesadelo.	
VO_Hero_07d_Male_OldGod_START_GARROSH_01	Nossas dádivas não são suas armas, Chefe Guerreiro.	
VO_Hero_07d_Male_OldGod_START_LADYPRESTOR_01	Eu enxergo sua verdadeira natureza.	
VO_Hero_07d_Male_OldGod_START_LADYVASHJ_01	Quantas dádivas foram concedidas por mim ao seu povo, à sua rainha...	
VO_Hero_07d_Male_OldGod_START_LAZUL_01	Por muito tempo eu sussurrei nos seus ouvidos...	
VO_Hero_07d_Male_OldGod_START_MORGL_01	Junte-se a mim nas profundezas, pequenino.	
VO_Hero_07d_Male_OldGod_START_NEMSY_01	Você também ouviu ao chamado das profundezas.	
VO_Hero_07d_Male_OldGod_START_SYLVANAS_01	Eu vejo as maquinações do seu coração sombrio.	
VO_Hero_07d_Male_OldGod_START_THUNDERKING_01	Serviçal dos Titãs, sua hora chegou.	
VO_Hero_07d_Male_OldGod_Thanks_01	Obrigado.	
VO_Hero_07d_Male_OldGod_Thinking_01	Hum... 	
VO_Hero_07d_Male_OldGod_Thinking_02	... verdades infinitas...	
VO_Hero_07d_Male_OldGod_Thinking_04	... o véu desvanece...	
VO_Hero_07d_Male_OldGod_Threaten_02	Sonhe comigo...	
VO_Hero_07d_Male_OldGod_Time_01	A hora está próxima!	
VO_Hero_07d_Male_OldGod_TRIGGER_BANEOFDOOM_01	O fim deles é apenas o início. 	
VO_Hero_07d_Male_OldGod_TRIGGER_DECKOFCHAOS_01	O futuro é a história reescrita.	
VO_Hero_07d_Male_OldGod_TRIGGER_DISCARD_01	Para as profundezas...	
VO_Hero_07d_Male_OldGod_TRIGGER_DRAINLIFE_01	Seu sofrimento é minha força. 	
VO_Hero_07d_Male_OldGod_TRIGGER_HELLFIRE_01	Tudo é ruína.	
VO_Hero_07d_Male_OldGod_TRIGGER_HEROPOWER_01	Sacrifício...	
VO_Hero_07d_Male_OldGod_TRIGGER_HEROPOWER_02	Mais...	
VO_Hero_07d_Male_OldGod_TRIGGER_HEROPOWER_03	Alimento...	
VO_Hero_07d_Male_OldGod_TRIGGER_NZOTH_01	Eu sou muitos. 	
VO_Hero_07d_Male_OldGod_TRIGGER_OPPONENT_SHADOWFORM_01	Sim. Aceite a sombra.	
VO_Hero_07d_Male_OldGod_TRIGGER_PLOTTWIST_01	Nada é o que parece.	
VO_Hero_07d_Male_OldGod_TRIGGER_SHADOWFLAME_01	Eles se entregam a mim.	
VO_Hero_07d_Male_OldGod_TRIGGER_SOULFRAGMENT_01	Meus olhos se abrem.	
VO_Hero_07d_Male_OldGod_TRIGGER_TWISTEDKNOWLEDGE_01	Eu sei o que não se pode saber. Vejo o que não se pode ver.	
VO_Hero_07d_Male_OldGod_TRIGGER_TWISTINGNETHER_01	O caos devora.	
VO_Hero_07d_Male_OldGod_Well_Played_01	Glorioso e terrível!	
VO_Hero_07d_Male_OldGod_WOW_01	Os muitos em mim gritam!	
VO_HERO_08_Female_Human_START_Arthas_01	Não há nada com que eu deva me preocupar, não é, Arthas?	
VO_HERO_08_HAPPY_NEW_YEAR_15	Feliz ano novo!	
VO_HERO_08b_HAPPY_NEW_YEAR_53	Feliz ano novo!	
VO_Hero_08e_Male_Lich_Concede_01	A vitória é sua.	
VO_Hero_08e_Male_Lich_ERROR_FULL_MINIONS_01	Minha seita não pode recrutar mais!	
VO_Hero_08e_Male_Lich_ERROR_GENERIC_01	Não!	
VO_Hero_08e_Male_Lich_ERROR_HAND_FULL_01	Cards demais!	
VO_Hero_08e_Male_Lich_ERROR_I_ATTACKED_01	Eu já ataquei.	
VO_Hero_08e_Male_Lich_ERROR_MINION_ATTACKED_01	Eu não posso atacar de novo.	
VO_Hero_08e_Male_Lich_ERROR_NEED_MANA_01	Mana insuficiente.	
VO_Hero_08e_Male_Lich_ERROR_NEED_WEAPON_02	Preciso de uma arma... 	
VO_Hero_08e_Male_Lich_ERROR_PLAY_01	Não faço ideia.	
VO_Hero_08e_Male_Lich_ERROR_STEALTH_01	Está se escondendo do meu olhar.	
VO_Hero_08e_Male_Lich_ERROR_SUMMON_SICKNESS_01	Ainda não está pronto.	
VO_Hero_08e_Male_Lich_ERROR_TARGET_01	Não consigo mirar.	
VO_Hero_08e_Male_Lich_ERROR_TAUNT_02	Tenho que atacar o que está me provocando.	
VO_Hero_08e_Male_Lich_FIRE_FESTIVAL_01	Por que tem gente com fogo por todo lado? Será que dava para PARAR?	
VO_Hero_08e_Male_Lich_Greetings_01	Saudações da escuridão gélida.	
VO_Hero_08e_Male_Lich_HAPPY_HALLOWEEN_01	Quantas fantasias de Noturnália! Nunca vi tanto morto... vivo!	
VO_Hero_08e_Male_Lich_HAPPY_HOLIDAYS_01	O inverno é minha estação favorita: frio, neve, presentes errados!	
VO_Hero_08e_Male_Lich_HAPPY_NEW_YEAR_01	Feliz ano novo!	
VO_Hero_08e_Male_Lich_HAPPY_NEW_YEAR_LUNAR_01	Feliz ano novo!	
VO_Hero_08e_Male_Lich_HAPPY_NOBLEGARDEN_01	Quem trocou meu filactério por um ovo?! Foi VOCÊ?	
VO_Hero_08e_Male_Lich_LowCards_01	Estou com poucos cards.	
VO_Hero_08e_Male_Lich_MIRROR_GREETINGS_01	Ah, meu lugar favorito!	
VO_Hero_08e_Male_Lich_MIRROR_START_01	Tarde demais.	
VO_Hero_08e_Male_Lich_NoCards_01	Estou sem cards!	
VO_Hero_08e_Male_Lich_Oops_01	Foi uma distração?	
VO_Hero_08e_Male_Lich_Picked_01	Atendam o chamado!	
VO_Hero_08e_Male_Lich_PIRATE_DAY_01	Com uma cara assim, eu seria minha própria bandeira negra.	
VO_Hero_08e_Male_Lich_Sorry_01	Lamento sepulcralmente.	
VO_Hero_08e_Male_Lich_Start_01	Sua curiosidade será a sua ruína.	
VO_Hero_08e_Male_Lich_Start_Arthas_01	Você tem tanto potencial.	
VO_Hero_08e_Male_Lich_Start_Jaina_01	Você ainda está do lado errado, Jaina.	
VO_Hero_08e_Male_Lich_Start_Sylvanas_01	Quer dizer que você ainda está lutando...	
VO_Hero_08e_Male_Lich_Thanks_01	Obrigado.	
VO_Hero_08e_Male_Lich_Thinking_01	Hm...	
VO_Hero_08e_Male_Lich_Thinking_02	Aah?	
VO_Hero_08e_Male_Lich_Thinking_04	Tudo no seu devido tempo.	
VO_Hero_08e_Male_Lich_Threaten_01	O caos sombrio os aguarda.	
VO_Hero_08e_Male_Lich_Time_01	O tempo está contra mim!	
VO_Hero_08e_Male_Lich_TRIGGER_Blizzard_01	Congelarei o sangue em suas veias!	
VO_Hero_08e_Male_Lich_TRIGGER_Cone_of_Cold_01	Sua alma agora é minha!	
VO_Hero_08e_Male_Lich_TRIGGER_Deep_Freeze_01	Não saia daí...	
VO_Hero_08e_Male_Lich_TRIGGER_Evocation_01	Por muitos anos, eu estudei...	
VO_Hero_08e_Male_Lich_TRIGGER_Font_of_Power_01	Guerreiros dos Ermos Gélidos, ergam-se!	
VO_Hero_08e_Male_Lich_TRIGGER_Frost_Nova_01	Tente ser paciente...	
VO_Hero_08e_Male_Lich_TRIGGER_Frostbolt_01	Supliquem por misericórdia!	
VO_Hero_08e_Male_Lich_TRIGGER_Icicle_01	Seus truques baratos não representam desafio!	
VO_Hero_08e_Male_Lich_TRIGGER_Snap_Freeze_01	<maniacal cackle>	
VO_Hero_08e_Male_Lich_Well_Played_01	Muito bem.	
VO_Hero_08e_Male_Lich_WOW_01	Poder incontestável!	
VO_HERO_08f_Female_Human_Attack_01	Aprenda com isso!	
VO_HERO_08f_Female_Human_Greetings_01	Que bom ver você!	
VO_HERO_08f_Female_Human_MIRROR_GREETINGS_01	A gente vive se encontrando.	
VO_HERO_08f_Female_Human_MIRROR_START_01	Você quer ser formar em gelo ou arcano?	
VO_HERO_08f_Female_Human_Oops_01	Só um pequeno deslize.	
VO_HERO_08f_Female_Human_Picked_01	Estou pronta para aprender.	
VO_HERO_08f_Female_Human_Start_01	Eu só queria estudar!	
VO_HERO_08f_Female_Human_Thanks_01	Obrigada pela sua ajuda.	
VO_HERO_08f_Female_Human_Threaten_01	Eu vou me tornar uma grande maga um dia. Você vai ver.	
VO_HERO_08f_Female_Human_Well_Played_01	Não tem ninguém melhor que você na classe.	
VO_HERO_08f_Female_Human_Wow_01	Empolgante!	
VO_HERO_08g_Female_Human_Attack_01	Pelo Kirin Tor!	
VO_HERO_08g_Female_Human_Greetings_01	O que você busca?	
VO_HERO_08g_Female_Human_MIRROR_GREETINGS_01	Paz, justiça e mais criaturas de Polimorfia...	
VO_HERO_08g_Female_Human_MIRROR_START_01	Do melhor tipo.	
VO_HERO_08g_Female_Human_Oops_01	Isso foi intencional?	
VO_HERO_08g_Female_Human_Picked_01	Passei anos estudando para dominar as artes arcanas.	
VO_HERO_08g_Female_Human_Start_01	Conhecimento é poder!	
VO_HERO_08g_Female_Human_Thanks_01	Você tem minha sincera gratidão.	
VO_HERO_08g_Female_Human_Threaten_01	Eu não vou tolerar rebeldia!	
VO_HERO_08g_Female_Human_Well_Played_01	Você é fora do comum.	
VO_HERO_08g_Female_Human_Wow_01	Que encantador!	
VO_HERO_08h_Female_Human_Attack_01	Não adianta. Renda-se!	
VO_HERO_08h_Female_Human_Greetings_01	Eu vim para ajudar!	
VO_HERO_08h_Female_Human_MIRROR_GREETINGS_01	É... muito gentil da sua parte!	
VO_HERO_08h_Female_Human_MIRROR_START_01	Engraçado, eu sinto o mesmo!	
VO_HERO_08h_Female_Human_Oops_01	Opa!	
VO_HERO_08h_Female_Human_Picked_01	Vamos estudar os elementais.	
VO_HERO_08h_Female_Human_Start_01	Eu estou com um bom pressentimento.	
VO_HERO_08h_Female_Human_Thanks_01	Ah, obrigada!	
VO_HERO_08h_Female_Human_Threaten_01	Detesto ter que recorrer à violência!	
VO_HERO_08h_Female_Human_Well_Played_01	Você demonstra verdadeira bravura.	
VO_HERO_08h_Female_Human_Wow_01	Que beleza!	
VO_HERO_08i_Female_Human_Attack_01	Você me faz perder tempo!	
VO_HERO_08i_Female_Human_Greetings_01	Cuidado em quem você confia.	
VO_HERO_08i_Female_Human_MIRROR_GREETINGS_01	Tenho a sensação de que eu posso confiar em você.	
VO_HERO_08i_Female_Human_MIRROR_START_01	Nem é a questão.	
VO_HERO_08i_Female_Human_Oops_01	Foi um lapso grave.	
VO_HERO_08i_Female_Human_Picked_01	Eu nunca vou esquecer Theramore.	
VO_HERO_08i_Female_Human_Start_01	A paz nem sempre é a resposta!	
VO_HERO_08i_Female_Human_Thanks_01	Estou em dívida com você.	
VO_HERO_08i_Female_Human_Threaten_01	Está prestes a ficar muito frio.	
VO_HERO_08i_Female_Human_Well_Played_01	Nunca deixe sua paixão arrefecer.	
VO_HERO_08i_Female_Human_Wow_01	Espetacular!	
VO_HERO_08j_Female_Human_Attack_01	É um mal necessário!	
VO_HERO_08j_Female_Human_Greetings_01	Todos temos nossos fantasmas.	
VO_HERO_08j_Female_Human_MIRROR_GREETINGS_01	Alguns mais do que outros.	
VO_HERO_08j_Female_Human_MIRROR_START_01	Talvez esse tempo nunca tenha existido.	
VO_HERO_08j_Female_Human_Oops_01	Um deslize?	
VO_HERO_08j_Female_Human_Picked_01	Temei a filha do mar.	
VO_HERO_08j_Female_Human_Start_01	A hora de sonhar acabou.	
VO_HERO_08j_Female_Human_Thanks_01	Sou grata pela sua ajuda.	
VO_HERO_08j_Female_Human_Threaten_01	Uma única centelha pode incendiar o mundo.	
VO_HERO_08j_Female_Human_Well_Played_01	Você tem muito poder... Não deixe de mantê-lo sob controle.	
VO_HERO_08j_Female_Human_Wow_01	Inacreditável!	
VO_HERO_08k_Female_Human_Attack_01	Questione tudo!	
VO_HERO_08k_Female_Human_Greetings_01	Saudações calorosas a você.	
VO_HERO_08k_Female_Human_MIRROR_GREETINGS_01	Imagens Espelhadas falam?	
VO_HERO_08k_Female_Human_MIRROR_START_01	Acho que você pode ter razão.	
VO_HERO_08k_Female_Human_Oops_01	O que foi isso?	
VO_HERO_08k_Female_Human_Picked_01	Meu poder trará paz, de um jeito ou de outro.	
VO_HERO_08k_Female_Human_Start_01	Minha magia prevalecerá.	
VO_HERO_08k_Female_Human_Thanks_01	Muitíssimo obrigada.	
VO_HERO_08k_Female_Human_Threaten_01	Você já deu o que tinha que dar.	
VO_HERO_08k_Female_Human_Well_Played_01	Você colocou algum feitiço em mim.	
VO_HERO_08k_Female_Human_Wow_01	Que momento mágico!	
VO_HERO_09_HAPPY_NEW_YEAR_15	Feliz ano novo!	
VO_HERO_09_Male_Human_Emote_01	A Luz é o caminho correto!	
VO_HERO_09_Male_Human_Emote_02	Eu vou rezar por você.	
VO_HERO_09_Male_Human_Emote_03	Os verdadeiros sacerdotes usam placas. 	
VO_HERO_09_Male_Human_Emote_04	Preciso de cura!	
VO_HERO_09_Male_Human_Emote_05	Manda brasa!	
VO_HERO_09_Male_Human_Emote_06	O que eu quero mais é ser rei.	
VO_HERO_09_Male_Human_Emote_07	Eu nem sempre sou legal, mas... geralmente sim. 	
VO_HERO_09_Male_Human_Emote_08	Pela Aliança!	
VO_HERO_09_Male_Human_Emote_09	Ventobravo vai resistir! 	
VO_HERO_09_Male_Human_Emote_10	Sempre vale a pena lutar por uma causa justa.	
VO_HERO_09_Male_Human_Emote_11	Um rei nobre usa cards justos.	
VO_HERO_09_Male_Human_Emote_12	Nunca perca a esperança. 	
VO_HERO_09a_Attack_15	Por Eluna!	
VO_HERO_09a_CONCEDE_06	Acabou. Você venceu.	
VO_HERO_09a_ERROR_FULL_MINIONS_25	Eu tenho lacaios demais!	
VO_HERO_09a_ERROR_GENERIC_30	Eu não posso fazer isso.	
VO_HERO_09a_ERROR_HAND_FULL_24	Minha mão está cheia!	
VO_HERO_09a_ERROR_I_ATTACKED_22	Eu já ataquei.	
VO_HERO_09a_ERROR_JUST_PLAYED_23	Espere um turno para o lacaio se preparar.	
VO_HERO_09a_ERROR_MINION_ATTACKED_21	Esse lacaio já atacou.	
VO_HERO_09a_ERROR_NEED_MANA_20	Não tenho mana suficiente.	
VO_HERO_09a_ERROR_NEED_WEAPON_19	Preciso de uma arma.	
VO_HERO_09a_ERROR_PLAY_27	Não posso fazer essa jogada.	
VO_HERO_09a_ERROR_STEALTH_26	Não consigo mirar em lacaios Furtivos.	
VO_HERO_09a_ERROR_TARGET_28	Este não é um alvo válido.	
VO_HERO_09a_ERROR_TAUNT_29	Há um lacaio com Provocar no caminho.	
VO_Hero_09a_Female_NightElf_Start_Illidan_01	O poder bruto não substitui a verdadeira força.	
VO_HERO_09a_FIRE_FESTIVAL	Feliz Festival do Solstício.	
VO_HERO_09a_GREETINGS_03	Muitas bênçãos para você.	
VO_HERO_09a_GREETINGS_RESPONSE	Para você também.	
VO_HERO_09a_HALLOWS_END	Feliz Noturnália.	
VO_HERO_09a_HAPPY_HOLIDAYS_52	Feliz Festa do Véu de Inverno!	
VO_HERO_09a_HAPPY_NEW_YEAR_01	Feliz ano novo!	
VO_HERO_09a_HAPPY_NEW_YEAR_LUNAR_53	Feliz Ano Novo!	
VO_HERO_09a_LOW_CARDS_17	Estou quase sem cards.	
VO_HERO_09a_MIRROR_GREETINGS_04	Para você também.	
VO_HERO_09a_MIRROR_START_02	A Deusa é a minha proteção.	
VO_HERO_09a_NO_CARDS_18	Estou sem cards!	
VO_HERO_09a_NOBLEGARDEN	Feliz Jardinova.	
VO_HERO_09a_OOPS_08	Apenas um erro.	
VO_HERO_09a_PICKED_11	A Deusa chama!	
VO_HERO_09a_PIRATE_DAY	Palavra de poder: Iarrrr!	
VO_HERO_09a_SORRY_10	Perdoe-me.	
VO_HERO_09a_START_01	Que Eluna me dê forças.	
VO_HERO_09a_START_MALFURION	Meu querido Malfurion.	
VO_HERO_09a_THANKS_09	Obrigada.	
VO_HERO_09a_THINK1_12	Hmm…	
VO_HERO_09a_THINK2_13	Será que…	
VO_HERO_09a_THINK3_14	Qual é a vontade de Eluna...?	
VO_HERO_09a_THREATEN_05	Você vai se arrepender disso!	
VO_HERO_09a_TIMER_16	Depressa!	
VO_HERO_09a_WELL_PLAYED_07	Bem jogado.	
VO_HERO_09a_WOW_10	Brilhante!	
VO_HERO_09b_Female_Troll_Concede_01	Você venceu. Era teu destino.	
VO_HERO_09b_Female_Troll_ERROR_FULL_MINIONS_02	Meu tabuleiro tá cheio!	
VO_HERO_09b_Female_Troll_ERROR_GENERIC_02	Isso é impossível.	
VO_HERO_09b_Female_Troll_ERROR_HAND_FULL_01	Minha mão está cheia!	
VO_HERO_09b_Female_Troll_ERROR_I_ATTACKED_01	Eu já ataquei.	
VO_HERO_09b_Female_Troll_ERROR_MINION_ATTACKED_01	Esse lacaio já atacou.	
VO_HERO_09b_Female_Troll_ERROR_NEED_MANA_02	Preciso de mana!	
VO_HERO_09b_Female_Troll_ERROR_NEED_WEAPON_01	Preciso de uma arma.	
VO_HERO_09b_Female_Troll_ERROR_PLAY_01	Não posso jogar isso.	
VO_HERO_09b_Female_Troll_ERROR_STEALTH_01	Ahhh, esse aí está furtivo.	
VO_HERO_09b_Female_Troll_ERROR_SUMMON_SICKNESS_01	Esse precisa de tempo pra se preparar.	
VO_HERO_09b_Female_Troll_ERROR_TARGET_01	Não tenho alvo.	
VO_HERO_09b_Female_Troll_ERROR_TAUNT_01	Eu tenho que cuidar do lacaio com Provocar.	
VO_HERO_09b_Female_Troll_FIRE_FESTIVAL_01	O Festival do Fogo começou!	
VO_HERO_09b_Female_Troll_Greetings_01	Boas-vindas! Quer que eu leia a tua mão?	
VO_HERO_09b_Female_Troll_HAPPY_HALLOWEEN_01	Ahhh, Noturnália.	
VO_HERO_09b_Female_Troll_HAPPY_HOLIDAYS_01	Boas festas.	
VO_HERO_09b_Female_Troll_HAPPY_NEW_YEAR_01	Um novo ano se inicia...	
VO_HERO_09b_Female_Troll_HAPPY_NEW_YEAR_LUNAR_01	Um novo ano se inicia...	
VO_HERO_09b_Female_Troll_HAPPY_NOBLEGARDEN_01	Feliz Jardinova! 	
VO_HERO_09b_Female_Troll_LowCards_02	Tô com poucos cards.	
VO_HERO_09b_Female_Troll_MIRROR_GREETINGS_02	Eu já sabia que tu ia dizer isso.	
VO_HERO_09b_Female_Troll_MIRROR_START_01	Então tu sabe como termina...	
VO_HERO_09b_Female_Troll_NoCards_02	Estou sem cards!	
VO_HERO_09b_Female_Troll_Oops_01	Opa, isso vai dar uma bela história.	
VO_HERO_09b_Female_Troll_Picked_02	Que tal a gente arranjar uma encrenca?	
VO_HERO_09b_Female_Troll_PIRATE_DAY_01	Io ho ho! 	
VO_HERO_09b_Female_Troll_Sorry_01	Perdão.	
VO_HERO_09b_Female_Troll_Start_02	Eu previ esse confronto...	
VO_HERO_09b_Female_Troll_Thanks_01	Obrigada.	
VO_HERO_09b_Female_Troll_Thinking_06	Hmmm...	
VO_HERO_09b_Female_Troll_Thinking_11	O que os cards dizem?	
VO_HERO_09b_Female_Troll_Thinking_12	... o que eu devo fazer...?	
VO_HERO_09b_Female_Troll_Threaten_03	Teu destino tá selado!	
VO_HERO_09b_Female_Troll_Time_02	O fim está próximo.	
VO_HERO_09b_Female_Troll_Well_Played_01	Bem jogado!	
VO_HERO_09b_Female_Troll_WOW_01	Pelos Deuses Antigos!	
VO_HERO_09d_Male_Human_Greetings_01	Um bom dia para você.	
VO_HERO_09d_Male_Human_MIRROR_GREETINGS_01	Para você também, meu amigo estranhamente familiar!	
VO_HERO_09d_Male_Human_MIRROR_START_01	É no que eu sempre acreditei.	
VO_HERO_09d_Male_Human_Oops_01	Vamos em frente.	
VO_HERO_09d_Male_Human_Thanks_01	Agradeço, sinceramente.	
VO_HERO_09d_Male_Human_Well_Played_01	A Luz guia você.	
VO_HERO_09d_Male_Human_Wow_01	Maravilhoso!	
VO_HERO_09e_Male_Human_Attack_01	Por Ventobravo!	
VO_HERO_09e_Male_Human_Greetings_01	Olá.	
VO_HERO_09e_Male_Human_MIRROR_GREETINGS_01	Ei, essa não é a saudação apropriada!	
VO_HERO_09e_Male_Human_MIRROR_START_01	Você não está sozinho!	
VO_HERO_09e_Male_Human_Oops_01	Como isso foi acontecer?	
VO_HERO_09e_Male_Human_Start_01	Eu protegerei a Aliança.	
VO_HERO_09e_Male_Human_Thanks_01	Você tem minha gratidão.	
VO_HERO_09e_Male_Human_Threaten_01	Não me provoque mais...	
VO_HERO_09e_Male_Human_Well_Played_01	Você luta bem!	
VO_HERO_09e_Male_Human_Wow_01	Uau. Sério, uau!	
VO_HERO_09f_Male_Human_Attack_01	Não reaja!	
VO_HERO_09f_Male_Human_Greetings_01	Meus cumprimentos.	
VO_HERO_09f_Male_Human_MIRROR_GREETINGS_01	Eu gosto do seu estilo.	
VO_HERO_09f_Male_Human_MIRROR_START_01	Sem dúvida a melhor estratégia...	
VO_HERO_09f_Male_Human_Oops_01	Mais cuidado da próxima vez.	
VO_HERO_09f_Male_Human_Start_01	A Sabedoria trará a vitória!	
VO_HERO_09f_Male_Human_Thanks_01	Meus cumprimentos a você.	
VO_HERO_09f_Male_Human_Threaten_01	A sagacidade é uma arma.	
VO_HERO_09f_Male_Human_Well_Played_01	Sábias decisões.	
VO_HERO_09f_Male_Human_Wow_01	Incrível.	
VO_HERO_09h_Female_Draenei_Attack_01	Afasta-te!	
VO_HERO_09h_Female_Draenei_Greetings_01	Eu lhe dou boas-vindas!	
VO_HERO_09h_Female_Draenei_MIRROR_GREETINGS_01	Obrigada por me receber.	
VO_HERO_09h_Female_Draenei_MIRROR_START_01	O momento é MEU.	
VO_HERO_09h_Female_Draenei_Oops_01	Nós crescemos através dos erros.	
VO_HERO_09h_Female_Draenei_Picked_01	Não descansarei até o naaru ser restaurado.	
VO_HERO_09h_Female_Draenei_Start_01	Este é o meu momento.	
VO_HERO_09h_Female_Draenei_Thanks_01	Fico muito grata.	
VO_HERO_09h_Female_Draenei_Threaten_01	Ninguém vai atrapalhar minha missão.	
VO_HERO_09h_Female_Draenei_Well_Played_01	Ah! Que habilidade!	
VO_HERO_09h_Female_Draenei_Wow_01	Eu estou espantada!	
VO_HERO_09i_Female_Draenei_Attack_01	Que a Luz me guie!	
VO_HERO_09i_Female_Draenei_Greetings_01	Archenon poros!	
VO_HERO_09i_Female_Draenei_MIRROR_GREETINGS_01	Sim, para ti e tua família.	
VO_HERO_09i_Female_Draenei_MIRROR_START_01	E eu acabarei com a escuridão.	
VO_HERO_09i_Female_Draenei_Oops_01	Temos que crescer com nossos erros!	
VO_HERO_09i_Female_Draenei_Picked_01	Não descansarei até o naaru ser restaurado.	
VO_HERO_09i_Female_Draenei_Start_01	Vou iluminar o caminho.	
VO_HERO_09i_Female_Draenei_Thanks_01	Gratidão.	
VO_HERO_09i_Female_Draenei_Threaten_01	Enfrentem minha ira!	
VO_HERO_09i_Female_Draenei_Well_Played_01	Estou impressionada.	
VO_HERO_09i_Female_Draenei_Wow_01	Monumental!	
VO_HERO_09j_Female_Draenei_Attack_01	Krypta voros!	
VO_HERO_09j_Female_Draenei_Greetings_01	Você lutará com dignidade.	
VO_HERO_09j_Female_Draenei_MIRROR_GREETINGS_01	Eu sinto o mesmo.	
VO_HERO_09j_Female_Draenei_MIRROR_START_01	Cabe a mim cumprir esse juramento.	
VO_HERO_09j_Female_Draenei_Oops_01	Um erro. Mas não o fim.	
VO_HERO_09j_Female_Draenei_Picked_01	Estamos muito perto do fim para desistir agora!	
VO_HERO_09j_Female_Draenei_Start_01	Pela Luz. Pela minha filha!	
VO_HERO_09j_Female_Draenei_Thanks_01	Quanta generosidade.	
VO_HERO_09j_Female_Draenei_Threaten_01	Arrepende-te!	
VO_HERO_09j_Female_Draenei_Well_Played_01	Um combate lendário!	
VO_HERO_09j_Female_Draenei_Wow_01	De fato vivemos numa era de maravilhas.	
VO_HERO_09k_Female_Draenei_Attack_01	<esforço de ataque>	
VO_HERO_09k_Female_Draenei_BRB_01	Eu voltarei.	
VO_HERO_09k_Female_Draenei_CELEBRATE_01	Desejo-lhe alegria nesta ocasião!	
VO_HERO_09k_Female_Draenei_CHEER_01	Ah, glorioso, glorioso!	
VO_HERO_09k_Female_Draenei_Concede_01	A batalha... é sua...	
VO_HERO_09k_Female_Draenei_CONGRATULATIONS_01	Tu tens a minha gratidão.	
VO_HERO_09k_Female_Draenei_CRY_01	<choro>	
VO_HERO_09k_Female_Draenei_CRY_02	É... demais... 	
VO_HERO_09k_Female_Draenei_DAY_OF_THE_DEAD_01	Um dia para rememorar... aqueles que perdemos.	
VO_HERO_09k_Female_Draenei_Death_01	<morte>	
VO_HERO_09k_Female_Draenei_END_OF_SEASON_01	A temporada se aproxima do fim.	
VO_HERO_09k_Female_Draenei_ERROR_FULL_MINIONS_01	Não há espaço.	
VO_HERO_09k_Female_Draenei_ERROR_GENERIC_01	Isso é impossível.	
VO_HERO_09k_Female_Draenei_ERROR_GENERIC_02	Impossível fazer isso.	
VO_HERO_09k_Female_Draenei_ERROR_HAND_FULL_01	Minha mão está cheia!	
VO_HERO_09k_Female_Draenei_ERROR_I_ATTACKED_01	Eu já ataquei.	
VO_HERO_09k_Female_Draenei_ERROR_MINION_ATTACKED_01	Esse lacaio já atacou.	
VO_HERO_09k_Female_Draenei_ERROR_NEED_MANA_01	Preciso de mais mana.	
VO_HERO_09k_Female_Draenei_ERROR_NEED_MANA_02	Eu preciso de mais poder pra isso. 	
VO_HERO_09k_Female_Draenei_ERROR_NEED_WEAPON_01	Preciso de uma arma.	
VO_HERO_09k_Female_Draenei_ERROR_PLAY_01	Não posso jogar isso.	
VO_HERO_09k_Female_Draenei_ERROR_STEALTH_01	Esse lacaio tem furtividade.	
VO_HERO_09k_Female_Draenei_ERROR_STEALTH_02	Não consigo ver esse!	
VO_HERO_09k_Female_Draenei_ERROR_SUMMON_SICKNESS_01	Esse lacaio não está pronto.	
VO_HERO_09k_Female_Draenei_ERROR_SUMMON_SICKNESS_02	Esse lacaio precisa de tempo para se preparar.	
VO_HERO_09k_Female_Draenei_ERROR_TARGET_01	Não tenho alvo.	
VO_HERO_09k_Female_Draenei_ERROR_TAUNT_01	Tem um lacaio com Provocar no caminho.	
VO_HERO_09k_Female_Draenei_ERROR_TAUNT_02	Preciso atacar o lacaio com Provocar.	
VO_HERO_09k_Female_Draenei_FACTION_CRY_01	Pela Aliança!	
VO_HERO_09k_Female_Draenei_FIDGET_01	Acho que vou aparar os cascos enquanto espero.	
VO_HERO_09k_Female_Draenei_FIRE_FESTIVAL_01	Vamos celebrar a pureza da chama!	
VO_HERO_09k_Female_Draenei_GG_01	Jogada de mestre!	
VO_HERO_09k_Female_Draenei_Greetings_01	Eu lhe trago saudações.	
VO_HERO_09k_Female_Draenei_HAPPY_BIRTHDAY_01	Feliz aniversário!	
VO_HERO_09k_Female_Draenei_HAPPY_BREWFEST_01	Um feriado só para celebrar bebidas. Que coisa.	
VO_HERO_09k_Female_Draenei_HAPPY_EVENT_01	É tempo de celebrar!	
VO_HERO_09k_Female_Draenei_HAPPY_HALLOWEEN_01	Noturnália? Que tradição estranha e sinistra!	
VO_HERO_09k_Female_Draenei_HAPPY_HOLIDAYS_01	Boas festas!	
VO_HERO_09k_Female_Draenei_HAPPY_NEW_YEAR_01	Feliz ano novo!	
VO_HERO_09k_Female_Draenei_HAPPY_NEW_YEAR_LUNAR_01	Feliz ano novo!	
VO_HERO_09k_Female_Draenei_HAPPY_NOBLEGARDEN_01	É para perseguir coelhos? E... ovos? Que coisa confusa.	
VO_HERO_09k_Female_Draenei_HUNGRY_01	Nem todos os que vagueiam estão perdidos, mas muitos estão famintos...	
VO_HERO_09k_Female_Draenei_INDEED_01	É o que dizem.	
VO_HERO_09k_Female_Draenei_KIDS_WEEK_01	Eu faria QUALQUER COISA pela minha filha...	
VO_HERO_09k_Female_Draenei_KISS_01	<som de beijo>	
VO_HERO_09k_Female_Draenei_KISS_02	Muá!	
VO_HERO_09k_Female_Draenei_LAUGH_01	<risada>	
VO_HERO_09k_Female_Draenei_LowCards_01	Meus cards estão ficando escassos.	
VO_HERO_09k_Female_Draenei_MIRROR_GREETINGS_01	Idem.	
VO_HERO_09k_Female_Draenei_MIRROR_START_01	Eu não te darei escolha.	
VO_HERO_09k_Female_Draenei_NICE_CARD_BACK_01	Seu verso de card é adorável!	
VO_HERO_09k_Female_Draenei_NoCards_01	Estou sem cards!	
VO_HERO_09k_Female_Draenei_Oops_01	Ninguém queria que isso acontecesse.	
VO_HERO_09k_Female_Draenei_PARTY_01	Festeje como se este planeta fosse o último!	
VO_HERO_09k_Female_Draenei_Picked_01	Que a Luz guie nossos passos!	
VO_HERO_09k_Female_Draenei_PIRATE_DAY_01	Não compreendo esse "Dia dos Piratas". Fiquei a ver navios.	
VO_HERO_09k_Female_Draenei_SALUTE_01	Eu te saúdo.	
VO_HERO_09k_Female_Draenei_Sorry_01	Ah, sim... Lamento. 	
VO_HERO_09k_Female_Draenei_Start_01	Eu não posso hesitar.	
VO_HERO_09k_Female_Draenei_Start_Cariel_01	Lamento ter chegado a esse ponto, colega.	
VO_HERO_09k_Female_Draenei_Start_Horde_01	Um mercenário da Horda!	
VO_HERO_09k_Female_Draenei_Start_Kazakus_01	A luz do naaru não é para ti.	
VO_HERO_09k_Female_Draenei_Start_Kurtrus_01	Não permita que a tua raiva determine quem tu és, Kurtrus.	
VO_HERO_09k_Female_Draenei_START_OF_SEASON_01	Começa uma temporada! Que ela traga alegria.	
VO_HERO_09k_Female_Draenei_Start_Scabbs_01	Vejo que tu continuas indo direto ao ponto.	
VO_HERO_09k_Female_Draenei_Start_Tavish_01	A busca continua, Tavish.	
VO_HERO_09k_Female_Draenei_Thanks_01	Obrigada.	
VO_HERO_09k_Female_Draenei_Thinking_01	Hmmm…	
VO_HERO_09k_Female_Draenei_Thinking_02	Guia meu punho...	
VO_HERO_09k_Female_Draenei_Thinking_03	Tenho que perseverar...	
VO_HERO_09k_Female_Draenei_Thinking_04	Sim, mas como...?	
VO_HERO_09k_Female_Draenei_Threaten_01	Eu NÃO recuarei.	
VO_HERO_09k_Female_Draenei_Time_01	Não há tempo...!	
VO_HERO_09k_Female_Draenei_TRIGGER_AGAINST_ALL_ODDS_01	Essa foi ímpar!	
VO_HERO_09k_Female_Draenei_TRIGGER_AGAINST_ALL_ODDS_02	Ao meu lado, amigos!	
VO_HERO_09k_Female_Draenei_TRIGGER_CIRCLE_OF_HEALING_01	Fiquem ao meu lado!	
VO_HERO_09k_Female_Draenei_TRIGGER_CONDEMN_LEVEL_1_01	Para trás, todos vocês!	
VO_HERO_09k_Female_Draenei_TRIGGER_CONDEMN_LEVEL_2_01	Fique longe!	
VO_HERO_09k_Female_Draenei_TRIGGER_CONDEMN_LEVEL_3_01	Eu condeno a todos!	
VO_HERO_09k_Female_Draenei_TRIGGER_DESPERATE_PRAYER_01	A batalha está longe de acabar.	
VO_HERO_09k_Female_Draenei_TRIGGER_HOLY_NOVA_01	Ninguém pode se esconder da Luz!	
VO_HERO_09k_Female_Draenei_TRIGGER_HYSTERIA_01	Um alvoroço!	
VO_HERO_09k_Female_Draenei_TRIGGER_IDOL_OF_YSHAARJ_01	Este mundo guarda muitos terrores.	
VO_HERO_09k_Female_Draenei_TRIGGER_MIND_CONTROL_01	Preciso tomar isso emprestado.	
VO_HERO_09k_Female_Draenei_TRIGGER_MOUNT_01	Hahaha, pra cima! Minha garota!	
VO_HERO_09k_Female_Draenei_TRIGGER_PALM_READING_01	Minha palma é roxa, não há como ler.	
VO_HERO_09k_Female_Draenei_TRIGGER_POWER_WORD_SHIELD_01	Que a luz esteja contigo!	
VO_HERO_09k_Female_Draenei_TRIGGER_SHADOW_WORD_DEATH_01	Fora daqui!	
VO_HERO_09k_Female_Draenei_TRIGGER_SHADOW_WORD_PAIN_01	Esse estava incomodando.	
VO_HERO_09k_Female_Draenei_TRIGGER_SILENCE_01	Shhhh…	
VO_HERO_09k_Female_Draenei_VALENTINES_01	Não passamos de carne. Mas o amor... o amor é eterno. 	
VO_HERO_09k_Female_Draenei_WELCOME_01	Boas-vindas!	
VO_HERO_09k_Female_Draenei_Well_Played_02	Tu és um oponente e tanto.	
VO_HERO_09k_Female_Draenei_WOW_02	Por todos os astros dos céus!	
VO_Hero_10_Male_NightElf_Attack_01	A vingança é minha.	
VO_Hero_10_Male_NightElf_Concede_01	Eu me rendo... por enquanto.	
VO_Hero_10_Male_NightElf_ERROR_FULL_MINIONS_01	Já tenho muitos sob meu comando.	
VO_Hero_10_Male_NightElf_ERROR_GENERIC_03	Não é possível.	
VO_Hero_10_Male_NightElf_ERROR_HAND_FULL_01	Minha mão está cheia!	
VO_Hero_10_Male_NightElf_ERROR_I_ATTACKED_01	Eu já ataquei!	
VO_Hero_10_Male_NightElf_ERROR_MINION_ATTACKED_01	O lacaio não pode atacar de novo.	
VO_Hero_10_Male_NightElf_ERROR_NEED_MANA_01	Meu mana está baixo demais.	
VO_Hero_10_Male_NightElf_ERROR_NEED_WEAPON_01	Eu preciso de uma arma.	
VO_Hero_10_Male_NightElf_ERROR_PLAY_01	Eu não consigo...	
VO_Hero_10_Male_NightElf_ERROR_STEALTH_01	Esse está à espreita sob Furtividade.	
VO_Hero_10_Male_NightElf_ERROR_SUMMON_SICKNESS_01	Esse aí NÃO está preparado.	
VO_Hero_10_Male_NightElf_ERROR_TARGET_01	Eu não consigo chegar lá.	
VO_Hero_10_Male_NightElf_ERROR_TAUNT_01	Tem outro ME provocando!	
VO_Hero_10_Male_NightElf_FIRE_FESTIVAL_01	Nossa chama brilhará mais do que a própria Legião!	
VO_Hero_10_Male_NightElf_Greetings_01	O mal se avizinha.	
VO_Hero_10_Male_NightElf_HAPPY_HALLOWEEN_01	A escuridão nos cerca... É Noturnália!	
VO_Hero_10_Male_NightElf_HAPPY_HOLIDAYS_01	Não há festas para traidores.	
VO_Hero_10_Male_NightElf_HAPPY_NEW_YEAR_01	Feliz Ano Novo!	
VO_Hero_10_Male_NightElf_HAPPY_NEW_YEAR_LUNAR_01	Feliz Ano Novo!	
VO_Hero_10_Male_NightElf_HAPPY_NOBLEGARDEN_01	Caçar ovos é um bom treinamento para caçar demônios.	
VO_Hero_10_Male_NightElf_LowCards_01	Restam poucos cards...	
VO_Hero_10_Male_NightElf_MIRROR_GREETINGS_01	Sim. VOCÊ está aqui. 	
VO_Hero_10_Male_NightElf_MIRROR_START_01	Como ousa dirigir a palavra a mim?	
VO_Hero_10_Male_NightElf_NoCards_01	Estou sem cards!	
VO_Hero_10_Male_NightElf_Oops_01	Um equívoco?	
VO_Hero_10_Male_NightElf_Picked_01	Estive preso na escuridão.	
VO_Hero_10_Male_NightElf_PIRATE_DAY_01	Todos a bordo do SS Traição para navegar os mares da Deslealdade!	
VO_Hero_10_Male_NightElf_Sorry_01	Peço desculpas.	
VO_Hero_10_Male_NightElf_Start_01	Isso acaba agora!	
VO_Hero_10_Male_NightElf_Start_Aranna_01	Eu não vou aliviar dessa vez.	
VO_Hero_10_Male_NightElf_Start_Arthas_01	Hoje e sempre… eu serei melhor que você, Arthas.	
VO_Hero_10_Male_NightElf_Start_Maiev_01	É impossível caçar um Caçador de Demônios.	
VO_Hero_10_Male_NightElf_Start_Malfurion_01	Ainda temos assuntos pendentes, irmão.	
VO_Hero_10_Male_NightElf_Start_Mecha_Jaraxxus_01	Voltou para apanhar mais, demônio?	
VO_Hero_10_Male_NightElf_Start_Tyrande_01	Eu vou provar meu valor para você.	
VO_Hero_10_Male_NightElf_Start_Vashj_01	Vamos testar nossa força.	
VO_Hero_10_Male_NightElf_Thanks_01	Eu agradeço.	
VO_Hero_10_Male_NightElf_Thinking_01	Hm...	
VO_Hero_10_Male_NightElf_Thinking_02	Tanta tribulação...	
VO_Hero_10_Male_NightElf_Thinking_03	Demônios? Demônios.	
VO_Hero_10_Male_NightElf_Thinking_04	Estou ficando sem paciência.	
VO_Hero_10_Male_NightElf_Threaten_01	Você não está preparado!	
VO_Hero_10_Male_NightElf_Time_01	O tempo é curto.	
VO_Hero_10_Male_NightElf_TRIGGER_Command_the_Illidari_01	Sirvam ao seu mestre!	
VO_Hero_10_Male_NightElf_TRIGGER_Inner_Demon_01	Todos temos demônios.	
VO_Hero_10_Male_NightElf_TRIGGER_Mana_Burn_01	Queime até virar cinza...	
VO_Hero_10_Male_NightElf_TRIGGER_Metamorphosis_01	Agora estou completo!	
VO_Hero_10_Male_NightElf_TRIGGER_Skull_of_Guldan_01	Ah, pobre bruxo...	
VO_Hero_10_Male_NightElf_TRIGGER_Spectral_Sight_01	Entendo...	
VO_Hero_10_Male_NightElf_Well_Played_01	Você possui poder de verdade.	
VO_Hero_10_Male_NightElf_WOW_01	Como isso é possível?	
VO_HERO_10c_Male_NightElf_Attack_01	Moleza!	
VO_HERO_10c_Male_NightElf_Greetings_01	Eu vou terminar minha caçada.	
VO_HERO_10c_Male_NightElf_MIRROR_GREETINGS_01	Cuide logo disso.	
VO_HERO_10c_Male_NightElf_MIRROR_START_01	Nem o tempo é capaz de atenuar nossa fúria.	
VO_HERO_10c_Male_NightElf_Oops_01	Passo errado?	
VO_HERO_10c_Male_NightElf_Picked_01	Os próprios demônios me temerão.	
VO_HERO_10c_Male_NightElf_Start_01	A fúria da Legião fica pequena perto da minha.	
VO_HERO_10c_Male_NightElf_Thanks_01	Eu agradeço quando é devido.	
VO_HERO_10c_Male_NightElf_Threaten_01	Você vai se arrepender de se aproximar de mim!	
VO_HERO_10c_Male_NightElf_Well_Played_01	Um inimigo interessante.	
VO_HERO_10c_Male_NightElf_Wow_01	Que poder irresistível!	
VO_HERO_10d_Male_NightElf_Attack_01	Estou ficando sem paciência!	
VO_HERO_10d_Male_NightElf_Greetings_01	Quem ousa se dirigir a mim?	
VO_HERO_10d_Male_NightElf_MIRROR_GREETINGS_01	Bem... na verdade, você mesmo.	
VO_HERO_10d_Male_NightElf_MIRROR_START_01	Arde eternamente na minha alma.	
VO_HERO_10d_Male_NightElf_Oops_01	Era isso mesmo?	
VO_HERO_10d_Male_NightElf_Picked_01	Vamos ver como isso termina.	
VO_HERO_10d_Male_NightElf_Start_01	Sinta o ódio de 10.000 anos!	
VO_HERO_10d_Male_NightElf_Thanks_01	Um dia lhe retribuirei esse favor.	
VO_HERO_10d_Male_NightElf_Threaten_01	Hoje e sempre, eu serei melhor que você.	
VO_HERO_10d_Male_NightElf_Well_Played_01	Sua destreza é inegável.	
VO_HERO_10d_Male_NightElf_Wow_01	Quanto esplendor!	
VO_HERO_10e_Male_NightElf_Attack_01	<Esforço de ataque>	
VO_HERO_10e_Male_NightElf_Attack_02	<Esforço de ataque>	
VO_HERO_10e_Male_NightElf_Greetings_01	Saudações.	
VO_HERO_10e_Male_NightElf_MIRROR_GREETINGS_01	Poupe-me das formalidades.	
VO_HERO_10e_Male_NightElf_MIRROR_START_01	… E termina… com Anetheron.	
VO_HERO_10e_Male_NightElf_Oops_01	Ops.	
VO_HERO_10e_Male_NightElf_Picked_01	Eu tenho um único propósito.	
VO_HERO_10e_Male_NightElf_Start_01	Minha missão começa...	
VO_HERO_10e_Male_NightElf_Thanks_01	Agradeço.	
VO_HERO_10e_Male_NightElf_Threaten_01	Trema diante de mim.	
VO_HERO_10e_Male_NightElf_Well_Played_01	Bem jogado.	
VO_HERO_10e_Male_NightElf_Wow_01	Uau.	
VO_HERO_10f_Male_NightElf_Attack_01	Ataque rápido!	
VO_HERO_10f_Male_NightElf_Greetings_01	Estou vendo você.	
VO_HERO_10f_Male_NightElf_MIRROR_GREETINGS_01	De certo modo.	
VO_HERO_10f_Male_NightElf_MIRROR_START_01	Eu nem sonharia com isso.	
VO_HERO_10f_Male_NightElf_Oops_01	Que inconveniente.	
VO_HERO_10f_Male_NightElf_Picked_01	Meu luto me impulsiona.	
VO_HERO_10f_Male_NightElf_Start_01	Não me atrapalhe.	
VO_HERO_10f_Male_NightElf_Thanks_01	Minha gratidão.	
VO_HERO_10f_Male_NightElf_Threaten_01	Saia da frente e não se envolva.	
VO_HERO_10f_Male_NightElf_Well_Played_01	Nossa luta perdurará na memória.	
VO_HERO_10f_Male_NightElf_Wow_01	Inacreditável!	
VO_HERO_10g_Male_NightElf_Attack_01	Finalmente!	
VO_HERO_10g_Male_NightElf_Attack_02	Finalmente!	
VO_HERO_10g_Male_NightElf_Greetings_01	Olá, finalmente.	
VO_HERO_10g_Male_NightElf_MIRROR_GREETINGS_01	Haha...	
VO_HERO_10g_Male_NightElf_MIRROR_START_01	Não mesmo.	
VO_HERO_10g_Male_NightElf_Oops_01	Loucura torpe.	
VO_HERO_10g_Male_NightElf_Picked_01	O dia está bom para vingança.	
VO_HERO_10g_Male_NightElf_Start_01	Esta é a minha forma final?!	
VO_HERO_10g_Male_NightElf_Thanks_01	Eu demonstro gratidão com atos, não com palavras.	
VO_HERO_10g_Male_NightElf_Threaten_01	Vou encontrar você.	
VO_HERO_10g_Male_NightElf_Well_Played_01	Que esse seja o fim.	
VO_HERO_10g_Male_NightElf_Wow_01	Fenomenal.	
VO_HERO_10i_Male_NightElf_Attack_01	Você não me escapa!	
VO_HERO_10i_Male_NightElf_Attack_02	<esforço de ataque>	
VO_HERO_10i_Male_NightElf_BRB_01	Eu estou LDT. Lascando Demônios a Toda.	
VO_HERO_10i_Male_NightElf_CELEBRATE_01	Vamos celebrar!	
VO_HERO_10i_Male_NightElf_CHEER_01	Sim!	
VO_HERO_10i_Male_NightElf_Concede_01	Não, espere!	
VO_HERO_10i_Male_NightElf_CONGRATULATIONS_01	Parabéns.	
VO_HERO_10i_Male_NightElf_CRY_01	<choro>	
VO_HERO_10i_Male_NightElf_DAY_OF_THE_DEAD_01	Neste dia, eu relembrarei aqueles que nós perdemos.	
VO_HERO_10i_Male_NightElf_Death_01	<estertor de morte>	
VO_HERO_10i_Male_NightElf_END_OF_SEASON_01	O pavio da temporada está perto do fim.	
VO_HERO_10i_Male_NightElf_ERROR_FULL_MINIONS_01	Meu tabuleiro está cheio.	
VO_HERO_10i_Male_NightElf_ERROR_GENERIC_01	Não.	
VO_HERO_10i_Male_NightElf_ERROR_GENERIC_02	Não vai dar.	
VO_HERO_10i_Male_NightElf_ERROR_HAND_FULL_01	Minha mão está cheia demais!	
VO_HERO_10i_Male_NightElf_ERROR_I_ATTACKED_01	Ainda não.	
VO_HERO_10i_Male_NightElf_ERROR_MINION_ATTACKED_01	Esse lacaio já atacou.	
VO_HERO_10i_Male_NightElf_ERROR_NEED_MANA_01	Eu não tenho mana suficiente.	
VO_HERO_10i_Male_NightElf_ERROR_NEED_WEAPON_01	Preciso de uma arma!	
VO_HERO_10i_Male_NightElf_ERROR_PLAY_01	Impossível.	
VO_HERO_10i_Male_NightElf_ERROR_STEALTH_01	Esse lacaio tem Furtividade.	
VO_HERO_10i_Male_NightElf_ERROR_SUMMON_SICKNESS_01	Espere um turno para o lacaio se preparar.	
VO_HERO_10i_Male_NightElf_ERROR_TARGET_01	Não consigo mirar nisso.	
VO_HERO_10i_Male_NightElf_ERROR_TAUNT_01	Não está vendo o lacaio com Provocar?	
VO_HERO_10i_Male_NightElf_FACTION_CRY_01	Pela Aliança!	
VO_HERO_10i_Male_NightElf_FACTION_CRY_02	Pelos Illidari!	
VO_HERO_10i_Male_NightElf_FIDGET_01	Não posso titubear na minha missão.	
VO_HERO_10i_Male_NightElf_FIRE_FESTIVAL_01	Desfrute deste dia. Mas eu não gosto do fogo.	
VO_HERO_10i_Male_NightElf_GG_01	Boa partida.	
VO_HERO_10i_Male_NightElf_Greetings_01	Amigo ou inimigo?	
VO_HERO_10i_Male_NightElf_HAPPY_BIRTHDAY_01	Seu aniversário me lembra que estamos um ano mais perto da morte.	
VO_HERO_10i_Male_NightElf_HAPPY_BREWFEST_01	Feliz CervaFest.	
VO_HERO_10i_Male_NightElf_HAPPY_EVENT_01	Hoje é um bom dia.	
VO_HERO_10i_Male_NightElf_HAPPY_HALLOWEEN_01	É Noturnália. Cuidado com os demônios à espreita.	
VO_HERO_10i_Male_NightElf_HAPPY_HOLIDAYS_01	Feliz Festa do Véu de Inverno. Você vai me dar uma glaive de presente?	
VO_HERO_10i_Male_NightElf_HAPPY_NEW_YEAR_01	Feliz ano novo!	
VO_HERO_10i_Male_NightElf_HAPPY_NEW_YEAR_LUNAR_01	Feliz ano novo!	
VO_HERO_10i_Male_NightElf_HAPPY_NOBLEGARDEN_01	Jardinova? Eu caço demônios, não ovos.	
VO_HERO_10i_Male_NightElf_HUNGRY_01	Tenho fome de vingança... e petiscos.	
VO_HERO_10i_Male_NightElf_INDEED_01	De fato.	
VO_HERO_10i_Male_NightElf_KIDS_WEEK_01	É preciso cuidar das crianças e protegê-las.	
VO_HERO_10i_Male_NightElf_KISS_01	<som de beijo>	
VO_HERO_10i_Male_NightElf_LAUGH_01	<risada>	
VO_HERO_10i_Male_NightElf_LowCards_01	Meu cards estão acabando.	
VO_HERO_10i_Male_NightElf_MIRROR_GREETINGS_01	Inimigo de Anetheron é meu amigo.	
VO_HERO_10i_Male_NightElf_MIRROR_START_01	Beba!	
VO_HERO_10i_Male_NightElf_NICE_CARD_BACK_01	Bonito verso de card. Os meus estão todos chamuscados de fogovil.	
VO_HERO_10i_Male_NightElf_NoCards_01	Estou sem cards!	
VO_HERO_10i_Male_NightElf_Oops_01	Não, não, não!	
VO_HERO_10i_Male_NightElf_PARTY_01	É hora de celebrar!	
VO_HERO_10i_Male_NightElf_Picked_01	Junte-se à minha caçada por vingança.	
VO_HERO_10i_Male_NightElf_PIRATE_DAY_01	Hoje eu faço demônios andarem na prancha.	
VO_HERO_10i_Male_NightElf_SALUTE_01	Você tem o meu respeito.	
VO_HERO_10i_Male_NightElf_Sorry_01	Tenho pena de você.	
VO_HERO_10i_Male_NightElf_Start_01	Tenho que saciar minha sede de vingança.	
VO_HERO_10i_Male_NightElf_Start_Illidan_01	Eu só posso descansar quando Anetheron sucumbir.	
VO_HERO_10i_Male_NightElf_Start_MECHAJARAXXUS_01	Aproveite seu suspiro final, demônio.	
VO_HERO_10i_Male_NightElf_START_OF_SEASON_01	Uma nova temporada começa, e a caçada continua.	
VO_HERO_10i_Male_NightElf_Start_Tamsin_01	Primeiro, vai ter que passar por mim.	
VO_HERO_10i_Male_NightElf_Thanks_01	Fico grato por isso.	
VO_HERO_10i_Male_NightElf_Thinking_01	Hmm…	
VO_HERO_10i_Male_NightElf_Thinking_02	Minha resposta está aqui.	
VO_HERO_10i_Male_NightElf_Thinking_03	Minha caçada continua.	
VO_HERO_10i_Male_NightElf_Thinking_04	O que Illidan faria?	
VO_HERO_10i_Male_NightElf_Threaten_01	A vantagem de eu não ter olhos é que não preciso ver a sua cara.	
VO_HERO_10i_Male_NightElf_Threaten_02	Você vai entrar para a minha lista.	
VO_HERO_10i_Male_NightElf_Time_01	As sombras se alargam.	
VO_HERO_10i_Male_NightElf_TRIGGER_AFIGHTOFFURY_01	Fique ao meu lado. Salve Ventobravo.	
VO_HERO_10i_Male_NightElf_TRIGGER_AFIGHTOFFURY_ALT_01	É hoje que você morre, Anetheron.	
VO_HERO_10i_Male_NightElf_TRIGGER_CHAOSNOVA_01	Caos total!	
VO_HERO_10i_Male_NightElf_TRIGGER_COORDINATEDSTRIKE_01	Junte-se a mim e lute!	
VO_HERO_10i_Male_NightElf_TRIGGER_FEASTOFSOULS_01	A guerra tem muito a nos ensinar.	
VO_HERO_10i_Male_NightElf_TRIGGER_FURY_01	<rugido de fúria>	
VO_HERO_10i_Male_NightElf_TRIGGER_INNERDEMON_01	A qualquer custo!	
VO_HERO_10i_Male_NightElf_TRIGGER_METAMORPHOSIS_01	Tudo que me restou foi esse poder!	
VO_HERO_10i_Male_NightElf_TRIGGER_SKULLOFGULDAN_01	Bruxos... são todos iguais.	
VO_HERO_10i_Male_NightElf_TRIGGER_SPECTRALSIGHT_01	Eu nunca vou parar de procurar.	
VO_HERO_10i_Male_NightElf_VALENTINES_01	Que as estrelas guiem você, meu amor. Cuide de nossas crianças.	
VO_HERO_10i_Male_NightElf_WELCOME_01	Boas-vindas!	
VO_HERO_10i_Male_NightElf_Well_Played_01	Você merece respeito.	
VO_HERO_10i_Male_NightElf_WOW_01	Eu vejo, mas não acredito.	
VO_HERO_11_HAPPY_NEW_YEAR_20	Feliz ano novo!	
VO_HERO_12_HAPPY_NEW_YEAR_20	Feliz ano novo!	
VO_HERO_13_HAPPY_NEW_YEAR_20	Feliz ano novo!	
VO_HERO_14_HAPPY_NEW_YEAR_20	Feliz ano novo!	
VO_HERO_15_HAPPY_NEW_YEAR_24	<Feliz Ano Novo!>	
VO_HERO_16_Female_Dryad_Concede_01	Não se pode vencer todas.	
VO_HERO_16_Female_Dryad_ERROR_01	Não tenho arma.	
VO_HERO_16_Female_Dryad_ERROR_02	Preciso de mais mana!	
VO_HERO_16_Female_Dryad_ERROR_03	Esse lacaio não pode atacar de novo!	
VO_HERO_16_Female_Dryad_ERROR_04	Eu já ataquei.	
VO_HERO_16_Female_Dryad_ERROR_05	Esse lacaio ainda não pode atacar.	
VO_HERO_16_Female_Dryad_ERROR_06	Minha mão está abarrotada!	
VO_HERO_16_Female_Dryad_ERROR_07	Eu tenho lacaios demais!	
VO_HERO_16_Female_Dryad_ERROR_08	Esse lacaio covarde está escondido.	
VO_HERO_16_Female_Dryad_ERROR_09	Não posso fazer isso.	
VO_HERO_16_Female_Dryad_ERROR_10	Impossível.	
VO_HERO_16_Female_Dryad_ERROR_11	Tenho que atacar o lacaio com Provocar!	
VO_HERO_16_Female_Dryad_ERROR_12	Não será possível.	
VO_HERO_16_Female_Dryad_FIRE_FESTIVAL_01	Adoro o festival do fogo!	
VO_HERO_16_Female_Dryad_Greetings_01	Que a natureza abençoe você.	
VO_HERO_16_Female_Dryad_GREETINGS_RESPONSE	E você também.	
VO_HERO_16_Female_Dryad_HAPPY_HALLOWEEN_01	Feliz Noturnália!	
VO_HERO_16_Female_Dryad_HAPPY_HOLIDAYS_01	Feliz Festa do Véu de Inverno!	
VO_HERO_16_Female_Dryad_HAPPY_NEW_YEAR_01	Vamos celebrar o Ano Novo!	
VO_HERO_16_Female_Dryad_HAPPY_NEW_YEAR_LUNAR_01	Vamos celebrar o Ano Novo!	
VO_HERO_16_Female_Dryad_HAPPY_NOBLEGARDEN_01	Feliz Jardinova!	
VO_HERO_16_Female_Dryad_LowCards_01	Estou ficando sem cards!	
VO_HERO_16_Female_Dryad_MALFURION_START_01	Ishnu'alah, Arquidruida.	
VO_HERO_16_Female_Dryad_MIRROR_GREETINGS_01	E você também!	
VO_HERO_16_Female_Dryad_MIRROR_START_01	Pelas terras selvagens!	
VO_HERO_16_Female_Dryad_NoCards_01	Não tenho mais cards!	
VO_HERO_16_Female_Dryad_Oops_02	Naturalmente, foi um erro de cálculo.	
VO_HERO_16_Female_Dryad_PIRATE_DAY_01	Iaar! Eu sou pirata!	
VO_HERO_16_Female_Dryad_Sorry_01	Peço desculpas por isso.	
VO_HERO_16_Female_Dryad_Start_01	A floresta contra-ataca.	
VO_HERO_16_Female_Dryad_Thanks_01	Fico grata pelos seus esforços.	
VO_HERO_16_Female_Dryad_Thinking_01	Vejamos...	
VO_HERO_16_Female_Dryad_Thinking_02	Qual tal agora...	
VO_HERO_16_Female_Dryad_Thinking_03	E se...	
VO_HERO_16_Female_Dryad_Threaten_01	Sofra como a natureza sofre!	
VO_HERO_16_Female_Dryad_Time_01	O tempo é curto.	
VO_HERO_16_Female_Dryad_Well_Played_01	Boa jogada!	
VO_HERO_16_Female_Dryad_WOW_01	Essa foi selvagem!	
VO_HERO_17_Female_Treant_CONCEDE	A árvore cai para dar vida à semente...	
VO_HERO_17_Female_Treant_ERROR_FULL_MINIONS	O tabuleiro está meio cheio.	
VO_HERO_17_Female_Treant_ERROR_GENERIC	Lamento, jovem. Não consigo.	
VO_HERO_17_Female_Treant_ERROR_HAND_FULL	Não posso segurar tudo isso.	
VO_HERO_17_Female_Treant_ERROR_I_ATTACKED	Devo descansar, criança.	
VO_HERO_17_Female_Treant_ERROR_JUST_PLAYED	Eles precisam descansar.	
VO_HERO_17_Female_Treant_ERROR_MINION_ATTACKED	Estão meio enrolados.	
VO_HERO_17_Female_Treant_ERROR_NEED_MANA	Acho que acabou o meu mana.	
VO_HERO_17_Female_Treant_ERROR_NEED_WEAPON	Não estou armada, criança.	
VO_HERO_17_Female_Treant_ERROR_PLAY	Não, não, não. Não podemos fazer isso.	
VO_HERO_17_Female_Treant_ERROR_STEALTH	Não estou enxergando bem.	
VO_HERO_17_Female_Treant_ERROR_TARGET	Como faço isso?	
VO_HERO_17_Female_Treant_ERROR_TAUNT	Há um rufião no meio do caminho.	
VO_HERO_17_Female_Treant_FIRE_FESTIVAL	Apague seus fogos de solstício, por favor.	
VO_HERO_17_Female_Treant_GREETINGS	Olá, jovem.	
VO_HERO_17_Female_Treant_GREETINGS_RESPONSE	Jovem? Hohoho! Olá!	VO_HERO_17_Female_Treant_MIRROR_GREETINGS_01.wav
VO_HERO_17_Female_Treant_HALLOWS_END	Estou velha demais para Noturnália.	
VO_HERO_17_Female_Treant_HAPPY_NEW_YEAR_20	Mais um ano que passa.	
VO_HERO_17_Female_Treant_LOW_CARDS	Hmmmm... Onde foram parar meus cards?	
VO_HERO_17_Female_Treant_LUNAR_NEW_YEAR	Olá, jovem.	
VO_HERO_17_Female_Treant_MIRROR_START	Hoje quem ensina sou eu!	
VO_HERO_17_Female_Treant_NO_CARDS	Parece que perdi todos os cards.	
VO_HERO_17_Female_Treant_NOBLEGARDEN	Boa festa de Jardinova para você!	
VO_HERO_17_Female_Treant_OOPS	Ainda sob efeito do sono, imagino.	
VO_HERO_17_Female_Treant_PICKED	Deixe-me contar uma história.	
VO_HERO_17_Female_Treant_PIRATE_DAY	Pirata?! Parece divertido.	
VO_HERO_17_Female_Treant_SORRY	Mil perdões, jovem.	
VO_HERO_17_Female_Treant_START	Quer uma lição?	
VO_HERO_17_Female_Treant_START_MALFURION	Malfurion! Como você cresceu.	
VO_HERO_17_Female_Treant_THANKS	Obrigada, benzinho.	
VO_HERO_17_Female_Treant_THINK1	Hummmm.	
VO_HERO_17_Female_Treant_THINK2	Ahhh, sim.	
VO_HERO_17_Female_Treant_THINK3	No que eu estava pensando mesmo?	
VO_HERO_17_Female_Treant_THREATEN	Você não devia acordar as árvores, criança.	
VO_HERO_17_Female_Treant_TIMER	Depressa.	
VO_HERO_17_Female_Treant_WELL_PLAYED	Impressionante.	
VO_HERO_17_Female_Treant_WINTERVEIL_GREETINGS	Feliz Festa do Véu de Inverno!	
VO_HERO_17_Female_Treant_WOW	Maravilhoso!	
VO_HERO_18_Female_Gnome_Concede_01	Impressionante. Você venceu esta.	
VO_HERO_18_Female_Gnome_ERROR_01	Não era pra eu ter uma arma?	
VO_HERO_18_Female_Gnome_ERROR_03	Mana insuficiente.	
VO_HERO_18_Female_Gnome_ERROR_04	Eles já atacaram.	
VO_HERO_18_Female_Gnome_ERROR_06	Não posso atacar duas vezes.	
VO_HERO_18_Female_Gnome_ERROR_07	Shhh! Ainda estão dormindo.	
VO_HERO_18_Female_Gnome_ERROR_08	Epa! Tem cards demais!	
VO_HERO_18_Female_Gnome_ERROR_10	Só sete lacaios, colega!	
VO_HERO_18_Female_Gnome_ERROR_12	Estão ocultos pela Furtividade!	
VO_HERO_18_Female_Gnome_ERROR_14	Hm, não dá.	
VO_HERO_18_Female_Gnome_ERROR_15	Não consigo mirar.	
VO_HERO_18_Female_Gnome_ERROR_17	Tem um Provocar no caminho.	
VO_HERO_18_Female_Gnome_ERROR_19	Isso é contra as regras!	
VO_HERO_18_Female_Gnome_FIRE_FESTIVAL_01	Os fogos do Solstício são a melhor coisa!	
VO_HERO_18_Female_Gnome_Greetings_01	Opa, camarada!	
VO_HERO_18_Female_Gnome_GREETINGS_RESPONSE	Hihi! Oi!	
VO_HERO_18_Female_Gnome_HAPPY_HALLOWEEN_01	Noturnália!? Oh, que medinho...	
VO_HERO_18_Female_Gnome_HAPPY_HOLIDAYS_01	Feliz Festa do Véu de Inverno!	
VO_HERO_18_Female_Gnome_HAPPY_NEW_YEAR_01	Feliz Ano Novo!	
VO_HERO_18_Female_Gnome_HAPPY_NEW_YEAR_LUNAR_16	Feliz ano novo!	
VO_HERO_18_Female_Gnome_LowCards_01	Meus cards estão acabando!	
VO_HERO_18_Female_Gnome_MIRROR_START_01	Oba! Vai ser muito legal!	
VO_HERO_18_Female_Gnome_NOBLEGARDEN	Adoro Jardinova!	
VO_HERO_18_Female_Gnome_NoCards_01	Estou sem cards!	
VO_HERO_18_Female_Gnome_Oops_02	Opa!	
VO_HERO_18_Female_Gnome_PIRATE_DAY_01	Iaar, eu sou pirata! Iaarr!	
VO_HERO_18_Female_Gnome_Sorry_01	Aaah, desculpa.	
VO_HERO_18_Female_Gnome_Start_01	Vamos nos divertir!	
VO_HERO_18_Female_Gnome_Thanks_02	Óuuuun, obrigada!	
VO_HERO_18_Female_Gnome_Thinking_01	Hummmm...	
VO_HERO_18_Female_Gnome_Thinking_03	Hm, dum, dum, dee, dum...	
VO_HERO_18_Female_Gnome_Thinking_04	Será que…	
VO_HERO_18_Female_Gnome_Threaten_01	Você daria uma marionete fofinha.	
VO_HERO_18_Female_Gnome_Time_01	Bora! Bora!	
VO_HERO_18_Female_Gnome_Well_Played_01	Uau, bem jogado!	
VO_HERO_18_Female_Gnome_WOW_01	Essa foi INCRÍVEL!	
VO_ICC08_LichKing_Male_Human_YoungArthas_02	Eu odeio jogar contra mim.	
VO_INNKEEPER_Male_Dwarf_HERONAME_ANNHYLDE_01	Annhylde!	
VO_INNKEEPER_Male_Dwarf_HERONAME_DEATHWING_01	Asa da Morte!	
VO_INNKEEPER_Male_Dwarf_HERONAME_ELISE_02	Elise!	
VO_Innkeeper_Male_Dwarf_HERONAME_ILLIDAN_01	Illidan!	
VO_Innkeeper_Male_Dwarf_HERONAME_KELTHUZAD_01	Kel'Thuzad!	
VO_INNKEEPER_Male_Dwarf_HERONAME_LAZUL_01	Lazul!	
VO_INNKEEPER_Male_Dwarf_HERONAME_LAZUL_02	Lazul!	
VO_INNKEEPER_Male_Dwarf_HERONAME_MECHAJAR_03	Meca-Jaraxxus!	
VO_INNKEEPER_Male_Dwarf_HERONAME_NZOTH_02	N'Zoth!	
VO_INNKEEPER_Male_Dwarf_HERONAME_NZOTH_03	N'Zoth!	
VO_INNKEEPER_Male_Dwarf_HERONAME_RASTAKHAN_01	Rastakhan!	
VO_INNKEEPER_Male_Dwarf_HERONAME_RASTAKHAN_02	Rastakhan!	
VO_INNKEEPER_Male_Dwarf_Heroname_ThunderKing_01	O Rei Trovão!	
VO_INNKEEPER_Male_Naga_HERONAME_VASHJ_01	Lady Vashj!	
VO_MechaJar_Male_Demon_Concede_01	Você venceu... MAS SEU MUNDO CONTINUA CONDENADO!	
VO_MechaJar_Male_Demon_ERROR_FULL_MINIONS_01	MEU TABULEIRO ESTÁ CHEIO.	
VO_MechaJar_Male_Demon_ERROR_GENERIC_01	IMPOSSÍVEL FAZER ISSO.	
VO_MechaJar_Male_Demon_ERROR_HAND_FULL_01	MINHA MÃO ESTÁ CHEIA.	
VO_MechaJar_Male_Demon_ERROR_I_ATTACKED_01	EU JÁ ATAQUEI.	
VO_MechaJar_Male_Demon_ERROR_MINION_ATTACKED_01	ESSE LACAIO JÁ ATACOU.	
VO_MechaJar_Male_Demon_ERROR_NEED_MANA_01	PRECISO DE MANA.	
VO_MechaJar_Male_Demon_ERROR_NEED_WEAPON_01	NÃO TENHO ARMA.	
VO_MechaJar_Male_Demon_ERROR_PLAY_01	NÃO POSSO JOGAR ESTE CARD.	
VO_MechaJar_Male_Demon_ERROR_STEALTH_01	ESSE LACAIO PATÉTICO ESTÁ ESCONDIDO.	
VO_MechaJar_Male_Demon_ERROR_SUMMON_SICKNESS_01	O LACAIO PRECISA DE UM TURNO PARA SE PREPARAR.	
VO_MechaJar_Male_Demon_ERROR_TARGET_01	NÃO CONSIGO MIRAR NISSO.	
VO_MechaJar_Male_Demon_ERROR_TAUNT_01	HÁ UM LACAIO COM PROVOCAR NO CAMINHO.	
VO_MechaJar_Male_Demon_FIRE_FESTIVAL_01	Feliz Festival do Fogo. TODOS PERECERÃO NAS CHAMAS.	
VO_MechaJar_Male_Demon_Greetings_02	Boas-vindas... À OBLITERAÇÃO!	
VO_MechaJar_Male_Demon_HAPPY_HALLOWEEN_01	É Noturnália. O DIA DA SUA DESTRUIÇÃO.	
VO_MechaJar_Male_Demon_HAPPY_HOLIDAYS_01	Aproveite a Festa do Véu de Inverno! ENQUANTO PODE!	
VO_MechaJar_Male_Demon_HAPPY_NEW_YEAR_01	Feliz ano novo. É SEU ÚLTIMO ANO NOVO.	
VO_MechaJar_Male_Demon_HAPPY_NEW_YEAR_LUNAR_01	Feliz ano novo!	
VO_MechaJar_Male_Demon_HAPPY_NOBLEGARDEN_01	AS FESTIVIDADES DE JARDINOVA TERÃO INÍCIO AGORA.	
VO_MechaJar_Male_Demon_LowCards_01	MEU DECK SE APROXIMA DO FIM.	
VO_MechaJar_Male_Demon_MIRROR_GREETINGS_03	Você apenas se filiou à obliteração. EU NASCI NELA!	
VO_MechaJar_Male_Demon_MIRROR_START_01	IDEM, TOLO!	
VO_MechaJar_Male_Demon_NoCards_01	MEUS CARDS SE ESGOTARAM.	
VO_MechaJar_Male_Demon_Oops_02	ERRO! ERRO!	
VO_MechaJar_Male_Demon_Picked_01	JARAXXUS CONECTADO.	
VO_MechaJar_Male_Demon_PIRATE_DAY_01	Io-ho. REPETIR. Io-ho. ENTRANDO EM MODO PIRATA.	
VO_MechaJar_Male_Demon_Sorry_01	Eu... LAMENTO!	
VO_MechaJar_Male_Demon_Start_02	Você enfrenta... MECA-JARAXXUS!	
VO_MechaJar_Male_Demon_Thanks_01	OBRIGADO.	
VO_MechaJar_Male_Demon_Thinking_01	Hmmm.	
VO_MechaJar_Male_Demon_Thinking_02	Eu vou... destruir...	
VO_MechaJar_Male_Demon_Thinking_05	Calculando...	
VO_MechaJar_Male_Demon_Threaten_04	A ARROGÂNCIA SERÁ SUA RUÍNA!	
VO_MechaJar_Male_Demon_Time_01	O TEMPO ESTÁ SE ESGOTANDO.	
VO_MechaJar_Male_Demon_TRIGGER_DOOM_01	DIA DE CABUM!	
VO_MechaJar_Male_Demon_TRIGGER_RENOUCEDARKNESS_01	EXCLUIR ESCURIDÃO!	
VO_MechaJar_Male_Demon_Well_Played_01	JOGOU BEM!	
VO_MechaJar_Male_Demon_WOW_01	IMPRESSIONANTE.	
VO_Story_Hero_Rexxar_Male_Orc-Ogre_Story_Rexxar_Attack_01	Não quero fazer isso... Mas farei.	
VO_Story_Hero_Rexxar_Male_Orc-Ogre_Story_Rexxar_Greetings_01	Saudações.	
VO_TBA01_4__Concede	*Rosnado*	
VO_TBA01_4__Error_Full_Minions	*Rosnado*	
VO_TBA01_4__Error_Generic	*Rosnado*	
VO_TBA01_4__Error_Hand_Full	*Rosnado*	
VO_TBA01_4__Error_I_Attacked	*Rosnado*	
VO_TBA01_4__Error_Just_Played	*Rosnado*	
VO_TBA01_4__Error_Minion_Attacked	*Rosnado*	
VO_TBA01_4__Error_Need_Mana	*Rosnado*	
VO_TBA01_4__Error_Need_Weapon	*Rosnado*	
VO_TBA01_4__Error_Play	*Rosnado*	
VO_TBA01_4__Error_Stealth	*Rosnado*	
VO_TBA01_4__Good_Game	*Rosnado*	
VO_TBA01_4__Greetings	Que comecem os jogos!	
VO_TBA01_4__Low_Cards	*Rosnado*	
VO_TBA01_4__No_Cards	*Rosnado*	
VO_TBA01_4__Oops	<risada sinistra>	
VO_TBA01_4__Sorry	<risada ameaçadora>	
VO_TBA01_4__Start	Eu sou o mestre aqui!	
VO_TBA01_4__Thanks	<risada maligna>	
VO_TBA01_4__Threaten	Contemple! O verdadeiro poder de NEFARIAN!	
VO_TBA01_4__Timer	*Rosnado*	
VO_TBA01_4__Well_Played	<risada malévola>	
VO_TRLA_204h_Male_Troll_Concede_03	Tu venceu... mas eu nunca esqueço e nunca perdoo!	
VO_TRLA_204h_Male_Troll_Greetings_01	Ah, olha só quem tá vindo!	
VO_TRLA_204h_Male_Troll_LowCards_01	Tô precisando de mais cards...	
VO_TRLA_204h_Male_Troll_Mirror_Greetings_01	É tu. Vai no curandeiro de olho.	
VO_TRLA_204h_Male_Troll_NoCards_01	Não tem mais nenhum card!	
VO_TRLA_204h_Male_Troll_Oops_01	Ah... Foi um erro.	
VO_TRLA_204h_Male_Troll_Thanks_01	Muita gentileza tua.	
VO_TRLA_204h_Male_Troll_Thinking_03	Hmmm… 	
VO_TRLA_204h_Male_Troll_Thinking_09	Hmm. O que é que eu faço?	
VO_TRLA_204h_Male_Troll_Thinking_10	Hmm. Isso vai doer... 	
VO_TRLA_204h_Male_Troll_Threaten_01	Tu vai provar o gosto do machado!	
VO_TRLA_204h_Male_Troll_Time_01	O tempo tá curto!	
VO_TRLA_204h_Male_Troll_Well_Played_02	Essa foi boa.	
VO_TRLA_204h_Male_Troll_WOW_01	Pelo loa do meu povo!	
VO_ULDA_Brann_Male_Dwarf_Attack_02	Você já era!	
VO_ULDA_Brann_Male_Dwarf_Concede_01	Os outros vão me vingar!	
VO_ULDA_Brann_Male_Dwarf_Death_02	Estava... ao meu alcance...	
VO_ULDA_Brann_Male_Dwarf_ERROR_FULL_MINIONS_02	Eu tenho lacaios demais.	
VO_ULDA_Brann_Male_Dwarf_ERROR_GENERIC_03	Não posso fazer isso.	
VO_ULDA_Brann_Male_Dwarf_ERROR_HAND_FULL_01	Minha mão está cheia!	
VO_ULDA_Brann_Male_Dwarf_ERROR_I_ATTACKED_01	Eu já ataquei.	
VO_ULDA_Brann_Male_Dwarf_ERROR_MINION_ATTACKED_01	Esse lacaio já atacou.	
VO_ULDA_Brann_Male_Dwarf_ERROR_NEED_MANA_02	Preciso de mais mana pra isso. 	
VO_ULDA_Brann_Male_Dwarf_ERROR_NEED_WEAPON_01	Preciso de uma arma.	
VO_ULDA_Brann_Male_Dwarf_ERROR_PLAY_01	Eu não posso jogar isso.	
VO_ULDA_Brann_Male_Dwarf_ERROR_STEALTH_01	Esse lacaio tem furtividade.	
VO_ULDA_Brann_Male_Dwarf_ERROR_SUMMON_SICKNESS_01	Esse lacaio precisa se preparar.	
VO_ULDA_Brann_Male_Dwarf_ERROR_TARGET_02	Me aponta um alvo!	
VO_ULDA_Brann_Male_Dwarf_ERROR_TAUNT_01	Há um lacaio com provocar no meio do caminho.	
VO_ULDA_Brann_Male_Dwarf_Greetings_01	Opa, olá!	
VO_ULDA_Brann_Male_Dwarf_HAPPY_BIRTHDAY_01	Feliz aniversário!	
VO_ULDA_Brann_Male_Dwarf_HAPPY_BREWFEST_01	Ah, CervaFest! A mais espumante das festas!	
VO_ULDA_Brann_Male_Dwarf_HAPPY_HALLOWEEN_01	Cuidado aí... É Noturnália!	
VO_ULDA_Brann_Male_Dwarf_HAPPY_HOLIDAYS_01	Boas festas!	
VO_ULDA_Brann_Male_Dwarf_HAPPY_NEW_YEAR_01	Feliz Ano Novo!	
VO_ULDA_Brann_Male_Dwarf_HAPPY_NEW_YEAR_LUNAR_01	Feliz Ano Novo!	
VO_ULDA_Brann_Male_Dwarf_HAPPY_NOBLEGARDEN_01	Esses ovos de Jardinova não são segredo pra mim.	
VO_ULDA_Brann_Male_Dwarf_LowCards_01	Preciso encontrar mais cards.	
VO_ULDA_Brann_Male_Dwarf_MIRROR_GREETINGS_01	Digo o mesmo, colega.	
VO_ULDA_Brann_Male_Dwarf_MIRROR_START_01	Alguém duplicou meu grito de guerra!	
VO_ULDA_Brann_Male_Dwarf_NoCards_01	Não tem mais nenhum card!	
VO_ULDA_Brann_Male_Dwarf_Oops_02	Ninguém precisa ficar sabendo disso.	
VO_ULDA_Brann_Male_Dwarf_Picked_01	As respostas estão aqui. Eu sinto que tão!	
VO_ULDA_Brann_Male_Dwarf_PIRATE_DAY_01	Tubarões me mordam! Se tu gosta, quem sou eu pra falar?	
VO_ULDA_Brann_Male_Dwarf_Sorry_01	Desculpa, tchê.	
VO_ULDA_Brann_Male_Dwarf_Start_01	Agora eu te encurralei.	
VO_ULDA_Brann_Male_Dwarf_Thanks_02	Agradeço bastante!	
VO_ULDA_Brann_Male_Dwarf_Thinking_01	Hmm…	
VO_ULDA_Brann_Male_Dwarf_Thinking_02	... Talvez seja uma armadilha...	
VO_ULDA_Brann_Male_Dwarf_Thinking_03	... Pense, Brann, pense…	
VO_ULDA_Brann_Male_Dwarf_Thinking_04	… Se eu fizer direito...	
VO_ULDA_Brann_Male_Dwarf_Thinking_05	... Nós somos a liga … dos exploradores...	
VO_ULDA_Brann_Male_Dwarf_Thinking_06	… venham lutar ao nosso lado	
VO_ULDA_Brann_Male_Dwarf_Threaten_02	Tu não vai conseguir me deter!	
VO_ULDA_Brann_Male_Dwarf_Time_01	Só uma pressãozinha do tempo.	
VO_ULDA_Brann_Male_Dwarf_Well_Played_01	Ah, é ASSIM que se faz!	
VO_ULDA_Brann_Male_Dwarf_WOW_01	Pela barba mineralizada de Magni!	
VO_ULDA_Elise_Female_NightElf_Concede_02	O mais recomendável é... recuar!	
VO_ULDA_Elise_Female_NightElf_Death_02	Não desse jeito...	
VO_ULDA_Elise_Female_NightElf_ERROR_FULL_MINIONS_01	Eu já atingi a cota de lacaios que posso controlar.	
VO_ULDA_Elise_Female_NightElf_ERROR_GENERIC_01	Absolutamente impossível.	
VO_ULDA_Elise_Female_NightElf_ERROR_HAND_FULL_01	Não posso segurar esses cards todos!	
VO_ULDA_Elise_Female_NightElf_ERROR_I_ATTACKED_01	Eu já ataquei.	
VO_ULDA_Elise_Female_NightElf_ERROR_MINION_ATTACKED_01	Esse aí está exausto. 	
VO_ULDA_Elise_Female_NightElf_ERROR_NEED_MANA_01	Mana insuficiente.	
VO_ULDA_Elise_Female_NightElf_ERROR_NEED_WEAPON_01	Seria bom equipar uma arma antes.	
VO_ULDA_Elise_Female_NightElf_ERROR_PLAY_01	Não dá.	
VO_ULDA_Elise_Female_NightElf_ERROR_STEALTH_01	Ainda está sob Furtividade.	
VO_ULDA_Elise_Female_NightElf_ERROR_SUMMON_SICKNESS_01	É só uma sonequinha.	
VO_ULDA_Elise_Female_NightElf_ERROR_TARGET_01	Está fora do meu alcance.	
VO_ULDA_Elise_Female_NightElf_ERROR_TAUNT_01	Tem um ser com Provocar no caminho.	
VO_ULDA_Elise_Female_NightElf_Greetings_01	Eu sou Elise Mirestela, e você não vai se safar!	
VO_ULDA_Elise_Female_NightElf_HAPPY_BIRTHDAY_01	Que seu dia seja cheio de tesouros.	
VO_ULDA_Elise_Female_NightElf_HAPPY_HALLOWEEN_01	As origens da Noturnália são aterrorizantes!	
VO_ULDA_Elise_Female_NightElf_HAPPY_HOLIDAYS_01	Você se comportou bem para o Papai Inverno?	
VO_ULDA_Elise_Female_NightElf_HAPPY_NEW_YEAR_01	Feliz Ano Novo!	
VO_ULDA_Elise_Female_NightElf_HAPPY_NEW_YEAR_LUNAR_01	Feliz Ano Novo!	
VO_ULDA_Elise_Female_NightElf_HAPPY_NOBLEGARDEN_01	Ah, como eu adoro Jardinova!	
VO_ULDA_Elise_Female_NightElf_LowCards_01	Estou com poucos cards.	
VO_ULDA_Elise_Female_NightElf_MIRROR_GREETINGS_01	É mesmo? Pouquíssimas coisas que você possa fazer me surpreenderiam. 	
VO_ULDA_Elise_Female_NightElf_MIRROR_START_01	Pelo visto eu sou minha pior inimiga.	
VO_ULDA_Elise_Female_NightElf_NoCards_01	Meus cards sumiram!	
VO_ULDA_Elise_Female_NightElf_Oops_01	Um erro.	
VO_ULDA_Elise_Female_NightElf_Picked_01	Hora de entrar em ação.	
VO_ULDA_Elise_Female_NightElf_PIRATE_DAY_01	Capitã Mirestela a seu dispor, marujo!	
VO_ULDA_Elise_Female_NightElf_Sorry_01	Aceite minhas desculpas.	
VO_ULDA_Elise_Female_NightElf_Start_02	A Liga dos Exploradores não fracassará!	
VO_ULDA_Elise_Female_NightElf_Thanks_02	Fico muito grata por isso!	
VO_ULDA_Elise_Female_NightElf_Thinking_01	Não posso fracassar...	
VO_ULDA_Elise_Female_NightElf_Thinking_02	Os riscos são altos...	
VO_ULDA_Elise_Female_NightElf_Thinking_03	Hm...	
VO_ULDA_Elise_Female_NightElf_Thinking_04	Que intrigante...	
VO_ULDA_Elise_Female_NightElf_Threaten_01	Estou avisando: eu estudei para esta luta.	
VO_ULDA_Elise_Female_NightElf_Time_01	O tempo é curto. 	
VO_ULDA_Elise_Female_NightElf_Well_Played_01	Esta batalha entrará para a história.	
VO_ULDA_Elise_Female_NightElf_WOW_01	Incrível.	
VO_ULDA_Finley_Male_Murloc_Concede_01	Muito bem, a vitória é sua.	
VO_ULDA_Finley_Male_Murloc_ERROR_FULL_MINIONS_01	Não há espaço suficiente.	
VO_ULDA_Finley_Male_Murloc_ERROR_GENERIC_04	Seria muita grosseria.	
VO_ULDA_Finley_Male_Murloc_ERROR_HAND_FULL_02	Card demais... Ó, céus.	
VO_ULDA_Finley_Male_Murloc_ERROR_I_ATTACKED_02	A ética dita que só posso atacar uma vez por turno.	
VO_ULDA_Finley_Male_Murloc_ERROR_MINION_ATTACKED_01	Esse lacaio já atacou.	
VO_ULDA_Finley_Male_Murloc_ERROR_NEED_MANA_02	Precisarei de mais mana pra isso. 	
VO_ULDA_Finley_Male_Murloc_ERROR_NEED_WEAPON_02	Para isto, precisarei de uma arma.	
VO_ULDA_Finley_Male_Murloc_ERROR_PLAY_01	Não dá pra fazer isto.	
VO_ULDA_Finley_Male_Murloc_ERROR_STEALTH_01	Esse lacaio tem furtividade.	
VO_ULDA_Finley_Male_Murloc_ERROR_SUMMON_SICKNESS_01	Espere um instante para o lacaio se preparar.	
VO_ULDA_Finley_Male_Murloc_ERROR_TARGET_02	É necessário haver um alvo.	
VO_ULDA_Finley_Male_Murloc_ERROR_TAUNT_02	Esse lacaio com Provocar está se provando um verdadeiro estorvo.	
VO_ULDA_Finley_Male_Murloc_Greetings_01	Ó, mas que belo dia.	
VO_ULDA_Finley_Male_Murloc_HAPPY_BIRTHDAY_01	Feliz aniversário!	
VO_ULDA_Finley_Male_Murloc_HAPPY_BREWFEST_01	CervaFest? Meu desejo é beber como um bacalhau no mar.	
VO_ULDA_Finley_Male_Murloc_HAPPY_HALLOWEEN_01	Noturnália! Ó, que feriado odioso.	
VO_ULDA_Finley_Male_Murloc_HAPPY_HOLIDAYS_01	Boas festas!	
VO_ULDA_Finley_Male_Murloc_HAPPY_NEW_YEAR_01	Feliz Ano Novo!	
VO_ULDA_Finley_Male_Murloc_HAPPY_NEW_YEAR_LUNAR_01	Feliz Ano Novo!	
VO_ULDA_Finley_Male_Murloc_HAPPY_NOBLEGARDEN_01	Este é um bom momento para refletirmos sobre as origens pagãs da Jardinova.	
VO_ULDA_Finley_Male_Murloc_LowCards_01	Estou com pouquíssimos cards. 	
VO_ULDA_Finley_Male_Murloc_MIRROR_GREETINGS_01	Dom Finlei, estou correto? 	
VO_ULDA_Finley_Male_Murloc_MIRROR_START_01	Céus! Um gêmeo do mal! 	
VO_ULDA_Finley_Male_Murloc_NoCards_01	Estou a puxar água de um poço seco!	
VO_ULDA_Finley_Male_Murloc_Oops_01	Ai, raios! Que equívoco.	
VO_ULDA_Finley_Male_Murloc_Picked_02	Que dia esplêndido para uma aventura! Hã... a despeito das pragas.	
VO_ULDA_Finley_Male_Murloc_PIRATE_DAY_01	Ah! Estamos a imitar piratas?... Ia-aar?	
VO_ULDA_Finley_Male_Murloc_Sorry_01	Ah, peço desculpas. 	
VO_ULDA_Finley_Male_Murloc_Start_01	Renda-se, patife! É hora de salvar o mundo. 	
VO_ULDA_Finley_Male_Murloc_Thanks_01	Meus agradecimentos, chapa!	
VO_ULDA_Finley_Male_Murloc_Thinking_01	Hmmm….	
VO_ULDA_Finley_Male_Murloc_Thinking_02	... Ora, pois...	
VO_ULDA_Finley_Male_Murloc_Thinking_03	... estou feito ao bife...	
VO_ULDA_Finley_Male_Murloc_Thinking_04	... de fato...	
VO_ULDA_Finley_Male_Murloc_Thinking_05	... tenho de ter lata...	
VO_ULDA_Finley_Male_Murloc_Threaten_03	Pois bem. As luvas já foram retiradas.	
VO_ULDA_Finley_Male_Murloc_Time_01	Hora de voltar à labuta. 	
VO_ULDA_Finley_Male_Murloc_Well_Played_01	Um desempenho digno.	
VO_ULDA_Finley_Male_Murloc_WOW_01	Raios!	
VO_ULDA_Reno_Male_Human_Attack_01	<Attack exertion>	
VO_ULDA_Reno_Male_Human_Concede_01	Nunca desista! Fuja.	
VO_ULDA_Reno_Male_Human_Death_01	<Death>	
VO_ULDA_Reno_Male_Human_ERROR_FULL_MINIONS_01	Não há espaço suficiente.	
VO_ULDA_Reno_Male_Human_ERROR_GENERIC_02	Se eu pudesse... eu faria.	
VO_ULDA_Reno_Male_Human_ERROR_HAND_FULL_02	O que que eu faço com tanto card?!	
VO_ULDA_Reno_Male_Human_ERROR_I_ATTACKED_02	Preciso recuperar o fôlego!	
VO_ULDA_Reno_Male_Human_ERROR_MINION_ATTACKED_01	Esse lacaio já atacou.	
VO_ULDA_Reno_Male_Human_ERROR_NEED_MANA_01	Preciso de mana!	
VO_ULDA_Reno_Male_Human_ERROR_NEED_WEAPON_01	Preciso de uma arma.	
VO_ULDA_Reno_Male_Human_ERROR_PLAY_01	Eu não posso jogar isso. 	
VO_ULDA_Reno_Male_Human_ERROR_STEALTH_02	Esse tá escondido. Malandrinho.	
VO_ULDA_Reno_Male_Human_ERROR_SUMMON_SICKNESS_01	Esse precisa de um turno pra se preparar.	
VO_ULDA_Reno_Male_Human_ERROR_TARGET_01	Não tenho alvo!	
VO_ULDA_Reno_Male_Human_ERROR_TAUNT_01	Há um lacaio com Provocar no meio do caminho.	
VO_ULDA_Reno_Male_Human_Greetings_01	Eu tiro meu chapéu pra você!	
VO_ULDA_Reno_Male_Human_HAPPY_BIRTHDAY_02	Ei, é seu aniversário! Escolha no máximo um de cada!	
VO_ULDA_Reno_Male_Human_HAPPY_BREWFEST_01	CervaFest! É o tipo de feriado que eu gosto. 	
VO_ULDA_Reno_Male_Human_HAPPY_HALLOWEEN_01	Noturnália me dá arrepios.	
VO_ULDA_Reno_Male_Human_HAPPY_HOLIDAYS_01	Boas festas!	
VO_ULDA_Reno_Male_Human_HAPPY_NEW_YEAR_01	Feliz Ano Novo!	
VO_ULDA_Reno_Male_Human_HAPPY_NEW_YEAR_LUNAR_01	Feliz Ano Novo!	
VO_ULDA_Reno_Male_Human_HAPPY_NOBLEGARDEN_01	É Jardinova. Me passa essa cesta aí!	
VO_ULDA_Reno_Male_Human_KISS_01	<Kissing noise>	
VO_ULDA_Reno_Male_Human_LowCards_01	Tô ficando com poucos cards aqui...	
VO_ULDA_Reno_Male_Human_MIRROR_GREETINGS_01	... Esse chapéu é MEU.	
VO_ULDA_Reno_Male_Human_MIRROR_START_01	Só uma dessas já tá de bom tamanho.	
VO_ULDA_Reno_Male_Human_NoCards_01	Acabou!	
VO_ULDA_Reno_Male_Human_Oops_02	Ninguém viu isso. Espero.	
VO_ULDA_Reno_Male_Human_Picked_02	Me dá o meu chapéu, Finlei. Eu vou nessa!	
VO_ULDA_Reno_Male_Human_PIRATE_DAY_01	E me chame de CAPITÃO JACKSON, marujo. Bom demais.	
VO_ULDA_Reno_Male_Human_Sorry_01	Acho que devo desculpas por isso.	
VO_ULDA_Reno_Male_Human_Start_01	Vamos ficar ricos! E salvar o mundo!	
VO_ULDA_Reno_Male_Human_Thanks_01	Ah, obrigado.	
VO_ULDA_Reno_Male_Human_Thinking_01	Hmmm…	
VO_ULDA_Reno_Male_Human_Thinking_02	Não parece nada bom...	
VO_ULDA_Reno_Male_Human_Thinking_03	É tão louco... que pode dar certo...	
VO_ULDA_Reno_Male_Human_Thinking_04	Você já escapou de situações mais difíceis, Reno...	
VO_ULDA_Reno_Male_Human_Threaten_02	Podemos fazer do jeito fácil... ou do MEU jeito.	
VO_ULDA_Reno_Male_Human_Time_01	É melhor ir mais rápido agora...	
VO_ULDA_Reno_Male_Human_Well_Played_01	Uma manobra brilhante!	
VO_ULDA_Reno_Male_Human_WOW_01	Santa mãe dos murlocs!	
VO_YOD_009_Male_Human_Concede_01	Augh. Você me pegou.	
VO_YOD_009_Male_Human_ERROR_FULL_MINIONS_02	Eu já tenho lacaios demais.	
VO_YOD_009_Male_Human_Greetings_01	Rá! Eu vou ficar rico!	
VO_YOD_009_Male_Human_LowCards_01	Meu grimório tá acabando.	
VO_YOD_009_Male_Human_MIRROR_GREETINGS_01	... hã, NÓS vamos ficar ricos?	
VO_YOD_009_Male_Human_MIRROR_START_01	Ei! Eu vi primeiro!	
VO_YOD_009_Male_Human_NoCards_01	Eu tô sem cards!	
VO_YOD_009_Male_Human_Oops_01	Rá! Hã, é tudo parte da estratégia.	
VO_YOD_009_Male_Human_Picked_01	Hora de lançar feitiços.	
VO_YOD_009_Male_Human_Sorry_01	Ah, opa. Eu... er... lamento!	
VO_YOD_009_Male_Human_Start_01	Tão precisando de alguém pra saquear tumbas?	
VO_YOD_009_Male_Human_Thanks_01	Valeu! Eu sou mesmo incrível.	
VO_YOD_009_Male_Human_Thinking_01	Hmmm...	
VO_YOD_009_Male_Human_Thinking_03	Se eu pudesse lançar...	
VO_YOD_009_Male_Human_Thinking_04	Se eu fizer isso, a gente fica rico?	
VO_YOD_009_Male_Human_Threaten_01	Não me faça usar minha magia PESADA!	
VO_YOD_009_Male_Human_Time_01	Achei que tinha mais tempo!	
VO_YOD_009_Male_Human_Well_Played_01	Parece que você tem seus truques também.	
VO_YOD_009_Male_Human_WOW_01	Incrível! Como eu.	
