TAG	TEXT	COMMENT
BATTLEGROUNDS_PROGRESSION_QUEST_TIME_UNTIL_NEXT	Nova missão em\n{0}	
GLOBAL_AADC_BUTTON_PRIVACY	Privacidade	
GLOBAL_AADC_BUTTON_PRIVACYSETTINGS	Configurações de Privacidade	
GLOBAL_AADC_CHATSETTINGS_DISABLEDESCRIPTION	Se desativar o bate-papo, você não poderá mandar nem receber mensagens de amigos.	
GLOBAL_AADC_CHATSETTINGS_DISABLEHEADER	Você quer desativar o bate-papo?	
GLOBAL_AADC_CHATSETTINGS_ENABLEDESCRIPTION	Se ativar o bate-papo, você poderá mandar e receber mensagens de amigos. Tome cuidado e não divulgue informações pessoais.	
GLOBAL_AADC_CHATSETTINGS_ENABLEHEADER	Você quer ativar o bate-papo?	
GLOBAL_AADC_CHATSETTINGS_SETTINGSUPDATED	Configurações de bate-papo atualizadas	
GLOBAL_AADC_CHATSETTINGS_TITLE	Configurações de bate-papo	
GLOBAL_AADC_CHATSETTINGS_UPDATINGSETTINGS	Atualizando configurações de bate-papo	
GLOBAL_AADC_CHATWARNING	Tome cuidado e não divulgue informações pessoais nas mensagens.	
GLOBAL_AADC_FRIENDSETTINGS_DISABLEDESCRIPTION	Desabilitar jogadores próximos impede que jogadores perto de você vejam suas atividades na lista de amigos.	
GLOBAL_AADC_FRIENDSETTINGS_DISABLEHEADER	Desabilitar jogadores próximos?	
GLOBAL_AADC_FRIENDSETTINGS_ENABLEDESCRIPTION	Habilitar jogadores próximos permite que jogadores perto de você vejam suas atividades na lista de amigos.	
GLOBAL_AADC_FRIENDSETTINGS_ENABLEHEADER	Habilitar jogadores próximos?	
GLOBAL_AADC_FRIENDSETTINGS_SETTINGSUPDATED	Jogadores próximos atualizados	
GLOBAL_AADC_FRIENDSETTINGS_TITLE	Configurações de amizade	
GLOBAL_AADC_FRIENDSETTINGS_TURN_OFF_BUTTON	Desativar	
GLOBAL_AADC_FRIENDSETTINGS_TURN_ON_BUTTON	Ativar	
GLOBAL_AADC_FRIENDSETTINGS_UPDATINGSETTINGS	Atualizando jogadores próximos	
GLOBAL_AADC_NEARBY_PLAYER_SETTINGS_TITLE	Jogadores próximos	
GLOBAL_AADC_PARENTALLOCK_DESCRIPTION	Para alterar esta opção, é necessário que seus pais ou responsáveis atualizem suas configurações de privacidade no Battle.net.	
GLOBAL_AADC_PRIVACYSETTINGSMENU_PRIVACYRIGHTS	Direitos de Privacidade	
GLOBAL_AADC_PRIVACYSETTINGSPOPUP_DEVICE_LOCATIONSETTINGS	Habilitar configurações de lugar	
GLOBAL_AADC_PRIVACYSETTINGSPOPUP_DEVICE_PUSHNOTIFICATIONS	Habilitar notificações via push	
GLOBAL_AADC_PRIVACYSETTINGSPOPUP_SECTIONHEADER_DEVICE	Opções de dispositivo	
GLOBAL_AADC_PRIVACYSETTINGSPOPUP_SECTIONHEADER_SOCIAL	Opções sociais	
GLOBAL_AADC_PRIVACYSETTINGSPOPUP_SOCIAL_CHATMESSAGES	Habilitar mensagens de bate-papo	
GLOBAL_AADC_PRIVACYSETTINGSPOPUP_SOCIAL_NEARBYFRIENDS	Habilitar jogadores próximos	
GLOBAL_AADC_PRIVACYSETTINGSPOPUP_SOCIAL_SPECIALOFFERS	Habilitar ofertas personalizadas da loja	
GLOBAL_AADC_PUSHNOTIFICATIONS_DISABLEDESCRIPTION	Desativar notificações via push impedirá que Hearthstone mande avisos ao seu dispositivo.	
GLOBAL_AADC_PUSHNOTIFICATIONS_DISABLEHEADER	Desativar notificações via push	
GLOBAL_AADC_PUSHNOTIFICATIONS_ENABLEDESCRIPTION	Habilitar notificações via push permitirá que Hearthstone mande avisos ao seu dispositivo.	
GLOBAL_AADC_PUSHNOTIFICATIONS_ENABLEHEADER	Ativar notificações via push	
GLOBAL_AADC_PUSHNOTIFICATIONS_SETTINGSUPDATED	Configurações de notificação atualizadas	
GLOBAL_AADC_PUSHNOTIFICATIONS_TITLE	Configurações de notificação	
GLOBAL_AADC_PUSHNOTIFICATIONS_UPDATINGSETTINGS	Atualizando configurações de notificação	
GLOBAL_AADC_SHOPSETTINGS_DISABLEDESCRIPTION	Desativar ofertas personalizadas da loja impedirá que você veja ofertas baseadas no seu estilo de jogo.	
GLOBAL_AADC_SHOPSETTINGS_DISABLEHEADER	Desativar ofertas personalizadas	
GLOBAL_AADC_SHOPSETTINGS_ENABLEDESCRIPTION	Habilitar ofertas personalizadas da loja permitirá que você veja ofertas baseadas no seu estilo de jogo.	
GLOBAL_AADC_SHOPSETTINGS_ENABLEHEADER	Ativar ofertas personalizadas	
GLOBAL_AADC_SHOPSETTINGS_SETTINGSUPDATED	Configurações da loja atualizadas	
GLOBAL_AADC_SHOPSETTINGS_TITLE	Configurações da loja	
GLOBAL_AADC_SHOPSETTINGS_UPDATINGSETTINGS	Atualizando configurações da loja	
GLOBAL_AADC_UPDATESETTINGSPOPUP_DESCRIPTION	Agora todas as suas preferências sociais e de dispositivo estão habilitadas, incluindo mensagens de bate-papo, loja e ofertas personalizadas.	
GLOBAL_AADC_UPDATESETTINGSPOPUP_TITLE	Configurações atualizadas	
GLOBAL_ACCOUNT	Conta	
GLOBAL_ACCOUNT_LINKING_CONFIRM_LINKED	Conta vinculada!	
GLOBAL_ACCOUNT_LINKING_CONFIRM_WAITING	Trabalhando nisso...	
GLOBAL_ADDFRIEND_BUTTON	Adicionar como Amigo	
GLOBAL_ADDFRIEND_ERROR_ALREADY_FRIEND	Essa pessoa já está na sua lista de amigos.	
GLOBAL_ADDFRIEND_ERROR_MALFORMED	É necessário inserir um endereço de e-mail ou Battle tag.	
GLOBAL_ADDFRIEND_HEADER	Adicionar um amigo no <color=#5ecaf0ff>Battle.net</color>	
GLOBAL_ADDFRIEND_INSTRUCTION	Digite o BattleTag ou endereço de e-mail.	
GLOBAL_ADDFRIEND_SENT_CONFIRMATION	Solicitação de amigo enviada.	
GLOBAL_ADVENTURE_CHOOSE_BUTTON_TEXT	Escolha	
GLOBAL_ADVENTURE_DESC_HEADER	Aventura	
GLOBAL_ADVENTURE_TRAY_HEADER	Selecione uma Aventura	
GLOBAL_APPROXIMATE_DATETIME	~{0}	0=time string
GLOBAL_APPROXIMATE_DATETIME_RANGE	~{0} - {1}	0=min seconds 1=max seconds string
GLOBAL_ARENA	Arena	
GLOBAL_ARENA_ERROR_NOT_ENOUGH_CLASSES	Lamentamos, mas é preciso ter desbloqueado três classes para jogar na Arena.	
GLOBAL_ARENA_MEDAL_0	Chave do Noviço	
GLOBAL_ARENA_MEDAL_1	Chave do Aprendiz	
GLOBAL_ARENA_MEDAL_10	Chave Gelonata	
GLOBAL_ARENA_MEDAL_11	Chave Incandescente	
GLOBAL_ARENA_MEDAL_12	Chave da Forja de Luz	
GLOBAL_ARENA_MEDAL_2	Chave do Profissional	
GLOBAL_ARENA_MEDAL_3	Chave de Cobre	
GLOBAL_ARENA_MEDAL_4	Chave de Prata	
GLOBAL_ARENA_MEDAL_5	Chave de Ouro	
GLOBAL_ARENA_MEDAL_6	Chave de Platina	
GLOBAL_ARENA_MEDAL_7	Chave de Diamante	
GLOBAL_ARENA_MEDAL_8	Chave do Campeão	
GLOBAL_ARENA_MEDAL_9	Chave de Rubi	
GLOBAL_ARENA_SEASON_ERROR_NOT_ACTIVE	A Arena solicitada não está mais disponível. Espere alguns minutos e tente novamente.	
GLOBAL_ASSET_DOWNLOAD	Download de Recursos	
GLOBAL_ASSET_DOWNLOAD_ALERT	Download de recursos desabilitado durante a partida.	
GLOBAL_ASSET_DOWNLOAD_AWAITING_FETCH	Procurando atualizações...	
GLOBAL_ASSET_DOWNLOAD_AWAITING_OTHER_DOWNLOAD	Esperando	
GLOBAL_ASSET_DOWNLOAD_AWAITING_WIFI	WiFi Necessário	
GLOBAL_ASSET_DOWNLOAD_BYTE_SYMBOL	B	
GLOBAL_ASSET_DOWNLOAD_CELLULAR_DATA_BODY	Baixar com dados móveis.	
GLOBAL_ASSET_DOWNLOAD_CELLULAR_DATA_HEADER	Dados Móveis	
GLOBAL_ASSET_DOWNLOAD_CELLULAR_POPUP_ADDITIONAL_BODY	Wi-Fi indisponível. Deseja baixar o restante dos dados extras ({0}) utilizando conexão de dados móveis?	
GLOBAL_ASSET_DOWNLOAD_CELLULAR_POPUP_HEADER	Dados Móveis	
GLOBAL_ASSET_DOWNLOAD_CELLULAR_POPUP_INITIAL_BODY	Wi-Fi indisponível. Deseja baixar o restante dos dados necessários ({0}) utilizando conexão de dados móveis?	
GLOBAL_ASSET_DOWNLOAD_COMPLETE	Concluído	
GLOBAL_ASSET_DOWNLOAD_DETAILS_AUDIO	Áudio	
GLOBAL_ASSET_DOWNLOAD_DETAILS_HIGHRES	Textura em alta resolução	
GLOBAL_ASSET_DOWNLOAD_DISABLED	Desativado	
GLOBAL_ASSET_DOWNLOAD_ENABLE_DOWNLOAD_BODY	Permitir que Hearthstone baixe recursos.	
GLOBAL_ASSET_DOWNLOAD_ENABLE_DOWNLOAD_HEADER	Ativar Download	
GLOBAL_ASSET_DOWNLOAD_ENABLED	Ativado	
GLOBAL_ASSET_DOWNLOAD_ERROR_AGENT_IMPEDED	Conexão lenta	
GLOBAL_ASSET_DOWNLOAD_ERROR_CELLULAR_DISABLED	Dados móveis desativados	
GLOBAL_ASSET_DOWNLOAD_ERROR_DOWNLOAD_DISABLED	Download desativado	
GLOBAL_ASSET_DOWNLOAD_ERROR_OUT_OF_STORAGE	Armazenamento cheio	
GLOBAL_ASSET_DOWNLOAD_FIRST_DOWNLOAD_BODY	Dados adicionais necessários - {0}\n\nHearthstone precisa baixar dados adicionais para que você possa jogar o jogo completo.	
GLOBAL_ASSET_DOWNLOAD_GIGABYTE_SYMBOL	GB	
GLOBAL_ASSET_DOWNLOAD_INTENTION_PAUSED	Pausado	
GLOBAL_ASSET_DOWNLOAD_IOS_REQ_POPUP_BODY	Download disponível. Deseja baixar os {0} restantess?	
GLOBAL_ASSET_DOWNLOAD_IOS_REQ_POPUP_HEADER	Dados extras	
GLOBAL_ASSET_DOWNLOAD_KILOBYTE_SYMBOL	KB	
GLOBAL_ASSET_DOWNLOAD_MEGABYTE_SYMBOL	MB	
GLOBAL_ASSET_DOWNLOAD_PAUSED	Pausado	
GLOBAL_ASSET_DOWNLOAD_SETTINGS	Configurações	
GLOBAL_ASSET_DOWNLOAD_STATUS	Restando {0} @ {1}/s	
GLOBAL_ASSET_DOWNLOAD_STATUS_DECIMAL_FORMAT	{0}.{1} {2}	
GLOBAL_ASSET_DOWNLOAD_STATUS_SHORT	{0} a {1}/s	
GLOBAL_ASSET_INTENTION_DONE	Pronto	
GLOBAL_ASSET_INTENTION_DOWNLOADING_EXPANSION_MUSIC	Som adicional (2/3)	
GLOBAL_ASSET_INTENTION_DOWNLOADING_FONTS	Fontes	
GLOBAL_ASSET_INTENTION_DOWNLOADING_HERO_MUSIC	Música de herói	
GLOBAL_ASSET_INTENTION_DOWNLOADING_HIGH_RES_PORTRAITS	Cards em alta resolução	
GLOBAL_ASSET_INTENTION_DOWNLOADING_LEGEND_STINGERS	Som adicional (1/3)	
GLOBAL_ASSET_INTENTION_DOWNLOADING_MINION_PLAY_SOUNDS	Sons de lacaios	
GLOBAL_ASSET_INTENTION_DOWNLOADING_MISSION_SOUNDS	Sons do Modo Aventura	
GLOBAL_ASSET_INTENTION_DOWNLOADING_OTHER_MINION_SOUNDS	Som adicional (3/3)	
GLOBAL_ASSET_INTENTION_DOWNLOADING_PREMIUM_ANIMATIONS	Animações douradas	
GLOBAL_ASSET_INTENTION_DOWNLOADING_SPELL_SOUNDS	Som de feitiço	
GLOBAL_ASSET_INTENTION_UNINITIALIZED	Iniciando	
GLOBAL_ATTACK	Ataque	
GLOBAL_BACK	Voltar	
GLOBAL_BASIC_DECK_NAME	{0}	0=class name
GLOBAL_BATTLEGROUNDS	Campos de Batalha	
GLOBAL_BETA_REIMBURSEMENT_DETAILS	Este ouro serve como crédito por suas compras passadas. Obrigado!	
GLOBAL_BETA_REIMBURSEMENT_HEADLINE	Crédito de limpeza de conta	
GLOBAL_BRAWLISEUM	Coliseu da Contenda	
GLOBAL_BUTTON_AWESOME	Incrível!	
GLOBAL_BUTTON_BUY	COMPRAR	
GLOBAL_BUTTON_CLOSE	Fechar	
GLOBAL_BUTTON_CONVERT	Converter	
GLOBAL_BUTTON_DOWNLOAD	Baixe agora	
GLOBAL_BUTTON_GO	Vamos!	
GLOBAL_BUTTON_GOT_IT	Entendi!	
GLOBAL_BUTTON_INFO_LETTER	i	
GLOBAL_BUTTON_LATER	Mais tarde	
GLOBAL_BUTTON_MORE_INFO	Mais Informações	
GLOBAL_BUTTON_NEXT	Próximo	
GLOBAL_BUTTON_NO	Não	
GLOBAL_BUTTON_NOT_NOW	Agora não	
GLOBAL_BUTTON_OK	OK	
GLOBAL_BUTTON_OR	OU	
GLOBAL_BUTTON_OWNED	Você possui	
GLOBAL_BUTTON_SUBMIT	Enviar	
GLOBAL_BUTTON_YES	Sim	
GLOBAL_CANCEL	Cancelar	
GLOBAL_CANCEL_MODULE_POPUP_PROMPT	Cancelar o download de {0}?	{0}=Module name to cancel downloading (e.g. Battlegrounds)
GLOBAL_CARD_SET_AV	Divididos no Vale Alterac	
GLOBAL_CARD_SET_AV_SEARCHABLE_SHORTHAND_NAMES	va dnva dva	This is a space-separated list indicating all of the allowable search keywords that can be used in Collection Manager screen's text-search feature to narrow down the cards to this specific Card Set via shorthand names (note: the full name above is also used for this feature). Also note: letter case is ignored.
GLOBAL_CARD_SET_AV_SHORT	Vale Alterac	
GLOBAL_CARD_SET_BAR	Forjado nos Sertões	
GLOBAL_CARD_SET_BAR_SEARCHABLE_SHORTHAND_NAMES	ser fns fs	This is a space-separated list indicating all of the allowable search keywords that can be used in Collection Manager screen's text-search feature to narrow down the cards to this specific Card Set via shorthand names (note: the full name above is also used for this feature). Also note: letter case is ignored.
GLOBAL_CARD_SET_BAR_SHORT	Sertões	
GLOBAL_CARD_SET_BASIC	Básico	
GLOBAL_CARD_SET_BOOMSDAY	Projeto Cabum	
GLOBAL_CARD_SET_BOOMSDAY_SEARCHABLE_SHORTHAND_NAMES	pc opc pjc pjcb cb	This is a space-separated list indicating all of the allowable search keywords that can be used in Collection Manager screen's text-search feature to narrow down the cards to this specific Card Set via shorthand names (note: the full name above is also used for this feature). Also note: letter case is ignored.
GLOBAL_CARD_SET_BOOMSDAY_SHORT	Projeto Cabum	
GLOBAL_CARD_SET_BRM	Montanha Rocha Negra	
GLOBAL_CARD_SET_BRM_SEARCHABLE_SHORTHAND_NAMES	mrn	This is a space-separated list indicating all of the allowable search keywords that can be used in Collection Manager screen's text-search feature to narrow down the cards to this specific Card Set via shorthand names (note: the full name above is also used for this feature). Also note: letter case is ignored.
GLOBAL_CARD_SET_BT	Cinzas de Terralém	
GLOBAL_CARD_SET_BT_SEARCHABLE_SHORTHAND_NAMES	cdt ct cinzas	This is a space-separated list indicating all of the allowable search keywords that can be used in Collection Manager screen's text-search feature to narrow down the cards to this specific Card Set via shorthand names (note: the full name above is also used for this feature). Also note: letter case is ignored.
GLOBAL_CARD_SET_BT_SHORT	Terralém	
GLOBAL_CARD_SET_CORE	Essencial	
GLOBAL_CARD_SET_CORE_HIDDEN	Essencial (inválido)	
GLOBAL_CARD_SET_CORE_SEARCHABLE_SHORTHAND_NAMES	essencial	This is a space-separated list indicating all of the allowable search keywords that can be used in Collection Manager screen's text-search feature to narrow down the cards to this specific Card Set via shorthand names (note: the full name above is also used for this feature). Also note: letter case is ignored.
GLOBAL_CARD_SET_CORE_SHORT	Essencial	
GLOBAL_CARD_SET_DALARAN	Ascensão das Sombras	
GLOBAL_CARD_SET_DALARAN_SEARCHABLE_SHORTHAND_NAMES	ads	This is a space-separated list indicating all of the allowable search keywords that can be used in Collection Manager screen's text-search feature to narrow down the cards to this specific Card Set via shorthand names (note: the full name above is also used for this feature). Also note: letter case is ignored.
GLOBAL_CARD_SET_DALARAN_SHORT	Ascensão das Sombras	
GLOBAL_CARD_SET_DEBUG	Neve Derretida	
GLOBAL_CARD_SET_DHI	Caçador de Demônios Iniciado	
GLOBAL_CARD_SET_DHI_SEARCHABLE_SHORTHAND_NAMES	cdi	This is a space-separated list indicating all of the allowable search keywords that can be used in Collection Manager screen's text-search feature to narrow down the cards to this specific Card Set via shorthand names (note: the full name above is also used for this feature). Also note: letter case is ignored.
GLOBAL_CARD_SET_DHI_SHORT	Iniciado	
GLOBAL_CARD_SET_DMF	Delírios em Negraluna	
GLOBAL_CARD_SET_DMF_SEARCHABLE_SHORTHAND_NAMES	dn	This is a space-separated list indicating all of the allowable search keywords that can be used in Collection Manager screen's text-search feature to narrow down the cards to this specific Card Set via shorthand names (note: the full name above is also used for this feature). Also note: letter case is ignored.
GLOBAL_CARD_SET_DMF_SHORT	Negraluna	
GLOBAL_CARD_SET_DRG	Despontar dos Dragões	
GLOBAL_CARD_SET_DRG_SEARCHABLE_SHORTHAND_NAMES	ddd dd	This is a space-separated list indicating all of the allowable search keywords that can be used in Collection Manager screen's text-search feature to narrow down the cards to this specific Card Set via shorthand names (note: the full name above is also used for this feature). Also note: letter case is ignored.
GLOBAL_CARD_SET_DRG_SHORT	Dragões	
GLOBAL_CARD_SET_EDR	Rumo ao Sonho Esmeralda	
GLOBAL_CARD_SET_EDR_SEARCHABLE_SHORTHAND_NAMES	rse	This is a space-separated list indicating all of the allowable search keywords that can be used in Collection Manager screen's text-search feature to narrow down the cards to this specific Card Set via shorthand names (note: the full name above is also used for this feature). Also note: letter case is ignored.
GLOBAL_CARD_SET_EDR_SHORT	Sonho Esmeralda	
GLOBAL_CARD_SET_ETC	Festival das Lendas	
GLOBAL_CARD_SET_ETC_SEARCHABLE_SHORTHAND_NAMES	fdl	This is a space-separated list indicating all of the allowable search keywords that can be used in Collection Manager screen's text-search feature to narrow down the cards to this specific Card Set via shorthand names (note: the full name above is also used for this feature). Also note: letter case is ignored.
GLOBAL_CARD_SET_ETC_SHORT	Festival	
GLOBAL_CARD_SET_EVE	Evento	
GLOBAL_CARD_SET_EVE_SEARCHABLE_SHORTHAND_NAMES	eve	This is a space-separated list indicating all of the allowable search keywords that can be used in Collection Manager screen's text-search feature to narrow down the cards to this specific Card Set via shorthand names (note: the full name above is also used for this feature). Also note: letter case is ignored.
GLOBAL_CARD_SET_EVE_SHORT	Evento	
GLOBAL_CARD_SET_EXPERT1	Clássico	
GLOBAL_CARD_SET_GANGS	Gangues de Geringontzan	
GLOBAL_CARD_SET_GANGS_RESERVE	Reserva das Gangues	
GLOBAL_CARD_SET_GANGS_SEARCHABLE_SHORTHAND_NAMES	gdg agdg	This is a space-separated list indicating all of the allowable search keywords that can be used in Collection Manager screen's text-search feature to narrow down the cards to this specific Card Set via shorthand names (note: the full name above is also used for this feature). Also note: letter case is ignored.
GLOBAL_CARD_SET_GANGS_SHORT	Geringontzan	
GLOBAL_CARD_SET_GDB	Grande Treva Infinita	
GLOBAL_CARD_SET_GDB_SEARCHABLE_SHORTHAND_NAMES	gti	This is a space-separated list indicating all of the allowable search keywords that can be used in Collection Manager screen's text-search feature to narrow down the cards to this specific Card Set via shorthand names (note: the full name above is also used for this feature). Also note: letter case is ignored.
GLOBAL_CARD_SET_GDB_SHORT	Treva Infinita	
GLOBAL_CARD_SET_GILNEAS	Bosque das Bruxas	
GLOBAL_CARD_SET_GILNEAS_SEARCHABLE_SHORTHAND_NAMES	bb	This is a space-separated list indicating all of the allowable search keywords that can be used in Collection Manager screen's text-search feature to narrow down the cards to this specific Card Set via shorthand names (note: the full name above is also used for this feature). Also note: letter case is ignored.
GLOBAL_CARD_SET_GILNEAS_SHORT	Bosque das Bruxas	
GLOBAL_CARD_SET_GVG	Goblins x Gnomos	
GLOBAL_CARD_SET_GVG_SEARCHABLE_SHORTHAND_NAMES	gvg	This is a space-separated list indicating all of the allowable search keywords that can be used in Collection Manager screen's text-search feature to narrow down the cards to this specific Card Set via shorthand names (note: the full name above is also used for this feature). Also note: letter case is ignored.
GLOBAL_CARD_SET_HOF	Salão da Fama	
GLOBAL_CARD_SET_ICECROWN	Cavaleiros do Trono de Gelo	
GLOBAL_CARD_SET_ICECROWN_SHORT	Trono de Gelo	
GLOBAL_CARD_SET_KARA	Uma Noite em Karazhan	
GLOBAL_CARD_SET_KARA_RESERVE	Reserva de Karazhan	
GLOBAL_CARD_SET_KARA_SHORT	Karazhan	
GLOBAL_CARD_SET_LEGACY	Legado	
GLOBAL_CARD_SET_LEGACY_SEARCHABLE_SHORTHAND_NAMES	lgdo	This is a space-separated list indicating all of the allowable search keywords that can be used in Collection Manager screen's text-search feature to narrow down the cards to this specific Card Set via shorthand names (note: the full name above is also used for this feature). Also note: letter case is ignored.
GLOBAL_CARD_SET_LEGACY_SHORT	Legado	
GLOBAL_CARD_SET_LETL		Lettuce
GLOBAL_CARD_SET_LETL_SEARCHABLE_SHORTHAND_NAMES	let	This is a space-separated list indicating all of the allowable search keywords that can be used in Collection Manager screen's text-search feature to narrow down the cards to this specific Card Set via shorthand names (note: the full name above is also used for this feature). Also note: letter case is ignored.
GLOBAL_CARD_SET_LETL_SHORT	Lettuce	
GLOBAL_CARD_SET_LOE	A Liga dos Exploradores	
GLOBAL_CARD_SET_LOE_SEARCHABLE_SHORTHAND_NAMES	loe lde	This is a space-separated list indicating all of the allowable search keywords that can be used in Collection Manager screen's text-search feature to narrow down the cards to this specific Card Set via shorthand names (note: the full name above is also used for this feature). Also note: letter case is ignored.
GLOBAL_CARD_SET_LOE_SHORT	Liga dos Exploradores	
GLOBAL_CARD_SET_LOOTAPALOOZA	Kobolds & Catacumbas	
GLOBAL_CARD_SET_LOOTAPALOOZA_SEARCHABLE_SHORTHAND_NAMES	kc kec k&c	This is a space-separated list indicating all of the allowable search keywords that can be used in Collection Manager screen's text-search feature to narrow down the cards to this specific Card Set via shorthand names (note: the full name above is also used for this feature). Also note: letter case is ignored.
GLOBAL_CARD_SET_LOOTAPALOOZA_SHORT	Kobolds	
GLOBAL_CARD_SET_NAXX	Naxxramas	
GLOBAL_CARD_SET_NAXX_SEARCHABLE_SHORTHAND_NAMES	Nax Naxx	This is a space-separated list indicating all of the allowable search keywords that can be used in Collection Manager screen's text-search feature to narrow down the cards to this specific Card Set via shorthand names (note: the full name above is also used for this feature). Also note: letter case is ignored.
GLOBAL_CARD_SET_OG	Sussurros dos Deuses Antigos	
GLOBAL_CARD_SET_OG_RESERVE	Reserva dos Deuses Antigos	
GLOBAL_CARD_SET_OG_SEARCHABLE_SHORTHAND_NAMES	tog sdda sda	This is a space-separated list indicating all of the allowable search keywords that can be used in Collection Manager screen's text-search feature to narrow down the cards to this specific Card Set via shorthand names (note: the full name above is also used for this feature). Also note: letter case is ignored.  For Whispers of the Old Gods, 'tog' should be available in all locales; wotog and wog are additional English shorthands, which should be replaced by locale specific variants.
GLOBAL_CARD_SET_OG_SHORT	Deuses Antigos	
GLOBAL_CARD_SET_PA	Caminho de Arthas	
GLOBAL_CARD_SET_PA_SEARCHABLE_SHORTHAND_NAMES	pa	This is a space-separated list indicating all of the allowable search keywords that can be used in Collection Manager screen's text-search feature to narrow down the cards to this specific Card Set via shorthand names (note: the full name above is also used for this feature). Also note: letter case is ignored.
GLOBAL_CARD_SET_PA_SHORT	Caminho de Arthas	
GLOBAL_CARD_SET_PROMO	Promoção	
GLOBAL_CARD_SET_REV	Assassinato no Castelo de Nathria	
GLOBAL_CARD_SET_REV_SEARCHABLE_SHORTHAND_NAMES	acn cn rev	This is a space-separated list indicating all of the allowable search keywords that can be used in Collection Manager screen's text-search feature to narrow down the cards to this specific Card Set via shorthand names (note: the full name above is also used for this feature). Also note: letter case is ignored.
GLOBAL_CARD_SET_REV_SHORT	Castelo de Nathria	
GLOBAL_CARD_SET_RLK	Ascensão do Lich Rei	
GLOBAL_CARD_SET_RLK_SEARCHABLE_SHORTHAND_NAMES	alr	This is a space-separated list indicating all of the allowable search keywords that can be used in Collection Manager screen's text-search feature to narrow down the cards to this specific Card Set via shorthand names (note: the full name above is also used for this feature). Also note: letter case is ignored.
GLOBAL_CARD_SET_RLK_SHORT	Lich Rei	
GLOBAL_CARD_SET_SCH	Universidade de Scolomântia	
GLOBAL_CARD_SET_SCH_SEARCHABLE_SHORTHAND_NAMES	scolo us	This is a space-separated list indicating all of the allowable search keywords that can be used in Collection Manager screen's text-search feature to narrow down the cards to this specific Card Set via shorthand names (note: the full name above is also used for this feature). Also note: letter case is ignored.
GLOBAL_CARD_SET_SCH_SHORT	Scolomântia	
GLOBAL_CARD_SET_SW	Juntos em Ventobravo	
GLOBAL_CARD_SET_SW_SEARCHABLE_SHORTHAND_NAMES	vb	uis
GLOBAL_CARD_SET_SW_SHORT	Ventobravo	
GLOBAL_CARD_SET_TGT	O Grande Torneio	
GLOBAL_CARD_SET_TGT_SEARCHABLE_SHORTHAND_NAMES	tgt	This is a space-separated list indicating all of the allowable search keywords that can be used in Collection Manager screen's text-search feature to narrow down the cards to this specific Card Set via shorthand names (note: the full name above is also used for this feature). Also note: letter case is ignored.
GLOBAL_CARD_SET_TGT_SHORT	Grande Torneio	
GLOBAL_CARD_SET_TOY	Oficina do Rojão	
GLOBAL_CARD_SET_TOY_SEARCHABLE_SHORTHAND_NAMES	brinquedo	This is a space-separated list indicating all of the allowable search keywords that can be used in Collection Manager screen's text-search feature to narrow down the cards to this specific Card Set via shorthand names (note: the full name above is also used for this feature). Also note: letter case is ignored.
GLOBAL_CARD_SET_TOY_SHORT	Oficina do Rojão	
GLOBAL_CARD_SET_TROLL	Ringue do Rastakhan	
GLOBAL_CARD_SET_TROLL_SEARCHABLE_SHORTHAND_NAMES	rr	This is a space-separated list indicating all of the allowable search keywords that can be used in Collection Manager screen's text-search feature to narrow down the cards to this specific Card Set via shorthand names (note: the full name above is also used for this feature). Also note: letter case is ignored.
GLOBAL_CARD_SET_TROLL_SHORT	Rastakhan	
GLOBAL_CARD_SET_TSC	Viagem à Cidade Submersa	
GLOBAL_CARD_SET_TSC_SEARCHABLE_SHORTHAND_NAMES	cs vacs vcs	This is a space-separated list indicating all of the allowable search keywords that can be used in Collection Manager screen's text-search feature to narrow down the cards to this specific Card Set via shorthand names (note: the full name above is also used for this feature). Also note: letter case is ignored.
GLOBAL_CARD_SET_TSC_SHORT	Cidade Submersa	
GLOBAL_CARD_SET_TTN	TITÃS	
GLOBAL_CARD_SET_TTN_SEARCHABLE_SHORTHAND_NAMES	titãs	This is a space-separated list indicating all of the allowable search keywords that can be used in Collection Manager screen's text-search feature to narrow down the cards to this specific Card Set via shorthand names (note: the full name above is also used for this feature). Also note: letter case is ignored.
GLOBAL_CARD_SET_TTN_SHORT	Titãs	
GLOBAL_CARD_SET_TUT	Tutorial	
GLOBAL_CARD_SET_TUT_SEARCHABLE_SHORTHAND_NAMES	tut	This is a space-separated list indicating all of the allowable search keywords that can be used in Collection Manager screen's text-search feature to narrow down the cards to this specific Card Set via shorthand names (note: the full name above is also used for this feature). Also note: letter case is ignored.
GLOBAL_CARD_SET_TUT_SHORT	Tutorial	
GLOBAL_CARD_SET_ULDUM	Salvadores de Uldum	
GLOBAL_CARD_SET_ULDUM_SEARCHABLE_SHORTHAND_NAMES	sdu	This is a space-separated list indicating all of the allowable search keywords that can be used in Collection Manager screen's text-search feature to narrow down the cards to this specific Card Set via shorthand names (note: the full name above is also used for this feature). Also note: letter case is ignored.
GLOBAL_CARD_SET_ULDUM_SHORT	Uldum	
GLOBAL_CARD_SET_UNGORO	Jornada a Un'Goro	
GLOBAL_CARD_SET_UNGORO_SHORT	Un'Goro	
GLOBAL_CARD_SET_VAC	Perigos no Paraíso	
GLOBAL_CARD_SET_VAC_SEARCHABLE_SHORTHAND_NAMES	vac	This is a space-separated list indicating all of the allowable search keywords that can be used in Collection Manager screen's text-search feature to narrow down the cards to this specific Card Set via shorthand names (note: the full name above is also used for this feature). Also note: letter case is ignored.
GLOBAL_CARD_SET_VAC_SHORT	Paraíso	
GLOBAL_CARD_SET_VANILLA	Clássico	
GLOBAL_CARD_SET_VANILLA_FORMAT_SEARCHABLE_SHORTHAND_NAMES	fmtcl	This is a space-separated list indicating all of the allowable search keywords that can be used in Collection Manager screen's text-search feature to narrow down the cards to this specific Card Set via shorthand names (note: the full name above is also used for this feature). Also note: letter case is ignored.
GLOBAL_CARD_SET_VANILLA_FORMAT_SHORT	Clássico	
GLOBAL_CARD_SET_VANILLA_SHORT	Clássico	
GLOBAL_CARD_SET_WILD_EVENT	Evento do Livre	
GLOBAL_CARD_SET_WILD_EVENT_SHORT	Evento do Livre	
GLOBAL_CARD_SET_WON	Cavernas do Tempo	
GLOBAL_CARD_SET_WON_SEARCHABLE_SHORTHAND_NAMES	cavernas cdt	This is a space-separated list indicating all of the allowable search keywords that can be used in Collection Manager screen's text-search feature to narrow down the cards to this specific Card Set via shorthand names (note: the full name above is also used for this feature). Also note: letter case is ignored.
GLOBAL_CARD_SET_WON_SHORT	Cavernas	
GLOBAL_CARD_SET_WST	Confronto Final nos Ermos	
GLOBAL_CARD_SET_WST_SEARCHABLE_SHORTHAND_NAMES	ermos	This is a space-separated list indicating all of the allowable search keywords that can be used in Collection Manager screen's text-search feature to narrow down the cards to this specific Card Set via shorthand names (note: the full name above is also used for this feature). Also note: letter case is ignored.
GLOBAL_CARD_SET_WST_SHORT	Ermos	
GLOBAL_CARD_SET_YOD	O Despertar de Galakrond	
GLOBAL_CARD_SET_YOD_SHORT	O Despertar de Galakrond	
GLOBAL_CARDTYPE_ANOMALY	Anomalia	
GLOBAL_CARDTYPE_BACONHEROBUDDY	Camarada de Herói	
GLOBAL_CARDTYPE_BACONQUESTREWARD	Recompensa	
GLOBAL_CARDTYPE_ENCHANTMENT	Encantamento	
GLOBAL_CARDTYPE_HERO	Herói	
GLOBAL_CARDTYPE_HEROPOWER	Poder Heroico	
GLOBAL_CARDTYPE_ITEM	Item	
GLOBAL_CARDTYPE_LOCATION	Lugar	
GLOBAL_CARDTYPE_MINION	Lacaio	
GLOBAL_CARDTYPE_SPELL	Feitiço	
GLOBAL_CARDTYPE_TOKEN	Ficha	
GLOBAL_CARDTYPE_TRINKET	Berloque	
GLOBAL_CARDTYPE_WEAPON	Arma	
GLOBAL_CHAT_BUBBLE_RECEIVER_NAME	Para: {0}	0=player name
GLOBAL_CHAT_CHALLENGE	Desafio	
GLOBAL_CHAT_DECK_CODE_HINT	\nClique para copiar	
GLOBAL_CHAT_DECK_CODE_HINT_TOUCH	\nToque para copiar	
GLOBAL_CHAT_DECK_CODE_MESSAGE	Deck de {0}{1}	0=class name,1=copy hint
GLOBAL_CHAT_DECK_CODE_WITH_NAME_MESSAGE	Deck de {0}: {1}{2}	0=class name,1=deck name,2=copy hint
GLOBAL_CHAT_MERCENARIES_PARTY_CODE_MESSAGE	Grupo de Mercenários{0}	0=copy hint
GLOBAL_CHAT_MERCENARIES_PARTY_CODE_WITH_NAME_MESSAGE	Grupo de Mercenários: {0}{1}	0=deck name,1=copy hint
GLOBAL_CHAT_NO_FRIENDS_ONLINE	Você não tem nenhum amigo conectado atualmente.	
GLOBAL_CHAT_NO_RECENT_CONVERSATIONS	Use o Menu de amigos para iniciar uma conversa com um amigo.	
GLOBAL_CHAT_RECEIVER_OFFLINE	{0} está desconectado.	0=player name
GLOBAL_CHAT_RECEIVER_ONLINE	{0} está conectado.	0=player name
GLOBAL_CHAT_SEND_DECK_MESSAGE	Deseja enviar uma nova mensagem com o deck que está na área de transferência?	
GLOBAL_CHAT_SEND_DECK_TITLE	Enviar mensagem de deck	
GLOBAL_CHAT_SENDER_APPEAR_OFFLINE	Não é possível enviar mensagens no bate-papo enquanto você aparece desconectado.	
GLOBAL_CHAT_SENDER_OFFLINE	Você está desconectado.	
GLOBAL_CHOOSE_PAYMENT	Escolher forma de pagamento	
GLOBAL_CLASS_DEATHKNIGHT	Cavaleiro da Morte	
GLOBAL_CLASS_DEMONHUNTER	Caçador de Demônios	
GLOBAL_CLASS_DRUID	Druida	
GLOBAL_CLASS_HUNTER	Caçador	
GLOBAL_CLASS_MAGE	Mago	
GLOBAL_CLASS_NEUTRAL	Neutro	
GLOBAL_CLASS_PALADIN	Paladino	
GLOBAL_CLASS_PRIEST	Sacerdote	
GLOBAL_CLASS_ROGUE	Ladino	
GLOBAL_CLASS_SHAMAN	Xamã	
GLOBAL_CLASS_WARLOCK	Bruxo	
GLOBAL_CLASS_WARRIOR	Guerreiro	
GLOBAL_CLASSIC	Clássico	
GLOBAL_CLICK_TO_CONTINUE	Clique para continuar	
GLOBAL_CLICK_TO_CONTINUE_TOUCH	Toque para continuar	
GLOBAL_COLLECTION_DIAMOND	Diamante	
GLOBAL_COLLECTION_GOLDEN	Dourado	
GLOBAL_COLLECTION_NORMAL	Normal	
GLOBAL_COLLECTION_SIGNATURE	Exclusivo	
GLOBAL_COMMA_SEPARATOR	,	
GLOBAL_CONCEDE	Desistir	
GLOBAL_CONFIRM	Confirmar	
GLOBAL_CONTINUE	Continuar	
GLOBAL_COST	Custo	
GLOBAL_CREATE	Criar	
GLOBAL_CURRENT_DATE	{0:dd/MM/yy}	see http://msdn.microsoft.com/en-us/library/8kb3ddd4.aspx
GLOBAL_CURRENT_TIME	{0:HH:mm}	see http://msdn.microsoft.com/en-us/library/8kb3ddd4.aspx
GLOBAL_CURRENT_TIME_AM	AM	
GLOBAL_CURRENT_TIME_AND_DATE_DEV	{0} ({1} - {2})	
GLOBAL_CURRENT_TIME_PM	PM	
GLOBAL_DATETIME_AFK_DAY	Ausente por mais de um dia	
GLOBAL_DATETIME_AFK_DAYS	Ausente por {0} |4(dia,dias) 	
GLOBAL_DATETIME_AFK_HOURS	Ausente por {0} |4(hora,horas) 	
GLOBAL_DATETIME_AFK_MINUTES	Ausente por {0} |4(minuto,minutos) 	
GLOBAL_DATETIME_AFK_MONTH	Ausente por mais de um mês	
GLOBAL_DATETIME_AFK_SECONDS	Ausente por menos de um minuto	
GLOBAL_DATETIME_AFK_WEEKS	Ausente por {0} |4(semana,semanas) 	
GLOBAL_DATETIME_COMING_SOON	Em Breve	
GLOBAL_DATETIME_COMING_SOON_DAYS	Abre em\n{0} |4(dia,dias)	
GLOBAL_DATETIME_COMING_SOON_HOURS	Abre em\n{0} |4(hora,horas)	
GLOBAL_DATETIME_COMING_SOON_MINUTES	Abre em menos\nde uma hora	
GLOBAL_DATETIME_COMING_SOON_WEEKS	Abre em\n{0} |4(semana,semanas)	
GLOBAL_DATETIME_FRIENDREQUEST_DAY	ontem	
GLOBAL_DATETIME_FRIENDREQUEST_DAYS	Há {0} |4(dia,dias)	
GLOBAL_DATETIME_FRIENDREQUEST_HOURS	Há {0} |4(hora,horas)	
GLOBAL_DATETIME_FRIENDREQUEST_MINUTES	Há {0} |4(minuto,minutos)	
GLOBAL_DATETIME_FRIENDREQUEST_MONTH	há mais de um mês	
GLOBAL_DATETIME_FRIENDREQUEST_SECONDS	menos de um minuto atrás	
GLOBAL_DATETIME_FRIENDREQUEST_WEEKS	Há {0} |4(semana,semanas)	
GLOBAL_DATETIME_GREATER_THAN_X_MINUTES	> {0} |4(minuto,minutos)	
GLOBAL_DATETIME_LASTONLINE_DAY	Última conexão foi ontem	
GLOBAL_DATETIME_LASTONLINE_DAYS	Última conexão há {0} |4(dia,dias)	
GLOBAL_DATETIME_LASTONLINE_HOURS	Última conexão há {0} |4(hora,horas)	
GLOBAL_DATETIME_LASTONLINE_MINUTES	Última conexão há {0} |4(minuto,minutos)	
GLOBAL_DATETIME_LASTONLINE_MONTH	Última conexão há mais de um mês	
GLOBAL_DATETIME_LASTONLINE_SECONDS	Última conexão há menos de um minuto	
GLOBAL_DATETIME_LASTONLINE_WEEKS	Última conexão há {0} |4(semana,semanas)	
GLOBAL_DATETIME_SPINNER_DAY	> 1 dia	
GLOBAL_DATETIME_SPINNER_DAYS	{0} |4(dia,dias)	
GLOBAL_DATETIME_SPINNER_HOURS	{0} |4(hora,horas)	
GLOBAL_DATETIME_SPINNER_MINUTES	{0} min	
GLOBAL_DATETIME_SPINNER_MONTH	> 1 mês	
GLOBAL_DATETIME_SPINNER_SECONDS	{0} s	
GLOBAL_DATETIME_SPINNER_WEEKS	{0} |4(semana,semanas)	
GLOBAL_DATETIME_SPLASHSCREEN_DAY	> 1 dia	
GLOBAL_DATETIME_SPLASHSCREEN_DAYS	{0} |4(dia,dias)	
GLOBAL_DATETIME_SPLASHSCREEN_HOURS	{0} |4(hora,horas)	
GLOBAL_DATETIME_SPLASHSCREEN_MINUTES	{0} min	
GLOBAL_DATETIME_SPLASHSCREEN_MONTH	> 1 mês	
GLOBAL_DATETIME_SPLASHSCREEN_SECONDS	< 1 min	
GLOBAL_DATETIME_SPLASHSCREEN_WEEKS	{0} |4(semana,semanas)	
GLOBAL_DATETIME_TIMER_DAYS_HOURS	{0}d {1}h	0=days 1=hours
GLOBAL_DATETIME_TIMER_HOURS_MINUTES	{0}h {1}min	0=hours 1=minutes
GLOBAL_DATETIME_TIMER_LESS_THAN_X_MINUTES	< {0} m	0=minutes
GLOBAL_DATETIME_TIMER_MINUTES	{0}min	0=minutes
GLOBAL_DATETIME_TIMER_SECONDS	{0} s	0=seconds
GLOBAL_DATETIME_UNLOCKS_SOON_WEEKS	Desbloqueia em {0} |4(semana,semanas)	
GLOBAL_DEATHKNIGHT_RUNE_BLOOD	Cavaleiro da Morte: Sangue	
GLOBAL_DEATHKNIGHT_RUNE_FROST	Cavaleiro da Morte: Gelo	
GLOBAL_DEATHKNIGHT_RUNE_LOCKED	Mostrar todas as runas	
GLOBAL_DEATHKNIGHT_RUNE_UNHOLY	Cavaleiro da Morte: Profano	
GLOBAL_DECK_SHARE_ACCEPT_REQUEST	Compartilhar	
GLOBAL_DECK_SHARE_DECLINE_REQUEST	De Jeito Nenhum!	
GLOBAL_DECK_SHARE_ERROR	Ocorreu um erro ao tentar compartilhar decks.	
GLOBAL_DECK_SHARE_HEADER	Compartilhar decks?	
GLOBAL_DECK_SHARE_REQUEST_CANCELED	{0} cancelou o pedido para compartilhar decks.	0=friend name
GLOBAL_DECK_SHARE_REQUEST_DECLINED	{0} recusou seu pedido para compartilhar decks.	0=friend name
GLOBAL_DECK_SHARE_REQUEST_WAITING_RESPONSE	Esperando {0} responder ao seu pedido para compartilhar decks.	
GLOBAL_DECK_SHARE_REQUESTED	{0} quer pegar um deck seu emprestado.	0=friend name
GLOBAL_DEFAULT_ALERT_HEADER	Alerta	
GLOBAL_DEMO_COMPLETE_BODY	Obrigado por jogar esta demo de Hearthstone!	
GLOBAL_DEMO_COMPLETE_HEADER	Parabéns!	
GLOBAL_DEMO_DISCLAIMER	Esta versão de Hearthstone foi criada especificamente para demonstrações.	
GLOBAL_DEMO_LEARN_MORE	Saiba mais	
GLOBAL_DEVICE_TYPE_CONSOLE	Console	The type of device is a game console
GLOBAL_DEVICE_TYPE_DESKTOP	PC	The type of device is a desktop computer
GLOBAL_DEVICE_TYPE_HANDHELD	Modo portátil	The type of device is a handheld device like a phone or tablet
GLOBAL_DISABLE	Desativar	
GLOBAL_DONE	Pronto	
GLOBAL_DOWNLOAD_MANAGER	Downloads	Label for the Download Manager menu
GLOBAL_DOWNLOAD_MANAGER_BUTTON_CANCEL	Cancelar	
GLOBAL_DOWNLOAD_MANAGER_BUTTON_DOWNLOAD	Baixar	
GLOBAL_DOWNLOAD_MANAGER_BUTTON_UNINSTALL	Desinstalar	
GLOBAL_DOWNLOAD_MANAGER_CANCEL_LOADING_POPUP_CANCEL_MESSAGE	Download cancelado	
GLOBAL_DOWNLOAD_MANAGER_CANCEL_LOADING_POPUP_LOADING_MESSAGE	Cancelando	
GLOBAL_DOWNLOAD_MANAGER_CANCEL_MODULE_POPUP_PROMPT	Cancelar o download de {0}?	{0}=Module name to cancel downloading (e.g. Battlegrounds)
GLOBAL_DOWNLOAD_MANAGER_CANCEL_MODULE_POPUP_TITLE	Cancelar download	
GLOBAL_DOWNLOAD_MANAGER_DISMISS_BUTTON	Concluído	
GLOBAL_DOWNLOAD_MANAGER_ENABLE_OPTIONAL_ASSETS_DOWNLOAD	Ativar	Description for optional assets to be displayed on Download Manager
GLOBAL_DOWNLOAD_MANAGER_FREE_SPACE	Espaço disponível: {0}	{0}=Free spaces available on the device (e.g. 8.23 GB)
GLOBAL_DOWNLOAD_MANAGER_GAME_MODES	Modos de jogo	Label for the Download Manager - Game modes section
GLOBAL_DOWNLOAD_MANAGER_OPTION_CELLULAR_DATA_DESC	Permitir que Hearthstone use os dados móveis.	
GLOBAL_DOWNLOAD_MANAGER_OPTION_CELLULAR_DATA_LABEL	Dados móveis	
GLOBAL_DOWNLOAD_MANAGER_OPTIONAL_ASSETS	Modo de alta qualidade	Name for optional assets to be displayed on Download Manager
GLOBAL_DOWNLOAD_MANAGER_OPTIONAL_ASSETS_DESCRIPTION	Ativa/desativa gráficos e sons de alta qualidade	Description for optional assets to be displayed on Download Manager
GLOBAL_DOWNLOAD_MANAGER_PAUSE_DOWNLOADS	Pausar tudo	
GLOBAL_DOWNLOAD_MANAGER_PROGRESS_STATUS_CANCELLING	Cancelando...	
GLOBAL_DOWNLOAD_MANAGER_PROGRESS_STATUS_DOWNLOADING	{0} / {1}	{0}=Downloaded size (e.g. 23 MB) {1}=Total size to download (e.g. 128 MB)
GLOBAL_DOWNLOAD_MANAGER_PROGRESS_STATUS_INSTALLED	Instalado!	
GLOBAL_DOWNLOAD_MANAGER_PROGRESS_STATUS_PAUSED	Pausado	
GLOBAL_DOWNLOAD_MANAGER_PROGRESS_STATUS_QUEUED	Na fila	
GLOBAL_DOWNLOAD_MANAGER_PROGRESS_STATUS_REMAINING	Restante: {0}	0=Time remaining. (e.g. 21:30)
GLOBAL_DOWNLOAD_MANAGER_PROGRESS_STATUS_UNINSTALLING	Desinstalando...	
GLOBAL_DOWNLOAD_MANAGER_RESUME_DOWNLOADS	Retomar tudo	
GLOBAL_DOWNLOAD_MANAGER_SETTINGS	Configurações	Label for the Download Manager - Settings section
GLOBAL_DOWNLOAD_MANAGER_UNINSTALL_LOADING_POPUP_COMPLETE_MESSAGE	Desinstalação completa	
GLOBAL_DOWNLOAD_MANAGER_UNINSTALL_LOADING_POPUP_LOADING_MESSAGE	Desinstalando	
GLOBAL_DOWNLOAD_MANAGER_UNINSTALL_MODULE_POPUP_BODY_FORMAT	{0}\n\n{1}\n{2}	{0}=Prompt string, {1}=Module size, {2}=Device size available
GLOBAL_DOWNLOAD_MANAGER_UNINSTALL_MODULE_POPUP_PROMPT	Desinstalar {0}?	{0}=Module name to uninstall (e.g. Battlegrounds)
GLOBAL_DOWNLOAD_MANAGER_UNINSTALL_MODULE_POPUP_TITLE	Desinstalar	Popup title for removing a module
GLOBAL_DOWNLOAD_MANAGER_UNINSTALL_OPTIONAL_ASSETS_POPUP_PROMPT	Deseja sair do modo de alta qualidade?\nVocê precisará baixar os recursos novamente ao voltar.	
GLOBAL_DOWNLOAD_MANAGER_UNINSTALL_OPTIONAL_ASSETS_POPUP_TITLE	Modo de alta qualidade	
GLOBAL_DOWNLOAD_MODULE_POPUP_FILE_SIZE	Tamanho do arquivo: {0}	{0}=File size to download (e.g. 1.8GB)
GLOBAL_DOWNLOAD_MODULE_POPUP_FREE_SPACE	Espaço disponível: {0}	{0}=Free spaces available on the device (e.g. 8.23 GB)
GLOBAL_DOWNLOAD_MODULE_POPUP_PROMPT	Baixar {0}?	{0}=Module name to download (e.g. Battlegrounds)
GLOBAL_ENABLE	Ativar	
GLOBAL_END_GAME	Fim de jogo	
GLOBAL_ENTER	Entrar	
GLOBAL_ERROR	Erro	
GLOBAL_ERROR_ACCOUNT_LICENSES	Tivemos problemas ao verificar o que você possui, então algumas coisas podem estar faltando. Pedimos desculpas! Tentaremos de novo da próxima vez que você conectar.	
GLOBAL_ERROR_ASSET_CREATE_PERSISTENT_DATA_PATH	Não foi possível criar uma pasta para salvar dados em {0}.	0=folder path
GLOBAL_ERROR_ASSET_DOWNLOAD_FAILED	Não foi possível baixar recurso {0}.	0=asset name
GLOBAL_ERROR_ASSET_INCORRECT_DATA	Recurso {0} contém dados incorretos.	0=asset name
GLOBAL_ERROR_ASSET_LOAD_FAILED	Não foi possível carregar recurso {0}.	0=asset name
GLOBAL_ERROR_ASSET_MANIFEST	Não foi possível carregar manifesto de recursos	
GLOBAL_ERROR_ASSET_NO_FILE_PATH	Não foi possível encontrar o caminho para o recurso {0}. 	0=asset name
GLOBAL_ERROR_CURRENCY_INVALID	O cliente tentou usar uma moeda inválida para completar a compra.	
GLOBAL_ERROR_FIND_GAME_SCENARIO_INCORRECT_NUM_PLAYERS	Houve um erro ao iniciar o jogo. O cenário tem um número inesperado de jogadores.	
GLOBAL_ERROR_FIND_GAME_SCENARIO_MISCONFIGURED	Houve um erro ao iniciar o jogo. Os dados do cenários estão mal configurados.	
GLOBAL_ERROR_FIND_GAME_SCENARIO_NO_DECK_SPECIFIED	Houve um erro ao iniciar o jogo. Nenhum deck especificado pelo(s) jogador(es).	
GLOBAL_ERROR_GAME_DENIED	Houve um erro ao iniciar o jogo. Espere alguns minutos e tente novamente.	
GLOBAL_ERROR_GAME_OPPONENT_TIMEOUT	O jogo falhou ao iniciar porque seu oponente não se conectou. Tente novamente.	
GLOBAL_ERROR_GENERIC_HEADER	Erro	
GLOBAL_ERROR_INACTIVITY_KICK	Sua última ação no Hearthstone foi algum tempo atrás e sua conexão foi encerrada. Reinicie o jogo para voltar!	
GLOBAL_ERROR_NETWORK_ACCOUNT_BANNED	Sua conta foi banida.	
GLOBAL_ERROR_NETWORK_ACCOUNT_CURFEW_REACHED	Você não pode se conectar devido a restrições legais de tempo de jogo para menores de idade. Procure manter um estilo de vida saudável enquanto joga videogame. Saiba mais: https://support.battlenet.com.cn/w/article/101015	
GLOBAL_ERROR_NETWORK_ACCOUNT_INVALID_NID	Infelizmente, você só pode prosseguir depois de passar por uma verificação de nome real. Acesse https://support.battlenet.com.cn/w/article/101015 para mais detalhes.	
GLOBAL_ERROR_NETWORK_ACCOUNT_PLAYTIME_EXCEEDED	Você não pode se conectar devido a restrições legais de tempo de jogo para menores de idade. Procure manter um estilo de vida saudável enquanto joga videogame. Saiba mais: https://support.battlenet.com.cn/w/article/101015	
GLOBAL_ERROR_NETWORK_ACCOUNT_SUSPENDED	Sua conta foi suspensa.	
GLOBAL_ERROR_NETWORK_ADMIN_KICKED	Você foi removido do serviço da Blizzard. Inicie Hearthstone novamente para se reconectar.	
GLOBAL_ERROR_NETWORK_ADVENTURE_RECONNECT_TIMEOUT	Seu jogo foi salvo. Reinicie Hearthstone para continuar de onde você parou.	
GLOBAL_ERROR_NETWORK_CONNECTION_TIMEOUT	Seu tempo de conexão se esgotou. Verifique se está conectado à internet.	
GLOBAL_ERROR_NETWORK_DISCONNECT	Você foi desconectado dos serviços da Blizzard. Reinicie o Hearthstone para reconectar.	
GLOBAL_ERROR_NETWORK_DISCONNECT_GAME_SERVER	Sua conexão com o serviço de jogo do Hearthstone foi interrompida.	
GLOBAL_ERROR_NETWORK_DISCONNECT_GENERIC	Você foi desconectado.	
GLOBAL_ERROR_NETWORK_DUPLICATE_LOGIN	Esta conta da Blizzard acabou de se conectar ao Hearthstone de outro dispositivo.\n\nEste cliente foi desconectado porque somente uma conexão pode estar ativa por vez.	
GLOBAL_ERROR_NETWORK_GENERIC	Ocorreu um erro interno de rede.	
GLOBAL_ERROR_NETWORK_INCORRECT_REGION	Sua conta da Blizzard não tem os requisitos para participar do teste do beta de Hearthstone. Tente novamente quando o beta de Hearthstone estiver disponível na sua região!	
GLOBAL_ERROR_NETWORK_LOGIN_FAILURE	O jogo não permitiu que você se conectasse aos serviços da Blizzard. Espere alguns minutos e tente novamente.	
GLOBAL_ERROR_NETWORK_LOST_GAME_CONNECTION	Seu jogo foi desconectado dos serviços da Blizzard. Você pode tentar se reconectar iniciando um outro jogo.	
GLOBAL_ERROR_NETWORK_NO_CONNECTION	Não foi possível conectar. Verifique se está conectado à internet.	
GLOBAL_ERROR_NETWORK_NO_GAME_SERVER	Opa! Não foi possível inicializar um jogo para você. Tente novamente.	
GLOBAL_ERROR_NETWORK_PARENTAL_CONTROLS	O acesso a esta conta está restrito pelo controle dos pais.	
GLOBAL_ERROR_NETWORK_PHONE_LOCK	Ligue para o número do seu Blizzard Phone Lock para permitir o login.\nTaiwan: 0800-303-585\nHong Kong: 396-54666	
GLOBAL_ERROR_NETWORK_RISK_ACCOUNT_LOCKED	Nós bloqueamos a sua conta! Visite https://us.battle.net/support/pt/ e procure por 7537 para saber o que aconteceu!	
GLOBAL_ERROR_NETWORK_SPAM	Você foi desconectado dos serviços da Blizzard por enviar um excesso de solicitações rápido demais. Reinicie o Hearthstone para reconectar.	
GLOBAL_ERROR_NETWORK_TITLE	ERRO DE REDE	
GLOBAL_ERROR_NETWORK_UNAVAILABLE_NEW_VERSION	Sua conta foi usada numa versão mais recente do jogo. Aguarde a atualização neste dispositivo para jogar.	
GLOBAL_ERROR_NETWORK_UNAVAILABLE_OFFLINE	Hearthstone está desconectado. Espere alguns minutos e tente novamente.	
GLOBAL_ERROR_NETWORK_UNAVAILABLE_UNKNOWN	Opa! Duendes engraçadinhos deram um nó no Hearthstone durante a conexão com os nossos servidores. Já, já eles caem fora. Tente novamente em alguns minutos.	
GLOBAL_ERROR_NETWORK_UNAVAILABLE_UPGRADE	Hearthstone foi atualizado! Baixe a mais nova versão.	
GLOBAL_ERROR_NETWORK_UTIL_TIMEOUT	O jogo expirou enquanto requisitava dados do serviço de utilidade do Hearthstone. Reinicie o Hearthstone para reconectar.	
GLOBAL_ERROR_NO_MAGE_PRECON	Encontramos um problema de rede ao carregar todos os cards da sua coleção. Reinicie o Hearthstone para acessar sua coleção e continuar seus duelos.	
GLOBAL_ERROR_STREAMING_ASSET_TIMEOUT	Expirou enquanto esperava pelo sistema de streaming. Estava carregando o recurso {0}.	0=asset name
GLOBAL_ERROR_UNKNOWN_ERROR	Ops! Duendes engraçadinhos deram um nó no Hearthstone durante a conexão com o serviço da Blizzard. Rapidinho eles caem fora. Tente reiniciar o jogo em alguns minutos.	
GLOBAL_EXIT	Sair	
GLOBAL_EXIT_CONFIRM_MESSAGE	Tem certeza de que deseja sair do jogo?	
GLOBAL_EXIT_CONFIRM_TITLE	Sair do jogo	
GLOBAL_FEATURE_DISABLED_MESSAGE_BATTLEGROUNDS	Desculpe, mas o modo Campos de Batalha está desativado no momento.	
GLOBAL_FEATURE_DISABLED_MESSAGE_COLLECTION	Desculpe, a Coleção está desativada no momento.	
GLOBAL_FEATURE_DISABLED_MESSAGE_FORGE	Desculpe, a Arena está desativada no momento.	
GLOBAL_FEATURE_DISABLED_MESSAGE_PLAY	Desculpe, mas o Hearthstone Tradicional está desativado no momento.	
GLOBAL_FEATURE_DISABLED_MESSAGE_PRACTICE	Desculpe, o Modo de Treinamento está desativado no momento.	
GLOBAL_FEATURE_DISABLED_TITLE	Desativado	
GLOBAL_FINISH	Concluir	
GLOBAL_FORGE_END_DONE	Pronto	
GLOBAL_FORGE_END_JOKE_0	Isso foi picante!	
GLOBAL_FORGE_END_JOKE_1	Estou sem palavras!	
GLOBAL_FORGE_END_JOKE_2	Eu não acredito!	
GLOBAL_FORGE_END_JOKE_3	Tu pegou algo realmente especial.	
GLOBAL_FORGE_END_JOKE_4	Será que tu consegue fazer isso direito de novo?	
GLOBAL_FORGE_END_JOKE_5	Isso merece uma dancinha!	
GLOBAL_FORGE_END_JOKE_6	Aquele turno foi incrível!	
GLOBAL_FORGE_END_JOKE_7	CONTEMPLE!	
GLOBAL_FORGE_END_JOKE_8	Ainda não acabou. Ah, pera. acabou sim.	
GLOBAL_FORGE_END_TITLE	Arena completa	
GLOBAL_FRIEND_CHALLENGE_ACCEPT	Aceitar	
GLOBAL_FRIEND_CHALLENGE_BODY_BACON	Você foi convidado para entrar\nnum grupo de Campos de Batalha por:	
GLOBAL_FRIEND_CHALLENGE_BODY_BATTLEGROUNDS_SUGGESTION	{0} quer convidar um amigo para o seu grupo dos Campos de Batalha:	0=suggester name
GLOBAL_FRIEND_CHALLENGE_BODY1	Você foi desafiado por:	
GLOBAL_FRIEND_CHALLENGE_BODY1_CLASSIC	Você foi desafiado para um\njogo Clássico por:	
GLOBAL_FRIEND_CHALLENGE_BODY1_STANDARD	Você foi desafiado para um\njogo Padrão por:	
GLOBAL_FRIEND_CHALLENGE_BODY1_TWIST	Você foi desafiado para\num jogo Imprevisível por:	
GLOBAL_FRIEND_CHALLENGE_BODY1_WILD	Você foi desafiado para um\njogo Livre por:	
GLOBAL_FRIEND_CHALLENGE_BODY2	Você aceita?	
GLOBAL_FRIEND_CHALLENGE_DECLINE	Rejeitar	
GLOBAL_FRIEND_CHALLENGE_HEADER	Desafio	
GLOBAL_FRIEND_CHALLENGE_NEARBY_PLAYER_NOTE	Você pode desligar os convites de jogadores próximos na Lista de Amigos.	
GLOBAL_FRIEND_CHALLENGE_OPPONENT_CANCELED	{0} cancelou o desafio.	0=friend name
GLOBAL_FRIEND_CHALLENGE_OPPONENT_DECLINED	{0} recusou seu desafio.	0=friend name
GLOBAL_FRIEND_CHALLENGE_OPPONENT_FRIEND_REMOVED	O desafio foi cancelado porque {0} não é mais seu amigo.	0=friend name
GLOBAL_FRIEND_CHALLENGE_OPPONENT_WAITING_DECK	Você está esperando que {0} selecione um deck.	0=friend name
GLOBAL_FRIEND_CHALLENGE_OPPONENT_WAITING_RESPONSE	Você está esperando que {0} responda seu desafio.	0=friend name
GLOBAL_FRIEND_CHALLENGE_OPPONENT_WAITING_TEAM	Você está esperando o oponente escolher uma equipe.	
GLOBAL_FRIEND_CHALLENGE_QUEUE_CANCELED	O desafio foi cancelado.	
GLOBAL_FRIEND_CHALLENGE_TAVERN_BRAWL_BODY1	Você foi desafiado para uma Contenda de Taverna por:	
GLOBAL_FRIEND_CHALLENGE_TAVERN_BRAWL_HEADER	Desafio da Contenda de Taverna	
GLOBAL_FRIEND_CHALLENGE_TAVERN_BRAWL_OPPONENT_WAITING_READY	Você está esperando que {0} entre na contenda.	0=friend name
GLOBAL_FRIEND_CHALLENGE_TAVERN_BRAWL_RECIPIENT_NO_VALID_DECK_RECIPIENT	{0} quer entrar na Contenda com você! Crie um deck de Contenda na Taverna para aceitar desafios de Contenda.	
GLOBAL_FRIEND_CHALLENGE_TAVERN_BRAWL_RECIPIENT_NO_VALID_DECK_SENDER	Seu amigo ainda não tem um deck de Contenda de Taverna. Tente novamente depois disso!	
GLOBAL_FRIEND_CHALLENGE_TAVERN_BRAWL_RECIPIENT_NOT_UNLOCKED_SENDER	Ainda falta seu amigo desbloquear a Contenda de Taverna. Tente de novo depois disso!	
GLOBAL_FRIEND_CHALLENGE_TITLE	Amistoso	
GLOBAL_FRIEND_PARTY_INVITATION_BODY_DECLINED	{0} recusou seu convite.	0=friend name
GLOBAL_FRIEND_PARTY_INVITATION_TITLE	Grupo	
GLOBAL_FRIENDLIST_ADD_FRIEND_BUTTON	Adicionar	
GLOBAL_FRIENDLIST_BATTLEGROUNDS_PARTY_INVITE	Convite para grupo	
GLOBAL_FRIENDLIST_BATTLEGROUNDS_PARTY_KICK	Expulsar do grupo	
GLOBAL_FRIENDLIST_BATTLEGROUNDS_TOOLTIP_INVITE_ALREADY_SENT_BODY	Você já convidou esse jogador.	
GLOBAL_FRIENDLIST_BATTLEGROUNDS_TOOLTIP_INVITE_ALREADY_SENT_HEADER	Já enviado	
GLOBAL_FRIENDLIST_BATTLEGROUNDS_TOOLTIP_INVITE_BODY	Convidar {0} para jogar Campos de Batalha com você.	0=player name
GLOBAL_FRIENDLIST_BATTLEGROUNDS_TOOLTIP_INVITE_FULL_PARTY_BODY	8 jogadores já foram convidados para esse grupo.	
GLOBAL_FRIENDLIST_BATTLEGROUNDS_TOOLTIP_INVITE_FULL_PARTY_HEADER	Grupo completo	
GLOBAL_FRIENDLIST_BATTLEGROUNDS_TOOLTIP_INVITE_HEADER	Convidar	
GLOBAL_FRIENDLIST_BATTLEGROUNDS_TOOLTIP_KICK_BODY	Remover {0} de seu grupo dos Campos de Batalha.	0=player name
GLOBAL_FRIENDLIST_BATTLEGROUNDS_TOOLTIP_KICK_HEADER	Expulsar	
GLOBAL_FRIENDLIST_BUSYSTATUS	Ocupado	
GLOBAL_FRIENDLIST_CHALLENGE_BUTTON_AVAILABLE	Desafie {0} para uma partida de Hearthstone.	0=player name
GLOBAL_FRIENDLIST_CHALLENGE_BUTTON_BATTLEGROUNDS_LOCKED	Conclua o tutorial dos Campos de Batalha para desbloquear.	
GLOBAL_FRIENDLIST_CHALLENGE_BUTTON_BATTLEGROUNDS_PARTY_MEMBER	Você não pode enviar um desafio estando num grupo dos Campos de Batalha.	
GLOBAL_FRIENDLIST_CHALLENGE_BUTTON_EARLY_ACCESS	Esse modo está em Acesso Antecipado.	
GLOBAL_FRIENDLIST_CHALLENGE_BUTTON_GAME_MODE_LOCKED	Você ainda não desbloqueou este modo.	
GLOBAL_FRIENDLIST_CHALLENGE_BUTTON_HEADER	Desafio Amistoso	
GLOBAL_FRIENDLIST_CHALLENGE_BUTTON_IM_APPEARING_OFFLINE	Você não pode desafiar {0} agora. Você aparece desconectado.	0=player name
GLOBAL_FRIENDLIST_CHALLENGE_BUTTON_IM_UNAVAILABLE	Você não pode desafiar {0} agora. Retorne ao menu principal.	0=player name
GLOBAL_FRIENDLIST_CHALLENGE_BUTTON_MERCS_LOCKED	Conclua o tutorial de Mercenários para desbloquear.	
GLOBAL_FRIENDLIST_CHALLENGE_BUTTON_MODE_UNAVAILABLE	Desafiar um amigo neste modo de jogo está indisponível. 	
GLOBAL_FRIENDLIST_CHALLENGE_BUTTON_TAVERN_BRAWL_LOCKED	Conclua o tutorial do Hearthstone Tradicional e alcance o nível 20 com uma classe para desbloquear.	
GLOBAL_FRIENDLIST_CHALLENGE_BUTTON_THEYRE_UNAVAILABLE	Não é possível desafiar {0} neste momento. Espere até que volte ao menu principal.	0=player name
GLOBAL_FRIENDLIST_CHALLENGE_BUTTON_TRADITIONAL_LOCKED	Conclua o tutorial do Hearthstone Tradicional para desbloquear.	
GLOBAL_FRIENDLIST_CHALLENGE_BUTTON_UNAVAILABLE	Você não pode desafiar {0} agora.	0=player name
GLOBAL_FRIENDLIST_CHALLENGE_CHALLENGEE_NO_BATTLEGROUNDS_EARLY_ACCESS	Esse jogador não tem acesso antecipado aos Campos de Batalha.	
GLOBAL_FRIENDLIST_CHALLENGE_CHALLENGEE_NO_BATTLEGROUNDS_TUTORIAL_COMPLETE	Este jogador ainda não concluiu o tutorial dos Campos de Batalha.	
GLOBAL_FRIENDLIST_CHALLENGE_CHALLENGEE_NO_CLASSIC_DECK	Este jogador não tem nenhum deck Clássico.	
GLOBAL_FRIENDLIST_CHALLENGE_CHALLENGEE_NO_DECK	Este jogador não tem nenhum deck.	
GLOBAL_FRIENDLIST_CHALLENGE_CHALLENGEE_NO_HEARTHSTONE_TUTORIAL_COMPLETE	Este jogador ainda não concluiu o tutorial de Hearthstone.	
GLOBAL_FRIENDLIST_CHALLENGE_CHALLENGEE_NO_MERCS_TUTORIAL_COMPLETE	Este jogador ainda não concluiu o contrato tutorial de Mercenários.	
GLOBAL_FRIENDLIST_CHALLENGE_CHALLENGEE_NO_STANDARD_DECK	Este jogador não tem nenhum deck Padrão.	
GLOBAL_FRIENDLIST_CHALLENGE_CHALLENGEE_NO_TAVERN_BRAWL_DECK	Este jogador ainda não criou nenhum deck para a Contenda de Taverna.	
GLOBAL_FRIENDLIST_CHALLENGE_CHALLENGEE_NO_TWIST_DECK	Este jogador não tem nenhum deck Imprevisível.	
GLOBAL_FRIENDLIST_CHALLENGE_CHALLENGEE_NOT_SEEN_WILD	Este jogador ainda não desbloqueou o Livre.	
GLOBAL_FRIENDLIST_CHALLENGE_CHALLENGEE_TAVERN_BRAWL_LOCKED	Este jogador não desbloqueou as Contendas de Taverna ainda.	
GLOBAL_FRIENDLIST_CHALLENGE_CHALLENGEE_USER_IS_BUSY	Este jogador está ocupado.	
GLOBAL_FRIENDLIST_CHALLENGE_CHALLENGER_NO_CLASSIC_DECK	Você não tem nenhum deck Clássico.	
GLOBAL_FRIENDLIST_CHALLENGE_CHALLENGER_NO_DECK	Primeiro você tem que montar um deck.	
GLOBAL_FRIENDLIST_CHALLENGE_CHALLENGER_NO_STANDARD_DECK	Você não tem nenhum deck Padrão.	
GLOBAL_FRIENDLIST_CHALLENGE_CHALLENGER_NO_TAVERN_BRAWL_DECK	Você precisa montar um deck para a Contenda desta semana.	
GLOBAL_FRIENDLIST_CHALLENGE_CHALLENGER_NO_TWIST_DECK	Você não tem nenhum deck Imprevisível.	
GLOBAL_FRIENDLIST_CHALLENGE_CHALLENGER_TAVERN_BRAWL_LOCKED	Desbloqueie a Contenda de Taverna chegando ao nível 20 com qualquer classe.	
GLOBAL_FRIENDLIST_CHALLENGE_MENU_CLASSIC_DUEL_BUTTON	Clássico	
GLOBAL_FRIENDLIST_CHALLENGE_MENU_DUEL_BUTTON	Duelar	
GLOBAL_FRIENDLIST_CHALLENGE_MENU_HEADER_FRIEND	Desafiar <color=#61C8E8>{0}</color> para...	0=battletag
GLOBAL_FRIENDLIST_CHALLENGE_MENU_HEADER_NONFRIEND	Desafiar {0} para...	0=battletag
GLOBAL_FRIENDLIST_CHALLENGE_MENU_HEARTHSTONE_BUTTON	Hearthstone	
GLOBAL_FRIENDLIST_CHALLENGE_MENU_HEARTHSTONE_EXTENDED_MENU_BUTTON	Hearthstone...	
GLOBAL_FRIENDLIST_CHALLENGE_MENU_OPTIONS_BUTTON	Opções...	
GLOBAL_FRIENDLIST_CHALLENGE_MENU_REMOVE_BUTTON	Remover amigo...	
GLOBAL_FRIENDLIST_CHALLENGE_MENU_REPORT_BUTTON	Denunciar...	
GLOBAL_FRIENDLIST_CHALLENGE_MENU_STANDARD_DUEL_BUTTON	Padrão	
GLOBAL_FRIENDLIST_CHALLENGE_MENU_TWIST_DUEL_BUTTON	Imprevisível	
GLOBAL_FRIENDLIST_CHALLENGE_MENU_WILD_DUEL_BUTTON	Livre	
GLOBAL_FRIENDLIST_CHALLENGE_TOOLTIP_NO_TAVERN_BRAWL	Contenda de Taverna não está disponível no momento. Volte mais tarde!	
GLOBAL_FRIENDLIST_CHALLENGE_TOOLTIP_NO_TWIST_SEASON	Imprevisível não está disponível no momento. Volte mais tarde!	
GLOBAL_FRIENDLIST_CHALLENGE_TOOLTIP_TAVERN_BRAWL_NOT_CHALLENGEABLE	O Desafio Amistoso não está disponível nesta Contenda de Taverna.	
GLOBAL_FRIENDLIST_CURRENT_GAMES_HEADER	JOGOS ATUAIS - {0}	0=number of friends you have unfinished games with
GLOBAL_FRIENDLIST_CURRENT_OPPONENT_STATUS	Oponente atual!	
GLOBAL_FRIENDLIST_CURRENT_TEAMMATE_STATUS	Colega de equipe atual!	
GLOBAL_FRIENDLIST_CURRENTLY_SPECTATING_STATUS	Assistindo	
GLOBAL_FRIENDLIST_FORMER_FRIEND_STATUS	Ex-amigo	
GLOBAL_FRIENDLIST_FRIENDS_HEADER	AMIGOS - {0}/{1} |4(conectado,conectados)	0=number of online friends 1=number of offline friends
GLOBAL_FRIENDLIST_FRIENDS_HEADER_ALL_ONLINE	AMIGOS - {0} |4(conectado,conectados)	
GLOBAL_FRIENDLIST_LAST_OPPONENT_STATUS	Último oponente	
GLOBAL_FRIENDLIST_LASTPLAYED	Jogado pela última vez:	
GLOBAL_FRIENDLIST_MYSTATUS	CONECTADO	
GLOBAL_FRIENDLIST_NEARBY_PLAYERS_DISABLED_HEADER	PRÓXIMOS (Desativado)	
GLOBAL_FRIENDLIST_NEARBY_PLAYERS_HEADER	PRÓXIMOS - {0}	0=number of players
GLOBAL_FRIENDLIST_NEW_FRIEND_STATUS	Amigo novo!	
GLOBAL_FRIENDLIST_NO_FRIENDS	Você ainda não possui amigos no <color=#61C8E8>Battle.net</color>!	
GLOBAL_FRIENDLIST_RECENT_CHALLENGED_STATUS	Desafiou recentemente	
GLOBAL_FRIENDLIST_RECENT_CHATTED_STATUS	Conversou recentemente	
GLOBAL_FRIENDLIST_RECENT_OPPONENT_STATUS	Oponente recente	
GLOBAL_FRIENDLIST_RECENT_PLAYERS_HEADER	RECENTE - {0}	0=number of players
GLOBAL_FRIENDLIST_RECENT_TEAMMATE_STATUS	Colega de equipe recente	
GLOBAL_FRIENDLIST_RECENTLY_SPECTATING_STATUS	Recém-assistido	
GLOBAL_FRIENDLIST_REMOVE_FRIEND_ALERT_MESSAGE	Tem certeza de que deseja remover {0}?	0=friend name
GLOBAL_FRIENDLIST_REMOVE_FRIEND_BUTTON	Remover	
GLOBAL_FRIENDLIST_REPORT_SELECT_COMPLETE	Obrigado por denunciar!	
GLOBAL_FRIENDLIST_REPORT_SELECT_HEADER_FRIEND	Denunciar <color=#61C8E8>{0}</color>	0=battletag
GLOBAL_FRIENDLIST_REPORT_SELECT_HEADER_NONFRIEND	Denunciar {0}	0=battletag
GLOBAL_FRIENDLIST_REPORT_SELECT_OPTIONS	Escolha tudo que se aplicar:	
GLOBAL_FRIENDLIST_REPORT_SELECT_REASON	Selecione um motivo...	
GLOBAL_FRIENDLIST_REPORT_TOOLTIP_COMING_SOON_TEXT	Em breve	
GLOBAL_FRIENDLIST_REPORT_TOOLTIP_CURRENTLY_UNAVAILABLE_TEXT	Indisponível no momento	
GLOBAL_FRIENDLIST_REPORT_TOOLTIP_HEADER	Denunciar um jogador	
GLOBAL_FRIENDLIST_REQUEST_SENT_TIME	Enviado: {0}	0=one of the GLOBAL_DATETIME_ELAPSED_ strings
GLOBAL_FRIENDLIST_REQUESTS_HEADER	PEDIDOS DE AMIZADE - {0}	0=number of received friend requests
GLOBAL_FRIENDLIST_SPECTATE_MENU_DESCRIPTION	{0} está jogando uma partida.	0=player name
GLOBAL_FRIENDLIST_SPECTATE_MENU_KICK	Expulsar espectador	
GLOBAL_FRIENDLIST_SPECTATE_MENU_STOP	Parar de assistir	
GLOBAL_FRIENDLIST_SPECTATE_TOOLTIP_AVAILABLE_HEADER	Assistir esse jogo	
GLOBAL_FRIENDLIST_SPECTATE_TOOLTIP_AVAILABLE_TEXT	Clique para começar a assistir o jogo desse jogador.	
GLOBAL_FRIENDLIST_SPECTATE_TOOLTIP_AVAILABLE_TEXT_TOUCH	Toque aqui para começar a assistir ao jogo desse jogador.	
GLOBAL_FRIENDLIST_SPECTATE_TOOLTIP_INVITE_HEADER	Convidar para assistir	
GLOBAL_FRIENDLIST_SPECTATE_TOOLTIP_INVITE_OTHER_SIDE_HEADER	Assistindo ao oponente	
GLOBAL_FRIENDLIST_SPECTATE_TOOLTIP_INVITE_OTHER_SIDE_TEXT	Clique para mostrar suas cartas a {0} também.	0=player name
GLOBAL_FRIENDLIST_SPECTATE_TOOLTIP_INVITE_OTHER_SIDE_TEXT_TOUCH	Toque para mostrar suas cartas a {0}.	0=player name
GLOBAL_FRIENDLIST_SPECTATE_TOOLTIP_INVITE_TEXT	Convidar {0} para observar você.	0=player name
GLOBAL_FRIENDLIST_SPECTATE_TOOLTIP_INVITED_HEADER	Convidado para assistir	
GLOBAL_FRIENDLIST_SPECTATE_TOOLTIP_INVITED_TEXT	Convite enviado para {0} começar a assistir.	0=player name
GLOBAL_FRIENDLIST_SPECTATE_TOOLTIP_KICK_HEADER	Expulsar	
GLOBAL_FRIENDLIST_SPECTATE_TOOLTIP_KICK_TEXT	{0} está observando você. Clique aqui para remover esse espectador.	
GLOBAL_FRIENDLIST_SPECTATE_TOOLTIP_KICK_TEXT_TOUCH	{0} está observando você. Toque aqui para remover esse espectador.	
GLOBAL_FRIENDLIST_SPECTATE_TOOLTIP_PREVIOUSLY_KICKED_HEADER	Não é possível observar	
GLOBAL_FRIENDLIST_SPECTATE_TOOLTIP_PREVIOUSLY_KICKED_TEXT	Você já foi impedido de observar este jogador. Não é possível tentar observá-lo novamente.	
GLOBAL_FRIENDLIST_SPECTATE_TOOLTIP_RECEIVED_INVITE_TEXT	{0} convidou você para ser espectador. Clique aqui para começar a assistir.	
GLOBAL_FRIENDLIST_SPECTATE_TOOLTIP_RECEIVED_INVITE_TEXT_TOUCH	{0} convidou você para ser espectador. Toque aqui para começar a assistir.	
GLOBAL_FRIENDLIST_SPECTATE_TOOLTIP_SPECTATING_HEADER	No modo Espectador	
GLOBAL_FRIENDLIST_SPECTATE_TOOLTIP_SPECTATING_TEXT	Você está assistindo ao jogo deste jogador.	
GLOBAL_FRIENDLYCHALLENGE_QUEST_REWARD_AT_LIMIT	Você atingiu o limite diário de recompensas de missão do Desafio de Amigo.	
GLOBAL_FRIENDLYCHALLENGE_REWARD_CONCEDED_YOUR_OPPONENT	Seu oponente saiu do jogo cedo demais e, por isso, você não obteve recompensas.	
GLOBAL_FRIENDLYCHALLENGE_REWARD_CONCEDED_YOURSELF	Você saiu do jogo cedo demais e, por isso, não obteve recompensas.	
GLOBAL_GAME_MENU	Menu do Jogo	
GLOBAL_GAME_MENU_BUTTON_DOWNLOAD_MANAGER	Downloads	Button label for Download manager on the Game Menu
GLOBAL_GAME_MENU_BUTTON_DOWNLOAD_MANAGER_LOCKED_TOOLTIP	Aqui você pode gerenciar os downloads de Hearthstone. Disponível apenas no menu principal.	
GLOBAL_GAME_MENU_BUTTON_DOWNLOAD_MANAGER_LOCKED_TOOLTIP_TITLE	Downloads	
GLOBAL_GAME_QUEUE_TIME_IN_QUEUE	Tempo na fila	
GLOBAL_GAME_QUEUE_WAIT_TIME	Tempo de espera	
GLOBAL_GOLD_REWARD_ALREADY_CAPPED	Você já ganhou {0} de ouro hoje.	
GLOBAL_GOLD_REWARD_BAD_RATING	Você ou seu oponente não possuem os requisitos de ranque necessários para ganhar ouro.	
GLOBAL_GOLD_REWARD_OVER_CAIS	Você não pode ganhar mais ouro devido ao CAIS.	
GLOBAL_GOLD_REWARD_SHORT_GAME_BY_TIME	Seu jogo não atendeu aos requisitos de tempo necessários para ganhar ouro.	
GLOBAL_HEALTH	Vida	
GLOBAL_HEALTHY_GAMING_CHINA_CAIS_ACTIVE	CAIS Ativo	
GLOBAL_HEALTHY_GAMING_CHINA_LESS_THAN_THREE_HOURS	您累计在线时间已满{0}小时。	
GLOBAL_HEALTHY_GAMING_CHINA_MORE_THAN_FIVE_HOURS	您已进入不健康游戏时间，为了您的健康，请您立即下线休息。如不下线，您的身体将受到损害，您的收益已降为零，直到您的累计下线时间满5小时后，才能恢复正常。	
GLOBAL_HEALTHY_GAMING_CHINA_MORE_THAN_FIVE_HOURS_PHONE	您已进入不健康游戏时间，为了您的健康，请您立即下线休息。如不下线，您的身体将受到损害，\n您的收益已降为零，直到您的累计下线时间满5小时后，才能恢复正常。	
GLOBAL_HEALTHY_GAMING_CHINA_STARTUP_MESSAGE	抵制不良游戏，拒绝盗版游戏。 \n注意自我保护，谨防受骗上当。\n适度游戏益脑，沉迷游戏伤身。\n合理安排时间，享受健康生活。	
GLOBAL_HEALTHY_GAMING_CHINA_STARTUP_SUBTEXT	ISBN：978-7-900262-36-3 版署批号：新出审字[2013]1510号 沪网文[2017]9633-727号\n文网进字[2013]029号 著作权：暴雪娱乐有限公司 出版单位：金报电子音像出版中心	
GLOBAL_HEALTHY_GAMING_CHINA_THREE_HOURS	您累计在线时间已满{0}小时，请您下线休息，做适当身体活动。	
GLOBAL_HEALTHY_GAMING_CHINA_THREE_TO_FIVE_HOURS	您已经进入疲劳游戏时间，您的游戏收益将降为正常值的0%，为了您的健康，请尽快下线休息，做适当身体活动，合理安排学习生活。	
GLOBAL_HEALTHY_GAMING_CHINA_THREE_TO_FIVE_HOURS_PHONE	您已经进入疲劳游戏时间，您的游戏收益将降为正常值的0%，为了您的健康，\n请尽快下线休息，做适当身体活动，合理安排学习生活。	
GLOBAL_HEALTHY_GAMING_KOREA_STARTUP_MESSAGE	본 게임물은 만 12세 이용가 게임으로서 해당 연령 미만의 청소년이 이용하기에 부적절합니다. 반드시 보호자의 지도 감독이 필요합니다.	
GLOBAL_HEALTHY_GAMING_TOAST	게임을 플레이한지 {0}시간 지났습니다. 과도한 게임이용은 정상적인 일상생활에 지장을 줄 수 있습니다	
GLOBAL_HEALTHY_GAMING_TOAST_OVER_THRESHOLD	Você já está jogando há {0} |4(hora,horas). É muito tempo mesmo.	0=hours
GLOBAL_HELP	Ajuda	
GLOBAL_HERO_LEVEL_NEXT_REWARD_TITLE	Próxima recompensa no nível {0}	0=level
GLOBAL_HERO_LEVEL_REWARD_ARCANE_DUST	{0} de pó arcano	0=amount
GLOBAL_HERO_LEVEL_REWARD_BOOSTER	{0} pacotes	0=booster type
GLOBAL_HERO_LEVEL_REWARD_GOLD	{0} de Ouro	0=amount
GLOBAL_HERO_LEVEL_REWARD_GOLDEN_CARD	{1} {0}	0=flair 1=card name
GLOBAL_HERO_WINS	Vitórias: {0}/{1}	0=number of games this class has won 1=number of wins to get golden
GLOBAL_HERO_WINS_PAST_MAX	Vitórias: {0}	0=number of games this class has won
GLOBAL_HERO_WINS_PAST_MAX_PHONE	Vitórias: {0}	0=number of games this class has won
GLOBAL_HERO_WINS_PHONE	Vitórias: {0}/{1}	0=number of games this class has won 1=number of wins to get golden
GLOBAL_HEROIC_BRAWL	Contenda Heroica	
GLOBAL_HIDE	Ocultar	
GLOBAL_IN_PROGRESS_REWARD_CHEST_INSTRUCTIONS	Vença mais {0} |4(partida,partidas) para receber o baú da temporada!\n(Desbloqueia mês que vem)	
GLOBAL_JOIN	Entrar	
GLOBAL_KEYWORD_ADAPT	Adapte‑se	
GLOBAL_KEYWORD_ADAPT_TEXT	Escolha um de 3 bônus.	
GLOBAL_KEYWORD_ADVANCED_BALLISTICS	Balística Avançada	
GLOBAL_KEYWORD_ADVANCED_BALLISTICS_TEXT	Sempre que este lacaio atacar, conceda +{0} de Ataque aos seus outros lacaios.	
GLOBAL_KEYWORD_ALLIANCE	Aliança	
GLOBAL_KEYWORD_ALLIANCE_TEXT	A Aliança inclui: Draenei, Anão, Gnomo, Humano, Elfo Noturno e Worgen	
GLOBAL_KEYWORD_ALLIED	Aliado	
GLOBAL_KEYWORD_ALLIED_TEXT	Seu herói assume a classe Aliada depois que você escolhe este tesouro.	
GLOBAL_KEYWORD_ATTACK_MERC	Ataque	
GLOBAL_KEYWORD_ATTACK_REF_TEXT_MERC	Ataque um personagem e receba dano do inimigo.	
GLOBAL_KEYWORD_ATTACK_TEXT_MERC	Ataque um personagem e receba dano do inimigo.	
GLOBAL_KEYWORD_AUTOATTACK	Ataque Automático	
GLOBAL_KEYWORD_AUTOATTACK_TEXT	Não pode atacar, mas faz algo no final do seu turno.	
GLOBAL_KEYWORD_AUTOCAST	Lançamento automático	
GLOBAL_KEYWORD_AUTOCAST_TEXT	Este Poder Heroico TEM que ser usado todos os turnos.	
GLOBAL_KEYWORD_AVENGE	Vingar (X)	
GLOBAL_KEYWORD_AVENGE_TEXT	Faz algo depois que X lacaios aliados morrem em combate.	
GLOBAL_KEYWORD_BACON_BONUS_KEYWORDS	Palavras-chave de Bônus	
GLOBAL_KEYWORD_BACON_BONUS_KEYWORDS_TEXT	Provocar, Escudo Divino, Renascer, Peçonhento, Fúria dos Ventos, Furtividade	
GLOBAL_KEYWORD_BACON_BUDDY	Camarada	
GLOBAL_KEYWORD_BACON_BUDDY_TEXT	Um lacaio poderoso que é único para cada Poder Heroico.	
GLOBAL_KEYWORD_BACON_BUY_BUDDY	Receba seu Camarada	
GLOBAL_KEYWORD_BACON_BUY_BUDDY_2	Receba 2 Camaradas	
GLOBAL_KEYWORD_BACON_BUY_BUDDY_2_TEXT	Vitória/Empate - Custa (3) a menos\nDerrota - Custa (2) a menos	
GLOBAL_KEYWORD_BACON_BUY_BUDDY_TEXT	Vitória/Empate - Custa (3) a menos\nDerrota - Custa (2) a menos	
GLOBAL_KEYWORD_BACON_CONSUME	Consumir	
GLOBAL_KEYWORD_BACON_CONSUME_TEXT	Remova um lacaio para receber seus atributos.	
GLOBAL_KEYWORD_BACON_DISCOUNTED	Com desconto	
GLOBAL_KEYWORD_BACON_DISCOUNTED_TEXT	Esse Berloque custa (1) a menos do que o normal.	
GLOBAL_KEYWORD_BACON_FREEZE	Congelar	
GLOBAL_KEYWORD_BACON_FREEZE_TEXT	Lacaios congelados ficam na loja no turno seguinte.	
GLOBAL_KEYWORD_BACON_PASS	Passar	
GLOBAL_KEYWORD_BACON_PASS_TEXT	Envie para a mão de seu colega de equipe.	
GLOBAL_KEYWORD_BACON_PUTRICIDESCREATION	Criação do Putricida	
GLOBAL_KEYWORD_BACON_PUTRICIDESCREATION_TEXT	Não pode virar trinca.	
GLOBAL_KEYWORD_BACON_QUEST	Missão	
GLOBAL_KEYWORD_BACON_QUEST_TEXT	Conclua para ganhar uma recompensa.	
GLOBAL_KEYWORD_BACON_REBORN	Renascer	
GLOBAL_KEYWORD_BACON_REBORN_TEXT	Evoca uma nova cópia com 1 de Vida ao morrer pela primeira vez.	
GLOBAL_KEYWORD_BACON_STEALTH	Furtividade	
GLOBAL_KEYWORD_BACON_STEALTH_TEXT	Não pode ser atacado até atacar.	
GLOBAL_KEYWORD_BACON_TRINKET	Berloque	
GLOBAL_KEYWORD_BACON_TRINKET_TEXT	Um poderoso bônus passivo que pode ser comprado em turnos específicos.	
GLOBAL_KEYWORD_BATTLECRY	Grito de Guerra	
GLOBAL_KEYWORD_BATTLECRY_TEXT	Faz alguma coisa ao ser colocado em jogo a partir de sua mão. 	
GLOBAL_KEYWORD_BATTLECRY_TEXT_MERC	Faz alguma coisa ao ser jogado da sua mão ou evocado por um Mercenário.	
GLOBAL_KEYWORD_BENCH_MERC	Banco	
GLOBAL_KEYWORD_BENCH_MERC_TEXT	Faz algo enquanto este Mercenário está no banco.	
GLOBAL_KEYWORD_BLEED	Sangramento	
GLOBAL_KEYWORD_BLEED_TEXT	Personagens sangrando recebem dano no final de cada turno. Sangramentos podem ser removidos com a restauração de vida.	
GLOBAL_KEYWORD_BLOOD_GEM	Gema Sangrenta	
GLOBAL_KEYWORD_BLOOD_GEM_TEXT	Feitiço que concede {0} a um lacaio.	
GLOBAL_KEYWORD_BLOOD_GEM_TEXT_ADDITIONAL	\nO seu concede {0}	
GLOBAL_KEYWORD_BONUSEFFECTS	Efeitos bônus	
GLOBAL_KEYWORD_BONUSEFFECTS_TEXT	Escudo Divino, Roubar Vida, Venenoso, Renascer, Rapidez, Elusivo, Provocar, Fúria dos Ventos	
GLOBAL_KEYWORD_BOSS	Chefe	
GLOBAL_KEYWORD_BOSS_TEXT	Os jogadores estão lutando juntos para vencer o Chefe.	
GLOBAL_KEYWORD_CADUCEUS_REACTOR	Reator Caduceu	
GLOBAL_KEYWORD_CADUCEUS_REACTOR_TEXT	<b>Último Suspiro:</b> Conceda +{0}/+{0} ao seu lacaio mais à esquerda.	
GLOBAL_KEYWORD_CASTS_WHEN_DRAWN	Lançado ao Comprar	
GLOBAL_KEYWORD_CASTS_WHEN_DRAWN_TEXT	Lança-se após ser comprado, depois compra outro card.	
GLOBAL_KEYWORD_CHARGE	Investida	
GLOBAL_KEYWORD_CHARGE_MERC	Investida	
GLOBAL_KEYWORD_CHARGE_MERC_TEXT	Ataca um alvo selecionado imediatamente depois de ser evocado.	
GLOBAL_KEYWORD_CHARGE_TEXT	Pode atacar imediatamente.	
GLOBAL_KEYWORD_COLOSSAL	Colossal +X	
GLOBAL_KEYWORD_COLOSSAL_TEXT	Quando evocado, gera X apêndices adicionais.	
GLOBAL_KEYWORD_COMBO	Combo	
GLOBAL_KEYWORD_COMBO_MERC	Combo	
GLOBAL_KEYWORD_COMBO_TEXT	Bônus caso você já tenha jogado um card neste turno.	
GLOBAL_KEYWORD_COMBO_TEXT_MERC	Bônus caso seu grupo já tenha jogado uma habilidade neste turno.	
GLOBAL_KEYWORD_CORPSE	Cadáver	
GLOBAL_KEYWORD_CORPSE_TEXT	Recurso obtido quando um lacaio aliado morre.	
GLOBAL_KEYWORD_CORRUPT	Corromper	
GLOBAL_KEYWORD_CORRUPT_TEXT	Aprimoramento na mão depois que você jogar um card que custa mais.	
GLOBAL_KEYWORD_CORRUPTEDCARD	Corrompido	
GLOBAL_KEYWORD_CORRUPTEDCARD_TEXT	Aprimorado por um card de custo maior.	
GLOBAL_KEYWORD_COUNTER	Anular	
GLOBAL_KEYWORD_COUNTER_TEXT	Um card Anulado não tem efeito.	
GLOBAL_KEYWORD_CRITICAL_DAMAGE	Dano Crítico	
GLOBAL_KEYWORD_CRITICAL_DAMAGE_TEXT	Recebe o dobro de dano.	
GLOBAL_KEYWORD_CTHUN	C'Thun, Deus Antigo	
GLOBAL_KEYWORD_CTHUN_TEXT	C'Thun recebe bônus onde quer que esteja, até no seu deck!	
GLOBAL_KEYWORD_DARKGIFT	Dádiva Sinistra	
GLOBAL_KEYWORD_DARKGIFT_BONUS	Bônus Dádiva Sinistra	
GLOBAL_KEYWORD_DARKGIFT_BONUS_MULTI	Dádiva Sinistra	
GLOBAL_KEYWORD_DARKGIFT_BONUS_MULTI_TEXT	Este lacaio tem {0} <b>Dádivas Sinistras</b>	
GLOBAL_KEYWORD_DARKGIFT_TEXT	Um bônus ligado a um lacaio.	
GLOBAL_KEYWORD_DEATH_KNIGHT_TOURIST	Turista: Cavaleiro da Morte	
GLOBAL_KEYWORD_DEATH_KNIGHT_TOURIST_TEXT	Seu deck pode incluir cards de Cavaleiro da Morte de Perigos no Paraíso.	
GLOBAL_KEYWORD_DEATHBLOW	Golpe Fatal	
GLOBAL_KEYWORD_DEATHBLOW_TEXT	Faz alguma coisa quando mata um personagem.	
GLOBAL_KEYWORD_DEATHRATTLE	Último Suspiro	
GLOBAL_KEYWORD_DEATHRATTLE_TEXT	Faz alguma coisa quando morre.	
GLOBAL_KEYWORD_DEMON_HUNTER_TOURIST	Turista: Caçador de Demônios	
GLOBAL_KEYWORD_DEMON_HUNTER_TOURIST_TEXT	Seu deck pode incluir cards de Caçador de Demônios de Perigos no Paraíso.	
GLOBAL_KEYWORD_DISCOVER	Descubra	
GLOBAL_KEYWORD_DISCOVER_MERC	Descobrir	
GLOBAL_KEYWORD_DISCOVER_TEXT	Escolha um entre três cards para acrescentar à sua mão.	
GLOBAL_KEYWORD_DISCOVER_TEXT_MERC	Escolha uma de três habilidades para lançar neste turno.	
GLOBAL_KEYWORD_DIVINE_SHIELD	Escudo Divino	
GLOBAL_KEYWORD_DIVINE_SHIELD_REF_TEXT	Um lacaio protegido ignora dano recebido pela primeira vez.	
GLOBAL_KEYWORD_DIVINE_SHIELD_TEXT	Na primeira vez em que este lacaio receber dano, ignore o dano.	
GLOBAL_KEYWORD_DONT_PICK_FROM_SUBSETS	[WIP] Não pode ser descoberto.	
GLOBAL_KEYWORD_DONT_PICK_FROM_SUBSETS_TEXT	[WIP] Não pode ser descoberto.	
GLOBAL_KEYWORD_DORMANT	Adormecido	
GLOBAL_KEYWORD_DORMANT_TEXT	Intocável para os dois jogadores.	
GLOBAL_KEYWORD_DREDGE	Dragar	
GLOBAL_KEYWORD_DREDGE_TEXT	Olhe os 3 cards do fim do seu deck.\nColoque um no topo.	
GLOBAL_KEYWORD_DRUID_TOURIST	Turista: Druida	
GLOBAL_KEYWORD_DRUID_TOURIST_TEXT	Seu deck pode incluir cards de Druida de Perigos no Paraíso.	
GLOBAL_KEYWORD_ECHO	Eco	
GLOBAL_KEYWORD_ECHO_TEXT	Pode ser repetido no turno em que for jogado. Cópias não podem custar menos de (1).	
GLOBAL_KEYWORD_ELUSIVE	Elusivo	
GLOBAL_KEYWORD_ELUSIVE_REF_TEXT	Não pode ser alvo de feitiços nem de Poderes Heroicos.	
GLOBAL_KEYWORD_ELUSIVE_TEXT	Não pode ser alvo de feitiços nem de Poderes Heroicos.	
GLOBAL_KEYWORD_ELVES_MERC	Elfos	
GLOBAL_KEYWORD_ELVES_MERC_TEXT	Elfos incluem: Elfo Sangrento e Elfo Noturno	
GLOBAL_KEYWORD_EMPOWER	Invocar	
GLOBAL_KEYWORD_EMPOWER_PRIEST	Invocar: Sacerdote	
GLOBAL_KEYWORD_EMPOWER_PRIEST_TEXT	Use o Poder de Galakrond. <i>(Adicione um lacaio aleatório de Sacerdote à sua mão.)</i>	
GLOBAL_KEYWORD_EMPOWER_ROGUE	Invocar: Ladino	
GLOBAL_KEYWORD_EMPOWER_ROGUE_COLLECTION_TEXT	Use o Poder de Galakrond. <i>(Adicione um Servo à sua mão.)</i>	
GLOBAL_KEYWORD_EMPOWER_ROGUE_TEXT	Use o Poder de Galakrond. <i>(Adicione um <b>Servo</b> à sua mão.)</i>	
GLOBAL_KEYWORD_EMPOWER_SHAMAN	Invocar: Xamã	
GLOBAL_KEYWORD_EMPOWER_SHAMAN_COLLECTION_TEXT	Use o Poder de Galakrond. <i>(Evoque um Elemental 2/1 com Rapidez.)</i>	
GLOBAL_KEYWORD_EMPOWER_SHAMAN_TEXT	Use o Poder de Galakrond. <i>(Evoque um Elemental 2/1 com <b>Rapidez</b>.)</i>	
GLOBAL_KEYWORD_EMPOWER_TEXT	Use o Poder de Galakrond.	
GLOBAL_KEYWORD_EMPOWER_WARLOCK	Invocar: Bruxo	
GLOBAL_KEYWORD_EMPOWER_WARLOCK_TEXT	Use o Poder de Galakrond. <i>(Evoque dois Diabretes 1/1.)</i>	
GLOBAL_KEYWORD_EMPOWER_WARRIOR	Invocar: Guerreiro	
GLOBAL_KEYWORD_EMPOWER_WARRIOR_TEXT	Use o Poder de Galakrond. <i>(Conceda +3 de Ataque ao seu herói neste turno.)</i>	
GLOBAL_KEYWORD_ENRAGED_TOOLTIP	Enfurecer	
GLOBAL_KEYWORD_ENRAGED_TOOLTIP_TEXT	Enquanto estiver ferido, este lacaio ganha um novo poder.	
GLOBAL_KEYWORD_EVILZUG	Servo	
GLOBAL_KEYWORD_EVILZUG_TEXT	Servos são lacaios de custo 1 com Gritos de Guerra.	
GLOBAL_KEYWORD_EXCAVATE	Escavar	
GLOBAL_KEYWORD_EXCAVATE_COMMON	Comum	
GLOBAL_KEYWORD_EXCAVATE_EPIC	Épico	
GLOBAL_KEYWORD_EXCAVATE_GAMEPLAY	Procure tesouros cada vez mais raros. Reinicia após {0}.\nSeguinte: {1}	
GLOBAL_KEYWORD_EXCAVATE_LEGENDARY	<b>Lendário</b>	
GLOBAL_KEYWORD_EXCAVATE_RARE	Raro	
GLOBAL_KEYWORD_EXCAVATE_REF_TEXT	Procure tesouros cada vez mais raros. Reinicia após a Raridade mais alta.	
GLOBAL_KEYWORD_EXCAVATE_TEXT	Procure tesouros cada vez mais raros. Reinicia após a Raridade mais alta.	
GLOBAL_KEYWORD_EXPLORER_MERC	Explorador	
GLOBAL_KEYWORD_EXPLORER_MERC_TEXT	Exploradores incluem: Reno, Brann, Elise, Finlei e o Explorador Amalgamado.	
GLOBAL_KEYWORD_FATIGUE	Fadiga	
GLOBAL_KEYWORD_FATIGUE_TEXT	Dano recebido quando se compra de um deck vazio.	
GLOBAL_KEYWORD_FINALE	Finale	
GLOBAL_KEYWORD_FINALE_TEXT	Bônus se este gastar todo seu mana restante.	
GLOBAL_KEYWORD_FLOOPY	Flupe Fuzubúrdio	
GLOBAL_KEYWORD_FLOOPY_TEXT	Transforma-se quando você joga um lacaio.	
GLOBAL_KEYWORD_FORGE	Forjar	
GLOBAL_KEYWORD_FORGE_TEXT	Arraste isto para o seu deck para gastar (2) de Mana num aprimoramento.	
GLOBAL_KEYWORD_FORGED	Forjado	
GLOBAL_KEYWORD_FORGED_TEXT	Aprimorado depois de arrastar isto para o seu deck e gastar (2) de Mana.	
GLOBAL_KEYWORD_FREEZE	Congelar	
GLOBAL_KEYWORD_FREEZE_TEXT	Personagens congelados perdem o próximo ataque.	
GLOBAL_KEYWORD_FREEZE_TEXT_MERC	Personagens congelados perdem a próxima habilidade neste turno.	
GLOBAL_KEYWORD_FRENZY	Frenesi	
GLOBAL_KEYWORD_FRENZY_TEXT	Efeito que ocorre uma vez após o lacaio sobreviver a dano.	
GLOBAL_KEYWORD_FROZEN	Congelado	
GLOBAL_KEYWORD_FROZEN_TEXT	Perde o próximo ataque.	
GLOBAL_KEYWORD_FROZEN_TEXT_MERC	Perde a próxima habilidade.	
GLOBAL_KEYWORD_GALAKROND	Galakrond	
GLOBAL_KEYWORD_GALAKROND_COLLECTION_TEXT	Você pode usar em decks de Sacerdote, Ladino, Xamã, Bruxo ou Guerreiro.	
GLOBAL_KEYWORD_GIGANTIC	Gigante!	
GLOBAL_KEYWORD_GIGANTIC_TEXT	Uma cópia 8/8 de custo 8 de outro card.	
GLOBAL_KEYWORD_GIGANTIFY	GIGANTIZAR!	
GLOBAL_KEYWORD_GIGANTIFY_TEXT	Receba uma cópia 8/8 de custo 8 deste card.	
GLOBAL_KEYWORD_GRIMY_GOONS	Capangas Cruéis	
GLOBAL_KEYWORD_GRIMY_GOONS_MULTI	Capangas Cruéis (Multi)	
GLOBAL_KEYWORD_GRIMY_GOONS_MULTI_TEXT	Este card é um membro da facção Capangas Cruéis e pode ser usado em {0} classes.	
GLOBAL_KEYWORD_GRIMY_GOONS_TEXT	Estre card é um membro da facção Capangas Cruéis.	
GLOBAL_KEYWORD_HEALING_POWER	Poder de Cura	
GLOBAL_KEYWORD_HEALING_POWER_TEXT	Suas habilidades de cura restauram vida extra.	
GLOBAL_KEYWORD_HONORABLEKILL	Abate Honroso	
GLOBAL_KEYWORD_HONORABLEKILL_TEXT	Cause o dano letal exato no seu turno para receber um bônus.	
GLOBAL_KEYWORD_HORDE	Horda	
GLOBAL_KEYWORD_HORDE_TEXT	A Horda inclui: Elfo Sangrento, Goblin, Meio-Orc, Ogro, Orc, Tauren, Troll e Morto-Vivo	
GLOBAL_KEYWORD_HUNTER_TOURIST	Turista: Caçador	
GLOBAL_KEYWORD_HUNTER_TOURIST_TEXT	Seu deck pode incluir cards de Caçador de Perigos no Paraíso.	
GLOBAL_KEYWORD_IMBUE	Intensificar	
GLOBAL_KEYWORD_IMBUE_TEXT	Receba um novo Poder Heroico que aprimora toda vez que você Intensificar.	
GLOBAL_KEYWORD_IMMUNE	Imune	
GLOBAL_KEYWORD_IMMUNE_REF_TEXT	Personagens imunes não podem ser alvo de inimigos ou receber dano.	
GLOBAL_KEYWORD_IMMUNE_TEXT	Não pode ser alvo de inimigos ou receber dano.	
GLOBAL_KEYWORD_INFUSE	Imbuir	
GLOBAL_KEYWORD_INFUSE_TEXT	Aprimora na mão depois que X lacaios aliados morrem.	
GLOBAL_KEYWORD_INFUSED	Imbuído	
GLOBAL_KEYWORD_INFUSED_TEXT	Aprimorado na mão depois que X lacaios aliados morreram.	
GLOBAL_KEYWORD_INSPIRE	Inspirar	
GLOBAL_KEYWORD_INSPIRE_TEXT	Faz algo depois que você usa o seu Poder Heroico.	
GLOBAL_KEYWORD_IS_HERO_PASSIVE	Passivo	
GLOBAL_KEYWORD_IS_HERO_PASSIVE_TEXT	Um efeito permanente.	
GLOBAL_KEYWORD_JADE_GOLEM	Golem de Jade	
GLOBAL_KEYWORD_JADE_GOLEM_COLLECTION_TEXT	Seu primeiro Golem de Jade é 1/1. Cada novo golem tem +1/+1.	
GLOBAL_KEYWORD_JADE_GOLEM_TEXT	Cada Golem de Jade tem +1/+1 a mais que o anterior.	
GLOBAL_KEYWORD_JADE_LOTUS	Lótus de Jade	
GLOBAL_KEYWORD_JADE_LOTUS_MULTI	Lótus de Jade (Multi)	
GLOBAL_KEYWORD_JADE_LOTUS_MULTI_TEXT	Este card é um membro da facção Lótus de Jade e pode ser usado em {0} classes.	
GLOBAL_KEYWORD_JADE_LOTUS_TEXT	Este card é um membro da facção Lótus de Jade.	
GLOBAL_KEYWORD_KABAL	Kabal	
GLOBAL_KEYWORD_KABAL_MULTI	Kabal (Multi)	
GLOBAL_KEYWORD_KABAL_MULTI_TEXT	Este card é um membro da facção Kabal e pode ser usado em {0} classes.	
GLOBAL_KEYWORD_KABAL_TEXT	Este card é um membro da facção Kabal.	
GLOBAL_KEYWORD_LIFESTEAL	Roubar Vida	
GLOBAL_KEYWORD_LIFESTEAL_TEXT	O dano causado também cura seu herói.	
GLOBAL_KEYWORD_MAGE_TOURIST	Turista: Mago	
GLOBAL_KEYWORD_MAGE_TOURIST_TEXT	Seu deck pode incluir cards de Mago de Perigos no Paraíso.	
GLOBAL_KEYWORD_MANATHIRST	Sede de Mana (X)	
GLOBAL_KEYWORD_MANATHIRST_TEXT	Um bônus quando você tem X Cristais de Mana.	
GLOBAL_KEYWORD_MEGAWINDFURY	Mega-Fúria dos Ventos	
GLOBAL_KEYWORD_MEGAWINDFURY_TEXT	Pode atacar quatro vezes a cada turno.	
GLOBAL_KEYWORD_MINI	Mini	
GLOBAL_KEYWORD_MINI_REF_TEXT	Uma cópia 1/1 de custo 1 de outro card.	
GLOBAL_KEYWORD_MINI_TEXT	Uma cópia 1/1 de custo 1 de outro card.	
GLOBAL_KEYWORD_MINIATURIZE	Miniaturizar	
GLOBAL_KEYWORD_MINIATURIZE_TEXT	Receba uma cópia 1/1 de custo 1 deste card.	
GLOBAL_KEYWORD_MINION_TYPE_REFERENCE	Tipo de Lacaio	
GLOBAL_KEYWORD_MINION_TYPE_REFERENCE_TEXT	Fera, Demônio, Dragão, Mecanoide, Murloc, Pirata e Totem.	
GLOBAL_KEYWORD_MODULAR	Magnético	
GLOBAL_KEYWORD_MODULAR_TEXT	Jogue à esquerda de um Mecanoide para fundir os dois!	
GLOBAL_KEYWORD_MULTICLASS	Multiclasse ({0})	Argument is number of classes the card can be used in (ex: 4)
GLOBAL_KEYWORD_MULTICLASS_SEARCH_TOKEN	Multiclasse	
GLOBAL_KEYWORD_MULTICLASS_TEXT	Este card pode ser usado em {0}	Argument is a comma separated list of classes the card can be used in
GLOBAL_KEYWORD_OFFHAND	Mão Secundária	
GLOBAL_KEYWORD_OFFHAND_TEXT	Indestrutível. Não encantável.	
GLOBAL_KEYWORD_OUTCAST	Exilar	
GLOBAL_KEYWORD_OUTCAST_TEXT	Bônus se o card for jogado quando estiver mais à esquerda ou à direita da sua mão.	
GLOBAL_KEYWORD_OVERHEAL	Cura Excessiva	
GLOBAL_KEYWORD_OVERHEAL_TEXT	Bônus se a cura for além da Vida máxima.	
GLOBAL_KEYWORD_OVERKILL	Massacre	
GLOBAL_KEYWORD_OVERKILL_TEXT	Cause excesso de dano no seu turno para receber um bônus.	
GLOBAL_KEYWORD_OVERLOAD	Sobrecarga: X	
GLOBAL_KEYWORD_OVERLOAD_REF_TEXT	Cards com Sobrecarga limitam seu mana no próximo turno.	
GLOBAL_KEYWORD_OVERLOAD_TEXT	Você terá X a menos de mana no próximo turno.	
GLOBAL_KEYWORD_PALADIN_TOURIST	Turista: Paladino	
GLOBAL_KEYWORD_PALADIN_TOURIST_TEXT	Seu deck pode incluir cards de Paladino de Perigos no Paraíso.	
GLOBAL_KEYWORD_PASSIVE	Passivo	
GLOBAL_KEYWORD_PASSIVE_TEXT	Efeito permanente para a sessão atual.	
GLOBAL_KEYWORD_POISONOUS	Venenoso	
GLOBAL_KEYWORD_POISONOUS_TEXT	Destrua qualquer lacaio atingido por este lacaio.	
GLOBAL_KEYWORD_PRIEST_TOURIST	Turista: Sacerdote	
GLOBAL_KEYWORD_PRIEST_TOURIST_TEXT	Seu deck pode incluir cards de Sacerdote de Perigos no Paraíso.	
GLOBAL_KEYWORD_PROTOSS	Protoss	
GLOBAL_KEYWORD_PROTOSS_MULTI	Protoss (Multi)	
GLOBAL_KEYWORD_PROTOSS_MULTI_TEXT	Este card é um membro da facção Protoss e pode ser usado em {0} classes.	
GLOBAL_KEYWORD_PROTOSS_TEXT	Este card é um membro da facção Protoss.	
GLOBAL_KEYWORD_QUEST	Missão	
GLOBAL_KEYWORD_QUEST_TEXT	Começa na sua mão. Conclua para ganhar uma recompensa.	
GLOBAL_KEYWORD_QUESTLINE	Série de Missões	
GLOBAL_KEYWORD_QUESTLINE_TEXT	Começa na sua mão. Conclua para ganhar uma recompensa, até 3 vezes!	
GLOBAL_KEYWORD_QUICKDRAW	Saque Rápido	
GLOBAL_KEYWORD_QUICKDRAW_REF_TEXT	Um bônus se este item chegou à sua mão neste turno.	
GLOBAL_KEYWORD_QUICKDRAW_TEXT	Um bônus se este item chegou à sua mão neste turno.	
GLOBAL_KEYWORD_REBORN	Renascer	
GLOBAL_KEYWORD_REBORN_TEXT	Ressuscita com 1 de Vida ao morrer pela primeira vez.	
GLOBAL_KEYWORD_RECRUIT	Recruta	
GLOBAL_KEYWORD_RECRUIT_TEXT	Evoque um lacaio do seu deck.	
GLOBAL_KEYWORD_REFRESH	Atualizar	
GLOBAL_KEYWORD_REFRESH_MERC	Restaurar	
GLOBAL_KEYWORD_REFRESH_MERC_TEXT	Reduz a recarga em (X).	
GLOBAL_KEYWORD_REFRESH_TEXT	Substitua os cards da Taverna por novos.	
GLOBAL_KEYWORD_REVIVE	Reviver (X)	
GLOBAL_KEYWORD_REVIVE_TEXT	Revive (X) turnos após morrer.	
GLOBAL_KEYWORD_ROGUE_TOURIST	Turista: Ladino	
GLOBAL_KEYWORD_ROGUE_TOURIST_TEXT	Seu deck pode incluir cards de Ladino de Perigos no Paraíso.	
GLOBAL_KEYWORD_ROOT	Enraizar	
GLOBAL_KEYWORD_ROOT_TEXT	Personagens Enraizados não podem atacar.	
GLOBAL_KEYWORD_RUSH	Rapidez	
GLOBAL_KEYWORD_RUSH_TEXT	Pode atacar lacaios imediatamente.	
GLOBAL_KEYWORD_RUSH_TEXT_MERC	Ataca imediatamente depois de ser evocado.	
GLOBAL_KEYWORD_SECRET	Segredo	
GLOBAL_KEYWORD_SECRET_TEXT	Oculto até ocorrer uma ação específica no turno do seu oponente.	
GLOBAL_KEYWORD_SHAMAN_TOURIST	Turista: Xamã	
GLOBAL_KEYWORD_SHAMAN_TOURIST_TEXT	Seu deck pode incluir cards de Xamã de Perigos no Paraíso.	
GLOBAL_KEYWORD_SHIFTING_ADDS_POISONOUS_TEXT	Adiciona <b>Venenoso</b>.	
GLOBAL_KEYWORD_SHIFTING_ADDS_SPELL_DAMAGE_TEXT	Adiciona <b>+1 de Dano Mágico</b>.	
GLOBAL_KEYWORD_SHIFTING_ADDS_STEALTH_TEXT	Adiciona <b>Furtividade</b>.	
GLOBAL_KEYWORD_SHIFTING_MINION_TEXT	Transforma-se em um novo lacaio no início do seu turno.	
GLOBAL_KEYWORD_SHIFTING_SPELL_TEXT	Transforma-se em um novo feitiço no início do seu turno.	
GLOBAL_KEYWORD_SHIFTING_TEXT	Transforma-se em um novo card no início do seu turno.	
GLOBAL_KEYWORD_SHIFTING_TOP_TEXT	Transforma-se no card do topo do seu deck.	
GLOBAL_KEYWORD_SHIFTING_WEAPON_TEXT	Transforma-se em uma nova arma no início do seu turno.	
GLOBAL_KEYWORD_SHRINE	Santuário	
GLOBAL_KEYWORD_SHRINE_TEXT	Revive em 3 turnos após ter morrido.	
GLOBAL_KEYWORD_SIDEQUEST	Tarefa	
GLOBAL_KEYWORD_SIDEQUEST_TEXT	Conclua para ganhar uma recompensa.	
GLOBAL_KEYWORD_SILENCE	Silêncio	
GLOBAL_KEYWORD_SILENCE_MERC	Silêncio	
GLOBAL_KEYWORD_SILENCE_MERC_TEXT	Remove o texto, equipamento, tesouro e encantamentos do card.	
GLOBAL_KEYWORD_SILENCE_TEXT	Remove o texto e os encantamentos do card.	
GLOBAL_KEYWORD_SPAREPART	Peças sobressalentes	
GLOBAL_KEYWORD_SPAREPART_TEXT	Peças sobressalentes são feitiços de custo 1 com pouco efeito.	
GLOBAL_KEYWORD_SPELLBURST	Sortilégio	
GLOBAL_KEYWORD_SPELLBURST_TEXT	Efeito que ocorre uma vez após você lançar um feitiço.	
GLOBAL_KEYWORD_SPELLCOMBO_MERC	Combo de Feitiço	
GLOBAL_KEYWORD_SPELLCOMBO_REF_TEXT_MERC	Bônus caso outro Mercenário aliado tenha jogado um feitiço da escola especificada neste turno.	
GLOBAL_KEYWORD_SPELLCOMBO_TEXT_MERC	Bônus caso outro Mercenário aliado tenha jogado um feitiço da escola especificada neste turno.	
GLOBAL_KEYWORD_SPELLCRAFT	Feitiçaria	
GLOBAL_KEYWORD_SPELLCRAFT_TEXT	Recebe um feitiço temporário a cada turno.	
GLOBAL_KEYWORD_SPELLPOWER	Dano Mágico	
GLOBAL_KEYWORD_SPELLPOWER_ARCANE	Dano Mágico Arcano	
GLOBAL_KEYWORD_SPELLPOWER_ARCANE_MERC	Dano Arcano	
GLOBAL_KEYWORD_SPELLPOWER_ARCANE_REF_TEXT	Seus feitiços Arcanos causam dano extra.	
GLOBAL_KEYWORD_SPELLPOWER_ARCANE_REF_TEXT_MERC	As habilidades Arcanas do seu personagem causam mais dano.	
GLOBAL_KEYWORD_SPELLPOWER_ARCANE_TEXT	Seus cards de feitiço Arcano causam {0} a mais de dano.	0=amount of spell damage
GLOBAL_KEYWORD_SPELLPOWER_ARCANE_TEXT_MERC	As habilidades Arcanas do seu personagem causam mais dano.	
GLOBAL_KEYWORD_SPELLPOWER_FEL	Dano Mágico Vil	
GLOBAL_KEYWORD_SPELLPOWER_FEL_MERC	Dano Vil	
GLOBAL_KEYWORD_SPELLPOWER_FEL_REF_TEXT	Seus feitiços Vis causam dano extra.	
GLOBAL_KEYWORD_SPELLPOWER_FEL_REF_TEXT_MERC	As habilidades Vis do seu personagem causam mais dano.	
GLOBAL_KEYWORD_SPELLPOWER_FEL_TEXT	Seus cards de feitiço Vil causam {0} a mais de dano.	0=amount of spell damage
GLOBAL_KEYWORD_SPELLPOWER_FEL_TEXT_MERC	As habilidades Vis do seu personagem causam mais dano.	
GLOBAL_KEYWORD_SPELLPOWER_FIRE	Dano Mágico de Fogo	
GLOBAL_KEYWORD_SPELLPOWER_FIRE_MERC	Dano de Fogo	
GLOBAL_KEYWORD_SPELLPOWER_FIRE_REF_TEXT	Seus feitiços de Fogo causam dano extra.	
GLOBAL_KEYWORD_SPELLPOWER_FIRE_REF_TEXT_MERC	As habilidades de Fogo do seu personagem causam mais dano.	
GLOBAL_KEYWORD_SPELLPOWER_FIRE_TEXT	Seus cards de feitiço de Fogo causam {0} a mais de dano.	0=amount of spell damage
GLOBAL_KEYWORD_SPELLPOWER_FIRE_TEXT_MERC	As habilidades de Fogo do seu personagem causam mais dano.	
GLOBAL_KEYWORD_SPELLPOWER_FROST	Dano Mágico de Gelo	
GLOBAL_KEYWORD_SPELLPOWER_FROST_MERC	Dano de Gelo	
GLOBAL_KEYWORD_SPELLPOWER_FROST_REF_TEXT	Seus feitiços de Gelo causam dano extra.	
GLOBAL_KEYWORD_SPELLPOWER_FROST_REF_TEXT_MERC	As habilidades de Gelo do seu personagem causam mais dano.	
GLOBAL_KEYWORD_SPELLPOWER_FROST_TEXT	Seus cards de feitiço de Gelo causam {0} a mais de dano.	0=amount of spell damage
GLOBAL_KEYWORD_SPELLPOWER_FROST_TEXT_MERC	As habilidades de Gelo do seu personagem causam mais dano.	
GLOBAL_KEYWORD_SPELLPOWER_HOLY	Dano Mágico Sagrado	
GLOBAL_KEYWORD_SPELLPOWER_HOLY_MERC	Dano Sagrado	
GLOBAL_KEYWORD_SPELLPOWER_HOLY_REF_TEXT	Seus feitiços Sagrados causam dano extra.	
GLOBAL_KEYWORD_SPELLPOWER_HOLY_REF_TEXT_MERC	As habilidades Sagradas do seu personagem causam mais dano.	
GLOBAL_KEYWORD_SPELLPOWER_HOLY_TEXT	Seus cards de feitiço Sagrado causam {0} a mais de dano.	0=amount of spell damage
GLOBAL_KEYWORD_SPELLPOWER_HOLY_TEXT_MERC	As habilidades Sagradas do seu personagem causam mais dano.	
GLOBAL_KEYWORD_SPELLPOWER_NATURE	Dano Mágico de Natureza	
GLOBAL_KEYWORD_SPELLPOWER_NATURE_MERC	Dano de Natureza	
GLOBAL_KEYWORD_SPELLPOWER_NATURE_REF_TEXT	Seus feitiços de Natureza causam dano extra.	
GLOBAL_KEYWORD_SPELLPOWER_NATURE_REF_TEXT_MERC	As habilidades de Natureza do seu personagem causam mais dano.	
GLOBAL_KEYWORD_SPELLPOWER_NATURE_TEXT	Seus cards de feitiço de Natureza causam {0} a mais de dano.	0=amount of spell damage
GLOBAL_KEYWORD_SPELLPOWER_NATURE_TEXT_MERC	As habilidades de Natureza do seu personagem causam mais dano.	
GLOBAL_KEYWORD_SPELLPOWER_PHYSICAL	Dano Mágico Físico	
GLOBAL_KEYWORD_SPELLPOWER_PHYSICAL_REF_TEXT	Seus feitiços Físicos causam dano extra.	
GLOBAL_KEYWORD_SPELLPOWER_PHYSICAL_TEXT	Seus cards de feitiço Físico causam {0} a mais de dano.	0=amount of spell damage
GLOBAL_KEYWORD_SPELLPOWER_REF_TEXT	Seus feitiços causam dano extra.	
GLOBAL_KEYWORD_SPELLPOWER_SHADOW	Dano Mágico de Sombra	
GLOBAL_KEYWORD_SPELLPOWER_SHADOW_MERC	Dano de Sombra	
GLOBAL_KEYWORD_SPELLPOWER_SHADOW_REF_TEXT	Seus feitiços de Sombra causam dano extra.	
GLOBAL_KEYWORD_SPELLPOWER_SHADOW_REF_TEXT_MERC	As habilidades de Sombra do seu personagem causam mais dano.	
GLOBAL_KEYWORD_SPELLPOWER_SHADOW_TEXT	Seus cards de feitiço de Sombra causam {0} a mais de dano.	0=amount of spell damage
GLOBAL_KEYWORD_SPELLPOWER_SHADOW_TEXT_MERC	As habilidades de Sombra do seu personagem causam mais dano.	
GLOBAL_KEYWORD_SPELLPOWER_TEXT	Seus cards de feitiço causam {0} a mais de dano.	0=amount of spell damage
GLOBAL_KEYWORD_SPELLRESISTANCE_ARCANE	Resistência ao Arcano	
GLOBAL_KEYWORD_SPELLRESISTANCE_ARCANE_REF_TEXT	Recebe menos dano de habilidades Arcanas.	
GLOBAL_KEYWORD_SPELLRESISTANCE_ARCANE_TEXT	Recebe {0} a menos de dano de habilidades Arcanas.	0=amount of spell damage
GLOBAL_KEYWORD_SPELLRESISTANCE_FEL	Resistência a Vileza	
GLOBAL_KEYWORD_SPELLRESISTANCE_FEL_REF_TEXT	Recebe menos dano de habilidades Vis.	
GLOBAL_KEYWORD_SPELLRESISTANCE_FEL_TEXT	Recebe {0} a menos de dano de habilidades Vis.	0=amount of spell damage
GLOBAL_KEYWORD_SPELLRESISTANCE_FIRE	Resistência ao Fogo	
GLOBAL_KEYWORD_SPELLRESISTANCE_FIRE_REF_TEXT	Recebe menos dano de habilidades de Fogo.	
GLOBAL_KEYWORD_SPELLRESISTANCE_FIRE_TEXT	Recebe {0} a menos de dano de habilidades de Fogo.	0=amount of spell damage
GLOBAL_KEYWORD_SPELLRESISTANCE_FROST	Resistência ao Gelo	
GLOBAL_KEYWORD_SPELLRESISTANCE_FROST_REF_TEXT	Recebe menos dano de habilidades de Gelo.	
GLOBAL_KEYWORD_SPELLRESISTANCE_FROST_TEXT	Recebe {0} a menos de dano de habilidades de Gelo.	0=amount of spell damage
GLOBAL_KEYWORD_SPELLRESISTANCE_HOLY	Resistência ao Sagrado	
GLOBAL_KEYWORD_SPELLRESISTANCE_HOLY_REF_TEXT	Recebe menos dano de habilidades Sagradas.	
GLOBAL_KEYWORD_SPELLRESISTANCE_HOLY_TEXT	Recebe {0} a menos de dano de habilidades Sagradas.	0=amount of spell damage
GLOBAL_KEYWORD_SPELLRESISTANCE_MERC	Resistência Mágica	
GLOBAL_KEYWORD_SPELLRESISTANCE_MERC_REF_TEXT	Recebe menos dano de todas as habilidades.	
GLOBAL_KEYWORD_SPELLRESISTANCE_MERC_TEXT	Você recebe {0} a menos de dano proveniente de todas as habilidades.	
GLOBAL_KEYWORD_SPELLRESISTANCE_NATURE	Resistência à Natureza	
GLOBAL_KEYWORD_SPELLRESISTANCE_NATURE_REF_TEXT	Recebe menos dano de habilidades de Natureza.	
GLOBAL_KEYWORD_SPELLRESISTANCE_NATURE_TEXT	Recebe {0} a menos de dano de habilidades de Natureza.	0=amount of spell damage
GLOBAL_KEYWORD_SPELLRESISTANCE_SHADOW	Resistência à Sombra	
GLOBAL_KEYWORD_SPELLRESISTANCE_SHADOW_REF_TEXT	Recebe menos dano de habilidades de Sombra.	
GLOBAL_KEYWORD_SPELLRESISTANCE_SHADOW_TEXT	Recebe {0} a menos de dano de habilidades de Sombra.	0=amount of spell damage
GLOBAL_KEYWORD_SPELLWEAKNESS_ARCANE	Fraqueza Arcana	
GLOBAL_KEYWORD_SPELLWEAKNESS_ARCANE_REF_TEXT	Recebe mais dano de habilidades Arcanas.	
GLOBAL_KEYWORD_SPELLWEAKNESS_ARCANE_TEXT	Recebe {0} a mais de dano de habilidades Arcanas.	0=amount of spell damage
GLOBAL_KEYWORD_SPELLWEAKNESS_FEL	Fraqueza Vil	
GLOBAL_KEYWORD_SPELLWEAKNESS_FEL_REF_TEXT	Recebe mais dano de habilidades Vis.	
GLOBAL_KEYWORD_SPELLWEAKNESS_FEL_TEXT	Recebe {0} a mais de dano de habilidades Vis.	0=amount of spell damage
GLOBAL_KEYWORD_SPELLWEAKNESS_FIRE	Fraqueza Ígnea	
GLOBAL_KEYWORD_SPELLWEAKNESS_FIRE_REF_TEXT	Recebe mais dano de habilidades de Fogo.	
GLOBAL_KEYWORD_SPELLWEAKNESS_FIRE_TEXT	Recebe {0} a mais de dano de habilidades de Fogo.	0=amount of spell damage
GLOBAL_KEYWORD_SPELLWEAKNESS_FROST	Fraqueza Gélida	
GLOBAL_KEYWORD_SPELLWEAKNESS_FROST_REF_TEXT	Recebe mais dano de habilidades de Gelo.	
GLOBAL_KEYWORD_SPELLWEAKNESS_FROST_TEXT	Recebe {0} a mais de dano de habilidades de Gelo.	0=amount of spell damage
GLOBAL_KEYWORD_SPELLWEAKNESS_HOLY	Fraqueza Sagrada	
GLOBAL_KEYWORD_SPELLWEAKNESS_HOLY_REF_TEXT	Recebe mais dano de habilidades Sagradas.	
GLOBAL_KEYWORD_SPELLWEAKNESS_HOLY_TEXT	Recebe {0} a mais de dano de habilidades Sagradas.	0=amount of spell damage
GLOBAL_KEYWORD_SPELLWEAKNESS_MERC	Fraqueza Mágica	
GLOBAL_KEYWORD_SPELLWEAKNESS_MERC_REF_TEXT	Recebe mais dano de todas as habilidades.	
GLOBAL_KEYWORD_SPELLWEAKNESS_MERC_TEXT	Recebe {0} a mais de dano proveniente de todas as habilidades.	
GLOBAL_KEYWORD_SPELLWEAKNESS_NATURE	Fraqueza Natural	
GLOBAL_KEYWORD_SPELLWEAKNESS_NATURE_REF_TEXT	Recebe mais dano de habilidades de Natureza.	
GLOBAL_KEYWORD_SPELLWEAKNESS_NATURE_TEXT	Recebe {0} a mais de dano de habilidades de Natureza.	0=amount of spell damage
GLOBAL_KEYWORD_SPELLWEAKNESS_SHADOW	Fraqueza Sombria	
GLOBAL_KEYWORD_SPELLWEAKNESS_SHADOW_REF_TEXT	Recebe mais dano de habilidades de Sombra.	
GLOBAL_KEYWORD_SPELLWEAKNESS_SHADOW_TEXT	Recebe {0} a mais de dano de habilidades de Sombra.	0=amount of spell damage
GLOBAL_KEYWORD_STARSHIP	Nave Estelar	
GLOBAL_KEYWORD_STARSHIP_TEXT	Tem os atributos e efeitos de suas Peças mortas. Clique para lançar!	
GLOBAL_KEYWORD_START_OF_COMBAT	Início do Combate	
GLOBAL_KEYWORD_START_OF_COMBAT_TEXT	Faz alguma coisa no início da Fase de Combate.	
GLOBAL_KEYWORD_START_OF_GAME	Início da Partida	
GLOBAL_KEYWORD_START_OF_GAME_TEXT	Faz alguma coisa antes do primeiro turno.	
GLOBAL_KEYWORD_STEALTH	Furtividade	
GLOBAL_KEYWORD_STEALTH_REF_TEXT	Não pode ser atacado nem alvejado até atacar.	
GLOBAL_KEYWORD_STEALTH_REF_TEXT_MERC	Não pode ser atacado nem alvejado até usar uma habilidade.	
GLOBAL_KEYWORD_STEALTH_TEXT	Não pode ser atacado nem alvejado até atacar.	
GLOBAL_KEYWORD_STEALTH_TEXT_MERC	Não pode ser atacado nem alvejado até usar uma habilidade.	
GLOBAL_KEYWORD_SUMMONED_WHEN_DRAWN	Evocado quando comprado	
GLOBAL_KEYWORD_SUMMONED_WHEN_DRAWN_TEXT	Evoca-se ao ser comprado, depois compre outro card.	
GLOBAL_KEYWORD_TAUNT	Provocar	
GLOBAL_KEYWORD_TAUNT_REF_TEXT	Os inimigos precisam atacar os lacaios que tiverem Provocar.	
GLOBAL_KEYWORD_TAUNT_REF_TEXT_Merc	Os inimigos precisam atacar personagens que tenham Provocar.	
GLOBAL_KEYWORD_TAUNT_TEXT	Os inimigos precisam atacar este lacaio.	
GLOBAL_KEYWORD_TEMPORARY	Temporário	
GLOBAL_KEYWORD_TEMPORARY_TEXT	Descartado no final do seu turno.	
GLOBAL_KEYWORD_TERRAN	Terrano	
GLOBAL_KEYWORD_TERRAN_MULTI	Terrano (Multi)	
GLOBAL_KEYWORD_TERRAN_MULTI_TEXT	Este card é um membro da facção Terrano e pode ser usado em {0} classes.	
GLOBAL_KEYWORD_TERRAN_TEXT	Este card é um membro da facção Terrano.	
GLOBAL_KEYWORD_TITAN	Titã	
GLOBAL_KEYWORD_TITAN_TEXT	Clique num Titã para usar\n1 de 3 habilidades em vez\nde atacar.	
GLOBAL_KEYWORD_TOOL	Ferramenta	
GLOBAL_KEYWORD_TOOL_TEXT	Um item com uma habilidade ativa.	
GLOBAL_KEYWORD_TRADE	Trocável	
GLOBAL_KEYWORD_TRADE_TEXT	Arraste esse card para o seu deck e gaste 1 de mana para comprar um novo card.	
GLOBAL_KEYWORD_TWINSPELL	Feitiço Duplo	
GLOBAL_KEYWORD_TWINSPELL_TEXT	Pode ser lançado duas vezes.	
GLOBAL_KEYWORD_VENOMOUS	Peçonhento	
GLOBAL_KEYWORD_VENOMOUS_TEXT	Destrua o primeiro lacaio que receber dano deste.	
GLOBAL_KEYWORD_WARLOCK_TOURIST	Turista: Bruxo	
GLOBAL_KEYWORD_WARLOCK_TOURIST_TEXT	Seu deck pode incluir cards de Bruxo de Perigos no Paraíso.	
GLOBAL_KEYWORD_WARRIOR_TOURIST	Turista: Guerreiro	
GLOBAL_KEYWORD_WARRIOR_TOURIST_TEXT	Seu deck pode incluir cards de Guerreiro de Perigos no Paraíso.	
GLOBAL_KEYWORD_WILD	Livre	
GLOBAL_KEYWORD_WILD_TEXT	Os cards Livres são cards antigos de Hearthstone que não são mais permitidos no Padrão.	
GLOBAL_KEYWORD_WINDFURY	Fúria dos Ventos	
GLOBAL_KEYWORD_WINDFURY_TEXT	Pode atacar duas vezes por turno.	
GLOBAL_KEYWORD_WINDFURY_TEXT_MERC	Ataca duas vezes sempre que atacar.	
GLOBAL_KEYWORD_YAMATO_CANNON	Canhão Yamato	
GLOBAL_KEYWORD_YAMATO_CANNON_TEXT	<b>Início do Combate:</b> Cause {0} de dano ao lacaio inimigo de maior Vida.	
GLOBAL_KEYWORD_YAMATO_CANNON_TEXT_ALT	<b>Início do Combate:</b> Cause {0} de dano ao lacaio inimigo de maior Vida, duas vezes.	
GLOBAL_KEYWORD_ZERG	Zerg	
GLOBAL_KEYWORD_ZERG_MULTI	Zerg (Multi)	
GLOBAL_KEYWORD_ZERG_MULTI_TEXT	Este card é um membro da facção Zerg e pode ser usado em {0} classes.	
GLOBAL_KEYWORD_ZERG_TEXT	Este card é um membro da facção Zerg.	
GLOBAL_LANGUAGE_CHANGE_CONFIRM_MESSAGE	Isto interromperá sua atividade atual. Tem certeza?	
GLOBAL_LANGUAGE_CHANGE_CONFIRM_TITLE	Mudar idioma?	
GLOBAL_LANGUAGE_CHANGE_OUT_OF_SPACE_MESSAGE	Você precisa de {0} de espaço livre no dispositivo para continuar.	
GLOBAL_LANGUAGE_CHANGE_OUT_OF_SPACE_TITLE	Espaço insuficiente!	
GLOBAL_LANGUAGE_DOWNLOAD_VOICE_PACK	(DEV) Pacote de vozes baixado	
GLOBAL_LANGUAGE_DROPDOWN	Idioma	
GLOBAL_LANGUAGE_NATIVE_DEDE	Deutsch	The name of the language IN THAT LANGUAGE.
GLOBAL_LANGUAGE_NATIVE_ENGB	Inglês (RU)	The name of the language IN THAT LANGUAGE.
GLOBAL_LANGUAGE_NATIVE_ENUS	English	The name of the language IN THAT LANGUAGE.
GLOBAL_LANGUAGE_NATIVE_ESES	Español (España)	The name of the language IN THAT LANGUAGE.
GLOBAL_LANGUAGE_NATIVE_ESMX	Español (Latinoamérica)	The name of the language IN THAT LANGUAGE.
GLOBAL_LANGUAGE_NATIVE_FRFR	Français	The name of the language IN THAT LANGUAGE.
GLOBAL_LANGUAGE_NATIVE_ITIT	Italiano	The name of the language IN THAT LANGUAGE.
GLOBAL_LANGUAGE_NATIVE_JAJP	日本語	The name of the language IN THAT LANGUAGE.
GLOBAL_LANGUAGE_NATIVE_KOKR	한국어	The name of the language IN THAT LANGUAGE.
GLOBAL_LANGUAGE_NATIVE_PLPL	Polski	The name of the language IN THAT LANGUAGE.
GLOBAL_LANGUAGE_NATIVE_PTBR	Português (Brasil)	The name of the language IN THAT LANGUAGE.
GLOBAL_LANGUAGE_NATIVE_RURU	Русский	The name of the language IN THAT LANGUAGE.
GLOBAL_LANGUAGE_NATIVE_THTH	ภาษาไทย	The name of the language IN THAT LANGUAGE.
GLOBAL_LANGUAGE_NATIVE_ZHCN	中文（简体）	The name of the language IN THAT LANGUAGE.
GLOBAL_LANGUAGE_NATIVE_ZHTW	繁體中文(台灣)	The name of the language IN THAT LANGUAGE.
GLOBAL_LEAVE	Abandonar	
GLOBAL_LEAVE_SPECTATOR_MODE	Abandonar	
GLOBAL_LEAVE_TUTORIAL	Sair do Tutorial	
GLOBAL_LETTUCE_LOBBY_TITLE	Escolha como jogar	
GLOBAL_LETTUCE_REWARD_BANNER_TEXT	Recompensa de Mercenários	
GLOBAL_LOCATIONS	Saiba mais	
GLOBAL_LOGIN	Conectar-se	
GLOBAL_LOGIN_CONFIRM_MESSAGE	Você perderá o progresso atual. Tem certeza?	
GLOBAL_LOGIN_CONFIRM_TITLE	Conectar-se?	
GLOBAL_LOGO_COPYRIGHT	炉石传说 - 魔兽英雄传 ©2016 暴雪娱乐股份有限公司版权所有 由上海网之易网络科技发展有限公司运营	
GLOBAL_LOGOUT	Desconectar-se	
GLOBAL_LOGOUT_CONFIRM_MESSAGE	Você tem certeza?	
GLOBAL_LOGOUT_CONFIRM_TITLE	Desconectar?	
GLOBAL_LOSSES	Derrotas	
GLOBAL_MEDAL_0	Lenda	
GLOBAL_MEDAL_1	Estalajadeiro	
GLOBAL_MEDAL_10	Ogro Mago	
GLOBAL_MEDAL_11	Caçador Profissional	
GLOBAL_MEDAL_12	Capitã do Brado Guerreiro	
GLOBAL_MEDAL_13	Corsário Terrível	
GLOBAL_MEDAL_14	Líder do Raide	
GLOBAL_MEDAL_15	Guardião de Luaprata	
GLOBAL_MEDAL_16	Aventureiro em Missão	
GLOBAL_MEDAL_17	Guerreiro Tauren	
GLOBAL_MEDAL_18	Aprendiz de Feiticeiro	
GLOBAL_MEDAL_19	Engenheira Novata	
GLOBAL_MEDAL_2	Cavaleiro Negro	
GLOBAL_MEDAL_20	Carrega-escudo	
GLOBAL_MEDAL_21	Marujo dos Mares do Sul	
GLOBAL_MEDAL_22	Murloc Saqueador	
GLOBAL_MEDAL_23	Escudeira Argêntea	
GLOBAL_MEDAL_24	Gnomo Leproso	
GLOBAL_MEDAL_25	Frango Nervoso	
GLOBAL_MEDAL_3	Gigante Derretido	
GLOBAL_MEDAL_4	Gigante da Montanha	
GLOBAL_MEDAL_5	Gigante do Mar	
GLOBAL_MEDAL_6	Anciente da Guerra	
GLOBAL_MEDAL_7	Andarilha do Sol	
GLOBAL_MEDAL_8	Senhor da Guerra Lobo do Gelo	
GLOBAL_MEDAL_9	Cavaleiro do Punho de Prata	
GLOBAL_MEDAL_ARENA_TOOLTIP_BODY	Esta é a melhor chave que você ganhou na Arena.\nVitórias: {0}	0=num wins
GLOBAL_MEDAL_REWARD_CONGRATULATIONS	Parabéns!	
GLOBAL_MEDAL_REWARD_DESCRIPTION	Medalha recebida semana passada	
GLOBAL_MEDAL_TOOLTIP_BEST_RANK_CLASSIC	Ranque do Clássico: {0}	
GLOBAL_MEDAL_TOOLTIP_BEST_RANK_STANDARD	Ranque no Padrão: {0}	
GLOBAL_MEDAL_TOOLTIP_BEST_RANK_TWIST	Ranque no Imprevisível: {0}	
GLOBAL_MEDAL_TOOLTIP_BEST_RANK_WILD	Ranque no Livre: {0}	
GLOBAL_MEDAL_TOOLTIP_BODY_ARENA_GRAND_MASTER	Você está entre os campeões da Arena!	
GLOBAL_MEDAL_TOOLTIP_BODY_CLASSIC	Vença partidas no Clássico para avançar para o próximo ranque!	
GLOBAL_MEDAL_TOOLTIP_BODY_LEGEND	Você é uma lenda! Sua posição neste ranque mudará com cada partida.	
GLOBAL_MEDAL_TOOLTIP_BODY_STANDARD	Vença partidas no Padrão para avançar para o próximo ranque!	
GLOBAL_MEDAL_TOOLTIP_BODY_TWIST	Vença partidas no Imprevisível para avançar para o próximo ranque!	
GLOBAL_MEDAL_TOOLTIP_BODY_WILD	Vença partidas no Livre para avançar para o próximo ranque!	
GLOBAL_MEDAL_TOOLTIP_HEADER	Medalha: {0}	0=medal name
GLOBAL_MEDAL_TOURNAMENT_TOOLTIP_BODY	Primeiros {0}% no modo jogo ranqueado desta temporada	0=rank percentile
GLOBAL_MERCENARIES	Mercenários	
GLOBAL_MERCENARIES_COOP	Cooperativo de Mercenários	
GLOBAL_MERCENARY_FACTION_ALLIANCE	Aliança	
GLOBAL_MERCENARY_FACTION_EMPIRE	Império	
GLOBAL_MERCENARY_FACTION_EXPLORER	Explorador	
GLOBAL_MERCENARY_FACTION_HORDE	Horda	
GLOBAL_MERCENARY_FACTION_LEGION	Legião	
GLOBAL_MERCENARY_FACTION_PIRATE	Pirata	
GLOBAL_MERCENARY_FACTION_SCOURGE	Flagelo	
GLOBAL_MINI_SET_BAR	Caverna Ululante	
GLOBAL_MINI_SET_DMF	Corrida de Negraluna	
GLOBAL_MINI_SET_ONY	Covil de Onyxia	
GLOBAL_MINI_SET_REV	Desordem no Tribunal	
GLOBAL_MINI_SET_RLK	Retorno a Naxxramas	
GLOBAL_MINI_SET_SW	Minas Mortas	
GLOBAL_MOBILE_ERROR_ANDROID_PHONE_DETECTED	No momento, o Hearthstone só roda em tablets Android de 6" ou maior.	
GLOBAL_MOBILE_ERROR_BREAKING_NEWS	Últimas notícias:\n\n{0}	
GLOBAL_MOBILE_ERROR_GAMESERVER_CONNECT	Vimos que você não conseguiu entrar numa partida porque estava numa conexão móvel. Confira este artigo de suporte para saber mais.	
GLOBAL_MOBILE_ERROR_LOGON_WEB_TIMEOUT	Faz algum tempo que você executou uma ação em Hearthstone e sua conexão foi fechada.	
GLOBAL_MOBILE_ERROR_NETWORK_DISCONNECT	Você foi desconectado.	
GLOBAL_MOBILE_ERROR_NETWORK_SPAM	Você foi desconectado por enviar solicitações demais muito depressa.	
GLOBAL_MOBILE_ERROR_NETWORK_UTIL_TIMEOUT	Sua conexão expirou enquanto requisitava dados dos servidores de Hearthstone.	
GLOBAL_MOBILE_ERROR_UNSUPPORTED_IOS_PHONE_DETECTED	Desculpe, Hearthstone requer iPhone 6S ou iPod Touch 7 ou mais recente.	
GLOBAL_MOBILE_ERROR_UNSUPPORTED_IOS_TABLET_DETECTED	Desculpe, Hearthstone requer iPad 5 ou iPad Air 2 ou iPad Mini 4 ou mais recente.	
GLOBAL_MOBILE_LOG_IN_TOOLTIP	Conecte-se se tiver uma conta!	
GLOBAL_MOBILE_LOGIN_POINTER	Conecte-se aqui	
GLOBAL_MOBILE_RESTART_APPLICATION	Reinicie o aplicativo	
GLOBAL_MOBILE_TAP_TO_RECONNECT	Toque em qualquer lugar para reconectar	
GLOBAL_MOBILE_TAP_TO_UPDATE	Toque em qualquer lugar para atualizar	
GLOBAL_MOBILECHAT_NOTIFICATION_MULLIGAIN	O jogo começou!	
GLOBAL_MOBILECHAT_NOTIFICATION_TURN_COUNTDOWN	O tempo está acabando!	
GLOBAL_MOBILECHAT_NOTIFICATION_YOUR_TURN	Seu turno!	
GLOBAL_MOBILECHAT_RETURN_TO_GAME	Fechar	
GLOBAL_MOBILECHAT_RETURN_TO_MENU	Retornar ao menu	
GLOBAL_MODULE_ADVENTURE	Modo Aventura	Module name for adventure
GLOBAL_MODULE_BGS	Campos de Batalha	Module name for battlegrounds
GLOBAL_MODULE_MERC	Mercenários	Module name for merc
GLOBAL_MORE	Mais	
GLOBAL_MY_NUM_WINS	{0}	0=number of games this player has won
GLOBAL_NOT_AVAILABLE	Indisponível	
GLOBAL_OFF	Desligado	
GLOBAL_OFFLINE	Desconectado	
GLOBAL_OKAY	OK	
GLOBAL_ON	Ligado	
GLOBAL_OPTIONS	Opções	
GLOBAL_OPTIONS_CARDBACK_LABEL	Escolha o verso do seu card	
GLOBAL_OPTIONS_CHOOSE_CARD_BACK	Escolha o verso do card	
GLOBAL_OPTIONS_CINEMATIC	Vídeo	
GLOBAL_OPTIONS_CREDITS	Créditos	
GLOBAL_OPTIONS_GRAPHICS_FPS_DEFAULT	Baixa	
GLOBAL_OPTIONS_GRAPHICS_FPS_HIGH	Alta	
GLOBAL_OPTIONS_GRAPHICS_FPS_LABEL	Taxa de Quadros	
GLOBAL_OPTIONS_GRAPHICS_FPS_MEDIUM	Média	
GLOBAL_OPTIONS_GRAPHICS_FULLSCREEN_LABEL	Tela cheia	
GLOBAL_OPTIONS_GRAPHICS_LABEL	Gráficos	
GLOBAL_OPTIONS_GRAPHICS_QUALITY_HIGH	Alta	
GLOBAL_OPTIONS_GRAPHICS_QUALITY_LABEL	Qualidade	
GLOBAL_OPTIONS_GRAPHICS_QUALITY_LOW	Baixa	
GLOBAL_OPTIONS_GRAPHICS_QUALITY_MEDIUM	Média	
GLOBAL_OPTIONS_GRAPHICS_RESOLUTION_CUSTOM	Personalizado	
GLOBAL_OPTIONS_GRAPHICS_RESOLUTION_LABEL	Resolução	
GLOBAL_OPTIONS_MISCELLANEOUS_LABEL	Diversos	
GLOBAL_OPTIONS_NEARBY_PLAYERS	Permite desafiar jogadores próximos - Lista de amigos	
GLOBAL_OPTIONS_OTHER_LABEL	Outros	
GLOBAL_OPTIONS_PREFERENCES_LABEL	Preferências	
GLOBAL_OPTIONS_PRIVACY_POLICY	Privacidade	
GLOBAL_OPTIONS_PUBLIC_CHAT_ENABLED	Bate-papo com estranhos	
GLOBAL_OPTIONS_RESTORE_PURCHASES	Restaurar compras	
GLOBAL_OPTIONS_RESTORE_PURCHASES_POPUP_TEXT	Não encontra uma compra? Verifique se você está conectado à conta certa.	
GLOBAL_OPTIONS_SCREEN_SHAKE	Ativar tremor de tela	
GLOBAL_OPTIONS_SKIP_NPR	Pular o Aprendiz	
GLOBAL_OPTIONS_SKIP_TO_RANK_25	Pular para o Ranque 25	
GLOBAL_OPTIONS_SOUND_AMBIENT_SOUNDS_VOLUME_LABEL	Som ambiente	
GLOBAL_OPTIONS_SOUND_DIALOG_VOLUME_LABEL	Diálogo	
GLOBAL_OPTIONS_SOUND_IN_BACKGROUND	Som de fundo	
GLOBAL_OPTIONS_SOUND_LABEL	Som	
GLOBAL_OPTIONS_SOUND_MASTER_VOLUME_LABEL	Volume geral	
GLOBAL_OPTIONS_SOUND_MONO	Som Mono	
GLOBAL_OPTIONS_SOUND_MUSIC_VOLUME_LABEL	Volume da música	
GLOBAL_OPTIONS_SOUND_OPTIONS_LABEL	Opções de som	
GLOBAL_OPTIONS_SOUND_RESET_DEFAULTS	Redefinir Padrões	
GLOBAL_OPTIONS_SOUND_SOUND_EFFECT_VOLUME_LABEL	Efeitos sonoros	
GLOBAL_OPTIONS_SPECTATOR_OPEN_JOIN	Permitir que amigos assistam aos meus jogos	
GLOBAL_PERSONAL_INFO_APP_ID	App Install ID	Label for showing their unqiue application install ID
GLOBAL_PERSONAL_INFO_DEVICE_ID	Device Unique ID	Label for showing their device's unique id
GLOBAL_PERSONAL_INFO_DEVICE_MODEL	Device Mode	Label for showing their device model
GLOBAL_PERSONAL_INFO_DEVICE_NAME	Device Name	Label for showing their device name
GLOBAL_PERSONAL_INFO_DEVICE_TYPE	Device Type	Label for showing their device type (Console/Handheld/Desktop)
GLOBAL_PERSONAL_INFO_LOCALE	Região	Label for showing their locale setting
GLOBAL_PERSONAL_INFO_OS_VERSION	Os Version	Label for showing their operating system version
GLOBAL_PERSONAL_INFO_REGION	Connected Battle.net Region	Label for showing their locale setting
GLOBAL_PLAY	Jogar	
GLOBAL_PLAY_RANKED	Jogar\nranqueado	
GLOBAL_PLAY_STANDARD	Jogar Padrão	
GLOBAL_PLAY_WAITING	Esperando	
GLOBAL_PLAY_WILD	Jogar Livre	
GLOBAL_PLAYER_MIGRATION_RESTART_BODY	Sua conta precisa ser atualizada.\nReinicie o jogo.	
GLOBAL_PLAYER_MIGRATION_RESTART_HEADER	A conta precisa ser atualizada	
GLOBAL_PLAYER_PLAYER	Jogador	this is the word for generic "Player" - this will be used when there a player's name is unknown at the time.
GLOBAL_PRACTICE_MAX_LEVEL_REACHED	Nível max. de treinamento	
GLOBAL_PRIVACY_PERSONAL_INFO_BUTTON_CN	Personal Info	Text for a button to show personal information collected by the game for CN users
GLOBAL_PRIVACY_PERSONAL_INFO_ERROR_BODY	Personal Info is not available right now.\nPlease try again later.	
GLOBAL_PRIVACY_PERSONAL_INFO_ERROR_TITLE	Indisponível	Title for dialog telling users personal information is unavailable
GLOBAL_PRIVACY_REGISTRATION_BUTTON_CN	沪B2-20080012-20A	Button text for registration information. Should not be translated
GLOBAL_PRIVACY_SDK_BUTTON_CN	3rd Party Info	Text for a button to show 3rd party sdk information for CN users
GLOBAL_PROGRAMNAME_ARCADECOLLECTION	Blizzard Arcade Collection	
GLOBAL_PROGRAMNAME_BLACKOPS4	Black Ops 4	
GLOBAL_PROGRAMNAME_BLACKOPSCOLDWAR	Black Ops Cold War	
GLOBAL_PROGRAMNAME_CODVANGUARD	Call of Duty: Vanguard	
GLOBAL_PROGRAMNAME_CRASHBANDICOOT4	Crash Bandicoot 4	
GLOBAL_PROGRAMNAME_DIABLO2R	Diablo II: Ressuscitado	
GLOBAL_PROGRAMNAME_DIABLO3	Diablo III	
GLOBAL_PROGRAMNAME_DIABLO4	Diablo IV	
GLOBAL_PROGRAMNAME_DIABLOIMMORTAL	Diablo Imortal	
GLOBAL_PROGRAMNAME_HEARTHSTONE	Hearthstone	
GLOBAL_PROGRAMNAME_HEROES	Heroes of the Storm	
GLOBAL_PROGRAMNAME_MODERNWARFARE	Guerra Moderna	
GLOBAL_PROGRAMNAME_MODERNWARFARE2	Guerra Moderna II	
GLOBAL_PROGRAMNAME_MODERNWARFARE2_REMASTER	MW2CR	
GLOBAL_PROGRAMNAME_OVERWATCH	Overwatch	
GLOBAL_PROGRAMNAME_OVERWATCH2	Overwatch 2	
GLOBAL_PROGRAMNAME_PHOENIX	Online	
GLOBAL_PROGRAMNAME_STARCRAFT	StarCraft	
GLOBAL_PROGRAMNAME_STARCRAFT2	StarCraft II	
GLOBAL_PROGRAMNAME_WARCRAFT3	Warcraft III: Reforged	
GLOBAL_PROGRAMNAME_WARCRAFTARCLIGHTRUMBLE	Warcraft Rumble	
GLOBAL_PROGRAMNAME_WOW	World of Warcraft	
GLOBAL_PROGRESSION_ACHIEVEMENT_COMPLETION	{0} concluído	
GLOBAL_PROGRESSION_ACHIEVEMENT_COMPLETION_DATE	{0:yyyy/MM/dd}	see http://msdn.microsoft.com/en-us/library/8kb3ddd4.aspx
GLOBAL_PROGRESSION_ACHIEVEMENT_COMPLETION_PERCENTAGE	{0}%	
GLOBAL_PROGRESSION_ACHIEVEMENT_SUBCATEGORY_LOCKED_TOOLTIP	Baixe {0} para visualizar conquistas.	{0}=Localised game mode name
GLOBAL_PROGRESSION_ACHIEVEMENT_SUBCATEGORY_LOCKED_TOOLTIP_TITLE	{0}	{0}=Localised game mode name
GLOBAL_PROGRESSION_ACHIEVEMENT_SUBCATEGORY_NAME	{0} - {1}	
GLOBAL_PROGRESSION_ACHIEVEMENT_TILE_LOCKED_MESSAGE	Baixe {0} para visualizar	{0}=Localised game mode name
GLOBAL_PROGRESSION_BATTLEGROUNDS_QUESTS_POPUP_TITLE	Suas missões semanais	
GLOBAL_PROGRESSION_DAILY_QUESTS_POPUP_TITLE	Suas Missões	
GLOBAL_PROGRESSION_EVENT_QUESTS_POPUP_TITLE	Suas missões de evento	
GLOBAL_PROGRESSION_POINTS	{0} Pontos de Conquista	
GLOBAL_PROGRESSION_PROFILE_ARENA_STAT_TOOLTIP	Maior número de vitórias alcançado na Arena.	
GLOBAL_PROGRESSION_PROFILE_ARENA_STAT_TOOLTIP_TITLE	Arena	
GLOBAL_PROGRESSION_PROFILE_ARENA_WINS	{0} |4(Vitória,Vitórias)	
GLOBAL_PROGRESSION_PROFILE_BATTLEGROUNDS_STAT_TOOLTIP	Aumente sua classificação vencendo partidas. Terminar entre os 4 melhores conta como vitória em missões!	
GLOBAL_PROGRESSION_PROFILE_BATTLEGROUNDS_STAT_TOOLTIP_TITLE	Campos de Batalha	
GLOBAL_PROGRESSION_PROFILE_BATTLEGROUNDS_TOP4	Entre os 4 melhores {0} |4(vez,vezes)	
GLOBAL_PROGRESSION_PROFILE_GAME_MODES	Modos de jogo	
GLOBAL_PROGRESSION_PROFILE_MERCENARIES_STAT_TOOLTIP	Mostra o ranque JxJ e o número de contratos concluídos no modo Mercenários.	
GLOBAL_PROGRESSION_PROFILE_MERCENARIES_STAT_TOOLTIP_TITLE	Mercenários	
GLOBAL_PROGRESSION_PROFILE_MERCENARIES_TOTAL_BOUNTIES	{0} |4(Contrato, Contratos) no Total	
GLOBAL_PROGRESSION_PROFILE_PLAY_MODE	Hearthstone Tradicional	
GLOBAL_PROGRESSION_PROFILE_PVPDR_CASUAL_STAT_TITLE	Duelos Casuais	
GLOBAL_PROGRESSION_PROFILE_PVPDR_CASUAL_STAT_TOOLTIP	Mostra sua melhor classificação no modo Duelos Casual ou Heroico.	
GLOBAL_PROGRESSION_PROFILE_PVPDR_CASUAL_STAT_TOOLTIP_TITLE	Duelos (Modo Casual)	
GLOBAL_PROGRESSION_PROFILE_PVPDR_HEROIC_STAT_TITLE	Duelos Heroicos	
GLOBAL_PROGRESSION_PROFILE_PVPDR_HEROIC_STAT_TOOLTIP	Mostra sua melhor classificação no modo Duelos Casual ou Heroico.	
GLOBAL_PROGRESSION_PROFILE_PVPDR_HEROIC_STAT_TOOLTIP_TITLE	Duelos (Modo Heroico)	
GLOBAL_PROGRESSION_PROFILE_RANKED_STAT_TOOLTIP	Total de vitórias no Jogo Ranqueado.	
GLOBAL_PROGRESSION_PROFILE_TOTAL_WINS	{0} |4(vitória,vitórias ao todo)	
GLOBAL_PROGRESSION_PROGRESS_MESSAGE	{0} / {1}	
GLOBAL_PROGRESSION_QUEST_TIME_UNTIL_NEXT	Nova missão em\n{0}	
GLOBAL_PROGRESSION_RANKED_REWARDS_TOOLTIP	Suba seu ranque todo mês e eleve o nível das suas classes para receber recompensas bacanas!	
GLOBAL_PROGRESSION_RANKED_REWARDS_TOOLTIP_TITLE	Recompensas	
GLOBAL_PROGRESSION_REWARD_SUMMARY	{0}\n{1}	
GLOBAL_PROGRESSION_REWARD_TRACK_XP	{0} de EXP de Recompensa	
GLOBAL_PROGRESSION_TIER_MESSAGE	{0}/{1}	
GLOBAL_PROGRESSION_TOOLTIP_CLASS_DEFAULT_DESC	Nível {0}	
GLOBAL_PROGRESSION_TOOLTIP_GOLDEN_WINS_DESC	Vença {0} partidas no Ranqueado ou Arena com {1} para ganhar o herói clássico Dourado!	{0}=win count {1}=class name
GLOBAL_PROGRESSION_TOOLTIP_PREMIUM_WINS_DESC	Vença {0} partidas no Ranqueado ou Arena com {1} para ganhar {2}!	{0}=win count {1}=class name {2}=hero card name
GLOBAL_PROGRESSION_TOOLTIP_PREMIUM_WINS_DONE_DESC	Vencer {0} partidas no Ranqueado ou Arena com {1} lhe rendeu {2}!	{0}=win count {1}=class name {2}=hero card name
GLOBAL_PROGRESSION_TOOLTIP_TOTAL_CLASS_WINS	Total de vitórias com {0}	{0}=class name
GLOBAL_PROGRESSION_WEEKLY_QUESTS_POPUP_TITLE	Suas Missões Semanais	
GLOBAL_PVPDR_SEASON_ERROR_NOT_ACTIVE	A temporada de Duelos solicitada não está mais disponível. Tente de novo depois.	
GLOBAL_QUEST_PROGRESS_COUNT	{0}/{1}	0=progress,1=max progress
GLOBAL_QUIT	Sair	
GLOBAL_RACE_ALL	Tudo	
GLOBAL_RACE_ALL_BATTLEGROUNDS	Amálgamas	This should be the plural of DAL_087t
GLOBAL_RACE_BLOODELF	Elfo Sangrento	
GLOBAL_RACE_BLOODELF_BATTLEGROUNDS	Elfos Sangrentos	
GLOBAL_RACE_CELESTIAL	Celestial	
GLOBAL_RACE_CENTAUR	Centauro	
GLOBAL_RACE_DEMON	Demônio	
GLOBAL_RACE_DEMON_BATTLEGROUNDS	Demônios	
GLOBAL_RACE_DRAENEI	Draenei	
GLOBAL_RACE_DRAENEI_BATTLEGROUNDS	Draenei	
GLOBAL_RACE_DRAGON	Dragão	
GLOBAL_RACE_DRAGON_BATTLEGROUNDS	Dragões	
GLOBAL_RACE_DWARF	Anão	
GLOBAL_RACE_DWARF_BATTLEGROUNDS	Anões	
GLOBAL_RACE_EGG	Ovo	
GLOBAL_RACE_EGG_BATTLEGROUNDS	Ovos	
GLOBAL_RACE_ELEMENTAL	Elemental	
GLOBAL_RACE_ELEMENTAL_BATTLEGROUNDS	Elementais	
GLOBAL_RACE_FURBOLG	Pelurso	
GLOBAL_RACE_GNOLL	Gnoll	
GLOBAL_RACE_GNOME	Gnomo	
GLOBAL_RACE_GNOME_BATTLEGROUNDS	Gnomos	
GLOBAL_RACE_GOBLIN	Goblin	
GLOBAL_RACE_GOBLIN_BATTLEGROUNDS	Goblins	
GLOBAL_RACE_GOLEM	Golem	
GLOBAL_RACE_GRONN	Gronn	
GLOBAL_RACE_HALFORC	Meio Orc	
GLOBAL_RACE_HARPY	Harpia	
GLOBAL_RACE_HIGHELF	Elfo Superior	
GLOBAL_RACE_HUMAN	Humano	
GLOBAL_RACE_HUMAN_BATTLEGROUNDS	Humanos	
GLOBAL_RACE_LOCK	Tranca	
GLOBAL_RACE_MECHANICAL	Mecanoide	
GLOBAL_RACE_MECHANICAL_BATTLEGROUNDS	Mecanoides	
GLOBAL_RACE_MIXED_BATTLEGROUNDS	Lacaios Mistos	
GLOBAL_RACE_MURLOC	Murloc	
GLOBAL_RACE_MURLOC_BATTLEGROUNDS	Murlocs	
GLOBAL_RACE_NAGA	Naga	
GLOBAL_RACE_NAGA_BATTLEGROUNDS	Naga	
GLOBAL_RACE_NERUBIAN	Nerubiano	
GLOBAL_RACE_NERUBIAN_BATTLEGROUNDS	Nerubianos	
GLOBAL_RACE_NIGHTELF	Elfo Noturno	
GLOBAL_RACE_NIGHTELF_BATTLEGROUNDS	Elfos Noturnos	
GLOBAL_RACE_OGRE	Ogro	
GLOBAL_RACE_OGRE_BATTLEGROUNDS	Ogros	
GLOBAL_RACE_OLDGOD	Deus Antigo	
GLOBAL_RACE_ORC	Orc	
GLOBAL_RACE_ORC_BATTLEGROUNDS	Orcs	
GLOBAL_RACE_OWLKIN	Corujante	
GLOBAL_RACE_PANDAREN	Pandaren	
GLOBAL_RACE_PET	Fera	
GLOBAL_RACE_PET_BATTLEGROUNDS	Feras	
GLOBAL_RACE_PIRATE	Pirata	
GLOBAL_RACE_PIRATE_BATTLEGROUNDS	Piratas	
GLOBAL_RACE_QUILBOAR	Javatusco	
GLOBAL_RACE_QUILBOARS_BATTLEGROUNDS	Javatusco	
GLOBAL_RACE_SCOURGE	Flagelo	
GLOBAL_RACE_SCOURGE_BATTLEGROUNDS	Flagelo	
GLOBAL_RACE_TAUREN	Tauren	
GLOBAL_RACE_TAUREN_BATTLEGROUNDS	Taurens	
GLOBAL_RACE_TOTEM	Totem	
GLOBAL_RACE_TOTEM_BATTLEGROUNDS	Totens	
GLOBAL_RACE_TREANT	Arvoroso	
GLOBAL_RACE_TROLL	Troll	
GLOBAL_RACE_TROLL_BATTLEGROUNDS	Trolls	
GLOBAL_RACE_UNDEAD	Morto-Vivo	
GLOBAL_RACE_UNDEAD_BATTLEGROUNDS	Mortos-vivos	
GLOBAL_RACE_VULPERA	Vulpera	
GLOBAL_RACE_WORGEN	Worgen	
GLOBAL_RACE_WORGEN_BATTLEGROUNDS	Worgens	
GLOBAL_RANK_CANT_LOSE_LEVEL	Você não pode ficar abaixo deste ranque.	
GLOBAL_RANK_PROMOTION_DESC	Você foi promovido ao Ranque 25!	
GLOBAL_RANK_SCRUB_RANK_DESC	Não é possível perder estrelas neste ranque.	
GLOBAL_RANK_STAR_MULT	Bônus de estrela! x{0}	
GLOBAL_RANK_STAR_MULT_STREAK	Bônus de vitórias seguidas! x2	
GLOBAL_RANK_WIN_STREAK	Vitórias em série - Estrela bônus!	
GLOBAL_RANKED	Ranqueado	
GLOBAL_RARITY_COMMON	Comum	
GLOBAL_RARITY_EPIC	Épico	
GLOBAL_RARITY_FREE	Grátis	
GLOBAL_RARITY_LEGENDARY	Lendário	
GLOBAL_RARITY_RARE	Raro	
GLOBAL_RECONNECT_EXIT_BUTTON	Sair	
GLOBAL_RECONNECT_FAIL_MODE_NOT_AVAILABLE	Não foi possível reconectar ao jogo; o modo {0} ainda não foi baixado	{0}=Name of the mode, (e.g. Battlegrounds, Mercenaries, Solo Adventures)
GLOBAL_RECONNECT_RECONNECTED	Você foi reconectado ao jogo. Retomando...	
GLOBAL_RECONNECT_RECONNECTED_HEADER	Reconectado	
GLOBAL_RECONNECT_RECONNECTED_LOGIN	Você foi reconectado ao último jogo. Retomando...	
GLOBAL_RECONNECT_RECONNECTING	Você foi desconectado do seu jogo. Reconectando...	
GLOBAL_RECONNECT_RECONNECTING_HEADER	Reconectando	
GLOBAL_RECONNECT_RECONNECTING_LOGIN	Você foi desconectado do seu último jogo. Reconectando...	
GLOBAL_RECONNECT_TIMEOUT	Não foi possível reconectar ao seu jogo.	
GLOBAL_RECONNECT_TIMEOUT_HEADER	Erro	
GLOBAL_REDUNDANT_NDE_BODY	Você ganhou a versão {0} |4(deste card, destes cards).\nDeseja trocar |4(a versão, as versões) {1} por |4(um card {3} aleatório de {2}, cards {3} aleatórios de {2})?	0=Newly Acquired Premium, 1=Premium to reroll, 2=reroll set name, 3=card rarity
GLOBAL_REDUNDANT_NDE_BODY_MULTIPLE_PREMIUMS	Você ganhou a versão {0} deste card.\nDeseja trocar a versão {1}/{2} por cards {4} aleatórios de {3}?	0=Newly Acquired Premium, 1=Higher premium to reroll, 2=Lower premium to reroll, 3=reroll set name, 4=card rarity
GLOBAL_REDUNDANT_NDE_BUTTON_DECLINE	Não, obrigado	
GLOBAL_REDUNDANT_NDE_BUTTON_REROLL	Trocar!	
GLOBAL_REDUNDANT_NDE_DOUBLE_BODY	Você ganhou versões [PH Premium] deste card.\nDeseja trocar as versões [PH Premium] por cards aleatórios de [PH SET] de raridade [PH RARITY]?	
GLOBAL_REDUNDANT_NDE_REROLL_RESULT_HEADER	Card trocado!	
GLOBAL_REDUNDANT_NDE_TITLE	{0}: Trocar |4(Card, Cards)?	0=card premium to reroll
GLOBAL_REDUNDANT_NDE_TITLE_MULTIPLE_PREMIUMS	Trocar cards {0}/{1}?	0=higher card premium to reroll, 1=lower card premium to reroll
GLOBAL_REFRESH	Atualizar	
GLOBAL_REGION_AMERICAS	Américas & Sudeste da Ásia	
GLOBAL_REGION_ASIA	Ásia	
GLOBAL_REGION_CHINA	China	
GLOBAL_REGION_EUROPE	Europa	
GLOBAL_RELAUNCH_APPLICATION_AFTER_INSTALLAPK	Tentando instalar novo cliente. Reinicie Hearthstone se o cliente não tiver sido instalado.	
GLOBAL_REMAINING_DATETIME	{0} restantes	0=time string
GLOBAL_REMINDER_CARDBACK_SEASON_END_DIALOG	Vença {0} |4(partida,partidas) para receber o verso de card da temporada.	
GLOBAL_REMINDER_CHEST_QUESTION_MARK	?	Label for unearned chest, assuming "?" universally means unknown, it doesn't need to be localized
GLOBAL_REMINDER_CHEST_SEASON_END_DIALOG	Vença 5 partidas para receber o Baú da Temporada.	
GLOBAL_REPORT_DETAIL_ADVERTISEMENT	Anúncio	
GLOBAL_REPORT_DETAIL_BATTLETAG	BattleTag	
GLOBAL_REPORT_DETAIL_BOTTING	Bots	
GLOBAL_REPORT_DETAIL_HACKING	Hackeando	
GLOBAL_REPORT_DETAIL_HARASSMENT	Assédio	
GLOBAL_REPORT_DETAIL_INTENTIONALLY_LOSING_DERANKING	Perdendo propositalmente	
GLOBAL_REPORT_DETAIL_SPAM	Spam	
GLOBAL_REPORT_REASON_CHEATING	Trapaça	
GLOBAL_REPORT_REASON_INAPPROPRIATE_CHAT	Conversa inadequada	
GLOBAL_REPORT_REASON_INAPPROPRIATE_NAME	Nome inapropriado	
GLOBAL_RESTART	Reiniciar	
GLOBAL_RESUME_GAME	Continuar	
GLOBAL_RETRY	Tentar novamente	
GLOBAL_RETURNING_PLAYER_GENERATED_DECK	Deck do Estalajadeiro	
GLOBAL_REWARD_ARCANE_DUST_HEADLINE	Pó Arcano recebido!	
GLOBAL_REWARD_ARCANE_ORBS_HEADLINE	Obteve Orbes Arcanos!	
GLOBAL_REWARD_ARENA_TICKET	Ingresso para a Arena	
GLOBAL_REWARD_ARENA_TICKET_ADMIT	INGRESSO	the word 'admit' in capital letters - displayed like "Admit 1" and looks like a movie/fair ticket. this is the Arena Ticket reward visual.
GLOBAL_REWARD_ARENA_TICKET_AUTHORIZED_BY	Autorizado por	a label that shows up in the Arena Ticket under the Player's name indicating this ticket reward was granted by some guy.
GLOBAL_REWARD_ARENA_TICKET_ENTRANT	Espectador	a label that shows up in the Arena Ticket under the Player's name to say this person is allowed entrance into the Arena.
GLOBAL_REWARD_ARENA_TICKET_HEADLINE	Ingresso grátis!	
GLOBAL_REWARD_ARENA_TICKET_LABEL	Arena	
GLOBAL_REWARD_ARENA_TICKET_STORE_COUNT_1	1	
GLOBAL_REWARD_ARENA_TICKET_TITLE	Taverna	
GLOBAL_REWARD_BATTLEGROUNDS_GUIDE_HEADLINE	Bartender dos Campos de Batalha desbloqueado	
GLOBAL_REWARD_BATTLEGROUNDS_HERO_HEADLINE	Herói dos Campos de Batalha desbloqueado	
GLOBAL_REWARD_BONUS_CHALLENGE_HEADLINE	Desafio Final desbloqueado	
GLOBAL_REWARD_BOOSTER_DETAILS_OUT_OF_BAND	{0} |4(pacote foi adicionado,pacotes foram adicionados) à sua conta de fora do jogo.	0=count
GLOBAL_REWARD_BOOSTER_DETAILS_PRESALE_OUT_OF_BAND	Sua compra pela web de {0} |4(pacote,pacotes) estará disponível em breve!	0=count
GLOBAL_REWARD_BOOSTER_HEADLINE_GENERIC	Pacote recebido!	
GLOBAL_REWARD_BOOSTER_HEADLINE_MULTIPLE	{0} |4(pacote obtido,pacotes obtidos)!	
GLOBAL_REWARD_BOOSTER_HEADLINE_OUT_OF_BAND	Pacote de Card concedido!	
GLOBAL_REWARD_BOOSTER_HEADLINE_OUT_OF_BAND_MULTI	Pacotes de Cards concedidos!	
GLOBAL_REWARD_CARD_BACK_HEADLINE	Verso de card recebido!	
GLOBAL_REWARD_CARD_COUNT_MULTIPLIER	x	
GLOBAL_REWARD_CARD_DETAILS_TUTORIAL01	Isso aí!	
GLOBAL_REWARD_CARD_DETAILS_TUTORIAL02	Isso é impressionante.	
GLOBAL_REWARD_CARD_DETAILS_TUTORIAL03	Tu é demais!	
GLOBAL_REWARD_CARD_DETAILS_TUTORIAL04	Isso foi incrível!	
GLOBAL_REWARD_CARD_DETAILS_TUTORIAL05	Magnífico!	
GLOBAL_REWARD_CARD_DETAILS_TUTORIAL06	Muito bem!	
GLOBAL_REWARD_CARD_HEADLINE	Recompensa!	
GLOBAL_REWARD_CARD_LEVEL_UP	Desbloqueado ao chegar no nível {0} como {1}	0=# level, 1=class
GLOBAL_REWARD_CHEST_HEADER	Você ganhou recompensas de ranque!	
GLOBAL_REWARD_CHEST_INSTRUCTIONS	Abra o baú no final da temporada.\nAprimore o baú subindo de ranque!	
GLOBAL_REWARD_CHEST_TIER1	Tesouro do Gigante do Mar	
GLOBAL_REWARD_CHEST_TIER1_EARNED	Você ganhou o Tesouro do Gigante do Mar!	
GLOBAL_REWARD_CHEST_TIER2	Tesouro do Ogro Mago	
GLOBAL_REWARD_CHEST_TIER2_EARNED	Você ganhou o Tesouro do Ogro Mago!	
GLOBAL_REWARD_CHEST_TIER3	Baú do Guardião	
GLOBAL_REWARD_CHEST_TIER3_EARNED	Você ganhou o Baú do Guardião!	
GLOBAL_REWARD_CHEST_TIER4	Caixa-forte do Carrega-escudo	
GLOBAL_REWARD_CHEST_TIER4_EARNED	Você ganhou a Caixa-forte do Carrega-escudo!	
GLOBAL_REWARD_CHEST_TIER5	Caixote do Frango Nervoso	
GLOBAL_REWARD_CHEST_TIER5_EARNED	Você ganhou o Caixote do Frango Nervoso!	
GLOBAL_REWARD_CHEST_TIER6	Quinhão do Freguês	
GLOBAL_REWARD_CHEST_TIER6_EARNED	Você obteve o Quinhão do Freguês!	
GLOBAL_REWARD_CLASS_CHALLENGE_DETAIL	{0}	0=first class
GLOBAL_REWARD_CLASS_CHALLENGE_DETAIL_DOUBLE	{0} e {1}	0=first class, 1=second class
GLOBAL_REWARD_CLASS_CHALLENGE_HEADLINE	|4(Desafio,Desafios) de classe |4(desbloqueado,desbloqueados)	
GLOBAL_REWARD_CORE_CARD_DETAILS	{0}/{1} cards de {2} desbloqueados	0=# cards unlocked, 1=# cards possible to unlock, 2=class
GLOBAL_REWARD_FIERY_HEART_MOUNT_HEADLINE	Montaria Coração em Chamas	
GLOBAL_REWARD_FORGE_DETAILS_OUT_OF_BAND	{0} |4(ingresso de arena foi adicionado,ingressos de arena foram adicionados) à sua conta de fora do jogo.	0=count
GLOBAL_REWARD_FORGE_HEADLINE	Ingresso de arena concedido	
GLOBAL_REWARD_FORGE_UNLOCKED_HEADLINE	Arena desbloqueada!	
GLOBAL_REWARD_FORGE_UNLOCKED_SOURCE	Recompensa por entrar na Arena	
GLOBAL_REWARD_GOLD_HEADLINE	Ouro recebido!	
GLOBAL_REWARD_GOLD_SOURCE_IGR	Recompensa por se conectar de uma IGR.	
GLOBAL_REWARD_GOLD_SOURCE_IGR_DATED	Recebido por se conectar de um IGR em {0}	0=GLOBAL_CURRENT_DATE
GLOBAL_REWARD_GOLD_SOURCE_TOURNEY	Premiado por vencer {0} |4(jogo,jogos) de Contenda de Taverna, Campos de Batalha ou no modo Jogo	
GLOBAL_REWARD_GOLDEN_HERO_HEADLINE	Herói Dourado disponível	
GLOBAL_REWARD_HEARTHSTEED_HEADLINE	Montaria Corcel de Regresso	
GLOBAL_REWARD_HERO_DETAILS	{0}/{1} heróis desbloqueados	
GLOBAL_REWARD_HERO_HEADLINE	{0} desbloqueado	
GLOBAL_REWARD_HEROES_CARD_MOUNT_HEADLINE	Montaria de Card de Hearthstone	
GLOBAL_REWARD_PROGRESS	Vitórias: {0}/{1}	0=current wins,1=required wins
GLOBAL_REWARD_SARGE_TALE_HEADLINE	Montaria de História do Sargento	
GLOBAL_ROLE_CASTER	Lançador	
GLOBAL_ROLE_FIGHTER	Lutador	
GLOBAL_ROLE_TANK	Protetor	
GLOBAL_RUNE_REQUIREMENT_POPUP_TEXT	Veja os requisitos da Runa aqui.	
GLOBAL_SCAN	Buscar	
GLOBAL_SCREENSHOT_COMPLETE	Captura de tela salva na área de trabalho	
GLOBAL_SCREENSHOT_COMPLETE_SPECIFIC_DIRECTORY	Captura de tela salva em {0}	0=The directory that the file was saved to
GLOBAL_SEASON_CHEST_BANNER	Baú da Temporada	Default label for the banner in the end game screen that is placed above the in progress chest
GLOBAL_SEASON_END_BEST_EVER_ABOVE_MAX	Com base em seu desempenho anterior, você sempre começa no ranque {0} ou superior.	0=rank
GLOBAL_SEASON_END_BONUS_STAR_BOOST	Seu bônus de estrela eleva você a	
GLOBAL_SEASON_END_BONUS_STAR_TITLE	Sua posição na última temporada concedeu a você	
GLOBAL_SEASON_END_BONUS_STARS_LABEL	|4(Estrela,Estrelas) Bônus	
GLOBAL_SEASON_END_CHEST_INSTRUCTIONS	Clique para abrir.	
GLOBAL_SEASON_END_CHEST_INSTRUCTIONS_TOUCH	Toque para abrir.	
GLOBAL_SEASON_END_NEW_CARD_BACK	Você ganhou um novo verso de card	
GLOBAL_SEASON_END_NEW_CARDBACK_TITLE	Verso de Card da nova Temporada!	
GLOBAL_SEASON_END_NEW_CARDBACK_TITLE_PHONE	Verso de Card da\nnova Temporada!	
GLOBAL_SEASON_END_NEW_SEASON	A {0} começou!	0=season name
GLOBAL_SEASON_END_PERCENTILE_LABEL	Isso põe você entre os primeiros {0}% do nosso ranque de jogadores!	0=rank percentile
GLOBAL_SEASON_END_RANK_LABEL	Você chegou ao ranque	
GLOBAL_SEASON_END_STAR_MULTIPLIER_LABEL	Bônus de estrela	
GLOBAL_SEASON_END_STAR_MULTIPLIER_TITLE	Seu desempenho no Ranqueado na última temporada lhe rendeu	
GLOBAL_SEASON_END_WELCOME	Bem-vindo	
GLOBAL_SET_BASIC	Conjunto Básico	
GLOBAL_SET_EXPERT1	Conjunto Clássico	
GLOBAL_SET_ROTATION_ROLLOVER_BODY_DESKTOP	Começa o novo ano de Hearthstone!\nReinicie o jogo para comemorar.	
GLOBAL_SET_ROTATION_ROLLOVER_BODY_MOBILE	Começa o novo ano de Hearthstone!\nReiniciando o jogo para comemorar.	
GLOBAL_SET_ROTATION_ROLLOVER_HEADER	Feliz ano novo!	
GLOBAL_SHOW	Mostrar	
GLOBAL_SHUTDOWN_TOAST	<color=#{0}>Os serviços da Blizzard serão desativados em {1} |4(minuto,minutos)</color>	0=color, 1=minutes
GLOBAL_SKIP	Pular	
GLOBAL_SKIP_TUTORIAL	Pular Tutorial	
GLOBAL_SOCIAL_ALERT_FRIEND_OFFLINE	{0} se desconectou.	0=Battletag
GLOBAL_SOCIAL_TOAST_FRIEND_ACHIEVEMENT	<color=#{0}>{1}</color> conquistou <color=#FFD451>{2}</color>	0=name color,1=player name,2=achievement name
GLOBAL_SOCIAL_TOAST_FRIEND_ACHIEVEMENT_TIER	<color=#{0}>{1}</color> conquistou <color=#FFD451>{2} (Grau {3})</color>	0=name color,1=player name,2=achievement name,3=tier
GLOBAL_SOCIAL_TOAST_FRIEND_ARENA_COMPLETE	<color=#{0}>{1}</color> acabou de encerrar uma aventura na Arena. ({2}-{3})	0=name color,1=player name,2=Arena Wins,3=Arena Losses
GLOBAL_SOCIAL_TOAST_FRIEND_ARENA_START	<color=#{0}>{1}</color> iniciou uma nova aventura na arena.	0=name color,1=player name
GLOBAL_SOCIAL_TOAST_FRIEND_ARENA_START_WITH_MANY_WINS	<color=#{0}>{1}</color> iniciou uma partida na Arena com {2} vitórias!	0=name color,1=player name,2=Arena Wins
GLOBAL_SOCIAL_TOAST_FRIEND_BRAWLISEUM_COMPLETE	<color=#{0}>{1}</color> acaba de terminar uma sessão no Coliseu da Contenda. ({2}-{3})	0=name color,1=player name,2=Brawl Wins,3=Brawl Losses
GLOBAL_SOCIAL_TOAST_FRIEND_BRAWLISEUM_START	<color=#{0}>{1}</color> iniciou uma nova sessão no Coliseu da Contenda.	0=name color,1=player name
GLOBAL_SOCIAL_TOAST_FRIEND_BRAWLISEUM_START_WITH_MANY_WINS	<color=#{0}>{1}</color> já tem {2} vitórias e iniciou um confronto no Coliseu da Contenda!	0=name color,1=player name,2=Brawl Wins
GLOBAL_SOCIAL_TOAST_FRIEND_DEATH_KNIGHT_LEVEL	<color=#{0}>{1}</color> tornou-se um Cavaleiro da Morte nível {2}.	0=name color,1=player name,2=level
GLOBAL_SOCIAL_TOAST_FRIEND_DEMON_HUNTER_LEVEL	<color=#{0}>{1}</color> tornou-se um Caçador de Demônios nível {2}.	0=name color,1=player name,2=level
GLOBAL_SOCIAL_TOAST_FRIEND_DRUID_LEVEL	<color=#{0}>{1}</color> tornou-se um Druida nível {2}.	0=name color,1=player name,2=level
GLOBAL_SOCIAL_TOAST_FRIEND_GOLDEN_LEGENDARY	<color=#{0}>{1}</color> abriu um <color=#{3}>{2} Dourado</color>!	0=name color,1=player name,2=card name,3=Golden Color
GLOBAL_SOCIAL_TOAST_FRIEND_HEROIC_BRAWL_COMPLETE	<color=#{0}>{1}</color> acaba de terminar uma contenda heroica. ({2}-{3})	0=name color,1=player name,2=Heroic brawl Wins,3=Heroic brawl Losses
GLOBAL_SOCIAL_TOAST_FRIEND_HEROIC_BRAWL_START	<color=#{0}>{1}</color> iniciou uma nova contenda heroica.	0=name color,1=player name
GLOBAL_SOCIAL_TOAST_FRIEND_HEROIC_BRAWL_START_WITH_MANY_WINS	<color=#{0}>{1}</color> iniciou uma partida de contenda heroica com {2} vitórias!	0=name color,1=player name,2=Heroic brawl Wins
GLOBAL_SOCIAL_TOAST_FRIEND_HUNTER_LEVEL	<color=#{0}>{1}</color> tornou-se um Caçador nível {2}.	0=name color,1=player name,2=level
GLOBAL_SOCIAL_TOAST_FRIEND_ILLIDAN_COMPLETE	<color=#{0}>{1}</color> derrotou Illidan Tempesfúria!	0=name color,1=player name
GLOBAL_SOCIAL_TOAST_FRIEND_LEGENDARY	<color=#{0}>{1}</color> abriu <color=#{3}>{2}</color>!	0=name color,1=player name,2=card name
GLOBAL_SOCIAL_TOAST_FRIEND_MAGE_LEVEL	<color=#{0}>{1}</color> tornou-se um Mago nível {2}.	0=name color,1=player name,2=level
GLOBAL_SOCIAL_TOAST_FRIEND_OFFLINE	<color=#{0}>{1}</color> se desconectou.	0=name color,1=player name
GLOBAL_SOCIAL_TOAST_FRIEND_ONLINE	<color=#{0}>{1}</color> se conectou.	0=name color,1=player name
GLOBAL_SOCIAL_TOAST_FRIEND_PALADIN_LEVEL	<color=#{0}>{1}</color> tornou-se um Paladino nível {2}.	0=name color,1=player name,2=level
GLOBAL_SOCIAL_TOAST_FRIEND_PRIEST_LEVEL	<color=#{0}>{1}</color> tornou-se um Sacerdote nível {2}.	0=name color,1=player name,2=level
GLOBAL_SOCIAL_TOAST_FRIEND_RANK_EARNED	<color=#{0}>{1}</color> acaba de alcançar {2}!	0=name color,1=player name,2=medal name
GLOBAL_SOCIAL_TOAST_FRIEND_RANK_EARNED_CLASSIC	<color=#{0}>{1}</color> acaba de alcançar {2} no Clássico!	0=name color,1=player name,2=medal name
GLOBAL_SOCIAL_TOAST_FRIEND_RANK_EARNED_WILD	<color=#{0}>{1}</color> acaba de alcançar {2} no Livre!	0=name color,1=player name,2=medal name
GLOBAL_SOCIAL_TOAST_FRIEND_RANK_LEGEND	<color=#{0}>{1}</color> conseguiu a posição de LENDA!	0=name color,1=player name
GLOBAL_SOCIAL_TOAST_FRIEND_RANK_LEGEND_CLASSIC	<color=#{0}>{1}</color> chegou ao ranque de LENDA no Clássico!	0=name color,1=player name
GLOBAL_SOCIAL_TOAST_FRIEND_RANK_LEGEND_WILD	<color=#{0}>{1}</color> conseguiu a posição de LENDA no modo Livre!	0=name color,1=player name
GLOBAL_SOCIAL_TOAST_FRIEND_REQUEST	<color=#{0}>{1}</color> enviou um pedido de amizade.	0=name color,1=player name
GLOBAL_SOCIAL_TOAST_FRIEND_ROGUE_LEVEL	<color=#{0}>{1}</color> tornou-se um Ladino nível {2}.	0=name color,1=player name,2=level
GLOBAL_SOCIAL_TOAST_FRIEND_SHAMAN_LEVEL	<color=#{0}>{1}</color> tornou-se um Xamã nível {2}.	0=name color,1=player name,2=level
GLOBAL_SOCIAL_TOAST_FRIEND_WARLOCK_LEVEL	<color=#{0}>{1}</color> tornou-se um Bruxo nível {2}.	0=name color,1=player name,2=level
GLOBAL_SOCIAL_TOAST_FRIEND_WARRIOR_LEVEL	<color=#{0}>{1}</color> tornou-se um Guerreiro nível {2}.	0=name color,1=player name,2=level
GLOBAL_SOCIAL_TOAST_RECENT_OPPONENT_FRIEND_REQUEST	Um oponente recente gostaria de ser seu amigo!	
GLOBAL_SOCIAL_TOAST_SPECTATOR_ADDED	<color=#{0}>{1}</color> começou a assistir.	0=name color,1=player name
GLOBAL_SOCIAL_TOAST_SPECTATOR_INVITE_RECEIVED	<color=#{0}>{1}</color> está te convidando para assistir ao jogo!	0=name color,1=player name
GLOBAL_SOCIAL_TOAST_SPECTATOR_INVITE_SENT	Convite de espectador enviado a <color=#{0}>{1}</color>.	0=name color,1=player name
GLOBAL_SOCIAL_TOAST_SPECTATOR_REMOVED	<color=#{0}>{1}</color> não está mais assistindo ao jogo.	0=name color,1=player name
GLOBAL_SPECTATE	Assistir	
GLOBAL_SPECTATOR_COUNT_PANEL_HEADER	Espectadores assistindo	
GLOBAL_SPECTATOR_COUNT_PANEL_TEXT_ONE	{0} está observando você.	0=player name, this is shown when there's only 1 person spectating you.
GLOBAL_SPECTATOR_ERROR_CANNOT_SPECTATE_2_GAMES	Não é possível observar dois jogos diferentes ao mesmo tempo.	
GLOBAL_SPECTATOR_ERROR_CREATE_PARTY_TEXT	Ocorreu um erro ao tentar criar um grupo de Espectadores.	
GLOBAL_SPECTATOR_ERROR_LEAVE_FOR_SPECTATE_PLAYER_TEXT	Ocorreu um erro ao tentar sair de um grupo anterior para observar {0}.	0=player name
GLOBAL_SPECTATOR_KICK_PROMPT_HEADER	Remover espectador	
GLOBAL_SPECTATOR_KICK_PROMPT_TEXT	Tem certeza de que deseja remover {0} do modo espectador? Ao desabilitar "Permitir que os amigos assistam aos meus jogos" no menu de opções, você impede que os outros o vejam jogar.	0=player name
GLOBAL_SPECTATOR_LEAVE_PROMPT_HEADER	Sair do modo Espectador	
GLOBAL_SPECTATOR_LEAVE_PROMPT_TEXT	Tem certeza de que deseja parar de assistir?	
GLOBAL_SPECTATOR_MODE_INDICATOR_TEXT	Modo Espectador	text that shows up on the bottom left of screen showing that you're currently in Spectator Mode.
GLOBAL_SPECTATOR_REMOVED_PROMPT_APPEAR_OFFLINE_TEXT	Aparecer offline remove você do Modo Espectador.	
GLOBAL_SPECTATOR_REMOVED_PROMPT_HEADER	Removido	
GLOBAL_SPECTATOR_REMOVED_PROMPT_TEXT	Você foi removido do modo espectador.	
GLOBAL_SPECTATOR_SERVER_REJECTED_HEADER	Espectador desconectado	
GLOBAL_SPECTATOR_SERVER_REJECTED_TEXT	O jogo ao qual você tentou assistir pode estar lotado, já terminou ou pode ter sido fechado para espectadores.	
GLOBAL_SPECTATOR_WAITING_FOR_NEXT_GAME_HEADER	Modo Espectador	
GLOBAL_SPECTATOR_WAITING_FOR_NEXT_GAME_TEXT	Esperando o próximo jogo.\n\n{0} está {1}	0=player name, 1=player's current activity -- will be filled in with values PRESENCE_STATUS_* and PRESENCE_SCENARIO_*_NORMAL_SCENARIO_* from PRESENCE.txt (e.g. "Jane Doe is Heading into Traditional Hearthstone")
GLOBAL_SPECTATOR_WAITING_FOR_NEXT_GAME_TEXT_BATTLING	Esperando o próximo jogo.\n\n{0} está enfrentando {1}	0=player name, 1=player's current activity -- will be filled in with values PRESENCE_SCENARIO_*_HEROIC_* from PRESENCE.txt (e.g. "Jane Doe is Battling Heroic Gothik the Harvester")
GLOBAL_SPECTATOR_WAITING_FOR_NEXT_GAME_TEXT_ENTERING	Esperando o próximo jogo.\n\n{0} está entrando em {1}	0=player name, 1=player's current activity -- will be filled in with values PRESENCE_ADVENTURE_MODE_* from PRESENCE.txt (e.g. "Jane Doe is entering Naxxramas")
GLOBAL_SPECTATOR_WAITING_FOR_NEXT_GAME_TEXT_OFFLINE	Esperando o próximo jogo.\n\n{0} está Desconectado.	0=player name; shown when player is offline.
GLOBAL_SPECTATOR_WAITING_FOR_NEXT_GAME_TEXT_ONLINE	Esperando a próxima partida.\n\n{0} está Online	0=player name; shown when there is no current activity string available.
GLOBAL_SPECTATOR_WAITING_FOR_NEXT_GAME_TEXT_PLAYING	Esperando o próximo jogo.\n\n{0} está jogando {1}	0=player name, 1=player's current activity -- will be filled in with values PRESENCE_SCENARIO_*_CLASS_CHALLENGE_* from PRESENCE.txt (e.g. "Jane Doe is playing Naxxramas Paladin Challenge")
GLOBAL_SPECTATOR_WAITING_FOR_NEXT_GAME_TIMEOUT	O jogador que você está observando demorou muito para começar o jogo seguinte. O Modo Espectador foi cancelado.	
GLOBAL_SPELL_SCHOOL_ARCANE	Arcano	
GLOBAL_SPELL_SCHOOL_FEL	Vil	
GLOBAL_SPELL_SCHOOL_FIRE	Fogo	
GLOBAL_SPELL_SCHOOL_FROST	Gelo	
GLOBAL_SPELL_SCHOOL_GREATER_TRINKET	Superior	
GLOBAL_SPELL_SCHOOL_HOLY	Sagrado	
GLOBAL_SPELL_SCHOOL_LESSER_TRINKET	Inferior	
GLOBAL_SPELL_SCHOOL_NATURE	Natureza	
GLOBAL_SPELL_SCHOOL_PHYSICAL_COMBAT	Ataque	
GLOBAL_SPELL_SCHOOL_SHADOW	Sombra	
GLOBAL_SPELL_SCHOOL_SPELLCRAFT	Feitiçaria	
GLOBAL_SPELL_SCHOOL_TAVERN	Taverna	
GLOBAL_SPELL_SCHOOL_UPGRADE	Aprimorar	
GLOBAL_SPLASH_CLOSED_RECONNECTING	Reconectando...	
GLOBAL_SPLASH_CLOSED_SIGN_TITLE	Fechado	
GLOBAL_STANDARD	Padrão	
GLOBAL_STORE_MOBILE_NAME_AMAZON	na Amazon Appstore	
GLOBAL_STORE_MOBILE_NAME_APPLE	na Apple App Store	
GLOBAL_STORE_MOBILE_NAME_DEFAULT	na loja da Blizzard	
GLOBAL_STORE_MOBILE_NAME_GOOGLE	no Google Play	
GLOBAL_SUPPORT	Suporte	
GLOBAL_SWITCH_ACCOUNT	Trocar de conta	
GLOBAL_TAVERN_BRAWL	Taverna	
GLOBAL_TAVERN_BRAWL_ERROR_NOT_ACTIVE	Desculpe. Esta Contenda de Taverna não está ativa no momento. Espere alguns minutos e tente novamente.	
GLOBAL_TAVERN_BRAWL_ERROR_SEASON_INCREMENTED	Desculpe. Este evento de Contenda de Taverna terminou. Em breve, outro terá início!	
GLOBAL_TOOLTIP_FRIEND_BUTTON_DESC	Converse com seus amigos e desafie-os.	
GLOBAL_TOOLTIP_FRIEND_BUTTON_HEADER	Amigos	
GLOBAL_TOOLTIP_MENU_DESC	Dê uma olhada nas Opções, Saia do jogo e mais.	
GLOBAL_TOOLTIP_MENU_HEADER	Menu do Jogo	
GLOBAL_TOOLTIP_MENU_OFFLINE_DESC	Você está desconectado. Clique aqui para reconectar.	
GLOBAL_TOOLTIP_MENU_OFFLINE_HEADER	Desconectado	
GLOBAL_TOOLTIP_MODE_CASUAL	Aproveite qualquer modo de jogo, com qualquer deck, sem afetar seu ranque.	
GLOBAL_TOOLTIP_MODE_STANDARD	Desafie jogadores de habilidades similares para uma partida.	
GLOBAL_TOOLTIP_MODE_TWIST	Jogue Hearthstone com um conjunto de regras rotativo a cada temporada.	
GLOBAL_TOOLTIP_MODE_TWIST_SEASON_DISABLED	Jogue Hearthstone com um conjunto de regras rotativo a cada temporada. Esse modo de jogo ficará bloqueado até a próxima temporada começar.	
GLOBAL_TOOLTIP_MODE_WILD	Enfrente oponentes com cards de qualquer conjunto.	
GLOBAL_TUTORIAL_ATTACK	Ataque	
GLOBAL_TUTORIAL_ATTACKER	Atacante	
GLOBAL_TUTORIAL_COST	Custo	
GLOBAL_TUTORIAL_DEFENDER	Defensor	
GLOBAL_TUTORIAL_HEALTH	Vida	
GLOBAL_TUTORIAL_HERO_POWER	Poder Heroico	
GLOBAL_TUTORIAL_MINION	Lacaio	
GLOBAL_TUTORIAL_REPLAY_HEADER	Regras de Hearthstone	
GLOBAL_TUTORIAL_TAUNT	Provocar	
GLOBAL_TUTORIAL_TAUNT_DESCRIPTION	Os inimigos precisam atacar este lacaio	
GLOBAL_TUTORIAL_USED	Usado	
GLOBAL_TUTORIAL_YOUR_MANA	Seu mana	
GLOBAL_TUTORIAL_YOUR_TURN	Seu turno	
GLOBAL_TWIST	Imprevisível	
GLOBAL_TWIST_LOCKED	Imprevisível (Bloqueado)	
GLOBAL_TWIST_LOCKED_DESC	Esse modo de jogo ficará bloqueado até a próxima temporada começar em\n{0}.	
GLOBAL_TWIST_SEASON_DESCRIPTION_116	Confira o novo formato Imprevisível; monte um deck usando apenas cards de classe desde Cinzas de Terralém!	
GLOBAL_TWIST_SEASON_DESCRIPTION_117	Confira o novo formato Imprevisível; monte um deck usando apenas cards de classe desde Cinzas de Terralém!	
GLOBAL_TWIST_SEASON_DESCRIPTION_119	Entre nas Cavernas do Tempo e monte um deck usando todas as expansões de Legacy até Gangues de Geringontzan.	
GLOBAL_TWIST_SEASON_DESCRIPTION_120	Desta vez, monte um deck de 30 a 40  cards de Legado até Gangues de Geringontzan, mais Cavernas do Tempo. Todos os jogadores começam com Vida igual ao tamanho do deck que estão usando!	
GLOBAL_TWIST_SEASON_DESCRIPTION_121	Viaje até o passado ancestral da era dos dinossauros! Un'Goro voltou com atualizações e se juntou aos outros conjuntos no formato Maravilhas.	
GLOBAL_TWIST_SEASON_DESCRIPTION_124	Não tem Lendários? Relaxa! Forme o melhor deck que puder usando apenas cards comuns de todas as expansões até o Ano do Dragão e Essencial.	
GLOBAL_TWIST_SEASON_DESCRIPTION_125	Jogue esses últimos dez anos de Hearthstone! Começando com o Legado, vamos adicionar um conjunto novo todo dia até chegarmos ao Confronto Final nos Ermos.	
GLOBAL_TWIST_SEASON_DESCRIPTION_128	Entre na ação com um dos Heróis do Rojão, incluindo decks multiclasse pré-construídos, novos Poderes Heroicos e habilidades passivas.	
GLOBAL_TWIST_SEASON_DESCRIPTION_129	Entre na ação com um dos Heróis do Rojão, incluindo decks multiclasse pré-construídos, novos Poderes Heroicos e habilidades passivas.	
GLOBAL_TWIST_SEASON_TITLE_116	Nova Era	
GLOBAL_TWIST_SEASON_TITLE_117	Nova Era	
GLOBAL_TWIST_SEASON_TITLE_119	Maravilhas	
GLOBAL_TWIST_SEASON_TITLE_120	Maravilhas XL	
GLOBAL_TWIST_SEASON_TITLE_121	Retorno a Un'Goro	
GLOBAL_TWIST_SEASON_TITLE_124	Comuns	
GLOBAL_TWIST_SEASON_TITLE_125	Avanço rápido	
GLOBAL_TWIST_SEASON_TITLE_128	Heróis do Rojão	
GLOBAL_TWIST_SEASON_TITLE_129	Heróis do Rojão	
GLOBAL_UNINSTALL_MODULE_POPUP_PROMPT	Desinstalar {0}?	{0}=Module name to uninstall (e.g. Battlegrounds)
GLOBAL_UPDATE	Atualizar	
GLOBAL_VERSION	Versão	
GLOBAL_WAIT_FOR_OPPONENT_RECONNECT	Esperando o oponente se reconectar... ({0}min{1}s)\nVocê pode abrir o menu de opções para terminar a partida.	
GLOBAL_WAIT_FOR_OPPONENT_RECONNECT_HEADER	Confronto pausado	
GLOBAL_WAIT_FOR_OPPONENT_RECONNECT_SPECTATOR	Esperando jogador se reconectar... ({0}min{1}s)	
GLOBAL_WARNING_GENERIC_HEADER	Alerta	
GLOBAL_WILD	Livre	
GLOBAL_WINS	Vitórias	
