TAG	TEXT	COMMENT
GAMEPLAY_EMOTE_EX1_323h_CONCEDE	네가 이겼다... 하지만 네 세계는 여전히 파멸하리라!	
GAMEPLAY_EMOTE_EX1_323h_ERROR_FULL_MINIONS	하수인이 너무 많아!	
GAMEPLAY_EMOTE_EX1_323h_ERROR_GENERIC	그럴 수 없어!	
GAMEPLAY_EMOTE_EX1_323h_ERROR_HAND_FULL	카드가 너무 많아!	
GAMEPLAY_EMOTE_EX1_323h_ERROR_I_ATTACKED	난 이미 공격했다!	
GAMEPLAY_EMOTE_EX1_323h_ERROR_JUST_PLAYED	방금 나왔잖아!	
GAMEPLAY_EMOTE_EX1_323h_ERROR_MINION_ATTACKED	그 녀석은 이미 공격했다!	
GAMEPLAY_EMOTE_EX1_323h_ERROR_NEED_MANA	마나가 없다!	
GAMEPLAY_EMOTE_EX1_323h_ERROR_NEED_WEAPON	내 무기가 어디갔지?!	
GAMEPLAY_EMOTE_EX1_323h_ERROR_PLAY	그건 낼 수 없어!	
GAMEPLAY_EMOTE_EX1_323h_ERROR_STEALTH	은신 중이잖아!	
GAMEPLAY_EMOTE_EX1_323h_ERROR_TARGET	유효한 대상이 아니야!	
GAMEPLAY_EMOTE_EX1_323h_ERROR_TAUNT	저 하수인의 도발 능력이 짜증나게 하잖아!	
GAMEPLAY_EMOTE_EX1_323h_FIRE_FESTIVAL	지옥불을 지펴라!	
GAMEPLAY_EMOTE_EX1_323h_GOOD_GAME	멋진 승부였다!	
GAMEPLAY_EMOTE_EX1_323h_GREETINGS	불타는 군단의 에레다르 군주, 자락서스 님이 상대해 주마!	
GAMEPLAY_EMOTE_EX1_323h_HALLOWS_END	할로윈 축제가 시작됐다!	
GAMEPLAY_EMOTE_EX1_323h_LOW_CARDS	이런! 덱에 카드가 거의 없다!	
GAMEPLAY_EMOTE_EX1_323h_LUNAR_NEW_YEAR	흥, 설날 따위 즐겁게 보내버려라!	
GAMEPLAY_EMOTE_EX1_323h_NO_CARDS	안 돼! 카드가 다 떨어졌다!	
GAMEPLAY_EMOTE_EX1_323h_NOBLEGARDEN	즐거운 귀족의 정원 축제다!	
GAMEPLAY_EMOTE_EX1_323h_OOPS	실수군!	
GAMEPLAY_EMOTE_EX1_323h_PIRATE_DAY	나는 자락서스다!	
GAMEPLAY_EMOTE_EX1_323h_SORRY	자락서스는... 미안하다.	
GAMEPLAY_EMOTE_EX1_323h_THANKS	고맙군.	
GAMEPLAY_EMOTE_EX1_323h_THINK1	흠...	
GAMEPLAY_EMOTE_EX1_323h_THINK2	그렇다면...	
GAMEPLAY_EMOTE_EX1_323h_THINK3	어떻게 끝장을 낼까...	
GAMEPLAY_EMOTE_EX1_323h_THREATEN	뼈에서 살을!	
GAMEPLAY_EMOTE_EX1_323h_TIMER	시간이 없다!	
GAMEPLAY_EMOTE_EX1_323h_WELL_PLAYED	제법 하는군.	
GAMEPLAY_EMOTE_EX1_323h_WINTERVEIL_GREETINGS	이번 겨울맞이 축제 때 네 영혼을 먹어치우리라!	
GAMEPLAY_EMOTE_EX1_323h_WOW_04	믿을 수 없다!	
GAMEPLAY_EMOTE_HERO_01_CONCEDE	난 죽음을 택하겠다!	
GAMEPLAY_EMOTE_HERO_01_ERROR_FULL_MINIONS	하수인이 너무 많아.	
GAMEPLAY_EMOTE_HERO_01_ERROR_GENERIC	그렇겐 못해.	
GAMEPLAY_EMOTE_HERO_01_ERROR_HAND_FULL	카드가 너무 많아!	
GAMEPLAY_EMOTE_HERO_01_ERROR_I_ATTACKED	난 이미 공격했다.	
GAMEPLAY_EMOTE_HERO_01_ERROR_JUST_PLAYED	그 하수인은 다음 턴에 준비될 거다.	
GAMEPLAY_EMOTE_HERO_01_ERROR_MINION_ATTACKED	그 하수인은 이미 공격했다.	
GAMEPLAY_EMOTE_HERO_01_ERROR_NEED_MANA	마나가 부족하군.	
GAMEPLAY_EMOTE_HERO_01_ERROR_NEED_WEAPON	무기가 필요하다.	
GAMEPLAY_EMOTE_HERO_01_ERROR_PLAY	그 카드는 낼 수 없다.	
GAMEPLAY_EMOTE_HERO_01_ERROR_STEALTH	은신 중인 하수인은 선택할 수 없다.	
GAMEPLAY_EMOTE_HERO_01_ERROR_TARGET	선택할 수 없는 대상이다.	
GAMEPLAY_EMOTE_HERO_01_ERROR_TAUNT	도발 능력이 있는 하수인이 가로막고 있다!	
GAMEPLAY_EMOTE_HERO_01_EVENT_FIRE_FESTIVAL	횃불을 들어라!	
GAMEPLAY_EMOTE_HERO_01_EVENT_LUNAR_NEW_YEAR	새해 복 많이 받아라.	
GAMEPLAY_EMOTE_HERO_01_GOOD_GAME	재미있었다!	
GAMEPLAY_EMOTE_HERO_01_GREETINGS	하, 잘 만났군...	
GAMEPLAY_EMOTE_HERO_01_GREETINGS_RESPONSE	흠. 반갑다.	
GAMEPLAY_EMOTE_HERO_01_HALLOWS_END	즐거운 할로윈 축제구나.	
GAMEPLAY_EMOTE_HERO_01_LOW_CARDS	카드가 거의 없어!	
GAMEPLAY_EMOTE_HERO_01_MIRROR_START	하! 그래, 덤벼봐라!	
GAMEPLAY_EMOTE_HERO_01_NO_CARDS	카드가 없다!	
GAMEPLAY_EMOTE_HERO_01_NOBLEGARDEN	즐거운 귀족의 정원 축제로군.	
GAMEPLAY_EMOTE_HERO_01_OOPS	실수였군.	
GAMEPLAY_EMOTE_HERO_01_PIRATE_DAY	야리 하리 하리 하!	
GAMEPLAY_EMOTE_HERO_01_SORRY	이거 참 미안하군.	
GAMEPLAY_EMOTE_HERO_01_START	승리가 아니면 죽음을!	
GAMEPLAY_EMOTE_HERO_01_THANKS	흐음, 고맙다.	
GAMEPLAY_EMOTE_HERO_01_THINK1	흐음...	
GAMEPLAY_EMOTE_HERO_01_THINK2	음, 글쎄...	
GAMEPLAY_EMOTE_HERO_01_THINK3	이젠 뭘 할까...	
GAMEPLAY_EMOTE_HERO_01_THREATEN	널 박살내 주마!	
GAMEPLAY_EMOTE_HERO_01_TIMER	으! 선택해야 한다!	
GAMEPLAY_EMOTE_HERO_01_WELL_PLAYED	아주 잘했다.	
GAMEPLAY_EMOTE_HERO_01_WINTERVEIL_GREETINGS	겨울맞이 축제를 즐겨라!	
GAMEPLAY_EMOTE_HERO_01_WOW	놀랍군!	
GAMEPLAY_EMOTE_HERO_01A_CELEBRATE	만세!	
GAMEPLAY_EMOTE_HERO_01A_CONCEDE	아, 그대가 이겼네!	
GAMEPLAY_EMOTE_HERO_01A_ERROR_FULL_MINIONS	하수인이 너무 많네.	
GAMEPLAY_EMOTE_HERO_01A_ERROR_GENERIC	그건 할 수 없네.	
GAMEPLAY_EMOTE_HERO_01A_ERROR_HAND_FULL	어허, 카드가 너무 많군!	
GAMEPLAY_EMOTE_HERO_01A_ERROR_I_ATTACKED	난 이미 공격했다네.	
GAMEPLAY_EMOTE_HERO_01A_ERROR_JUST_PLAYED	그 하수인은 다음 턴에 준비될 걸세.	
GAMEPLAY_EMOTE_HERO_01A_ERROR_MINION_ATTACKED	그 하수인은 이미 공격했네.	
GAMEPLAY_EMOTE_HERO_01A_ERROR_NEED_MANA	마나가 부족하군.	
GAMEPLAY_EMOTE_HERO_01A_ERROR_NEED_WEAPON	무기가 필요하다네.	
GAMEPLAY_EMOTE_HERO_01A_ERROR_PLAY	그 카드는 낼 수 없네.	
GAMEPLAY_EMOTE_HERO_01A_ERROR_STEALTH	은신한 하수인은 선택할 수 없어.	
GAMEPLAY_EMOTE_HERO_01A_ERROR_TARGET	선택할 수 없는 대상이야.	
GAMEPLAY_EMOTE_HERO_01A_ERROR_TAUNT	도발 능력이 있는 하수인을 공격해야 하네.	
GAMEPLAY_EMOTE_HERO_01A_EVENT_LUNAR_NEW_YEAR	새해 복 많이 받으라고!	
GAMEPLAY_EMOTE_HERO_01A_FIRE_FESTIVAL	즐거운 한여름 불꽃축제 보내게나!	
GAMEPLAY_EMOTE_HERO_01A_GOOD_GAME	멋진 승부였네!	
GAMEPLAY_EMOTE_HERO_01A_GREETINGS	안녕하신가!	
GAMEPLAY_EMOTE_HERO_01A_GREETINGS_RESPONSE	이게 누구신가!	
GAMEPLAY_EMOTE_HERO_01A_HALLOWS_END	할로윈 축제는 즐기고 있나, 친구?!	
GAMEPLAY_EMOTE_HERO_01A_LOW_CARDS	카드가 거의 없네!	
GAMEPLAY_EMOTE_HERO_01A_MIRROR_START	그래, 카즈 모단을 위하여!	
GAMEPLAY_EMOTE_HERO_01A_NO_CARDS	이런, 카드가 없지 않나!	
GAMEPLAY_EMOTE_HERO_01A_NOBLEGARDEN	즐거운 귀족의 정원 축제가 되길!	
GAMEPLAY_EMOTE_HERO_01A_OOPS	어이쿠... 저런...	
GAMEPLAY_EMOTE_HERO_01A_PIRATE_DAY	이야! 내가 바다의 왕이다!	
GAMEPLAY_EMOTE_HERO_01A_SORRY	미안하네, 친구.	
GAMEPLAY_EMOTE_HERO_01A_START	카즈 모단을 위하여!	
GAMEPLAY_EMOTE_HERO_01A_THANKS	오호! 고맙네!	
GAMEPLAY_EMOTE_HERO_01A_THINK1	흐음...	
GAMEPLAY_EMOTE_HERO_01A_THINK2	이걸로? 아니, 아냐...	
GAMEPLAY_EMOTE_HERO_01A_THINK3	할 게 너무 많잖아...	
GAMEPLAY_EMOTE_HERO_01A_THREATEN	산의 분노를 느껴 보게나!	
GAMEPLAY_EMOTE_HERO_01A_TIMER	이런! 뭐든 해야겠군!	
GAMEPLAY_EMOTE_HERO_01A_WELL_PLAYED	잘했네.	
GAMEPLAY_EMOTE_HERO_01A_WINTERVEIL_GREETINGS	즐거운 겨울맞이 축제 보내게나!	
GAMEPLAY_EMOTE_HERO_01A_WOW	아이쿠, 수염 떨어질 뻔했네!	
GAMEPLAY_EMOTE_HERO_02_CONCEDE	이번엔 자네가 이겼군, 친구.	
GAMEPLAY_EMOTE_HERO_02_ERROR_FULL_MINIONS	하수인이 너무 많네.	
GAMEPLAY_EMOTE_HERO_02_ERROR_GENERIC	그렇게는 할 수 없네.	
GAMEPLAY_EMOTE_HERO_02_ERROR_HAND_FULL	카드가 너무 많네!	
GAMEPLAY_EMOTE_HERO_02_ERROR_I_ATTACKED	나는 이미 공격했네.	
GAMEPLAY_EMOTE_HERO_02_ERROR_JUST_PLAYED	그 하수인은 다음 턴에 준비될 걸세.	
GAMEPLAY_EMOTE_HERO_02_ERROR_MINION_ATTACKED	그 하수인은 이미 공격했네.	
GAMEPLAY_EMOTE_HERO_02_ERROR_NEED_MANA	마나가 부족하네.	
GAMEPLAY_EMOTE_HERO_02_ERROR_NEED_WEAPON	무기가 필요하네.	
GAMEPLAY_EMOTE_HERO_02_ERROR_PLAY	그 카드는 낼 수 없네.	
GAMEPLAY_EMOTE_HERO_02_ERROR_STEALTH	은신 중인 하수인은 선택할 수 없네.	
GAMEPLAY_EMOTE_HERO_02_ERROR_TARGET	선택할 수 없는 대상이네.	
GAMEPLAY_EMOTE_HERO_02_ERROR_TAUNT	도발 능력이 있는 하수인이 가로막고 있네!	
GAMEPLAY_EMOTE_HERO_02_EVENT_FIRE_FESTIVAL	정령들을 위한 축제로군!	
GAMEPLAY_EMOTE_HERO_02_EVENT_LUNAR_NEW_YEAR	새해 복 많이 받게, 친구여.	
GAMEPLAY_EMOTE_HERO_02_GOOD_GAME	좋은 승부였네!	
GAMEPLAY_EMOTE_HERO_02_GREETINGS	반갑네, 친구!	
GAMEPLAY_EMOTE_HERO_02_GREETINGS_RESPONSE	만나서 반갑네!	
GAMEPLAY_EMOTE_HERO_02_HALLOWS_END	즐거운 할로윈 축제로군.	
GAMEPLAY_EMOTE_HERO_02_LOW_CARDS	카드가 거의 없네!	
GAMEPLAY_EMOTE_HERO_02_MIRROR_START	서리늑대 부족을 위하여!	
GAMEPLAY_EMOTE_HERO_02_NO_CARDS	카드가 없어!	
GAMEPLAY_EMOTE_HERO_02_NOBLEGARDEN	즐거운 귀족의 정원 축제 보내게.	
GAMEPLAY_EMOTE_HERO_02_OOPS	실수였네.	
GAMEPLAY_EMOTE_HERO_02_PIRATE_DAY	오늘은 해적의 날이라네!	
GAMEPLAY_EMOTE_HERO_02_SORRY	안타깝군.	
GAMEPLAY_EMOTE_HERO_02_START	둠해머를 위하여!	
GAMEPLAY_EMOTE_HERO_02_THANKS	고맙네.	
GAMEPLAY_EMOTE_HERO_02_THINK1	흠...	
GAMEPLAY_EMOTE_HERO_02_THINK2	이건 어떨까...	
GAMEPLAY_EMOTE_HERO_02_THINK3	흠... 어떻게 할까...	
GAMEPLAY_EMOTE_HERO_02_THREATEN	정령들이 자네를 파괴할 걸세!	
GAMEPLAY_EMOTE_HERO_02_TIMER	시간이 없네!	
GAMEPLAY_EMOTE_HERO_02_WELL_PLAYED	잘했네.	
GAMEPLAY_EMOTE_HERO_02_WINTERVEIL_GREETINGS	즐거운 겨울맞이 축제 보내게나.	
GAMEPLAY_EMOTE_HERO_02_WOW	정말 놀랍군!	
GAMEPLAY_EMOTE_HERO_02A_CELEBRATE	<뜻깊은 날이다옳!>	
GAMEPLAY_EMOTE_HERO_02A_CONCEDE	<내가 졌다옳.>	
GAMEPLAY_EMOTE_HERO_02A_ERROR_FULL_MINIONS	<하수인이\n너무 많다옳.>	
GAMEPLAY_EMOTE_HERO_02A_ERROR_GENERIC	<그건 할 수\n없다옳.>	
GAMEPLAY_EMOTE_HERO_02A_ERROR_HAND_FULL	<카드가 너무\n많다옳.>	
GAMEPLAY_EMOTE_HERO_02A_ERROR_I_ATTACKED	<난 이미\n공격했다옳.>	VO_HERO_15_ERROR04_43.wav
GAMEPLAY_EMOTE_HERO_02A_ERROR_JUST_PLAYED	<그 하수인은 다음\n턴에 준비된다옳.>	
GAMEPLAY_EMOTE_HERO_02A_ERROR_MINION_ATTACKED	<그 하수인은 이미\n공격했다옳.>	
GAMEPLAY_EMOTE_HERO_02A_ERROR_NEED_MANA	<마나가\n부족하다옳.>	
GAMEPLAY_EMOTE_HERO_02A_ERROR_NEED_WEAPON	<무기가\n필요하다옳.>	
GAMEPLAY_EMOTE_HERO_02A_ERROR_PLAY	<그 카드는 낼\n수 없다옳.>	
GAMEPLAY_EMOTE_HERO_02A_ERROR_STEALTH	<은신한 하수인은\n선택할 수\n없다옳!>	
GAMEPLAY_EMOTE_HERO_02A_ERROR_TARGET	<선택할 수 없는\n대상이다옳.>	
GAMEPLAY_EMOTE_HERO_02A_ERROR_TAUNT	<도발 능력이 있는\n하수인이\n가로막고 있다옳.>	
GAMEPLAY_EMOTE_HERO_02A_EVENT_LUNAR_NEW_YEAR	<새해에도\n번창해라옳!>	
GAMEPLAY_EMOTE_HERO_02A_FIRE_FESTIVAL	<내 고향에는\n불꽃축제라는 게\n없다옳.>	
GAMEPLAY_EMOTE_HERO_02A_GREETINGS	<만나서 반갑다옳.>	
GAMEPLAY_EMOTE_HERO_02A_GREETINGS_RESPONSE	<나도 반갑다옳.>	
GAMEPLAY_EMOTE_HERO_02A_HALLOWS_END	<으스스한 할로윈\n축제 보내라옳.>	
GAMEPLAY_EMOTE_HERO_02A_LOW_CARDS	<카드가 거의\n없다옳!>	
GAMEPLAY_EMOTE_HERO_02A_MIRROR_START	<젊은이!? 너야말로\n아직 멀었다옳.>	
GAMEPLAY_EMOTE_HERO_02A_NO_CARDS	<카드가 없다옳!>	
GAMEPLAY_EMOTE_HERO_02A_NOBLEGARDEN	<즐거운 귀족의 정원\n축제다옳!>	
GAMEPLAY_EMOTE_HERO_02A_OOPS	<에구머니나옳!>	
GAMEPLAY_EMOTE_HERO_02A_PIRATE_DAY	<해적이라고!?\n우리가 여기\n먼저 왔다옳!>	
GAMEPLAY_EMOTE_HERO_02A_SORRY	<사과하겠다옳.>	
GAMEPLAY_EMOTE_HERO_02A_START	<젊은이, 내가 한 수\n가르쳐 주겠다옳!>	
GAMEPLAY_EMOTE_HERO_02A_THANKS	<정말 고맙다옳.>	
GAMEPLAY_EMOTE_HERO_02A_THINK1	<이렇게 할까옳...>	VO_HERO_15_Thinking1_13.wav
GAMEPLAY_EMOTE_HERO_02A_THINK2	<흥미로운\n생각이다옳...>	
GAMEPLAY_EMOTE_HERO_02A_THINK3	<가능성은 있다옳...>	
GAMEPLAY_EMOTE_HERO_02A_THREATEN	<바다의 지혜를\n느껴봐라옳!>	
GAMEPLAY_EMOTE_HERO_02A_TIMER	<빨리! 시간이\n없다옳!>	
GAMEPLAY_EMOTE_HERO_02A_WELL_PLAYED	<잘했다옳.>	
GAMEPLAY_EMOTE_HERO_02A_WINTERVEIL_GREETINGS	<즐거운 겨울맞이\n축제 보내라옳!>	
GAMEPLAY_EMOTE_HERO_02A_WOW	<상상도 못했다옳!>	
GAMEPLAY_EMOTE_HERO_03_CONCEDE	포기하겠어.	
GAMEPLAY_EMOTE_HERO_03_ERROR_FULL_MINIONS	하수인이 너무 많아.	
GAMEPLAY_EMOTE_HERO_03_ERROR_GENERIC	그렇게는 못해.	
GAMEPLAY_EMOTE_HERO_03_ERROR_HAND_FULL	카드가 너무 많아!	
GAMEPLAY_EMOTE_HERO_03_ERROR_I_ATTACKED	난 이미 공격했어.	
GAMEPLAY_EMOTE_HERO_03_ERROR_JUST_PLAYED	그 하수인은 다음 턴에 준비될 거야.	
GAMEPLAY_EMOTE_HERO_03_ERROR_MINION_ATTACKED	그 하수인은 이미 공격했어.	
GAMEPLAY_EMOTE_HERO_03_ERROR_NEED_MANA	마나가 부족해.	
GAMEPLAY_EMOTE_HERO_03_ERROR_NEED_WEAPON	무기가 필요한데.	
GAMEPLAY_EMOTE_HERO_03_ERROR_PLAY	그 카드는 사용할 수 없는데.	
GAMEPLAY_EMOTE_HERO_03_ERROR_STEALTH	은신 중인 하수인은 선택할 수 없어.	
GAMEPLAY_EMOTE_HERO_03_ERROR_TARGET	선택할 수 있는 대상이 아니야.	
GAMEPLAY_EMOTE_HERO_03_ERROR_TAUNT	도발 능력이 있는 하수인이 가로막고 있어!	
GAMEPLAY_EMOTE_HERO_03_EVENT_LUNAR_NEW_YEAR	새해에도 잘 부탁해.	
GAMEPLAY_EMOTE_HERO_03_FIRE_FESTIVAL	즐거운 한여름 축제네!	
GAMEPLAY_EMOTE_HERO_03_GOOD_GAME	좋은 승부였어!	
GAMEPLAY_EMOTE_HERO_03_GREETINGS	잘 부탁해.	
GAMEPLAY_EMOTE_HERO_03_GREETINGS_RESPONSE	나야말로.	
GAMEPLAY_EMOTE_HERO_03_HALLOWS_END	즐거운 할로윈 축제네.	
GAMEPLAY_EMOTE_HERO_03_LOW_CARDS	카드가 거의 없어!	
GAMEPLAY_EMOTE_HERO_03_MIRROR_START	남 걱정할 때가 아닐텐데?	
GAMEPLAY_EMOTE_HERO_03_NO_CARDS	카드가 없어!	
GAMEPLAY_EMOTE_HERO_03_NOBLEGARDEN	즐거운 귀족의 정원 축제 보내.	
GAMEPLAY_EMOTE_HERO_03_OOPS	때로는 실수도 하는 법...	
GAMEPLAY_EMOTE_HERO_03_PIRATE_DAY	야르!	
GAMEPLAY_EMOTE_HERO_03_SORRY	방금 건 미안하군.	
GAMEPLAY_EMOTE_HERO_03_START	등... 뒤를... 조심해...	
GAMEPLAY_EMOTE_HERO_03_THANKS	고마워.	
GAMEPLAY_EMOTE_HERO_03_THINK1	흠...	
GAMEPLAY_EMOTE_HERO_03_THINK2	이건 어떨까...	
GAMEPLAY_EMOTE_HERO_03_THINK3	선택지가 정말 많아...	
GAMEPLAY_EMOTE_HERO_03_THREATEN	숨통을 끊어주지!	
GAMEPLAY_EMOTE_HERO_03_TIMER	빨리 선택해야 해.	
GAMEPLAY_EMOTE_HERO_03_WELL_PLAYED	제법인데?	
GAMEPLAY_EMOTE_HERO_03_WINTERVEIL_GREETINGS	겨울맞이 축제, 재밌게 보내!	
GAMEPLAY_EMOTE_HERO_03_WOW	놀라워!	
GAMEPLAY_EMOTE_HERO_04_CONCEDE	승리는 자네 것일세.	
GAMEPLAY_EMOTE_HERO_04_ERROR_FULL_MINIONS	하수인이 너무 많아.	
GAMEPLAY_EMOTE_HERO_04_ERROR_GENERIC	그렇겐 할 수 없네.	
GAMEPLAY_EMOTE_HERO_04_ERROR_HAND_FULL	카드가 너무 많아!	
GAMEPLAY_EMOTE_HERO_04_ERROR_I_ATTACKED	난 이미 공격했네.	
GAMEPLAY_EMOTE_HERO_04_ERROR_JUST_PLAYED	그 하수인은 다음 턴에 준비될 거야.	
GAMEPLAY_EMOTE_HERO_04_ERROR_MINION_ATTACKED	그 하수인은 이미 공격했네.	
GAMEPLAY_EMOTE_HERO_04_ERROR_NEED_MANA	마나가 부족하군.	
GAMEPLAY_EMOTE_HERO_04_ERROR_NEED_WEAPON	무기가 필요해.	
GAMEPLAY_EMOTE_HERO_04_ERROR_PLAY	그 카드는 낼 수 없다네.	
GAMEPLAY_EMOTE_HERO_04_ERROR_STEALTH	은신 중인 하수인은 선택할 수 없네.	
GAMEPLAY_EMOTE_HERO_04_ERROR_TARGET	선택할 수 없는 대상이야.	
GAMEPLAY_EMOTE_HERO_04_ERROR_TAUNT	도발 능력이 있는 하수인이 가로막고 있다네!	
GAMEPLAY_EMOTE_HERO_04_EVENT_LUNAR_NEW_YEAR	용사여, 즐거운 새해가 되길.	
GAMEPLAY_EMOTE_HERO_04_FIRE_FESTIVAL	불꽃이 가득한 한여름 축제가 되길!	
GAMEPLAY_EMOTE_HERO_04_GOOD_GAME	멋진 승부였네!	
GAMEPLAY_EMOTE_HERO_04_GREETINGS	반갑네.	
GAMEPLAY_EMOTE_HERO_04_GREETINGS_RESPONSE	아, 나도 반갑네.	
GAMEPLAY_EMOTE_HERO_04_HALLOWS_END	즐거운 할로윈 축제 보내게, 용사여!	VO_HERO_04_HAPPY_HALLOWEEN_13.wav
GAMEPLAY_EMOTE_HERO_04_LOW_CARDS	카드가 거의 없어!	
GAMEPLAY_EMOTE_HERO_04_MIRROR_START	빛의 힘을 보여주겠네.	
GAMEPLAY_EMOTE_HERO_04_NO_CARDS	카드가 없어!	
GAMEPLAY_EMOTE_HERO_04_NOBLEGARDEN	귀족의 정원 축제를 즐기게나.	VO_HERO_04_HAPPY_NOBLEGARDEN_17.wav
GAMEPLAY_EMOTE_HERO_04_OOPS	실수였네.	
GAMEPLAY_EMOTE_HERO_04_PIRATE_DAY	어기여차! 닻을 올려라!	VO_HERO_04_PIRATE_DAY_33.wav
GAMEPLAY_EMOTE_HERO_04_SORRY	미안하네.	
GAMEPLAY_EMOTE_HERO_04_START	명예롭게 싸우리라.	
GAMEPLAY_EMOTE_HERO_04_THANKS	고맙네.	
GAMEPLAY_EMOTE_HERO_04_THINK1	흠...	
GAMEPLAY_EMOTE_HERO_04_THINK2	이건 어떨까...	
GAMEPLAY_EMOTE_HERO_04_THINK3	생각 좀 해야겠어...	
GAMEPLAY_EMOTE_HERO_04_THREATEN	정의의 심판을 내려야겠군!	
GAMEPLAY_EMOTE_HERO_04_TIMER	어서 움직여야 해!	
GAMEPLAY_EMOTE_HERO_04_WELL_PLAYED	훌륭하군.	
GAMEPLAY_EMOTE_HERO_04_WINTERVEIL_GREETINGS	흥겨운 겨울맞이 축제로군!	
GAMEPLAY_EMOTE_HERO_04_WOW	참으로 놀랍군!	
GAMEPLAY_EMOTE_HERO_04A_CELEBRATE	오늘, 찬란한 빛이 드리웁니다!	
GAMEPLAY_EMOTE_HERO_04A_CONCEDE	당신의 승리입니다. 항복할게요.	
GAMEPLAY_EMOTE_HERO_04A_ERROR_FULL_MINIONS	하수인이 너무 많습니다.	
GAMEPLAY_EMOTE_HERO_04A_ERROR_GENERIC	그건 할 수 없습니다.	
GAMEPLAY_EMOTE_HERO_04A_ERROR_HAND_FULL	카드가 너무 많아요!	
GAMEPLAY_EMOTE_HERO_04A_ERROR_I_ATTACKED	전 이미 공격했습니다.	
GAMEPLAY_EMOTE_HERO_04A_ERROR_JUST_PLAYED	그 하수인은 다음 턴에 준비될 겁니다.	
GAMEPLAY_EMOTE_HERO_04A_ERROR_MINION_ATTACKED	그 하수인은 이미 공격했어요.	
GAMEPLAY_EMOTE_HERO_04A_ERROR_NEED_MANA	마나가 부족합니다.	
GAMEPLAY_EMOTE_HERO_04A_ERROR_NEED_WEAPON	무기가 필요합니다.	
GAMEPLAY_EMOTE_HERO_04A_ERROR_PLAY	그 카드는 낼 수 없습니다.	
GAMEPLAY_EMOTE_HERO_04A_ERROR_STEALTH	은신한 하수인은 선택할 수 없어요.	
GAMEPLAY_EMOTE_HERO_04A_ERROR_TARGET	선택할 수 없는 대상입니다.	
GAMEPLAY_EMOTE_HERO_04A_ERROR_TAUNT	도발 능력이 있는 하수인을 공격해야 해요.	
GAMEPLAY_EMOTE_HERO_04A_FIRE_FESTIVAL	한여름 불꽃축제를 즐기십시오!	
GAMEPLAY_EMOTE_HERO_04A_GOOD_GAME	재미있었습니다.	
GAMEPLAY_EMOTE_HERO_04A_GREETINGS	아! 도전자여, 안녕하십니까.	
GAMEPLAY_EMOTE_HERO_04A_GREETINGS_RESPONSE	안녕하세요!	
GAMEPLAY_EMOTE_HERO_04A_HALLOWS_END	즐거운 할로윈 축제가 되길.	
GAMEPLAY_EMOTE_HERO_04A_LOW_CARDS	카드가 얼마 없습니다.	
GAMEPLAY_EMOTE_HERO_04A_LUNAR_NEW_YEAR	새해에도 빛의 축복이 함께하시길.	
GAMEPLAY_EMOTE_HERO_04A_MIRROR_START	이봐요, 그건 내 대사라고요.	
GAMEPLAY_EMOTE_HERO_04A_NO_CARDS	카드가 없어요!	
GAMEPLAY_EMOTE_HERO_04A_NOBLEGARDEN	즐거운 귀족의 정원 축제가 되길.	
GAMEPLAY_EMOTE_HERO_04A_OOPS	확실히, 실수했군요.	
GAMEPLAY_EMOTE_HERO_04A_PIRATE_DAY	하! 네 보물은 내 차지다!	
GAMEPLAY_EMOTE_HERO_04A_SORRY	아, 미안해요.	
GAMEPLAY_EMOTE_HERO_04A_START	제 칼날은 신성한 불꽃으로 타오릅니다!	
GAMEPLAY_EMOTE_HERO_04A_THANKS	진심으로 감사드립니다.	
GAMEPLAY_EMOTE_HERO_04A_THINK1	흐음...	
GAMEPLAY_EMOTE_HERO_04A_THINK2	이것도 괜찮고, 저것도 괜찮고...	
GAMEPLAY_EMOTE_HERO_04A_THINK3	이걸로 할까... 흠...	
GAMEPLAY_EMOTE_HERO_04A_THREATEN	하, 각오하십시오!	
GAMEPLAY_EMOTE_HERO_04A_TIMER	어서 결정하죠!	
GAMEPLAY_EMOTE_HERO_04A_WELL_PLAYED	잘하셨습니다.	
GAMEPLAY_EMOTE_HERO_04A_WINTERVEIL_GREETINGS	즐거운 겨울맞이 축제가 되길 기원하겠습니다.	
GAMEPLAY_EMOTE_HERO_04A_WOW	무척 놀랍군요!	
GAMEPLAY_EMOTE_HERO_05_CONCEDE	잘 싸웠어. 항복하겠네.	
GAMEPLAY_EMOTE_HERO_05_ERROR_FULL_MINIONS	하수인이 너무 많아.	
GAMEPLAY_EMOTE_HERO_05_ERROR_GENERIC	그럴 순 없네.	
GAMEPLAY_EMOTE_HERO_05_ERROR_HAND_FULL	카드가 너무 많아!	
GAMEPLAY_EMOTE_HERO_05_ERROR_I_ATTACKED	난 이미 공격했네.	
GAMEPLAY_EMOTE_HERO_05_ERROR_JUST_PLAYED	그 하수인은 다음 턴에 준비될 거야.	
GAMEPLAY_EMOTE_HERO_05_ERROR_MINION_ATTACKED	그 하수인은 이미 공격했네.	
GAMEPLAY_EMOTE_HERO_05_ERROR_NEED_MANA	마나가 부족해.	
GAMEPLAY_EMOTE_HERO_05_ERROR_NEED_WEAPON	무기가 필요하네.	
GAMEPLAY_EMOTE_HERO_05_ERROR_PLAY	그 카드는 낼 수 없어.	
GAMEPLAY_EMOTE_HERO_05_ERROR_STEALTH	은신 중인 하수인은 선택할 수 없네.	
GAMEPLAY_EMOTE_HERO_05_ERROR_TARGET	선택할 수 없는 대상이야.	
GAMEPLAY_EMOTE_HERO_05_ERROR_TAUNT	도발 능력이 있는 하수인이 가로막고 있네!	
GAMEPLAY_EMOTE_HERO_05_EVENT_LUNAR_NEW_YEAR	여행자여, 새해 복 많이 받게.	
GAMEPLAY_EMOTE_HERO_05_FIRE_FESTIVAL	한여름 축제를 함께 즐기세나.	
GAMEPLAY_EMOTE_HERO_05_GOOD_GAME	멋진 승부였네!	
GAMEPLAY_EMOTE_HERO_05_GREETINGS	반갑네, 여행자여.	
GAMEPLAY_EMOTE_HERO_05_GREETINGS_RESPONSE	여어, 안녕하신가.	
GAMEPLAY_EMOTE_HERO_05_HALLOWS_END	즐거운 할로윈 축제라네.	
GAMEPLAY_EMOTE_HERO_05_LOW_CARDS	카드가 거의 없네!	
GAMEPLAY_EMOTE_HERO_05_MIRROR_START	덤벼보게나!	
GAMEPLAY_EMOTE_HERO_05_NO_CARDS	카드가 없어!	
GAMEPLAY_EMOTE_HERO_05_NOBLEGARDEN	즐거운 귀족의 정원 축제로군.	
GAMEPLAY_EMOTE_HERO_05_OOPS	그건 좀 실망인데.	
GAMEPLAY_EMOTE_HERO_05_PIRATE_DAY	물개를 풀어라!	
GAMEPLAY_EMOTE_HERO_05_SORRY	내 사과하지.	
GAMEPLAY_EMOTE_HERO_05_START	사냥을 시작하지!	
GAMEPLAY_EMOTE_HERO_05_THANKS	고맙네.	
GAMEPLAY_EMOTE_HERO_05_THINK1	흠...	
GAMEPLAY_EMOTE_HERO_05_THINK2	이러면 어떨까...	
GAMEPLAY_EMOTE_HERO_05_THINK3	흐음...	
GAMEPLAY_EMOTE_HERO_05_THREATEN	네놈을 추격해 주마!	
GAMEPLAY_EMOTE_HERO_05_TIMER	시간은 기다리지 않아!	
GAMEPLAY_EMOTE_HERO_05_WELL_PLAYED	좋은 수였네.	
GAMEPLAY_EMOTE_HERO_05_WINTERVEIL_GREETINGS	겨울맞이 축제를 함께 하세나!	
GAMEPLAY_EMOTE_HERO_05_WOW	내 눈을 믿을 수 없군!	
GAMEPLAY_EMOTE_HERO_05A_CELEBRATE	하하하하! 그래, 이거죠!	
GAMEPLAY_EMOTE_HERO_05A_CONCEDE	대단하군요. 항복할게요.	
GAMEPLAY_EMOTE_HERO_05A_ERROR_FULL_MINIONS	하수인이 너무 많아요.	
GAMEPLAY_EMOTE_HERO_05A_ERROR_GENERIC	그건 할 수 없어요.	
GAMEPLAY_EMOTE_HERO_05A_ERROR_HAND_FULL	카드가 너무 많다고요!	
GAMEPLAY_EMOTE_HERO_05A_ERROR_I_ATTACKED	전 이미 공격했어요.	
GAMEPLAY_EMOTE_HERO_05A_ERROR_JUST_PLAYED	그 하수인은 다음 턴에 준비될 거예요.	
GAMEPLAY_EMOTE_HERO_05A_ERROR_MINION_ATTACKED	그 하수인은 이미 공격했어요.	
GAMEPLAY_EMOTE_HERO_05A_ERROR_NEED_MANA	마나가 부족해요.	
GAMEPLAY_EMOTE_HERO_05A_ERROR_NEED_WEAPON	무기가 필요해요.	
GAMEPLAY_EMOTE_HERO_05A_ERROR_PLAY	그 카드는 낼 수 없어요.	
GAMEPLAY_EMOTE_HERO_05A_ERROR_STEALTH	은신한 하수인은 선택할 수 없어요.	
GAMEPLAY_EMOTE_HERO_05A_ERROR_TARGET	선택할 수 없는 대상이네요.	
GAMEPLAY_EMOTE_HERO_05A_ERROR_TAUNT	도발 능력이 있는 하수인을 공격해야 해요.	
GAMEPLAY_EMOTE_HERO_05A_EVENT_FIRE_FESTIVAL	불꽃축제가 시작됐군요.	
GAMEPLAY_EMOTE_HERO_05A_EVENT_HALLOWS_END	즐거운 할로윈 축제가 되길.	
GAMEPLAY_EMOTE_HERO_05A_EVENT_LUNAR_NEW_YEAR	기쁜 새해가 되길.	
GAMEPLAY_EMOTE_HERO_05A_EVENT_NOBLEGARDEN	즐거운 귀족의 정원 축제가 되길!	
GAMEPLAY_EMOTE_HERO_05A_EVENT_PIRATE_DAY	널 바다에 빠뜨려 버리겠어!	
GAMEPLAY_EMOTE_HERO_05A_GOOD_GAME	재미있는 경기였어요.	
GAMEPLAY_EMOTE_HERO_05A_GREETINGS	방랑자여, 안녕하세요.	
GAMEPLAY_EMOTE_HERO_05A_GREETINGS_RESPONSE	하! 네, 안녕하시죠?	
GAMEPLAY_EMOTE_HERO_05A_LOW_CARDS	카드가 얼마 없어요.	
GAMEPLAY_EMOTE_HERO_05A_MIRROR_START	전율이라... 그러기엔 부족한데요?	
GAMEPLAY_EMOTE_HERO_05A_NO_CARDS	카드가 하나도 없어요!	
GAMEPLAY_EMOTE_HERO_05A_OOPS	흠, 실수였네요.	
GAMEPLAY_EMOTE_HERO_05A_SORRY	저런... 미안해요.	
GAMEPLAY_EMOTE_HERO_05A_START	엘프의 힘 앞에서 전율하세요!	
GAMEPLAY_EMOTE_HERO_05A_THANKS	고마워요.	
GAMEPLAY_EMOTE_HERO_05A_THINK1	흐음...	
GAMEPLAY_EMOTE_HERO_05A_THINK2	누굴 쏠까?	
GAMEPLAY_EMOTE_HERO_05A_THINK3	어떻게 하지?	
GAMEPLAY_EMOTE_HERO_05A_THREATEN	신속하게 끝내드리죠!	
GAMEPLAY_EMOTE_HERO_05A_TIMER	결정해야 해요! 빨리!	
GAMEPLAY_EMOTE_HERO_05A_WELL_PLAYED	아주 잘했어요.	
GAMEPLAY_EMOTE_HERO_05A_WINTERVEIL_GREETING	즐거운 겨울맞이 축제가 되길 바랄게요.	
GAMEPLAY_EMOTE_HERO_05A_WOW	대단해요!	
GAMEPLAY_EMOTE_HERO_06_CONCEDE	나의 패배를 인정한다.	
GAMEPLAY_EMOTE_HERO_06_ERROR_FULL_MINIONS	하수인이 너무 많다.	
GAMEPLAY_EMOTE_HERO_06_ERROR_GENERIC	그럴 순 없어.	
GAMEPLAY_EMOTE_HERO_06_ERROR_HAND_FULL	카드가 너무 많다!	
GAMEPLAY_EMOTE_HERO_06_ERROR_I_ATTACKED	나는 이미 공격했다.	
GAMEPLAY_EMOTE_HERO_06_ERROR_JUST_PLAYED	그 하수인은 다음 턴에 준비될 것이다.	
GAMEPLAY_EMOTE_HERO_06_ERROR_MINION_ATTACKED	그 하수인은 이미 공격했다.	
GAMEPLAY_EMOTE_HERO_06_ERROR_NEED_MANA	마나가 부족하다.	
GAMEPLAY_EMOTE_HERO_06_ERROR_NEED_WEAPON	무기가 필요하다.	
GAMEPLAY_EMOTE_HERO_06_ERROR_PLAY	그 카드는 낼 수 없다.	
GAMEPLAY_EMOTE_HERO_06_ERROR_STEALTH	은신 중인 하수인은 선택할 수 없어.	
GAMEPLAY_EMOTE_HERO_06_ERROR_TARGET	선택할 수 없는 대상이다.	
GAMEPLAY_EMOTE_HERO_06_ERROR_TAUNT	도발 능력이 있는 하수인이 가로막고 있네!	
GAMEPLAY_EMOTE_HERO_06_EVENT_LUNAR_NEW_YEAR	새해 복 많이 받게나.	
GAMEPLAY_EMOTE_HERO_06_FIRE_FESTIVAL	한여름 축제로군! 산불을 조심하게나.	
GAMEPLAY_EMOTE_HERO_06_GOOD_GAME	좋은 승부였다!	
GAMEPLAY_EMOTE_HERO_06_GREETINGS	반갑네.	
GAMEPLAY_EMOTE_HERO_06_GREETINGS_RESPONSE	만나서 반갑네.	
GAMEPLAY_EMOTE_HERO_06_HALLOWS_END	즐거운 할로윈 축제로군!	
GAMEPLAY_EMOTE_HERO_06_LOW_CARDS	카드가 거의 없다!	
GAMEPLAY_EMOTE_HERO_06_MIRROR_START	자연은 반드시 보호해야 한다!	
GAMEPLAY_EMOTE_HERO_06_NO_CARDS	카드가 없다!	
GAMEPLAY_EMOTE_HERO_06_NOBLEGARDEN	즐거운 귀족의 정원 축제로군.	
GAMEPLAY_EMOTE_HERO_06_OOPS	실수할 수도 있지.	
GAMEPLAY_EMOTE_HERO_06_PIRATE_DAY	야르!!	
GAMEPLAY_EMOTE_HERO_06_SORRY	미안하군.	
GAMEPLAY_EMOTE_HERO_06_START	내가 대자연을 수호하겠다!	
GAMEPLAY_EMOTE_HERO_06_START_TYRANDE	티란데, 당신은 언제 봐도 아름답구려!	
GAMEPLAY_EMOTE_HERO_06_THANKS	고맙네.	
GAMEPLAY_EMOTE_HERO_06_THINK1	흠...	
GAMEPLAY_EMOTE_HERO_06_THINK2	흠... 이러면 어떨까?	
GAMEPLAY_EMOTE_HERO_06_THINK3	과연, 어떻게 할까...	
GAMEPLAY_EMOTE_HERO_06_THREATEN	자연이 그대를 거부하리라!	
GAMEPLAY_EMOTE_HERO_06_TIMER	시간은 누구도 기다리지 않는다!	
GAMEPLAY_EMOTE_HERO_06_WELL_PLAYED	흠, 잘했군.	
GAMEPLAY_EMOTE_HERO_06_WINTERVEIL_GREETINGS	겨울맞이 축제를 즐기게나!	
GAMEPLAY_EMOTE_HERO_06_WOW	대단하군!	
GAMEPLAY_EMOTE_HERO_07_CONCEDE	네 승리는... 이번뿐이다...	
GAMEPLAY_EMOTE_HERO_07_ERROR_FULL_MINIONS	하수인이 너무 많다.	
GAMEPLAY_EMOTE_HERO_07_ERROR_GENERIC	그건 할 수 없다.	
GAMEPLAY_EMOTE_HERO_07_ERROR_HAND_FULL	카드가 너무 많다!	
GAMEPLAY_EMOTE_HERO_07_ERROR_I_ATTACKED	난 이미 공격했다.	
GAMEPLAY_EMOTE_HERO_07_ERROR_JUST_PLAYED	그 하수인은 다음 턴에 준비될 거야.	
GAMEPLAY_EMOTE_HERO_07_ERROR_MINION_ATTACKED	그 하수인은 이미 공격했다.	
GAMEPLAY_EMOTE_HERO_07_ERROR_NEED_MANA	마나가 부족하군.	
GAMEPLAY_EMOTE_HERO_07_ERROR_NEED_WEAPON	무기가 필요해.	
GAMEPLAY_EMOTE_HERO_07_ERROR_PLAY	그 카드는 낼 수 없다.	
GAMEPLAY_EMOTE_HERO_07_ERROR_STEALTH	은신한 하수인은 선택할 수 없어.	
GAMEPLAY_EMOTE_HERO_07_ERROR_TARGET	선택할 수 없는 대상이다.	
GAMEPLAY_EMOTE_HERO_07_ERROR_TAUNT	도발 능력이 있는 하수인이 가로막고 있다!	
GAMEPLAY_EMOTE_HERO_07_EVENT_LUNAR_NEW_YEAR	새해 복 많이 받아라.	
GAMEPLAY_EMOTE_HERO_07_FIRE_FESTIVAL	불을 지펴라.	
GAMEPLAY_EMOTE_HERO_07_GOOD_GAME	좋은 승부였다!	
GAMEPLAY_EMOTE_HERO_07_GREETINGS	반갑다.	
GAMEPLAY_EMOTE_HERO_07_GREETINGS_RESPONSE	그래, 반갑군.	
GAMEPLAY_EMOTE_HERO_07_HALLOWS_END	할로윈 축제는 언제나 즐겁지.	
GAMEPLAY_EMOTE_HERO_07_LOW_CARDS	카드가 거의 없다!	
GAMEPLAY_EMOTE_HERO_07_MIRROR_START	두려움에 떨어라, 나약한 자여!	
GAMEPLAY_EMOTE_HERO_07_NO_CARDS	카드가 다 떨어졌어!	
GAMEPLAY_EMOTE_HERO_07_NOBLEGARDEN	즐거운 귀족의 정원 축제 보내라.	
GAMEPLAY_EMOTE_HERO_07_OOPS	이런, 실수였다.	
GAMEPLAY_EMOTE_HERO_07_PIRATE_DAY	해적의 날이라고? 이해가 안되는군.	
GAMEPLAY_EMOTE_HERO_07_SORRY	미안하군.	
GAMEPLAY_EMOTE_HERO_07_START	네 영혼은 내 것이다!	
GAMEPLAY_EMOTE_HERO_07_THANKS	고맙다.	
GAMEPLAY_EMOTE_HERO_07_THINK1	흠...	
GAMEPLAY_EMOTE_HERO_07_THINK2	뭐가 좋을까...	
GAMEPLAY_EMOTE_HERO_07_THINK3	할 수 있는 게 너무 많군...	
GAMEPLAY_EMOTE_HERO_07_THREATEN	네 영혼에 고통을 안겨주마!	
GAMEPLAY_EMOTE_HERO_07_TIMER	시간이 별로 없어!	
GAMEPLAY_EMOTE_HERO_07_WELL_PLAYED	나쁘지 않군.	
GAMEPLAY_EMOTE_HERO_07_WINTERVEIL_GREETINGS	즐거운 겨울맞이 축제로군.	
GAMEPLAY_EMOTE_HERO_07_WOW	놀랍군!	
GAMEPLAY_EMOTE_HERO_08_CONCEDE	이번엔 당신이 이겼어요.	
GAMEPLAY_EMOTE_HERO_08_ERROR_FULL_MINIONS	하수인이 너무 많아요.	
GAMEPLAY_EMOTE_HERO_08_ERROR_GENERIC	그렇게는 못 해요.	
GAMEPLAY_EMOTE_HERO_08_ERROR_HAND_FULL	카드가 너무 많아요!	
GAMEPLAY_EMOTE_HERO_08_ERROR_I_ATTACKED	전 이미 공격했어요.	
GAMEPLAY_EMOTE_HERO_08_ERROR_JUST_PLAYED	그 하수인은 다음 턴에 준비될 거예요.	
GAMEPLAY_EMOTE_HERO_08_ERROR_MINION_ATTACKED	그 하수인은 이미 공격했어요.	
GAMEPLAY_EMOTE_HERO_08_ERROR_NEED_MANA	마나가 부족해요.	
GAMEPLAY_EMOTE_HERO_08_ERROR_NEED_WEAPON	무기가 필요해요.	
GAMEPLAY_EMOTE_HERO_08_ERROR_PLAY	그건 낼 수 없어요.	
GAMEPLAY_EMOTE_HERO_08_ERROR_STEALTH	은신한 하수인은 선택할 수 없어요.	
GAMEPLAY_EMOTE_HERO_08_ERROR_TARGET	선택할 수 없는 대상이에요.	
GAMEPLAY_EMOTE_HERO_08_ERROR_TAUNT	도발 능력이 있는 하수인이 가로막고 있어요!	
GAMEPLAY_EMOTE_HERO_08_EVENT_LUNAR_NEW_YEAR	즐거움 가득한 새해가 되길.	
GAMEPLAY_EMOTE_HERO_08_FIRE_FESTIVAL	한여름 축제를 즐기세요!	
GAMEPLAY_EMOTE_HERO_08_GOOD_GAME	멋진 승부였어요!	
GAMEPLAY_EMOTE_HERO_08_GREETINGS	반가워요.	
GAMEPLAY_EMOTE_HERO_08_GREETINGS_RESPONSE	안녕하세요, 낯선 이여.	
GAMEPLAY_EMOTE_HERO_08_HALLOWS_END	즐거운 할로윈 축제군요.	
GAMEPLAY_EMOTE_HERO_08_LOW_CARDS	카드가 거의 없어요!	
GAMEPLAY_EMOTE_HERO_08_MIRROR_START	과연 그럴 수 있겠어요?	
GAMEPLAY_EMOTE_HERO_08_NO_CARDS	카드가 없어요!	
GAMEPLAY_EMOTE_HERO_08_NOBLEGARDEN	즐거운 귀족의 정원 축제가 되길.	
GAMEPLAY_EMOTE_HERO_08_OOPS	이런! 실수했네요.	
GAMEPLAY_EMOTE_HERO_08_PIRATE_DAY	야르! 어기여차!	
GAMEPLAY_EMOTE_HERO_08_SORRY	미안해요.	
GAMEPLAY_EMOTE_HERO_08_START	후회하게 해드리죠.	
GAMEPLAY_EMOTE_HERO_08_THANKS	고마워요.	
GAMEPLAY_EMOTE_HERO_08_THINK1	흐음...	
GAMEPLAY_EMOTE_HERO_08_THINK2	글쎄요...	
GAMEPLAY_EMOTE_HERO_08_THINK3	어쩌죠... 어떻게 한담...	
GAMEPLAY_EMOTE_HERO_08_THREATEN	제 마법이 당신을 조각낼 거예요!	
GAMEPLAY_EMOTE_HERO_08_TIMER	시간이 별로 없어요!	
GAMEPLAY_EMOTE_HERO_08_WELL_PLAYED	잘했어요.	
GAMEPLAY_EMOTE_HERO_08_WINTERVEIL_GREETINGS	즐거운 겨울맞이 축제로군요!	
GAMEPLAY_EMOTE_HERO_08_WOW	놀랍군요!	
GAMEPLAY_EMOTE_HERO_08A_CELEBRATE	그래, 그래! 하하!	
GAMEPLAY_EMOTE_HERO_08A_CONCEDE	결정적이군! 정말 잘했네.	
GAMEPLAY_EMOTE_HERO_08A_ERROR_FULL_MINIONS	하수인이 너무 많네.	
GAMEPLAY_EMOTE_HERO_08A_ERROR_GENERIC	그건 할 수 없네.	
GAMEPLAY_EMOTE_HERO_08A_ERROR_HAND_FULL	카드가 너무 많군!	
GAMEPLAY_EMOTE_HERO_08A_ERROR_I_ATTACKED	난 이미 공격했네.	
GAMEPLAY_EMOTE_HERO_08A_ERROR_JUST_PLAYED	그 하수인은 다음 턴에 준비될 걸세.	
GAMEPLAY_EMOTE_HERO_08A_ERROR_MINION_ATTACKED	그 하수인은 이미 공격했다네.	
GAMEPLAY_EMOTE_HERO_08A_ERROR_NEED_MANA	으... 마나가 부족하군.	
GAMEPLAY_EMOTE_HERO_08A_ERROR_NEED_WEAPON	무기가 필요하다네.	
GAMEPLAY_EMOTE_HERO_08A_ERROR_PLAY	그 카드는 낼 수 없다네.	
GAMEPLAY_EMOTE_HERO_08A_ERROR_STEALTH	은신한 하수인은 선택할 수 없네.	
GAMEPLAY_EMOTE_HERO_08A_ERROR_TARGET	선택할 수 없는 대상일세.	
GAMEPLAY_EMOTE_HERO_08A_ERROR_TAUNT	도발 능력이 있는 하수인을 공격해야 하네.	
GAMEPLAY_EMOTE_HERO_08A_FIRE_FESTIVAL	한여름 불꽃축제가 왔다네!	
GAMEPLAY_EMOTE_HERO_08A_GOOD_GAME	재미있는 게임이었네!	
GAMEPLAY_EMOTE_HERO_08A_GREETINGS	아, 안녕하신가.	
GAMEPLAY_EMOTE_HERO_08A_GREETINGS_RESPONSE	수호자여, 반갑군.	
GAMEPLAY_EMOTE_HERO_08A_HALLOWS_END	신나는 할로윈 축제일세.	
GAMEPLAY_EMOTE_HERO_08A_LOW_CARDS	카드가 얼마 남지 않았네.	
GAMEPLAY_EMOTE_HERO_08A_LUNAR_NEW_YEAR	즐거운 새해가 되길.	
GAMEPLAY_EMOTE_HERO_08A_MIRROR_START	흠, 이미 시작했다네.	
GAMEPLAY_EMOTE_HERO_08A_NO_CARDS	카드가 없네!	
GAMEPLAY_EMOTE_HERO_08A_NOBLEGARDEN	귀족의 정원 축제를 맞아 즐거운 시간 보내게!	
GAMEPLAY_EMOTE_HERO_08A_OOPS	어리석은 행동이었네.	
GAMEPLAY_EMOTE_HERO_08A_PIRATE_DAY	이 몸은 메디브, 최후의 해적이다!	
GAMEPLAY_EMOTE_HERO_08A_SORRY	진심으로 사과하겠네.	
GAMEPLAY_EMOTE_HERO_08A_START	게임을 시작하세!	
GAMEPLAY_EMOTE_HERO_08A_THANKS	감사하네.	
GAMEPLAY_EMOTE_HERO_08A_THINK1	흐음...	
GAMEPLAY_EMOTE_HERO_08A_THINK2	흥미롭군...	
GAMEPLAY_EMOTE_HERO_08A_THINK3	어쩌면...	
GAMEPLAY_EMOTE_HERO_08A_THREATEN	그 무엇도 날 막을 순 없다네!	
GAMEPLAY_EMOTE_HERO_08A_TIMER	가만히 있어서는 안 되네!	
GAMEPLAY_EMOTE_HERO_08A_WELL_PLAYED	잘했네.	
GAMEPLAY_EMOTE_HERO_08A_WINTERVEIL_GREETINGS	도전자여, 축제를 즐기길.	
GAMEPLAY_EMOTE_HERO_08A_WOW	아... 놀랍군.	
GAMEPLAY_EMOTE_HERO_08B_CONCEDE	훌륭하군. 그대가 이겼소.	
GAMEPLAY_EMOTE_HERO_08B_ERROR_FULL_MINIONS	하수인이 너무 많소.	
GAMEPLAY_EMOTE_HERO_08B_ERROR_GENERIC	그건 할 수 없소.	
GAMEPLAY_EMOTE_HERO_08B_ERROR_HAND_FULL	카드가 너무 많소!	
GAMEPLAY_EMOTE_HERO_08B_ERROR_I_ATTACKED	난 이미 공격했소.	
GAMEPLAY_EMOTE_HERO_08B_ERROR_JUST_PLAYED	그 하수인은 다음 턴에 준비될 거요.	
GAMEPLAY_EMOTE_HERO_08B_ERROR_MINION_ATTACKED	그 하수인은 이미 공격했소.	
GAMEPLAY_EMOTE_HERO_08B_ERROR_NEED_MANA	마나가 부족하군.	
GAMEPLAY_EMOTE_HERO_08B_ERROR_NEED_WEAPON	무기가 필요하오.	
GAMEPLAY_EMOTE_HERO_08B_ERROR_PLAY	그 카드는 낼 수 없소.	
GAMEPLAY_EMOTE_HERO_08B_ERROR_STEALTH	은신한 하수인은 선택할 수 없소.	
GAMEPLAY_EMOTE_HERO_08B_ERROR_TARGET	선택할 수 없는 대상이오.	
GAMEPLAY_EMOTE_HERO_08B_ERROR_TAUNT	도발 능력이 있는 하수인이 가로막고 있소.	
GAMEPLAY_EMOTE_HERO_08B_FIRE_FESTIVAL	즐거운 한여름 축제 보내시오.	
GAMEPLAY_EMOTE_HERO_08B_GOOD_GAME	참으로 멋진 대결이었소!	
GAMEPLAY_EMOTE_HERO_08B_GREETINGS	반갑소, 진리의 탐구자여.	
GAMEPLAY_EMOTE_HERO_08B_GREETINGS_RESPONSE	서로가 찾는 걸 얻을 수 있길.	
GAMEPLAY_EMOTE_HERO_08B_HALLOWS_END	즐거운 할로윈 축제요.	
GAMEPLAY_EMOTE_HERO_08B_LOW_CARDS	카드가 거의 없소.	
GAMEPLAY_EMOTE_HERO_08B_LUNAR_NEW_YEAR	새해 복 많이 받으시오!	
GAMEPLAY_EMOTE_HERO_08B_MIRROR_START	서로에게서 많은 걸 배우길.	
GAMEPLAY_EMOTE_HERO_08B_NO_CARDS	카드가 없소!	
GAMEPLAY_EMOTE_HERO_08B_NOBLEGARDEN	즐거운 귀족의 정원 축제가 되길.	
GAMEPLAY_EMOTE_HERO_08B_OOPS	이런, 실수였군.	
GAMEPLAY_EMOTE_HERO_08B_PIRATE_DAY	오늘은... 바다의 범죄자들을 기념한다는 거요?	
GAMEPLAY_EMOTE_HERO_08B_SORRY	오, 저런. 사과하겠소.	
GAMEPLAY_EMOTE_HERO_08B_START	지식은 곧 힘이오.	
GAMEPLAY_EMOTE_HERO_08B_THANKS	고맙소, 친구여.	
GAMEPLAY_EMOTE_HERO_08B_THINK1	흠...	
GAMEPLAY_EMOTE_HERO_08B_THINK2	관찰하고, 생각한다...	
GAMEPLAY_EMOTE_HERO_08B_THINK3	뭔가 방법이 있을 텐데...	
GAMEPLAY_EMOTE_HERO_08B_THREATEN	한수 똑똑히 가르쳐주겠소!	
GAMEPLAY_EMOTE_HERO_08B_TIMER	시간이 벌써 이렇게 됐나!	
GAMEPLAY_EMOTE_HERO_08B_WELL_PLAYED	잘했소.	
GAMEPLAY_EMOTE_HERO_08B_WINTERVEIL_GREETINGS	즐거운 겨울맞이 축제 보내시오!	
GAMEPLAY_EMOTE_HERO_08B_WOW	멋지군!	
GAMEPLAY_EMOTE_HERO_09_CONCEDE	저보다 훨씬 강하시네요.	
GAMEPLAY_EMOTE_HERO_09_ERROR_FULL_MINIONS	하수인이 너무 많아요.	
GAMEPLAY_EMOTE_HERO_09_ERROR_GENERIC	그건 할 수 없어요.	
GAMEPLAY_EMOTE_HERO_09_ERROR_HAND_FULL	카드가 너무 많아요!	
GAMEPLAY_EMOTE_HERO_09_ERROR_I_ATTACKED	전 이미 공격했어요.	
GAMEPLAY_EMOTE_HERO_09_ERROR_JUST_PLAYED	그 하수인은 다음 턴에 준비될 거예요.	
GAMEPLAY_EMOTE_HERO_09_ERROR_MINION_ATTACKED	그 하수인은 이미 공격했어요.	
GAMEPLAY_EMOTE_HERO_09_ERROR_NEED_MANA	마나가 부족해요.	
GAMEPLAY_EMOTE_HERO_09_ERROR_NEED_WEAPON	무기가 필요해요.	
GAMEPLAY_EMOTE_HERO_09_ERROR_PLAY	그 카드는 낼 수 없어요.	
GAMEPLAY_EMOTE_HERO_09_ERROR_STEALTH	은신 중인 하수인은 선택할 수 없어요.	
GAMEPLAY_EMOTE_HERO_09_ERROR_TARGET	선택할 수 없는 대상이에요.	
GAMEPLAY_EMOTE_HERO_09_ERROR_TAUNT	도발 능력이 있는 하수인이 가로막고 있어요!	
GAMEPLAY_EMOTE_HERO_09_EVENT_LUNAR_NEW_YEAR	새해 복 많이 받으세요!	
GAMEPLAY_EMOTE_HERO_09_FIRE_FESTIVAL	불꽃놀이가 정말 기대되네요!	
GAMEPLAY_EMOTE_HERO_09_GOOD_GAME	좋은 승부였어요!	
GAMEPLAY_EMOTE_HERO_09_GREETINGS	안녕하세요!	
GAMEPLAY_EMOTE_HERO_09_GREETINGS_DISABLED	으읍!	
GAMEPLAY_EMOTE_HERO_09_GREETINGS_RESPONSE	반가워요, 친구여!	
GAMEPLAY_EMOTE_HERO_09_HALLOWS_END	즐거운 할로윈 축제네요!	
GAMEPLAY_EMOTE_HERO_09_LOW_CARDS	카드가 거의 없어요!	
GAMEPLAY_EMOTE_HERO_09_MIRROR_START	빛은 정의로운 자의 편이죠!	
GAMEPLAY_EMOTE_HERO_09_NO_CARDS	카드가 없어요!	
GAMEPLAY_EMOTE_HERO_09_NOBLEGARDEN	즐거운 귀족의 정원 축제로군요.	
GAMEPLAY_EMOTE_HERO_09_OOPS	이게 아닌데...	
GAMEPLAY_EMOTE_HERO_09_OOPS_DISABLED	으읍?	
GAMEPLAY_EMOTE_HERO_09_PIRATE_DAY	하하하! 공포의 해적단을 위해!	
GAMEPLAY_EMOTE_HERO_09_SORRY	죄송합니다.	
GAMEPLAY_EMOTE_HERO_09_START	빛이 승리를 불러올 것입니다!	
GAMEPLAY_EMOTE_HERO_09_THANKS	감사합니다!	
GAMEPLAY_EMOTE_HERO_09_THANKS_DISABLED	으읍...	
GAMEPLAY_EMOTE_HERO_09_THINK1	흠...	
GAMEPLAY_EMOTE_HERO_09_THINK2	이건 어떨까...	
GAMEPLAY_EMOTE_HERO_09_THINK3	괜찮을까...	
GAMEPLAY_EMOTE_HERO_09_THREATEN	빛이 당신을 태울 것입니다!	
GAMEPLAY_EMOTE_HERO_09_THREATEN_DISABLED	으으으읍!!!	
GAMEPLAY_EMOTE_HERO_09_TIMER	빨리 선택해야 하는데...	
GAMEPLAY_EMOTE_HERO_09_WELL_PLAYED	정말 잘하셨어요.	
GAMEPLAY_EMOTE_HERO_09_WELL_PLAYED_DISABLED	으으읍...	
GAMEPLAY_EMOTE_HERO_09_WINTERVEIL_GREETINGS	즐거운 겨울맞이 축제 보내세요!	
GAMEPLAY_EMOTE_HERO_09_WOW	놀랍군요!	
GAMEPLAY_EMOTE_HERO_09_WOW_DISABLED	으으읍!!	
GAMEPLAY_EMOTE_HERO_EVILBRM_START	흥!	
GAMEPLAY_EMOTE_HERO_EVILBRM_WOW	*악한 웃음*	
GAMEPLAY_EMOTE_HERO_TBKTRAF_KT_CONCEDE	나는... 돌아올... 것이다...	
GAMEPLAY_EMOTE_HERO_TBKTRAF_KT_GREETINGS	드디어 만났군.	
GAMEPLAY_EMOTE_HERO_TBKTRAF_KT_LOW_CARDS	카드가 얼마 없다!	
GAMEPLAY_EMOTE_HERO_TBKTRAF_KT_NO_CARDS	안 돼! 저주가 내릴 것이다, 침입자 녀석! 	
GAMEPLAY_EMOTE_HERO_TBKTRAF_KT_OOPS	계획을 다시 짜야겠군.	
GAMEPLAY_EMOTE_HERO_TBKTRAF_KT_SORRY	안 돼! 저주가 내릴 것이다, 침입자 녀석! 	
GAMEPLAY_EMOTE_HERO_TBKTRAF_KT_START	어서 내게 맞서라, 침입자여!	
GAMEPLAY_EMOTE_HERO_TBKTRAF_KT_THANKS	벼... 별말씀을?	
GAMEPLAY_EMOTE_HERO_TBKTRAF_KT_THINK1	이거면 될까?	
GAMEPLAY_EMOTE_HERO_TBKTRAF_KT_THINK2	그래... 그래!	
GAMEPLAY_EMOTE_HERO_TBKTRAF_KT_THINK3	비글스워스 씨, 너라면 어떻게 하겠니?	
GAMEPLAY_EMOTE_HERO_TBKTRAF_KT_THREATEN	네놈 뼛속까지 얼려 주마!	
GAMEPLAY_EMOTE_HERO_TBKTRAF_KT_WELL_PLAYED	하, 당연하지. 나는 위대한 켈투자드 님이다!	
GAMEPLAY_EMOTE_HERO_TBKTRAF_RAF_CONCEDE	안 돼! 내가 패배할 수는 없어...	
GAMEPLAY_EMOTE_HERO_TBKTRAF_RAF_GREETINGS	안녕하신가, 탐험가여.	
GAMEPLAY_EMOTE_HERO_TBKTRAF_RAF_LOW_CARDS	카드가 거의 다 떨어졌다!	
GAMEPLAY_EMOTE_HERO_TBKTRAF_RAF_NO_CARDS	내 보물들이 다 사라졌다!	
GAMEPLAY_EMOTE_HERO_TBKTRAF_RAF_OOPS	실패다!	
GAMEPLAY_EMOTE_HERO_TBKTRAF_RAF_SORRY	불쌍하군.	
GAMEPLAY_EMOTE_HERO_TBKTRAF_RAF_START	위대한 고고학자, 라팜!	
GAMEPLAY_EMOTE_HERO_TBKTRAF_RAF_THANKS	아, 고맙다.	
GAMEPLAY_EMOTE_HERO_TBKTRAF_RAF_THINK1	흐음...	
GAMEPLAY_EMOTE_HERO_TBKTRAF_RAF_THINK2	뭘 낼까...	
GAMEPLAY_EMOTE_HERO_TBKTRAF_RAF_THINK3	이거 괜찮겠는데...	
GAMEPLAY_EMOTE_HERO_TBKTRAF_RAF_THREATEN	압도적인 힘으로!	
GAMEPLAY_EMOTE_HERO_TBKTRAF_RAF_WELL_PLAYED	훌륭하다.	
GAMEPLAY_EMOTE_HERO_TBMECHWAR01_CONCEDE	<항복>	The text is in brackets because the VO files is just Annoy-o-Tron's greeting
GAMEPLAY_EMOTE_HERO_TBMECHWAR01_ERROR_FULL_MINIONS	<오류 발생!>	The text is in brackets because the VO files is just Annoy-o-Tron's greeting
GAMEPLAY_EMOTE_HERO_TBMECHWAR01_ERROR_HAND_FULL	<오류 발생!>	The text is in brackets because the VO files is just Annoy-o-Tron's greeting
GAMEPLAY_EMOTE_HERO_TBMECHWAR01_ERROR_I_ATTACKED	<오류 발생!>	The text is in brackets because the VO files is just Annoy-o-Tron's greeting
GAMEPLAY_EMOTE_HERO_TBMECHWAR01_ERROR_JUST_PLAYED	<오류 발생!>	The text is in brackets because the VO files is just Annoy-o-Tron's greeting
GAMEPLAY_EMOTE_HERO_TBMECHWAR01_ERROR_MINION_ATTACKED	<오류 발생!>	The text is in brackets because the VO files is just Annoy-o-Tron's greeting
GAMEPLAY_EMOTE_HERO_TBMECHWAR01_ERROR_NEED_MANA	<오류 발생!>	The text is in brackets because the VO files is just Annoy-o-Tron's greeting
GAMEPLAY_EMOTE_HERO_TBMECHWAR01_ERROR_NEED_WEAPON	<오류 발생!>	The text is in brackets because the VO files is just Annoy-o-Tron's greeting
GAMEPLAY_EMOTE_HERO_TBMECHWAR01_ERROR_PLAY	<오류 발생!>	The text is in brackets because the VO files is just Annoy-o-Tron's greeting
GAMEPLAY_EMOTE_HERO_TBMECHWAR01_ERROR_STEALTH	<오류 발생!>	The text is in brackets because the VO files is just Annoy-o-Tron's greeting
GAMEPLAY_EMOTE_HERO_TBMECHWAR01_ERROR_TARGET	<오류 발생!>	The text is in brackets because the VO files is just Annoy-o-Tron's greeting
GAMEPLAY_EMOTE_HERO_TBMECHWAR01_ERROR_TAUNT	<오류 발생!>	The text is in brackets because the VO files is just Annoy-o-Tron's greeting
GAMEPLAY_EMOTE_HERO_TBMECHWAR01_GREETINGS	<안녕! 안녕! 안녕!>	The text is in brackets because the VO files is just Annoy-o-Tron's greeting
GAMEPLAY_EMOTE_HERO_TBMECHWAR01_LOW_CARDS	<카드 부족>	The text is in brackets because the VO files is just Annoy-o-Tron's greeting
GAMEPLAY_EMOTE_HERO_TBMECHWAR01_NO_CARDS	<카드 없음>	The text is in brackets because the VO files is just Annoy-o-Tron's greeting
GAMEPLAY_EMOTE_HERO_TBMECHWAR01_OOPS	<오류 발생>	The text is in brackets because the VO files is just Annoy-o-Tron's greeting
GAMEPLAY_EMOTE_HERO_TBMECHWAR01_SORRY	<사과>	The text is in brackets because the VO files is just Annoy-o-Tron's greeting
GAMEPLAY_EMOTE_HERO_TBMECHWAR01_START	<시작>	The text is in brackets because the VO files is just Annoy-o-Tron's greeting
GAMEPLAY_EMOTE_HERO_TBMECHWAR01_THANKS	<감사>	The text is in brackets because the VO files is just Annoy-o-Tron's greeting
GAMEPLAY_EMOTE_HERO_TBMECHWAR01_THINK1	<데이터 처리 중...>	The text is in brackets because the VO files is just Annoy-o-Tron's greeting
GAMEPLAY_EMOTE_HERO_TBMECHWAR01_THINK2	<대상 포착 중...>	The text is in brackets because the VO files is just Annoy-o-Tron's greeting
GAMEPLAY_EMOTE_HERO_TBMECHWAR01_THINK3	<연산 중...>	The text is in brackets because the VO files is just Annoy-o-Tron's greeting
GAMEPLAY_EMOTE_HERO_TBMECHWAR01_THREATEN	<위협>	The text is in brackets because the VO files is just Annoy-o-Tron's attack
GAMEPLAY_EMOTE_HERO_TBMECHWAR01_TIMER	<시간 촉박>	The text is in brackets because the VO files is just Annoy-o-Tron's greeting
GAMEPLAY_EMOTE_HERO_TBMECHWAR01_WELL_PLAYED	<칭찬>	The text is in brackets because the VO files is just Annoy-o-Tron's greeting
GAMEPLAY_EMOTE_HERO_TBMECHWAR01_WOW	<깜짝!>	The text is in brackets because the VO files is just Annoy-o-Tron's greeting
GAMEPLAY_EMOTE_HERO_TBMECHWAR02_CONCEDE	<시스템 종료>	The text is in brackets because the VO files is just Boom Bot's greeting
GAMEPLAY_EMOTE_HERO_TBMECHWAR02_ERROR_FULL_MINIONS	<오류 발생!>	The text is in brackets because the VO files is just Boom Bot's greeting
GAMEPLAY_EMOTE_HERO_TBMECHWAR02_ERROR_HAND_FULL	<오류 발생!>	The text is in brackets because the VO files is just Boom Bot's greeting
GAMEPLAY_EMOTE_HERO_TBMECHWAR02_ERROR_I_ATTACKED	<오류 발생!>	The text is in brackets because the VO files is just Boom Bot's greeting
GAMEPLAY_EMOTE_HERO_TBMECHWAR02_ERROR_JUST_PLAYED	<오류 발생!>	The text is in brackets because the VO files is just Boom Bot's greeting
GAMEPLAY_EMOTE_HERO_TBMECHWAR02_ERROR_MINION_ATTACKED	<오류 발생!>	The text is in brackets because the VO files is just Boom Bot's greeting
GAMEPLAY_EMOTE_HERO_TBMECHWAR02_ERROR_NEED_MANA	<오류 발생!>	The text is in brackets because the VO files is just Boom Bot's greeting
GAMEPLAY_EMOTE_HERO_TBMECHWAR02_ERROR_NEED_WEAPON	<오류 발생!>	The text is in brackets because the VO files is just Boom Bot's greeting
GAMEPLAY_EMOTE_HERO_TBMECHWAR02_ERROR_PLAY	<오류 발생!>	The text is in brackets because the VO files is just Boom Bot's greeting
GAMEPLAY_EMOTE_HERO_TBMECHWAR02_ERROR_STEALTH	<오류 발생!>	The text is in brackets because the VO files is just Boom Bot's greeting
GAMEPLAY_EMOTE_HERO_TBMECHWAR02_ERROR_TARGET	<오류 발생!>	The text is in brackets because the VO files is just Boom Bot's greeting
GAMEPLAY_EMOTE_HERO_TBMECHWAR02_ERROR_TAUNT	<오류 발생!>	The text is in brackets because the VO files is just Boom Bot's greeting
GAMEPLAY_EMOTE_HERO_TBMECHWAR02_GREETINGS	<만나서 반가움>	The text is in brackets because the VO files is just Annoy-o-Tron's greeting
GAMEPLAY_EMOTE_HERO_TBMECHWAR02_LOW_CARDS	<카드 부족>	The text is in brackets because the VO files is just Boom Bot's greeting
GAMEPLAY_EMOTE_HERO_TBMECHWAR02_NO_CARDS	<카드 없음!>	The text is in brackets because the VO files is just Boom Bot's greeting
GAMEPLAY_EMOTE_HERO_TBMECHWAR02_OOPS	<오류 발생!>	The text is in brackets because the VO files is just Boom Bot's greeting
GAMEPLAY_EMOTE_HERO_TBMECHWAR02_SORRY	<사과>	The text is in brackets because the VO files is just Boom Bot's greeting
GAMEPLAY_EMOTE_HERO_TBMECHWAR02_START	<가동 완료>	The text is in brackets because the VO files is just Boom Bot's greeting
GAMEPLAY_EMOTE_HERO_TBMECHWAR02_THANKS	<감사>	The text is in brackets because the VO files is just Boom Bot's greeting
GAMEPLAY_EMOTE_HERO_TBMECHWAR02_THINK1	<데이터 처리 중...>	The text is in brackets because the VO files is just Boom Bot's greeting
GAMEPLAY_EMOTE_HERO_TBMECHWAR02_THINK2	<대상 포착 중...>	The text is in brackets because the VO files is just Boom Bot's greeting
GAMEPLAY_EMOTE_HERO_TBMECHWAR02_THINK3	<연산 중...>	The text is in brackets because the VO files is just Boom Bot's greeting
GAMEPLAY_EMOTE_HERO_TBMECHWAR02_THREATEN	<위협!>	The text is in brackets because the VO files is just Boom Bot's Attack sound
GAMEPLAY_EMOTE_HERO_TBMECHWAR02_TIMER	<시간 촉박>	The text is in brackets because the VO files is just Boom Bot's greeting
GAMEPLAY_EMOTE_HERO_TBMECHWAR02_WELL_PLAYED	<칭찬>	The text is in brackets because the VO files is just Boom Bot's greeting
GAMEPLAY_EMOTE_HERO_TBMECHWAR02_WOW	<깜짝!>	The text is in brackets because the VO files is just Annoy-o-Tron's greeting
GAMEPLAY_EMOTE_ICC_481_CONCEDE	하찮은 승리를 만끽해라.	
GAMEPLAY_EMOTE_ICC_481_GREETINGS	죽음의 차가운 품에 안겨라.	
GAMEPLAY_EMOTE_ICC_481_LOW_CARDS	카드가 바닥날 지경이다!	
GAMEPLAY_EMOTE_ICC_481_NO_CARDS	카드가 없다!	
GAMEPLAY_EMOTE_ICC_481_OOPS	끔찍한 실수로군.	
GAMEPLAY_EMOTE_ICC_481_START	나는 스컬지의 얼어붙은 심장이다!	
GAMEPLAY_EMOTE_ICC_481_THANKS	하하... 고맙다.	
GAMEPLAY_EMOTE_ICC_481_THINK1	흠...	
GAMEPLAY_EMOTE_ICC_481_THINK2	흠, 정령들이 말이 없군.	
GAMEPLAY_EMOTE_ICC_481_THINK3	내가 선택해야 한다.	
GAMEPLAY_EMOTE_ICC_481_THREATEN	산산조각 내주마!	
GAMEPLAY_EMOTE_ICC_481_TIMER	결정을 내려야 한다!	
GAMEPLAY_EMOTE_ICC_481_WELL_PLAYED	제법이군.	
GAMEPLAY_EMOTE_ICC_481_WOW	엄청나군.	
GAMEPLAY_EMOTE_ICC_827_CONCEDE	오늘은 너의 날이구나.	
GAMEPLAY_EMOTE_ICC_827_GREETINGS	어디 숨어 있었느냐?	
GAMEPLAY_EMOTE_ICC_827_LOW_CARDS	카드가 얼마 없다.	
GAMEPLAY_EMOTE_ICC_827_NO_CARDS	카드가 없어!	
GAMEPLAY_EMOTE_ICC_827_OOPS	참으로 비극적이야...	
GAMEPLAY_EMOTE_ICC_827_START	죽음의 그림자에서 벗어날 순 없다!	
GAMEPLAY_EMOTE_ICC_827_THANKS	고마워.	
GAMEPLAY_EMOTE_ICC_827_THINK1	흠...	
GAMEPLAY_EMOTE_ICC_827_THINK2	죽음의 그림자가 커진다...	
GAMEPLAY_EMOTE_ICC_827_THINK3	시간이 스쳐 지나간다...	
GAMEPLAY_EMOTE_ICC_827_THREATEN	네 그림자를 두려워하는 게 좋을 거다.	
GAMEPLAY_EMOTE_ICC_827_TIMER	빨리 선택해야 한다...	
GAMEPLAY_EMOTE_ICC_827_WELL_PLAYED	괜찮은데?	
GAMEPLAY_EMOTE_ICC_827_WOW	믿을 수가 없어!	
GAMEPLAY_EMOTE_ICC_828_CONCEDE	이 사냥은 너의 승리군.	
GAMEPLAY_EMOTE_ICC_828_GREETINGS	어서 뛰어라, 사냥감아!	
GAMEPLAY_EMOTE_ICC_828_LOW_CARDS	카드가 얼마 없다.	
GAMEPLAY_EMOTE_ICC_828_MIRROR_START	멀리 달아나라. 그래야 더 재밌을테니.	
GAMEPLAY_EMOTE_ICC_828_NO_CARDS	카드가 없다!	
GAMEPLAY_EMOTE_ICC_828_OOPS	빗맞았나.	
GAMEPLAY_EMOTE_ICC_828_START	사냥을 시작하지!	
GAMEPLAY_EMOTE_ICC_828_THANKS	고맙다.	
GAMEPLAY_EMOTE_ICC_828_THINK1	흠...	
GAMEPLAY_EMOTE_ICC_828_THINK2	길을 찾아야 한다...	
GAMEPLAY_EMOTE_ICC_828_THINK3	이러면 어떨까...	
GAMEPLAY_EMOTE_ICC_828_THREATEN	널 사냥해주마... 영원히!	
GAMEPLAY_EMOTE_ICC_828_TIMER	냄새가 옅어진다!	
GAMEPLAY_EMOTE_ICC_828_WELL_PLAYED	날카로운 수였어.	
GAMEPLAY_EMOTE_ICC_828_WOW	대단하군!	
GAMEPLAY_EMOTE_ICC_829_CONCEDE	네가 승리했다. 하지만 이번만이다.	
GAMEPLAY_EMOTE_ICC_829_GREETINGS	나만의 정의를 이루겠다.	
GAMEPLAY_EMOTE_ICC_829_LOW_CARDS	카드가 얼마 없다.	
GAMEPLAY_EMOTE_ICC_829_NO_CARDS	카드가 없어!	
GAMEPLAY_EMOTE_ICC_829_OOPS	실망스럽군.	
GAMEPLAY_EMOTE_ICC_829_START	빛의 정의는 허상일 뿐이다!	
GAMEPLAY_EMOTE_ICC_829_THANKS	고맙다.	
GAMEPLAY_EMOTE_ICC_829_THINK1	흠...	
GAMEPLAY_EMOTE_ICC_829_THINK2	서리한이 부른다.	
GAMEPLAY_EMOTE_ICC_829_THINK3	얼어붙은 왕좌가 부른다...	
GAMEPLAY_EMOTE_ICC_829_THREATEN	너는 자비를 구걸하겠지. 나는 거부할 테고!	
GAMEPLAY_EMOTE_ICC_829_TIMER	종말이 다가온다!	
GAMEPLAY_EMOTE_ICC_829_WELL_PLAYED	제법이군.	
GAMEPLAY_EMOTE_ICC_829_WOW	믿을 수가 없군!	
GAMEPLAY_EMOTE_ICC_830_CONCEDE	안 돼! 내가 패배해도 바뀌는 건 없다!	
GAMEPLAY_EMOTE_ICC_830_GREETINGS	칠흑같은 어둠으로 내 복수를 이루리라.	
GAMEPLAY_EMOTE_ICC_830_LOW_CARDS	카드가 얼마 없다!	
GAMEPLAY_EMOTE_ICC_830_NO_CARDS	카드가 없다니!	
GAMEPLAY_EMOTE_ICC_830_OOPS	인간다운 실수로군.	
GAMEPLAY_EMOTE_ICC_830_START	어둠이 승리를 불러올 것이다.	
GAMEPLAY_EMOTE_ICC_830_THANKS	고맙다.	
GAMEPLAY_EMOTE_ICC_830_THINK1	흠...	
GAMEPLAY_EMOTE_ICC_830_THINK2	어둠이 속삭인다...	
GAMEPLAY_EMOTE_ICC_830_THINK3	암흑이 이끄는 대로...	
GAMEPLAY_EMOTE_ICC_830_THREATEN	어둠이 널 삼킬 것이다!	
GAMEPLAY_EMOTE_ICC_830_TIMER	어둠이 흩어진다!	
GAMEPLAY_EMOTE_ICC_830_WELL_PLAYED	제법인데.	
GAMEPLAY_EMOTE_ICC_830_WOW	범상치 않아.	
GAMEPLAY_EMOTE_ICC_831_CONCEDE	네가 이겼다... 이번에는.	
GAMEPLAY_EMOTE_ICC_831_GREETINGS	두려움에 몸서리쳐라.	
GAMEPLAY_EMOTE_ICC_831_LOW_CARDS	카드가 얼마 없다.	
GAMEPLAY_EMOTE_ICC_831_NO_CARDS	카드가 없다!	
GAMEPLAY_EMOTE_ICC_831_OOPS	헛수고였군.	
GAMEPLAY_EMOTE_ICC_831_START	피와 어둠으로 맺은 계약이로다.	
GAMEPLAY_EMOTE_ICC_831_THANKS	아아... 고맙다.	
GAMEPLAY_EMOTE_ICC_831_THINK1	흠...	
GAMEPLAY_EMOTE_ICC_831_THINK2	허기가 지는군...	
GAMEPLAY_EMOTE_ICC_831_THINK3	판단할 게 너무 많다.	
GAMEPLAY_EMOTE_ICC_831_THREATEN	네가 겪을 고통은... 전설적일 것이다!	
GAMEPLAY_EMOTE_ICC_831_TIMER	굶주림을 참을 수 없다!	
GAMEPLAY_EMOTE_ICC_831_WELL_PLAYED	아주 훌륭하군.	
GAMEPLAY_EMOTE_ICC_831_WOW	인상적이군.	
GAMEPLAY_EMOTE_ICC_832_CONCEDE	네가 이겼다. 이제 나도 쉴 수 있겠군.	
GAMEPLAY_EMOTE_ICC_832_GREETINGS	부패의 순환이 시작된다.	
GAMEPLAY_EMOTE_ICC_832_LOW_CARDS	카드가 얼마 없다.	
GAMEPLAY_EMOTE_ICC_832_NO_CARDS	카드가 없다!	
GAMEPLAY_EMOTE_ICC_832_OOPS	거미줄이 드리우는군.	
GAMEPLAY_EMOTE_ICC_832_START	생명의 순환은 이제 종식되리라.	
GAMEPLAY_EMOTE_ICC_832_THANKS	고맙다.	
GAMEPLAY_EMOTE_ICC_832_THINK1	흠...	
GAMEPLAY_EMOTE_ICC_832_THINK2	뒤엉킨 거미줄을 풀어볼까...	
GAMEPLAY_EMOTE_ICC_832_THINK3	머리 속이 흐릿하군.	
GAMEPLAY_EMOTE_ICC_832_THREATEN	너는 썩고 메마를 것이다!	
GAMEPLAY_EMOTE_ICC_832_TIMER	죽음은 영원하지만... 시간은 그렇지 않다!	
GAMEPLAY_EMOTE_ICC_832_WELL_PLAYED	아주 능숙하군.	
GAMEPLAY_EMOTE_ICC_832_WOW	충격적이군!	
GAMEPLAY_EMOTE_ICC_833_CONCEDE	너의 힘을 인정해주지.	
GAMEPLAY_EMOTE_ICC_833_GREETINGS	떨고 있구나... 내가 두렵느냐?	
GAMEPLAY_EMOTE_ICC_833_LOW_CARDS	카드가 얼마 없다.	
GAMEPLAY_EMOTE_ICC_833_NO_CARDS	카드가 없다!	
GAMEPLAY_EMOTE_ICC_833_OOPS	치명적인 실수였다.	
GAMEPLAY_EMOTE_ICC_833_START	힘 그 자체를 두려워해선 안 되노라. 그 힘을 거머쥔 자를 두려워할 지니!	
GAMEPLAY_EMOTE_ICC_833_THANKS	하하하! 고맙다...	
GAMEPLAY_EMOTE_ICC_833_THINK1	흠...	
GAMEPLAY_EMOTE_ICC_833_THINK2	시간이 녹아내린다...	
GAMEPLAY_EMOTE_ICC_833_THINK3	흠... 결정해야겠어...	
GAMEPLAY_EMOTE_ICC_833_THREATEN	여왕에게 고개를 조아려라!	
GAMEPLAY_EMOTE_ICC_833_TIMER	바로 지금이다!	
GAMEPLAY_EMOTE_ICC_833_WELL_PLAYED	제법이구나...	
GAMEPLAY_EMOTE_ICC_833_WOW	놀랍구나!	
GAMEPLAY_EMOTE_ICC_834_CONCEDE	난 죽음을 택하겠다!	
GAMEPLAY_EMOTE_ICC_834_GREETINGS	헬스크림의 분노를 피할 순 없다!	
GAMEPLAY_EMOTE_ICC_834_LOW_CARDS	카드가 얼마 없어.	
GAMEPLAY_EMOTE_ICC_834_NO_CARDS	카드가 없다!	
GAMEPLAY_EMOTE_ICC_834_OOPS	실패라니!	
GAMEPLAY_EMOTE_ICC_834_START	이 세계를 불태우고, 잿더미만 남기리라!	
GAMEPLAY_EMOTE_ICC_834_THANKS	흐음, 고맙다.	
GAMEPLAY_EMOTE_ICC_834_THINK1	흠...	
GAMEPLAY_EMOTE_ICC_834_THINK2	시간이 흘러간다...	
GAMEPLAY_EMOTE_ICC_834_THINK3	이젠 뭘 할까...	
GAMEPLAY_EMOTE_ICC_834_THREATEN	네가 가장 먼저 무릎 꿇으리라!	
GAMEPLAY_EMOTE_ICC_834_TIMER	선택해야 한다!	
GAMEPLAY_EMOTE_ICC_834_WELL_PLAYED	내게 걸맞은 적수로군!	
GAMEPLAY_EMOTE_ICC_834_WOW	엄청나군!	
VO__Female_Naga_Concede_02	이번엔 네가 승리했구나...	
VO__Female_Naga_ERROR_FULL_MINIONS_01	하수인이 너무 많다.	
VO__Female_Naga_ERROR_GENERIC_04	말도 안 되는 소리.	
VO__Female_Naga_ERROR_HAND_FULL_01	카드가 너무 많다.	
VO__Female_Naga_ERROR_I_ATTACKED_01	난 이미 공격했다.	
VO__Female_Naga_ERROR_MINION_ATTACKED_01	그 하수인은 이미 공격했다.	
VO__Female_Naga_ERROR_NEED_MANA_01	마나가 부족하다.	
VO__Female_Naga_ERROR_NEED_WEAPON_01	무기가 필요하다.	
VO__Female_Naga_ERROR_PLAY_01	그건 낼 수 없다.	
VO__Female_Naga_ERROR_STEALTH_01	그 하수인은 은신 중이다.	
VO__Female_Naga_ERROR_SUMMON_SICKNESS_01	아니, 그 녀석은 쉬어야 한다.	
VO__Female_Naga_ERROR_TARGET_01	대상이 없잖느냐!	
VO__Female_Naga_ERROR_TAUNT_01	날 도발하는 저 멍청이가 보이느냐?	
VO__Female_Naga_FIRE_FESTIVAL_01	이 얼토당토않은 불꽃축제를 꺼트려버렸으면.	
VO__Female_Naga_Greetings_01	반갑다, 침입자여.	
VO__Female_Naga_HAPPY_HALLOWEEN_01	그때 그 놀이가 이젠 축제가 되었다고?	
VO__Female_Naga_HAPPY_HOLIDAYS_01	명가보다 더 화려하게 노는 자들은 없을 거다!	
VO__Female_Naga_HAPPY_NEW_YEAR_01	기쁜 새해로구나!	
VO__Female_Naga_HAPPY_NEW_YEAR_LUNAR_01	하해와도 같은 복을 받아라!	
VO__Female_Naga_HAPPY_NOBLEGARDEN_01	귀족의 정원 축제라고? 귀족들은 전부 바다 속에 잠겼거늘!	
VO__Female_Naga_LowCards_01	카드가 얼마 없다.	
VO__Female_Naga_MIRROR_GREETINGS_01	침입자라고? 내가? 어이가 없군.	
VO__Female_Naga_MIRROR_START_01	아직 단정 짓기엔 이르다.	
VO__Female_Naga_NoCards_01	카드가 하나도 없다!	
VO__Female_Naga_Oops_02	저주받을!	
VO__Female_Naga_Picked_01	표적을 향해 날아가라!	
VO__Female_Naga_PIRATE_DAY_01	너흰 모두 육지 놈들일 뿐이다!	
VO__Female_Naga_Sorry_01	이런 불행한 일이.	
VO__Female_Naga_Start_01	네놈은 여기까지다!	
VO__Female_Naga_Start_Illidan_01	영광입니다, 일리단 군주님.	
VO__Female_Naga_Start_Maiev_01	아, 그 끈질긴 감시관이로구나.	
VO__Female_Naga_Start_Morgl_01	작은 이여, 바다가 널 부른다.	
VO__Female_Naga_Start_Tyrande_01	만 년이 지났건만, 여전히 날 귀찮게 하는구나.	
VO__Female_Naga_Thanks_02	감사를 전한다.	
VO__Female_Naga_Thinking_01	흠...	
VO__Female_Naga_Thinking_02	흐으음...	
VO__Female_Naga_Thinking_03	선택할 게 많군...	
VO__Female_Naga_Threaten_01	머리부터 발끝까지 성치 못할 줄 알아라!	
VO__Female_Naga_Time_01	시간이 없다.	
VO__Female_Naga_TRIGGER_ANCESTRAL_SPIRIT	고대의 방식은 익숙하지.	
VO__Female_Naga_TRIGGER_EARTH_SHOCK	이거면 고분고분해지겠지!	
VO__Female_Naga_TRIGGER_EVERYFIN_IS_AWESOME	아가미와 지느러미로.	
VO__Female_Naga_TRIGGER_FORKED_LIGHTNING	어딜 기어오르는 것이냐!	
VO__Female_Naga_TRIGGER_LIGHTNING_STORM	한 놈도 살려두지 마라!	
VO__Female_Naga_TRIGGER_MUTATE	변화엔 힘이 있지.	
VO__Female_Naga_TRIGGER_SERPENT_WARD	<어두운 웃음>	
VO__Female_Naga_TRIGGER_UNSTABLE_EVOLUTION	나도 한때는 나이트 엘프였다.	
VO__Female_Naga_TRIGGER_WITCHS_BREW	맛있구나.	
VO__Female_Naga_Well_Played_01	놀랍구나.	
VO__Female_Naga_WOW_01	충격적이야!	
VO__Female_Night Elf_Concede_01	당신이 승리했어요!	
VO__Female_Night Elf_ERROR_FULL_MINIONS_01	하수인을 더 관리할 수 없어요.	
VO__Female_Night Elf_ERROR_GENERIC_01	불가능하다고요.	
VO__Female_Night Elf_ERROR_HAND_FULL_02	카드가 너무 많아요!	
VO__Female_Night Elf_ERROR_I_ATTACKED_01	전 이미 공격했어요!	
VO__Female_Night Elf_ERROR_MINION_ATTACKED_01	그 하수인은 지친 거 같네요.	
VO__Female_Night Elf_ERROR_NEED_MANA_02	마나가 부족해요.	
VO__Female_Night Elf_ERROR_NEED_WEAPON_01	우선 무기부터 주실래요?	
VO__Female_Night Elf_ERROR_PLAY_01	그럴 순 없겠네요.	
VO__Female_Night Elf_ERROR_STEALTH_01	아직 은신 중이에요.	
VO__Female_Night Elf_ERROR_SUMMON_SICKNESS_01	잠깐 쉬게 둬야 할 거 같은데요.	
VO__Female_Night Elf_ERROR_TARGET_01	제 능력 밖의 일이군요.	
VO__Female_Night Elf_ERROR_TAUNT_01	뭔가가 절 도발하고 있어요.	
VO__Female_Night Elf_FIRE_FESTIVAL_01	오늘 같은 날엔 불을 더욱 조심히 다루세요.	
VO__Female_Night Elf_Greetings_01	안녕하세요!	
VO__Female_Night Elf_HAPPY_HALLOWEEN_01	할로윈 축제의 기원은 정말 충격적이더군요!	
VO__Female_Night Elf_HAPPY_HOLIDAYS_01	올해에는 착한 일을 많이 하셨나요?	
VO__Female_Night Elf_HAPPY_NEW_YEAR_01	즐거운 새해군요!	
VO__Female_Night Elf_HAPPY_NEW_YEAR_LUNAR_01	새해에도 복이 가득하시길!	
VO__Female_Night Elf_HAPPY_NOBLEGARDEN_01	아, 귀족의 정원 축제는 정말 즐거워요!	
VO__Female_Night Elf_LowCards_01	카드가 거의 없다고요? 특이하군요.	
VO__Female_Night Elf_MIRROR_GREETINGS_01	오늘은 뭘 공부해볼까요?	
VO__Female_Night Elf_MIRROR_START_01	과목은 고고학으로 할까요?	
VO__Female_Night Elf_NoCards_01	이런... 제 카드가 다 사라졌군요.	
VO__Female_Night Elf_Oops_01	이건... 교훈으로 삼아야겠네요.	
VO__Female_Night Elf_Picked_01	저는 숲의 제자이자 많은 이들의 스승이죠.	
VO__Female_Night Elf_PIRATE_DAY_01	스타시커 선장, 승선합니다!	
VO__Female_Night Elf_Sorry_01	사과드릴게요!	
VO__Female_Night Elf_Start_01	수업을 시작하죠!	
VO__Female_Night Elf_Thanks_02	진심으로 감사드려요!	
VO__Female_Night Elf_Thinking_01	흠...	
VO__Female_Night Elf_Thinking_03	정말 흥미롭군요...	
VO__Female_Night Elf_Thinking_04	염두에 둘 게 참 많군요...	
VO__Female_Night Elf_Threaten_03	한 수 똑똑히 가르쳐드리죠!	
VO__Female_Night Elf_Time_01	시간의 모래가 거의 없어요.	
VO__Female_Night Elf_Well_Played_01	전설적인 실력이군요!	
VO__Female_Night Elf_WOW_01	이런 광경을 직접 보게 되다니.	
VO__Female_Val'kyr_Attack_01	너에게 망각을 선서하노라!	
VO__Female_Val'kyr_Concede_01	너의 용맹함이 승리했구나.	
VO__Female_Val'kyr_Death_02	전부... 끝이다...	
VO__Female_Val'kyr_ERROR_FULL_MINIONS_01	하수인을 너무 많이 거느리고 있다.	
VO__Female_Val'kyr_ERROR_GENERIC_03	그리 될 순 없다.	
VO__Female_Val'kyr_ERROR_HAND_FULL_01	손에 카드가 가득하다.	
VO__Female_Val'kyr_ERROR_I_ATTACKED_01	난 이미 적을 공격했다.	
VO__Female_Val'kyr_ERROR_MINION_ATTACKED_01	그 녀석은 이제 쉬어야 한다.	
VO__Female_Val'kyr_ERROR_NEED_MANA_01	마나가 부족하다.	
VO__Female_Val'kyr_ERROR_NEED_WEAPON_01	우선 무기가 필요하다.	
VO__Female_Val'kyr_ERROR_PLAY_01	그건 낼 수 없다.	
VO__Female_Val'kyr_ERROR_STEALTH_01	그 녀석은 숨어있다.	
VO__Female_Val'kyr_ERROR_SUMMON_SICKNESS_01	아직 쉬고 있는 녀석이다.	
VO__Female_Val'kyr_ERROR_TARGET_01	내 능력 밖이다.	
VO__Female_Val'kyr_ERROR_TAUNT_01	누가 날 도발하고 있다.	
VO__Female_Val'kyr_FIRE_FESTIVAL_01	불꽃축제 동안 찬란하게 타올라라!	
VO__Female_Val'kyr_Greetings_01	반갑다, 도전자여.	
VO__Female_Val'kyr_HAPPY_HALLOWEEN_01	영광스러운 망자들을 존중해라.	
VO__Female_Val'kyr_HAPPY_HOLIDAYS_01	내 영혼까지 따뜻해지는 느낌이구나.	
VO__Female_Val'kyr_HAPPY_NEW_YEAR_01	즐거운 새해가 왔다!	
VO__Female_Val'kyr_HAPPY_NEW_YEAR_LUNAR_01	너에게 새해 복이 가득하길!	
VO__Female_Val'kyr_HAPPY_NOBLEGARDEN_01	넌 알을 모아라. 난 전사들을 모을 테니.	
VO__Female_Val'kyr_LowCards_01	카드가 거의 없다.	
VO__Female_Val'kyr_MIRROR_GREETINGS_01	반갑다. 내 숙적이여.	
VO__Female_Val'kyr_MIRROR_START_01	안 그래도 그럴 참이었다!	
VO__Female_Val'kyr_NoCards_01	카드가 떨어졌다.	
VO__Female_Val'kyr_Oops_01	정말 기이하군.	
VO__Female_Val'kyr_Picked_01	내 용맹함을 목도해라!	
VO__Female_Val'kyr_PIRATE_DAY_01	죽은 자들도 말할 순 있다. 내가 허락한다면.	
VO__Female_Val'kyr_Sorry_01	유감이구나.	
VO__Female_Val'kyr_Start_01	일어나라! 여왕님의 뜻을 받들어라!	
VO__Female_Val'kyr_Start_Sylvanas_01	여왕이시여, 이번만큼은 당신을 대신해 죽진 않겠습니다.	
VO__Female_Val'kyr_Thanks_02	감사를 전한다.	
VO__Female_Val'kyr_Thinking_01	흠...	
VO__Female_Val'kyr_Thinking_03	가치 있는... 선택일까?	
VO__Female_Val'kyr_Thinking_04	다음은...	
VO__Female_Val'kyr_Threaten_01	순순히 너의 운명을 받아들여라!	
VO__Female_Val'kyr_Time_01	시간이 촉박하다.	
VO__Female_Val'kyr_TRIGGER_BRAWL_01	과연 누가 승리할 것인가?	
VO__Female_Val'kyr_TRIGGER_DEAD_MANS_HAND_01	망자는 날 거스를 수 없다.	
VO__Female_Val'kyr_TRIGGER_DEADLY_ARSENAL_01	이렇게나 많은 칼날이라니!	
VO__Female_Val'kyr_TRIGGER_DEVASTATE_01	영광스럽게 최후를 맞이해라!	
VO__Female_Val'kyr_TRIGGER_FORGE_OF_SOULS_01	힘은 영원하다.	
VO__Female_Val'kyr_TRIGGER_HEROIC_STRIKE_01	운명이 부른다!	
VO__Female_Val'kyr_TRIGGER_MORTAL_STRIKE_01	어둠이 손짓한다!	
VO__Female_Val'kyr_TRIGGER_RAMPAGE_01	아직은 너의 때가 아니다.	
VO__Female_Val'kyr_TRIGGER_WARPATH_01	이건 시작일 뿐이다!	
VO__Female_Val'kyr_Well_Played_01	넌... 가치 있는 자로구나.	
VO__Female_Val'kyr_WOW_01	놀랍구나!	
VO__Male_Dragon_Attack_01	이 세상을 조각내주마!	
VO__Male_Dragon_Concede_02	만물의 끝이 곧 다가오리라!	
VO__Male_Dragon_ERROR_FULL_MINIONS_02	머저리들을 더 내보낼 수 없다.	
VO__Male_Dragon_ERROR_GENERIC_01	그럴 수 없다.	
VO__Male_Dragon_ERROR_HAND_FULL_01	더 가질 순 없다!	
VO__Male_Dragon_ERROR_I_ATTACKED_01	난 이미 내 분노를 보였다!	
VO__Male_Dragon_ERROR_MINION_ATTACKED_01	그 하수인은 이미 공격했다.	
VO__Male_Dragon_ERROR_NEED_MANA_02	내게 마나를 대령해라!	
VO__Male_Dragon_ERROR_NEED_WEAPON_02	내 분노를 담을 무기가 필요하다.	
VO__Male_Dragon_ERROR_PLAY_01	불가능하다!	
VO__Male_Dragon_ERROR_STEALTH_01	저 성가신 녀석이 은신 중이다.	
VO__Male_Dragon_ERROR_SUMMON_SICKNESS_01	그 미천한 것은 아직 공격할 수 없다.	
VO__Male_Dragon_ERROR_TARGET_01	대상이 필요하다.	
VO__Male_Dragon_ERROR_TAUNT_01	저 역겨운 것이 날 도발한다!	
VO__Male_Dragon_FIRE_FESTIVAL_01	모든 것이 불꽃축제 때 활활 타오를 것이다!	
VO__Male_Dragon_Greetings_01	죽음의 위상을 목도하라!	
VO__Male_Dragon_HAPPY_BIRTHDAY_01	네가 태어난 날이라고? 흠.	
VO__Male_Dragon_HAPPY_BREWFEST_01	가을축제라고? 왜 아무 것도 불타지 않는 것이냐?	
VO__Male_Dragon_HAPPY_HALLOWEEN_01	어둠과 죽음이 가득한 날이라? 마음에 드는군.	
VO__Male_Dragon_HAPPY_HOLIDAYS_01	그래, 축제를 즐겨라. 그럴 수 있을 때.	
VO__Male_Dragon_HAPPY_NEW_YEAR_01	새해가 도래했다!	
VO__Male_Dragon_HAPPY_NEW_YEAR_LUNAR_01	격변의 새해를 맞이해라!	
VO__Male_Dragon_HAPPY_NOBLEGARDEN_01	검은용군단의 알을 훔치면 가만두지 않겠다!	
VO__Male_Dragon_LowCards_01	카드가 부족하다!	
VO__Male_Dragon_MIRROR_GREETINGS_01	넌 그저 과거의 잔재일 뿐이다.	
VO__Male_Dragon_MIRROR_START_01	그래, 피할 수 없는 혼돈을!	
VO__Male_Dragon_NoCards_01	카드를 모두 잃었다!	
VO__Male_Dragon_Oops_01	나라고 매번 완벽할 순 없지.	
VO__Male_Dragon_Picked_01	내가 이 세상을 갈기갈기 찢어주마!	
VO__Male_Dragon_PIRATE_DAY_01	나는 해적왕 넬타리온이다!	
VO__Male_Dragon_Sorry_01	심해만큼이나 깊이 후회한다.	
VO__Male_Dragon_Start_01	혼돈을 맞이해라!	
VO__Male_Dragon_Thanks_01	흐으음. 고맙다.	
VO__Male_Dragon_Thinking_01	흠...	
VO__Male_Dragon_Thinking_03	오묘하군...	
VO__Male_Dragon_Thinking_04	전부 불태워버려야 한다....	
VO__Male_Dragon_Threaten_01	내 분노에서 탈출할 곳은 없다!	
VO__Male_Dragon_Time_01	서둘러라!	
VO__Male_Dragon_Well_Played_01	끈기 하나는 인정해 줘야겠군.	
VO__Male_Dragon_WOW_01	충격적이군!	
VO__Male_Mogu_Concede_01	너의 승리다. 이번에는.	
VO__Male_Mogu_ERROR_FULL_MINIONS_02	더 징집할 수 없다.	
VO__Male_Mogu_ERROR_GENERIC_02	그건 불가능하다.	
VO__Male_Mogu_ERROR_HAND_FULL_02	카드가 이미 많다.	
VO__Male_Mogu_ERROR_I_ATTACKED_01	천둥은 한 번만 울린다.	
VO__Male_Mogu_ERROR_MINION_ATTACKED_02	그 하수인은 이미 공격했다.	
VO__Male_Mogu_ERROR_NEED_MANA_02	마나가 더 필요하다.	
VO__Male_Mogu_ERROR_NEED_WEAPON_01	무기를 대령해라!	
VO__Male_Mogu_ERROR_PLAY_02	그건 낼 수 없다.	
VO__Male_Mogu_ERROR_STEALTH_01	그 녀석은 숨어있다... 지금은.	
VO__Male_Mogu_ERROR_SUMMON_SICKNESS_01	아직 전투에 뛰어들 수 없는 녀석이다.	
VO__Male_Mogu_ERROR_TARGET_01	대상이 필요하다.	
VO__Male_Mogu_ERROR_TAUNT_01	감히 천둥왕을 도발하다니!	
VO__Male_Mogu_FIRE_FESTIVAL_01	불과 번개의 영광을 누려라!	
VO__Male_Mogu_Greetings_01	내 힘을 목도해라.	
VO__Male_Mogu_HAPPY_HALLOWEEN_01	네가 사탕과 의상에 정신이 팔린 동안, 난 다음 계획을 준비하겠다.	
VO__Male_Mogu_HAPPY_HOLIDAYS_01	이 날을 되뇌고 전통을 존중해라.	
VO__Male_Mogu_HAPPY_NEW_YEAR_01	새로운 해가 시작됐다!	
VO__Male_Mogu_HAPPY_NEW_YEAR_LUNAR_01	새해 복을 내리노라!	
VO__Male_Mogu_HAPPY_NOBLEGARDEN_01	봄의 아름다움에 취해 긴장을 풀진 마라.	
VO__Male_Mogu_LowCards_01	카드가 거의 없다.	
VO__Male_Mogu_MIRROR_GREETINGS_01	별로 놀랍진 않구나.	
VO__Male_Mogu_MIRROR_START_01	지켜볼 만한 가치가 있겠어.	
VO__Male_Mogu_NoCards_01	카드가 없다.	
VO__Male_Mogu_Oops_01	순간 주의가 산만했군.	
VO__Male_Mogu_Picked_01	내 힘을 막을 수 있겠느냐!	
VO__Male_Mogu_PIRATE_DAY_01	왕에게 진상하는 거라면 약탈도 허하겠다.	
VO__Male_Mogu_Sorry_01	잘못된 판단이었다.	
VO__Male_Mogu_Start_01	나는 레이 션, 왕과 신을 살해한 자다!	
VO__Male_Mogu_Thanks_01	정말 충직하군.	
VO__Male_Mogu_Thinking_01	흠...	
VO__Male_Mogu_Thinking_02	더 깊게 생각해야...	
VO__Male_Mogu_Thinking_03	아주 교묘해...	
VO__Male_Mogu_Threaten_03	내 앞에 무릎 꿇어라!	
VO__Male_Mogu_Time_01	신속히 움직여라!	
VO__Male_Mogu_Well_Played_01	승리를 갈망하는 모습은 높이 평가하겠다.	
VO__Male_Mogu_WOW_01	날 놀라게 하다니. 예사롭지 않군.	
VO_AnnoyO_Male_Mech_Attack_01	안녕!	
VO_AnnoyO_Male_Mech_Concede_02	안녕...	
VO_AnnoyO_Male_Mech_Death_01	안... 녕...	
VO_AnnoyO_Male_Mech_ERROR_FULL_MINIONS_01	안녕!	
VO_AnnoyO_Male_Mech_ERROR_GENERIC_04	안녕.	
VO_AnnoyO_Male_Mech_ERROR_HAND_FULL_02	아! 안녕!	
VO_AnnoyO_Male_Mech_ERROR_I_ATTACKED_02	아... 안녕...	
VO_AnnoyO_Male_Mech_ERROR_MINION_ATTACKED_01	안녕? 안녕...	
VO_AnnoyO_Male_Mech_ERROR_NEED_MANA_01	안녕, 안녕.	
VO_AnnoyO_Male_Mech_ERROR_NEED_WEAPON_01	안녕.	
VO_AnnoyO_Male_Mech_ERROR_PLAY_01	안녕.	
VO_AnnoyO_Male_Mech_ERROR_STEALTH_01	안녕...	
VO_AnnoyO_Male_Mech_ERROR_SUMMON_SICKNESS_01	안녕... 안녕... 안녕...	
VO_AnnoyO_Male_Mech_ERROR_TARGET_01	안녕.	
VO_AnnoyO_Male_Mech_ERROR_TAUNT_01	안녕.	
VO_AnnoyO_Male_Mech_FIRE_FESTIVAL_01	안녕. 안녕! 안녕!!!	
VO_AnnoyO_Male_Mech_GG_01	안녕!	
VO_AnnoyO_Male_Mech_Greetings_03	안녕! 안녕! 안녕!	
VO_AnnoyO_Male_Mech_HAPPY_HALLOWEEN_01	할로우! 할로우! 할로우!	
VO_AnnoyO_Male_Mech_HAPPY_HOLIDAYS_01	안녀어엉!	
VO_AnnoyO_Male_Mech_HAPPY_NEW_YEAR_01	안녕... 안녕... 안녕!	
VO_AnnoyO_Male_Mech_HAPPY_NEW_YEAR_LUNAR_01	설날! 설날! 설날!	
VO_AnnoyO_Male_Mech_HAPPY_NOBLEGARDEN_01	안녕!	
VO_AnnoyO_Male_Mech_LowCards_01	안녕?!	
VO_AnnoyO_Male_Mech_MIRROR_GREETINGS_02	안녕! 안녕! 안녕!	
VO_AnnoyO_Male_Mech_MIRROR_START_01	안녕? 안녕. 안녕!	
VO_AnnoyO_Male_Mech_NoCards_01	안녕?!	
VO_AnnoyO_Male_Mech_Oops_01	안녕...	
VO_AnnoyO_Male_Mech_Picked_01	안녕! 안녕! 안녕!	
VO_AnnoyO_Male_Mech_PIRATE_DAY_02	해적! 해적! 해적!	
VO_AnnoyO_Male_Mech_Sorry_01	안녕...	
VO_AnnoyO_Male_Mech_Start_01	안녕! 안녕! 안녕!	
VO_AnnoyO_Male_Mech_Thanks_01	안녕!	
VO_AnnoyO_Male_Mech_Thinking_02	안녕? 안녕?	
VO_AnnoyO_Male_Mech_Thinking_03	안... 녕?	
VO_AnnoyO_Male_Mech_Thinking_07	안녕! 안녕! 안녕?	
VO_AnnoyO_Male_Mech_Threaten_01	안녕!	
VO_AnnoyO_Male_Mech_Time_01	안녕! 안녕! 안녕!	
VO_AnnoyO_Male_Mech_Well_Played_01	안녕!	
VO_AnnoyO_Male_Mech_WOW_01	아안녀엉!	
VO_Arthas_Male_Human_Attack_01	악을 정화하겠다!	
VO_Arthas_Male_Human_CONCEDE_01	네가 승리했군. 전투는 끝났다.	
VO_Arthas_Male_Human_ERROR_FULL_MINIONS_01	하수인이 너무 많다!	
VO_Arthas_Male_Human_ERROR_GENERIC_01	그건 할 수 없노라.	
VO_Arthas_Male_Human_ERROR_HAND_FULL_01	카드가 너무 많다!	
VO_Arthas_Male_Human_ERROR_I_ATTACKED_01	난 이미 공격했다.	
VO_Arthas_Male_Human_ERROR_JUST_PLAYED_01	그 하수인은 다음 턴에 준비되겠군.	
VO_Arthas_Male_Human_ERROR_MINION_ATTACKED_01	그 하수인은 이미 공격했다.	
VO_Arthas_Male_Human_ERROR_NEED_MANA_01	마나가 부족하다.	
VO_Arthas_Male_Human_ERROR_NEED_WEAPON_01	무기가 필요하다.	
VO_Arthas_Male_Human_ERROR_PLAY_01	그 카드는 낼 수 없다.	
VO_Arthas_Male_Human_ERROR_STEALTH_01	은신한 하수인은 선택할 수 없다.	
VO_Arthas_Male_Human_ERROR_TARGET_01	선택할 수 없는 대상이다.	
VO_Arthas_Male_Human_ERROR_TAUNT_01	도발 능력이 있는 하수인이 가로막고 있다!	
VO_Arthas_Male_Human_FIRE_FESTIVAL_01	화톳불을 피워라!	
VO_Arthas_Male_Human_GREETINGS_01	로데론의 왕자가 널 맞이하노라.	
VO_Arthas_Male_Human_GREETINGS_RESPONSE	아아, 참으로 반갑군!	
VO_Arthas_Male_Human_HAPPY_HALLOWEEN_01	즐거운 할로윈 축제로군...	
VO_Arthas_Male_Human_HAPPY_HOLIDAYS_01	겨울맞이 축제를 즐겨라!	
VO_Arthas_Male_Human_HAPPY_NEW_YEAR_01	새해에도 왕가의 축복이 함께하길.	
VO_Arthas_Male_Human_HAPPY_NEW_YEAR_LUNAR_01	하하! 너에게 만복이 깃들기를 기원하겠다.	
VO_Arthas_Male_Human_HAPPY_NOBLEGARDEN	즐거운 귀족의 정원 축제로군.	
VO_Arthas_Male_Human_LOW_CARDS_01	카드가 거의 없다.	
VO_Arthas_Male_Human_MIRROR_GREETINGS_01	아아, 참으로 반갑군!	
VO_Arthas_Male_Human_MIRROR_START_01	나의 아버지, 국왕 폐하를 위하여!	
VO_Arthas_Male_Human_NO_CARDS_01	카드가 없다!	
VO_Arthas_Male_Human_OOPS_01	착오였나?	
VO_Arthas_Male_Human_PIRATE_DAY_01	해적이 되기 좋은 날이군.	
VO_Arthas_Male_Human_SORRY_01	부디 용서해라, 친구여.	
VO_Arthas_Male_Human_START_01	로데론을 위하여!	
VO_Arthas_Male_Human_THANKS_01	내 친히 감사의 뜻을 전하지.	
VO_Arthas_Male_Human_THINK1_01	흠...	
VO_Arthas_Male_Human_THINK2_01	선택의 시간이군...	
VO_Arthas_Male_Human_THINK3_01	우서라면 어떻게 했을까...	
VO_Arthas_Male_Human_THREATEN_01	넌 구원받지 못하리라!	
VO_Arthas_Male_Human_TIMER_01	어서 선택해야 한다!	
VO_Arthas_Male_Human_WELL_PLAYED_01	훌륭한 전략이군.	
VO_Arthas_Male_Human_WOW_01	감탄이 절로 나오는군!	
VO_BOT_238_Male_Goblin_Concede_01	망했네. 자폭!	
VO_BOT_238_Male_Goblin_Greetings_02	붐 박사 나가신다!	
VO_BOT_238_Male_Goblin_HAPPY_HALLOWEEN_01	워! 하하하! 할로윈 축제야!	
VO_BOT_238_Male_Goblin_LowCards_01	카드가 거의 없어...	
VO_BOT_238_Male_Goblin_NoCards_01	젠장! 카드가 없어!	
VO_BOT_238_Male_Goblin_Oops_01	맙소사. 실수라니.	
VO_BOT_238_Male_Goblin_Thanks_01	고마워! 넌 맨 마지막에 처리해줄게.	
VO_BOT_238_Male_Goblin_Thinking_01	그렇다면...	
VO_BOT_238_Male_Goblin_Thinking_02	계획이 필요하겠는데...	
VO_BOT_238_Male_Goblin_Thinking_03	흐으음...	
VO_BOT_238_Male_Goblin_Threaten_01	이 커다랗고 빨간 버튼 누르게 하지 마!	
VO_BOT_238_Male_Goblin_Time_03	아, 이 소리 정말 듣기 좋다니까.	
VO_BOT_238_Male_Goblin_Well_Played_02	너 좀 잘하네.	
VO_BOT_238_Male_Goblin_WOW_01	오호라!	
VO_BRM_027h__LUNAR_NEW_YEAR	화염 속에 새해를 맞이하라!	
VO_BRM_027h_Attack_15	설퍼론의 유황 맛을 보아라!	
VO_BRM_027h_Concede_11	네가 이겼노라! 잘했다!	
VO_BRM_027h_Emote_Start	복수의 시간이다, 용이여!	
VO_BRM_027h_ERROR01_51	무기가 필요하다!	
VO_BRM_027h_ERROR02_52	마나가 부족하다!	
VO_BRM_027h_ERROR03_53	그건 이미 공격했다.	
VO_BRM_027h_ERROR04_54	난 이미 공격했노라.	
VO_BRM_027h_ERROR05_55	그 필멸자는 다음 턴에 준비될 것이다.	
VO_BRM_027h_ERROR06_56	카드가 너무 많다!	
VO_BRM_027h_ERROR07_57	하수인이 너무 많군.	
VO_BRM_027h_ERROR08_58	그건 은신하고 있다!	
VO_BRM_027h_ERROR09_59	그건 낼 수 없노라.	
VO_BRM_027h_ERROR10_60	유효하지 않다.	
VO_BRM_027h_ERROR11_61	저 도발 하수인이 거슬린다!	
VO_BRM_027h_ERROR12_62	그럴 수 없다.	
VO_BRM_027h_FIRE_FESTIVAL	내가 주인공인 축제구나!	
VO_BRM_027h_GG_16	좋은 승부였다!	
VO_BRM_027h_Greetings_04	불의 세례를 받아라!	
VO_BRM_027h_GREETINGS_RESPONSE	이단자로군! 너부터 내가 정화해주겠다!	
VO_BRM_027h_HALLOWS_END	즐거운 할로윈 축제군!	
VO_BRM_027h_HAPPY_NEW_YEAR_38	새로운 해가 타오른다!	
VO_BRM_027h_LowCards_49	카드를 거의 다 태워버렸다!	
VO_BRM_027h_NOBLEGARDEN	귀족의 정원이라니, 깡그리 태워버리겠다!	
VO_BRM_027h_NoCards_50	카드를 모두 태워버렸다!	
VO_BRM_027h_Oops_07	흥! 실수였다!	
VO_BRM_027h_PIRATE_DAY	불의 축복을 받아라, 해적들이여!	
VO_BRM_027h_Sorry_10	미안하다!	
VO_BRM_027h_Thanks_09	훈훈하군.	
VO_BRM_027h_Thinking1_12	흠...	
VO_BRM_027h_Thinking2_13	고민되는군...	
VO_BRM_027h_Thinking3_14	어느 놈부터 태워버릴까...	
VO_BRM_027h_Threaten_08	너희 모두 불꽃으로 스러지리라!	
VO_BRM_027h_Time_48	심지가 불타고 있다!	
VO_BRM_027h_Well_Played_06	훌륭하군!	
VO_BRM_027h_Winterveil_Greetings	이 계절은 좀 따뜻해질 필요가 있겠군!	
VO_BRM_027h_WOW_20	강렬하군!	
VO_DRG_600_Male_Dragon_Concede_01	내 군대를 물리쳤구나. 축하한다.	
VO_DRG_600_Male_Dragon_Greetings_01	지옥불꽃에 휩싸여라!	
VO_DRG_600_Male_Dragon_MIRROR_GREETINGS_01	이미 휩싸였거늘 무슨 소리냐!	
VO_DRG_600_Male_Dragon_MIRROR_START_01	그래, 너까지 불태워주마!	
VO_DRG_600_Male_Dragon_Oops_01	방금 건... 고통스럽군.	
VO_DRG_600_Male_Dragon_Picked_01	온 세상을 불태울 시간이로다!	
VO_DRG_600_Male_Dragon_Sorry_01	미안하구나. 하지만 네가 더 미안하게 될 거다.	
VO_DRG_600_Male_Dragon_Start_01	불태워라! 전부 다!	
VO_DRG_600_Male_Dragon_Thanks_01	네 부질 없는 노력에 감사를 표한다.	
VO_DRG_600_Male_Dragon_Threaten_01	영원은 너의 영혼에게 자비를 베풀지 않으리라.	
VO_DRG_600_Male_Dragon_Time_01	시간이 불타고 있다!	
VO_DRG_600_Male_Dragon_Well_Played_01	놀랍구나. 필멸자 치고는.	
VO_DRG_600_Male_Dragon_WOW_01	아주 만족스러운 악랄함이구나.	
VO_DRG_610_Male_Dragon_Concede_01	악몽이 끝났다. 네가 이겼구나.	
VO_DRG_610_Male_Dragon_Greetings_01	너의 공포는 아주 탐스럽구나.	
VO_DRG_610_Male_Dragon_MIRROR_GREETINGS_01	네 공포를 나의 것으로 착각하지 마라.	
VO_DRG_610_Male_Dragon_MIRROR_START_01	그러면 너에게 진정한 공포를 보여주지.	
VO_DRG_610_Male_Dragon_Oops_01	소름이 끼치는군.	
VO_DRG_610_Male_Dragon_Picked_01	어둠을 택하다니, 현명하구나.	
VO_DRG_610_Male_Dragon_Sorry_01	미안하군. 내가 그렇게 무섭나?	
VO_DRG_610_Male_Dragon_Start_01	넌 이 악몽에서 깨어날 수 없다.	
VO_DRG_610_Male_Dragon_Thanks_01	고맙다. 넌 가장 나중에 없애주마.	
VO_DRG_610_Male_Dragon_Threaten_01	너의 비명은 아주 감미롭구나.	
VO_DRG_610_Male_Dragon_Time_01	어둠이 옅어진다!	
VO_DRG_610_Male_Dragon_Well_Played_01	네 평정심은... 인상적이구나.	
VO_DRG_610_Male_Dragon_WOW_01	놀랍군!	
VO_DRG_620_Male_Dragon_Concede_01	폭풍이 멎었군. 포기하겠다.	
VO_DRG_620_Male_Dragon_Greetings_01	폭풍을 견딜 수 있겠느냐?	
VO_DRG_620_Male_Dragon_MIRROR_GREETINGS_01	폭풍은 내 의지만을 따른다!	
VO_DRG_620_Male_Dragon_MIRROR_START_01	하늘은 나에게만 복종한다!	
VO_DRG_620_Male_Dragon_Oops_01	이런 대참사가!	
VO_DRG_620_Male_Dragon_Picked_01	폭풍 앞에 전율해라!	
VO_DRG_620_Male_Dragon_Sorry_01	안됐지만, 제물이 필요하다 보니.	
VO_DRG_620_Male_Dragon_Start_01	나는 휘몰아치는 폭풍이다!	
VO_DRG_620_Male_Dragon_Thanks_01	고맙다. 내 바람이 더욱 세차게 부는구나.	
VO_DRG_620_Male_Dragon_Threaten_02	감히 자연의 섭리에 맞서려 하느냐?	
VO_DRG_620_Male_Dragon_Time_01	폭풍의 눈이 다가온다!	
VO_DRG_620_Male_Dragon_Well_Played_01	대지조차 전율하는구나!	
VO_DRG_620_Male_Dragon_WOW_01	돌풍처럼 휩쓰는구나!	
VO_DRG_650_Male_Dragon_Concede_01	용케 날 막았구나. 하지만 난 돌아오리라!	
VO_DRG_650_Male_Dragon_Greetings_01	무적의 갈라크론드에게 굴복하라!	
VO_DRG_650_Male_Dragon_MIRROR_GREETINGS_01	과연 누가 먼저 굴복할지 보자꾸나.	
VO_DRG_650_Male_Dragon_MIRROR_START_01	무적의 존재가 둘이라? 이거 재밌겠군.	
VO_DRG_650_Male_Dragon_Oops_02	아주 치명적인 실수로군!	
VO_DRG_650_Male_Dragon_Picked_01	누가 내 힘에 대적하겠느냐!	
VO_DRG_650_Male_Dragon_Sorry_01	미안하다. 이제야 알아차렸군.	
VO_DRG_650_Male_Dragon_Start_01	승리를 향한 너의 집념은 부질 없다.	
VO_DRG_650_Male_Dragon_Thanks_01	하찮은 선물이지만 고맙다고 해두지.	
VO_DRG_650_Male_Dragon_Threaten_01	거인 앞의 벌레 같은 꼴이구나!	
VO_DRG_650_Male_Dragon_Time_01	난 무적이지만, 시간을 막을 순 없다!	
VO_DRG_650_Male_Dragon_Well_Played_01	강렬하구나!	
VO_DRG_650_Male_Dragon_WOW_02	그건, 좀 놀랍군.	
VO_DRG_660_Male_Dragon_Concede_01	포기하겠다. 네가 얻어낸 적막함을 즐겨라.	
VO_DRG_660_Male_Dragon_Greetings_01	네가 보인다.	
VO_DRG_660_Male_Dragon_MIRROR_GREETINGS_01	내가 숨어 있다 생각한 거냐?	
VO_DRG_660_Male_Dragon_MIRROR_START_01	그래, 나에게만 들리는 속삭임이다.	
VO_DRG_660_Male_Dragon_Oops_01	아, 공포스럽군.	
VO_DRG_660_Male_Dragon_Picked_01	저들의 세계를 광기로 뒤덮으리라!	
VO_DRG_660_Male_Dragon_Sorry_01	미안하군. 내가 대체 무슨 짓을 한 건지.	
VO_DRG_660_Male_Dragon_Start_01	들린다. 그들의 속삭임이.	
VO_DRG_660_Male_Dragon_Thanks_01	너의 광기는... 만족스럽구나.	
VO_DRG_660_Male_Dragon_Threaten_01	네 정신이 무너진다.	
VO_DRG_660_Male_Dragon_Time_01	뭐라고?! 시간이 없다!	
VO_DRG_660_Male_Dragon_Well_Played_01	미친 짓이지만... 마음에 드는군.	
VO_DRG_660_Male_Dragon_WOW_01	방금 건... 예상 외였어.	
VO_DRG_6x_Male_Dragon_ERROR_FULL_MINIONS_01	하수인이 너무 많다!	
VO_DRG_6x_Male_Dragon_ERROR_GENERIC_01	그건 불가능하다.	
VO_DRG_6x_Male_Dragon_ERROR_HAND_FULL_01	카드가 너무 많다.	
VO_DRG_6x_Male_Dragon_ERROR_I_ATTACKED_01	다시 공격할 순 없다.	
VO_DRG_6x_Male_Dragon_ERROR_MINION_ATTACKED_01	그 하수인은 이미 공격했다.	
VO_DRG_6x_Male_Dragon_ERROR_NEED_MANA_01	그러려면 마나가 더 필요하다.	
VO_DRG_6x_Male_Dragon_ERROR_NEED_WEAPON_01	무기가 필요하다. 발톱이나.	
VO_DRG_6x_Male_Dragon_ERROR_PLAY_01	그건 할 수 없다.	
VO_DRG_6x_Male_Dragon_ERROR_STEALTH_01	그 하수인은 은신 중이다.	
VO_DRG_6x_Male_Dragon_ERROR_SUMMON_SICKNESS_01	저 나약한 것은 준비할 시간이 필요하다.	
VO_DRG_6x_Male_Dragon_ERROR_TARGET_01	그건 대상으로 지정할 수 없다.	
VO_DRG_6x_Male_Dragon_ERROR_TAUNT_01	도발 능력이 있는 하수인을 공격해야 한다!	
VO_DRG_6x_Male_Dragon_FIRE_FESTIVAL_01	불꽃놀이인가. 재밌겠군.	
VO_DRG_6x_Male_Dragon_HAPPY_HALLOWEEN_01	할로윈 축제라. 내가 가장 좋아하는 기간이군.	
VO_DRG_6x_Male_Dragon_HAPPY_HOLIDAYS_01	즐거운 겨울맞이 축제로다!	
VO_DRG_6x_Male_Dragon_HAPPY_NEW_YEAR_01	새해를 맞이해라!	
VO_DRG_6x_Male_Dragon_HAPPY_NEW_YEAR_LUNAR_01	내 친히 너에게 복을 내리노라.	
VO_DRG_6x_Male_Dragon_HAPPY_NOBLEGARDEN_01	귀족의 정원 축제라. 역겹군.	
VO_DRG_6x_Male_Dragon_LowCards_01	카드가 얼마 없다.	
VO_DRG_6x_Male_Dragon_NoCards_01	카드가 없다!	
VO_DRG_6x_Male_Dragon_PIRATE_DAY_01	야르! 하늘의 약탈자 갈라크론드가 왔노라!	
VO_DRG_6x_Male_Dragon_Thinking_01	이건 어떨까...	
VO_DRG_6x_Male_Dragon_Thinking_02	그렇다면...	
VO_DRG_6x_Male_Dragon_Thinking_03	만약에...	
VO_EX1_323h_HAPPY_NEW_YEAR_13	새해가 밝았다!	
VO_GIL_504_Female_Orc_Concede_01	이번엔 네가 이겼구나.	
VO_GIL_504_Female_Orc_Greetings_02	내 영지에 온 걸 환영한다.	
VO_GIL_504_Female_Orc_GREETINGS_RESPONSE	과연 누구의 영역일지 결판을 내자.	
VO_GIL_504_Female_Orc_LowCards_01	카드가 거의 없다!	
VO_GIL_504_Female_Orc_NoCards_01	카드가 없다!	
VO_GIL_504_Female_Orc_Oops_01	어리석었군.	
VO_GIL_504_Female_Orc_Start_01	한밤중의 숲은 위험한 곳이지.	
VO_GIL_504_Female_Orc_Thanks_01	고맙다.	
VO_GIL_504_Female_Orc_Thinking_01	흠...	
VO_GIL_504_Female_Orc_Thinking_02	오묘하군...	
VO_GIL_504_Female_Orc_Thinking_03	어둑한 오솔길을 따라서...	
VO_GIL_504_Female_Orc_Threaten_02	저주받을지어다!	
VO_GIL_504_Female_Orc_Time_01	선택해야만 해!	
VO_GIL_504_Female_Orc_Well_Played_01	경이롭군.	
VO_GIL_504_Female_Orc_Wow_01	이토록 놀라울 수가!	
VO_GILA_400h_Male_Human_Concede_01	넌 좀 대단한 녀석이군!	
VO_GILA_400h_Male_Human_Death_02	<죽음>	
VO_GILA_400h_Male_Human_ERROR_FULL_MINIONS_01	공간이 없어.	
VO_GILA_400h_Male_Human_ERROR_GENERIC_01	그럴 수 없어.	
VO_GILA_400h_Male_Human_ERROR_GENERIC_04	안 돼, 그건.	
VO_GILA_400h_Male_Human_ERROR_HAND_FULL_01	카드가 너무 많아!	
VO_GILA_400h_Male_Human_ERROR_I_ATTACKED_01	난 이미 공격했다.	
VO_GILA_400h_Male_Human_ERROR_MINION_ATTACKED_01	그 하수인은 이미 공격했어.	
VO_GILA_400h_Male_Human_ERROR_NEED_MANA_02	마나가 부족해!	
VO_GILA_400h_Male_Human_ERROR_NEED_WEAPON_02	무기가 필요한데.	
VO_GILA_400h_Male_Human_ERROR_STEALTH_01	은신한 녀석이야.	
VO_GILA_400h_Male_Human_ERROR_SUMMON_SICKNESS_01	아직 준비가 안 된 녀석이야.	
VO_GILA_400h_Male_Human_ERROR_TARGET_01	대상으로 지정할 수 없어.	
VO_GILA_400h_Male_Human_ERROR_TAUNT_01	도발 능력이 있는 하수인이 가로막고 있군.	
VO_GILA_400h_Male_Human_Greetings_01	넌... 마음에 안 들어.	
VO_GILA_400h_Male_Human_GREETINGS_RESPONSE	그래, 그럴 줄 알았지.	
VO_GILA_400h_Male_Human_LowCards_01	카드가 거의 없다...	
VO_GILA_400h_Male_Human_NoCards_01	카드가 없어!	
VO_GILA_400h_Male_Human_Oops_01	아, 젠장.	
VO_GILA_400h_Male_Human_Sorry_01	미안하군.	
VO_GILA_400h_Male_Human_Start_01	개들이 뭔가를 찾아냈군.	
VO_GILA_400h_Male_Human_Thanks_01	고맙다고 해야하나.	
VO_GILA_400h_Male_Human_Thinking_01	흠...	
VO_GILA_400h_Male_Human_Thinking_03	다시 생각해봐야겠어...	
VO_GILA_400h_Male_Human_Thinking_04	이걸 이러면...	
VO_GILA_400h_Male_Human_Threaten_04	죽은척 하는 게 좋을 거다.	
VO_GILA_400h_Male_Human_Time_01	시간이 촉박하다.	
VO_GILA_400h_Male_Human_Well_Played_01	괜찮은 재주로군!	
VO_GILA_400h_Male_Human_WOW_01	요놈 봐라!	
VO_GILA_500h3_Female_Human_Concede_01	너한테... 당하다니!	
VO_GILA_500h3_Female_Human_ERROR_FULL_MINIONS_01	공간이 없다.	
VO_GILA_500h3_Female_Human_ERROR_GENERIC_04	그런 게 가능할 리가!	
VO_GILA_500h3_Female_Human_ERROR_HAND_FULL_02	손에 카드가 가득해!	
VO_GILA_500h3_Female_Human_ERROR_I_ATTACKED_02	두 번 공격할 순 없다!	
VO_GILA_500h3_Female_Human_ERROR_MINION_ATTACKED_01	이미 공격한 하수인이다.	
VO_GILA_500h3_Female_Human_ERROR_NEED_MANA_02	마나가 부족하다.	
VO_GILA_500h3_Female_Human_ERROR_NEED_WEAPON_02	무기가 필요하겠는데?	
VO_GILA_500h3_Female_Human_ERROR_PLAY_01	규칙을 어길 수는 없다.	
VO_GILA_500h3_Female_Human_ERROR_STEALTH_01	대상이 보이지 않는다!	
VO_GILA_500h3_Female_Human_ERROR_SUMMON_SICKNESS_01	그 하수인은 아직 준비되지 않았다.	
VO_GILA_500h3_Female_Human_ERROR_TARGET_01	그건 대상으로 지정할 수 없어.	
VO_GILA_500h3_Female_Human_ERROR_TAUNT_01	도발 능력이 있는 하수인이 가로막고 있다!	
VO_GILA_500h3_Female_Human_Greetings_01	무관의 연맹이 너에게 안부를 전한다.	
VO_GILA_500h3_Female_Human_GREETINGS_RESPONSE	나도 똑같이 돌려주도록 하지.	
VO_GILA_500h3_Female_Human_LowCards_01	카드가 얼마 없어...	
VO_GILA_500h3_Female_Human_NoCards_01	카드가 없다!	
VO_GILA_500h3_Female_Human_Oops_02	방금 그건... 좀 의외군.	
VO_GILA_500h3_Female_Human_Sorry_01	방금 건 미안하구나.	
VO_GILA_500h3_Female_Human_Start_01	길이 날 이곳으로 이끌었다.	
VO_GILA_500h3_Female_Human_Thanks_01	고맙구나.	
VO_GILA_500h3_Female_Human_Thinking_02	해답은 반드시 있는 법...	
VO_GILA_500h3_Female_Human_Thinking_03	집중해, 테스.	
VO_GILA_500h3_Female_Human_Thinking_05	아... 흠.	
VO_GILA_500h3_Female_Human_Threaten_03	널 끝장내버리겠어!	
VO_GILA_500h3_Female_Human_Time_01	서둘러야 한다.	
VO_GILA_500h3_Female_Human_Well_Played_01	좋은 전술이다.	
VO_GILA_500h3_Female_Human_WOW_01	실로 놀랍구나.	
VO_GILA_600h_Male_Worgen_Concede_01	나보다 한 수 위군!	
VO_GILA_600h_Male_Worgen_ERROR_FULL_MINIONS_02	전장에 하수인이 너무 많소.	
VO_GILA_600h_Male_Worgen_ERROR_GENERIC_01	불가능하오.	
VO_GILA_600h_Male_Worgen_ERROR_GENERIC_02	그건 할 수 없소.	
VO_GILA_600h_Male_Worgen_ERROR_HAND_FULL_01	카드가 너무 많소!	
VO_GILA_600h_Male_Worgen_ERROR_I_ATTACKED_01	난 이미 공격했소.	
VO_GILA_600h_Male_Worgen_ERROR_MINION_ATTACKED_01	그 하수인은 이미 공격했소.	
VO_GILA_600h_Male_Worgen_ERROR_NEED_MANA_01	마나가 없소.	
VO_GILA_600h_Male_Worgen_ERROR_NEED_WEAPON_02	무기가 필요하오.	
VO_GILA_600h_Male_Worgen_ERROR_STEALTH_01	저 하수인이 은신해 있소!	
VO_GILA_600h_Male_Worgen_ERROR_SUMMON_SICKNESS_01	아직 움직일 수 없소.	
VO_GILA_600h_Male_Worgen_ERROR_TARGET_01	대상으로 지정할 수 없소.	
VO_GILA_600h_Male_Worgen_ERROR_TAUNT_01	도발 능력이 있는 하수인이 가로막고 있소!	
VO_GILA_600h_Male_Worgen_Greetings_01	내 커다란 친구에게 인사나 하시오.	
VO_GILA_600h_Male_Worgen_GREETINGS_RESPONSE	반갑군, 커다란 친구여.	
VO_GILA_600h_Male_Worgen_LowCards_01	카드가 거의 없소.	
VO_GILA_600h_Male_Worgen_NoCards_01	카드가 다 떨어졌소!	
VO_GILA_600h_Male_Worgen_Oops_01	잘못된 판단을 했군!	
VO_GILA_600h_Male_Worgen_Sorry_01	음... 미안하오.	
VO_GILA_600h_Male_Worgen_Start_01	전 포대 위치로!	
VO_GILA_600h_Male_Worgen_Thanks_01	고맙소.	
VO_GILA_600h_Male_Worgen_Thinking_01	흠...	
VO_GILA_600h_Male_Worgen_Thinking_02	다음 수는...	
VO_GILA_600h_Male_Worgen_Thinking_04	방법을 찾아야 해...	
VO_GILA_600h_Male_Worgen_Threaten_01	그대를 조각내버리겠소!	
VO_GILA_600h_Male_Worgen_Time_01	재촉하지 마시오!	
VO_GILA_600h_Male_Worgen_Well_Played_01	훌륭한 책략이오.	
VO_GILA_600h_Male_Worgen_WOW_01	믿을 수 없군!	
VO_GILA_900h_Female_Gnome_Concede_01	아, 제겐 벅차네요. 당신이 이겼어요!	
VO_GILA_900h_Female_Gnome_ERROR_FULL_MINIONS_02	하수인을 더 낼 수 없어요.	
VO_GILA_900h_Female_Gnome_ERROR_GENERIC_01	그럴 수 없어요.	
VO_GILA_900h_Female_Gnome_ERROR_HAND_FULL_01	카드가 너무 많아요!	
VO_GILA_900h_Female_Gnome_ERROR_I_ATTACKED_02	아직 공격할 수 없어요!	
VO_GILA_900h_Female_Gnome_ERROR_MINION_ATTACKED_01	그 하수인은 이미 공격했어요.	
VO_GILA_900h_Female_Gnome_ERROR_NEED_MANA_01	마나가 부족해요!	
VO_GILA_900h_Female_Gnome_ERROR_NEED_WEAPON_01	무기가 없어요.	
VO_GILA_900h_Female_Gnome_ERROR_PLAY_01	저조차도 그건 할 수 없어요.	
VO_GILA_900h_Female_Gnome_ERROR_STEALTH_01	그 대상은 은신하고 있어요!	
VO_GILA_900h_Female_Gnome_ERROR_SUMMON_SICKNESS_01	그 하수인은 준비할 시간이 필요해요.	
VO_GILA_900h_Female_Gnome_ERROR_TARGET_01	잘못된 대상이에요.	
VO_GILA_900h_Female_Gnome_ERROR_TAUNT_01	도발 능력이 있는 하수인이 가로막고 있어요!	
VO_GILA_900h_Female_Gnome_GG_01	정말 좋은 승부였어요!	
VO_GILA_900h_Female_Gnome_Greetings_01	아, 안녕하세요! 또 당신이군요.	
VO_GILA_900h_Female_Gnome_GREETINGS_RESPONSE	대체 제가 시간을 얼마나 엉망으로 만든 거죠?	
VO_GILA_900h_Female_Gnome_LowCards_01	카드가 얼마 없어요...	
VO_GILA_900h_Female_Gnome_NoCards_01	카드가 없어요!	
VO_GILA_900h_Female_Gnome_Oops_02	방금 그건 실수 같아요.	
VO_GILA_900h_Female_Gnome_Sorry_01	어... 죄송해요.	
VO_GILA_900h_Female_Gnome_Start_01	당신의 시간은 끝났어요!	
VO_GILA_900h_Female_Gnome_Thanks_01	고마워요.	
VO_GILA_900h_Female_Gnome_Thinking_02	흠...	
VO_GILA_900h_Female_Gnome_Thinking_03	...4차원적으로 생각해야겠어...	
VO_GILA_900h_Female_Gnome_Thinking_05	똑딱똑딱...	
VO_GILA_900h_Female_Gnome_Threaten_01	시간대에서 당신을 지워버리겠어요!	
VO_GILA_900h_Female_Gnome_Time_01	제게 시간이 없다니 말도 안 돼요!	
VO_GILA_900h_Female_Gnome_Well_Played_01	저라도 그렇게 못 했을 거예요!	
VO_GILA_900h_Female_Gnome_WOW_02	말도 안 돼요!	
VO_HERO_01_HAPPY_NEW_YEAR_06	새로운 해가 밝았다!	
VO_HERO_01d_Male_Orc_Attack_01	마그하르를 위하여!	
VO_HERO_01d_Male_Orc_Greetings_01	모크라.	
VO_HERO_01d_Male_Orc_MIRROR_GREETINGS_01	반갑다, 친구.	
VO_HERO_01d_Male_Orc_MIRROR_START_01	그 끝에 승리가 있다면 기꺼이.	
VO_HERO_01d_Male_Orc_Oops_01	어색하기 짝이 없군.	
VO_HERO_01d_Male_Orc_Start_01	운명을 받아들여라.	
VO_HERO_01d_Male_Orc_Thanks_01	고맙다.	
VO_HERO_01d_Male_Orc_Threaten_01	난 그 누구도 따르지 않는다!	
VO_HERO_01d_Male_Orc_Well_Played_01	넌 진정한 명예가 뭔지 아는구나.	
VO_HERO_01d_Male_Orc_Wow_01	정말 놀랍군.	
VO_HERO_01g_Male_Orc_Attack_01	내 힘을 보아라!	
VO_HERO_01g_Male_Orc_Greetings_01	강인함을 잃지 마라.	
VO_HERO_01g_Male_Orc_IntroValeera_01	그렇고말고!	
VO_HERO_01g_Male_Orc_MIRROR_GREETINGS_01	강인하게, 그리고 용맹하게.	
VO_HERO_01g_Male_Orc_MIRROR_START_01	그렇다면 여기서 결판을 내자!	
VO_HERO_01g_Male_Orc_Oops_01	아무리 위대한 전사라도 어려움에 처할 때가 있는 법.	
VO_HERO_01g_Male_Orc_Start_01	누구도 내게 대적할 순 없다!	
VO_HERO_01g_Male_Orc_Thanks_01	내 감사를 받아라.	
VO_HERO_01g_Male_Orc_Threaten_01	피라미는 썩 비켜라!	
VO_HERO_01g_Male_Orc_Well_Played_01	나름 자격이 있는 녀석이구나.	
VO_HERO_01g_Male_Orc_Wow_01	대단하군!	
VO_HERO_02_HAPPY_NEW_YEAR_07	즐거운 새해로군, 친구여!	
VO_HERO_02b_Male_Troll_Concede_01	정말 용맹하군. 난 여기까진가!	
VO_HERO_02b_Male_Troll_ERROR_FULL_MINIONS_02	하수인이 너무 많다.	
VO_HERO_02b_Male_Troll_ERROR_GENERIC_02	아니, 그럴 순 없어.	
VO_HERO_02b_Male_Troll_ERROR_HAND_FULL_01	카드가 너무 많아!	
VO_HERO_02b_Male_Troll_ERROR_I_ATTACKED_02	난 이미 공격했다.	
VO_HERO_02b_Male_Troll_ERROR_MINION_ATTACKED_01	그 하수인은 이미 공격했다.	
VO_HERO_02b_Male_Troll_ERROR_NEED_MANA_01	마나가 필요하군.	
VO_HERO_02b_Male_Troll_ERROR_NEED_WEAPON_01	무기가 필요하다.	
VO_HERO_02b_Male_Troll_ERROR_PLAY_01	그럴 순 없다.	
VO_HERO_02b_Male_Troll_ERROR_STEALTH_01	내게서 숨어있다니!	
VO_HERO_02b_Male_Troll_ERROR_SUMMON_SICKNESS_01	그 하수인은 다음 턴에 준비될 거다.	
VO_HERO_02b_Male_Troll_ERROR_TARGET_01	대상이 없군.	
VO_HERO_02b_Male_Troll_ERROR_TAUNT_02	도발 하수인을 공격해야 해.	
VO_HERO_02b_Male_Troll_FIRE_FESTIVAL_01	불꽃축제가 시작됐군!	
VO_HERO_02b_Male_Troll_Greetings_01	환영한다! 예를 갖추는 걸 허하노라.	
VO_HERO_02b_Male_Troll_HAPPY_HALLOWEEN_01	하하! 할로윈 축제로군!	
VO_HERO_02b_Male_Troll_HAPPY_HOLIDAYS_01	뜻깊은 날들을 보내길.	
VO_HERO_02b_Male_Troll_HAPPY_NEW_YEAR_01	한 해 동안 평안하길.	
VO_HERO_02b_Male_Troll_HAPPY_NEW_YEAR_LUNAR_01	새해에도 복이 가득하길.	
VO_HERO_02b_Male_Troll_HAPPY_NOBLEGARDEN_01	마지막으로 말하는데, 이 머리 장식에는 알이 없다!	
VO_HERO_02b_Male_Troll_LowCards_01	카드가 얼마 없다.	
VO_HERO_02b_Male_Troll_MIRROR_GREETINGS_01	내 즐거움을 망치지 마라.	
VO_HERO_02b_Male_Troll_MIRROR_START_01	우리들 중 한 명은 곧 무릎을 꿇게 되겠군.	
VO_HERO_02b_Male_Troll_NoCards_01	카드가 다 떨어졌다!	
VO_HERO_02b_Male_Troll_Oops_02	가끔씩 일어나는 일이지.	
VO_HERO_02b_Male_Troll_Picked_01	왕이 되는 건 좋은 일이지.	
VO_HERO_02b_Male_Troll_PIRATE_DAY_01	오늘만큼은 해적질을 허하노라.	
VO_HERO_02b_Male_Troll_Sorry_01	미안하군.	
VO_HERO_02b_Male_Troll_Start_02	내가 바로 왕 라스타칸이다.	
VO_HERO_02b_Male_Troll_Thanks_01	고맙다.	
VO_HERO_02b_Male_Troll_Thinking_05	아... 흠...	
VO_HERO_02b_Male_Troll_Thinking_11	내 영광을 위해서라면...	
VO_HERO_02b_Male_Troll_Thinking_15	로아께서 내게 말씀하시는군...	
VO_HERO_02b_Male_Troll_Threaten_04	고개를 조아려라!	
VO_HERO_02b_Male_Troll_Time_01	날 재촉하지 마라!	
VO_HERO_02b_Male_Troll_Well_Played_01	아주 인상적이군.	
VO_HERO_02b_Male_Troll_WOW_01	어찌 이런 일이?	
VO_HERO_03_Female_BloodElf_Emote_05	수상하다고? 내가?	
VO_HERO_03_HAPPY_NEW_YEAR_06	올해도 좋은 일만 가득하길.	
VO_HERO_03a_Attack_15	정의를 실현하리라!	
VO_HERO_03a_CONCEDE_06	영리한 판단이군. 항복하지.	
VO_HERO_03a_ERROR_FULL_MINIONS_25	하수인이 너무 많다!	
VO_HERO_03a_ERROR_GENERIC_30	그건 할 수 없다.	
VO_HERO_03a_ERROR_HAND_FULL_24	카드가 너무 많다.	
VO_HERO_03a_ERROR_I_ATTACKED_22	난 이미 공격했다.	
VO_HERO_03a_ERROR_JUST_PLAYED_23	그 하수인은 다음 턴에 준비될 거다.	
VO_HERO_03a_ERROR_MINION_ATTACKED_21	그 하수인은 이미 공격했다.	
VO_HERO_03a_ERROR_NEED_MANA_20	마나가 부족하다.	
VO_HERO_03a_ERROR_NEED_WEAPON_19	무기가 필요하다.	
VO_HERO_03a_ERROR_PLAY_27	그 카드는 낼 수 없다.	
VO_HERO_03a_ERROR_STEALTH_26	은신한 하수인은 선택할 수 없다.	
VO_HERO_03a_ERROR_TARGET_28	선택할 수 없는 대상이다.	
VO_HERO_03a_ERROR_TAUNT_29	도발 능력이 있는 하수인이 가로막고 있다.	
VO_Hero_03a_Female_NightElf_Start_Illidan_01	사냥감을 찾았다.	
VO_HERO_03a_FIRE_FESTIVAL	즐거운 한여름 축제로군!	
VO_HERO_03a_GREETINGS_03	반갑군, 친구여.	
VO_HERO_03a_GREETINGS_RESPONSE	누군가 했더니. 반갑구나.	
VO_HERO_03a_HALLOWS_END	할로윈 축제를 즐겨라!	
VO_HERO_03a_HAPPY_HOLIDAYS_52	즐거운 겨울맞이 축제로군!	
VO_HERO_03a_HAPPY_NEW_YEAR_53	즐거운 새해로다!	
VO_HERO_03a_HAPPY_NEW_YEAR_LUNAR_16	즐거운 새해로다!	
VO_HERO_03a_LOW_CARDS_17	카드가 거의 없다.	
VO_HERO_03a_MIRROR_GREETINGS_04	누군가 했더니. 반갑군요!	
VO_HERO_03a_MIRROR_START_02	나는 정의를 수호한다!	
VO_HERO_03a_NO_CARDS_18	카드가 없다!	
VO_HERO_03a_NOBLEGARDEN	귀족의 정원 축제로군. 알은 어디있지?	
VO_HERO_03a_OOPS_08	전술적 착오로군.	
VO_HERO_03a_PICKED_11	때가 왔다!	
VO_HERO_03a_PIRATE_DAY	야르! 승선하라!	
VO_HERO_03a_SORRY_10	미안하군요.	
VO_HERO_03a_START_01	누구도 내 분노를 피할 수는 없다!	
VO_HERO_03a_THANKS_09	고맙다.	
VO_HERO_03a_THINK1_12	흠...	
VO_HERO_03a_THINK2_13	흠... 이렇게 하면...	
VO_HERO_03a_THINK3_14	생각해보자...	
VO_HERO_03a_THREATEN_05	네놈에게 내 분노를 보여주겠다!	
VO_HERO_03a_TIMER_16	빨리 결정해야한다!	
VO_HERO_03a_WELL_PLAYED_07	훌륭하다.	
VO_HERO_03a_WOW_35	놀랍군!	
VO_HERO_03e_Female_BloodElf_Attack_01	하!	
VO_HERO_03e_Female_BloodElf_Greetings_01	안녕!	
VO_HERO_03e_Female_BloodElf_IntroGarrosh_01	이제 좀 재밌겠는데!	
VO_HERO_03e_Female_BloodElf_MIRROR_GREETINGS_01	낯익은 얼굴이네.	
VO_HERO_03e_Female_BloodElf_MIRROR_START_01	괜찮은 상대를 만났네.	
VO_HERO_03e_Female_BloodElf_Oops_01	실수라고?	
VO_HERO_03e_Female_BloodElf_Start_01	한 곡 추겠어?	
VO_HERO_03e_Female_BloodElf_Thanks_01	정말 고마워.	
VO_HERO_03e_Female_BloodElf_Threaten_01	모든 꽃에는 가시가 있지.	
VO_HERO_03e_Female_BloodElf_Well_Played_01	잘 싸웠어.	
VO_HERO_03e_Female_BloodElf_Wow_01	흥미로운데?	
VO_HERO_04_HAPPY_NEW_YEAR_15	새로운 해가 밝았군!	
VO_HERO_04e_Male_Human_Attack_01	로데론을 위하여!	
VO_HERO_04e_Male_Human_Greetings_01	만나서 반갑네.	
VO_HERO_04e_Male_Human_MIRROR_GREETINGS_01	빛의 축복이 함께하길.	
VO_HERO_04e_Male_Human_MIRROR_START_01	선의의 경쟁을 시작하세나!	
VO_HERO_04e_Male_Human_Oops_01	실수를 저질렀군...	
VO_HERO_04e_Male_Human_PICKED_01	로서 님을 기리며.	
VO_HERO_04e_Male_Human_Start_01	은빛 성기사단에 영광을!	
VO_HERO_04e_Male_Human_Thanks_01	정말 감사하네.	
VO_HERO_04e_Male_Human_Threaten_01	자네의 목숨은 여기서 끝일세.	
VO_HERO_04e_Male_Human_Well_Played_01	인상 깊은 광경이군.	
VO_HERO_04e_Male_Human_Wow_01	환상적이군!	
VO_HERO_04f_Male_Human_Attack_01	그 입 다물어라!	
VO_HERO_04f_Male_Human_Greetings_01	저주받은 기사가 밤하늘을 가로지른다!	
VO_HERO_04f_Male_Human_MIRROR_GREETINGS_01	상대할 가치도 없군. 썩 비켜라!	
VO_HERO_04f_Male_Human_MIRROR_START_01	하하, 하!	
VO_HERO_04f_Male_Human_Oops_01	실수라니? 이런 일이!	
VO_HERO_04f_Male_Human_Picked_01	하하, 하!	
VO_HERO_04f_Male_Human_Start_01	아하하하하!	
VO_HERO_04f_Male_Human_Thanks_01	감사를 표한다.	
VO_HERO_04f_Male_Human_Threaten_01	그러게 내 경고를 들었어야지...	
VO_HERO_04f_Male_Human_Well_Played_01	훌륭하다! 마음에 드는군.	
VO_HERO_04f_Male_Human_Wow_01	정신이 혼미할 정도야!	
VO_HERO_04h_Male_Human_Attack_01	용맹히 나아가리라!	
VO_HERO_04h_Male_Human_Greetings_01	명예롭게 나아가게.	
VO_HERO_04h_Male_Human_MIRROR_GREETINGS_01	그대 또한 그러길.	
VO_HERO_04h_Male_Human_MIRROR_START_01	후회 없는 승부를 하세나!	
VO_HERO_04h_Male_Human_Oops_01	이런 실수를!	
VO_HERO_04h_Male_Human_Picked_01	명예로운 승부가 되길!	
VO_HERO_04h_Male_Human_Start_01	의로운 자가 승리하길!	
VO_HERO_04h_Male_Human_Thanks_01	자네에게 감사를 표하네.	
VO_HERO_04h_Male_Human_Threaten_01	술이 식기 전에 끝을 내겠네.	
VO_HERO_04h_Male_Human_Well_Played_01	자네는 명예롭게 싸우는군.	
VO_HERO_04h_Male_Human_Wow_01	영광스럽네!	
VO_HERO_05_FACTION_CRY_24	호드를 위하여!	
VO_HERO_05_FIDGET_09	시간이 흐르고 있다네.	
VO_HERO_05_HAPPY_NEW_YEAR_15	즐거운 새해라네!	
VO_HERO_05_INDEED_05	동의하네.	
VO_HERO_05_SALUTE_07	과연… 놀랍군!	
VO_HERO_05b_Female_Undead_Concede_01	견딜 만큼 견뎠다...	
VO_HERO_05b_Female_Undead_ERROR_FULL_MINIONS_02	하수인이 너무 많다.	
VO_HERO_05b_Female_Undead_ERROR_GENERIC_02	그럴 순 없다.	
VO_HERO_05b_Female_Undead_ERROR_HAND_FULL_01	카드가 너무 많다!	
VO_HERO_05b_Female_Undead_ERROR_I_ATTACKED_01	난 이미 공격했다.	
VO_HERO_05b_Female_Undead_ERROR_MINION_ATTACKED_01	그 하수인은 이미 공격했다.	
VO_HERO_05b_Female_Undead_ERROR_NEED_MANA_01	마나가 필요하다.	
VO_HERO_05b_Female_Undead_ERROR_NEED_WEAPON_01	무기가 필요하다.	
VO_HERO_05b_Female_Undead_ERROR_PLAY_01	그건 낼 수 없다.	
VO_HERO_05b_Female_Undead_ERROR_STEALTH_01	그 하수인은 은신하고 있다.	
VO_HERO_05b_Female_Undead_ERROR_SUMMON_SICKNESS_01	그 하수인은 아직 싸울 수 없다.	
VO_HERO_05b_Female_Undead_ERROR_TARGET_01	대상이 필요하다.	
VO_HERO_05b_Female_Undead_ERROR_TAUNT_01	도발 능력이 있는 하수인이 걸리적거린다.	
VO_HERO_05b_Female_Undead_FIRE_FESTIVAL_01	전부 불태워라!	
VO_HERO_05b_Female_Undead_Greetings_01	반갑다. 감히 내 시간을 낭비하진 않겠지.	
VO_HERO_05b_Female_Undead_HAPPY_HALLOWEEN_01	할로윈 축제라! 가장 근사한 밤을 자랑하지.	
VO_HERO_05b_Female_Undead_HAPPY_HOLIDAYS_01	즐거운 축제 보내거라.	
VO_HERO_05b_Female_Undead_HAPPY_NEW_YEAR_01	새로운 해가 밝았구나.	
VO_HERO_05b_Female_Undead_HAPPY_NEW_YEAR_LUNAR_01	새로운 해가 밝았구나.	
VO_HERO_05b_Female_Undead_HAPPY_NOBLEGARDEN_01	즐거운 귀족의 정원 축제구나.	
VO_HERO_05b_Female_Undead_LowCards_01	카드가 거의 없다.	
VO_HERO_05b_Female_Undead_MIRROR_GREETINGS_01	...우리 가문에 내가 모르던 자매가 있었다니.	
VO_HERO_05b_Female_Undead_MIRROR_START_01	나에게... 승리를.	
VO_HERO_05b_Female_Undead_NoCards_01	카드가 없다!	
VO_HERO_05b_Female_Undead_Oops_02	실수로군.	
VO_HERO_05b_Female_Undead_Picked_01	내 화살이 빗나가지 않길.	
VO_HERO_05b_Female_Undead_PIRATE_DAY_02	어기여... 아, 이게 무슨 짓이람.	
VO_HERO_05b_Female_Undead_Sorry_01	미안하다.	
VO_HERO_05b_Female_Undead_Start_01	포세이큰에 승리를!	
VO_HERO_05b_Female_Undead_Thanks_02	감사를 전한다.	
VO_HERO_05b_Female_Undead_Thinking_02	복수가 머지 않았다...	
VO_HERO_05b_Female_Undead_Thinking_03	...모두 없애라...	
VO_HERO_05b_Female_Undead_Thinking_04	승리가 내 손안에 있나니...	
VO_HERO_05b_Female_Undead_Threaten_02	너 또한 고통받을 지어다.	
VO_HERO_05b_Female_Undead_Time_01	장난 칠 시간 없다!	
VO_HERO_05b_Female_Undead_Well_Played_01	과연... 대단하구나.	
VO_HERO_05b_Female_Undead_WOW_01	아주 날카롭군!	
VO_HERO_06_HAPPY_NEW_YEAR_15	새로운 해가 밝았다네!	
VO_Hero_06_Male_NightElf_Start_Illidan_01	네가 설명할 일이 아주 많다.	
VO_HERO_07_HAPPY_NEW_YEAR_15	새해가 다가왔다!	
VO_Hero_07d_Male_OldGod_Attack_02	<공격>	
VO_Hero_07d_Male_OldGod_Concede_01	다시... 잠드노라...	
VO_Hero_07d_Male_OldGod_Death_02	끝이로구나...	
VO_Hero_07d_Male_OldGod_ERROR_FULL_MINIONS_02	너무 많다.	
VO_Hero_07d_Male_OldGod_ERROR_GENERIC_04	할 수 없노라.	
VO_Hero_07d_Male_OldGod_ERROR_HAND_FULL_01	카드가 너무 많다.	
VO_Hero_07d_Male_OldGod_ERROR_I_ATTACKED_01	공격할 수 없다.	
VO_Hero_07d_Male_OldGod_ERROR_MINION_ATTACKED_01	그 하수인은 기력이 쇠했다.	
VO_Hero_07d_Male_OldGod_ERROR_NEED_MANA_02	마나가 부족하다.	
VO_Hero_07d_Male_OldGod_ERROR_NEED_WEAPON_01	무기가 필요하다.	
VO_Hero_07d_Male_OldGod_ERROR_PLAY_01	그건 낼 수 없다.	
VO_Hero_07d_Male_OldGod_ERROR_STEALTH_01	그 하수인은 은신 중이다.	
VO_Hero_07d_Male_OldGod_ERROR_STEALTH_02	숨겨진 것은 볼 수 없다.	
VO_Hero_07d_Male_OldGod_ERROR_SUMMON_SICKNESS_02	준비할 시간이 필요하다.	
VO_Hero_07d_Male_OldGod_ERROR_TARGET_01	대상이 필요하다.	
VO_Hero_07d_Male_OldGod_ERROR_TAUNT_01	도발 능력이 있는 하수인을 공격해야 한다.	
VO_Hero_07d_Male_OldGod_FIRE_FESTIVAL_01	불꽃은 모든 걸 삼키지만, 화염은 모든 걸 정화하지.	
VO_Hero_07d_Male_OldGod_Greetings_01	환영한다, 내 충직한 신봉자여.	
VO_Hero_07d_Male_OldGod_HAPPY_BIRTHDAY_01	촛불이 일렁이는구나. 소원을 빌어라!	
VO_Hero_07d_Male_OldGod_HAPPY_BIRTHDAY_02	너의 생일을... 축하한다.	
VO_Hero_07d_Male_OldGod_HAPPY_HALLOWEEN_01	할로윈 축제에는 저 너머를 들여다볼 수 있지...	
VO_Hero_07d_Male_OldGod_HAPPY_HOLIDAYS_01	뜻깊은 날이구나.	
VO_Hero_07d_Male_OldGod_HAPPY_NEW_YEAR_01	또 한 해가 종말을 맞이한다.	
VO_Hero_07d_Male_OldGod_HAPPY_NEW_YEAR_LUNAR_01	새로운 해가 떠오른다.	
VO_Hero_07d_Male_OldGod_HAPPY_NOBLEGARDEN_01	저 깊은 곳에 수많은 알들이 숨겨져 있나니...	
VO_Hero_07d_Male_OldGod_LowCards_01	내 덱의 최후가 다가온다...	
VO_Hero_07d_Male_OldGod_MIRROR_GREETINGS_01	함께 꿈꾸고,\n한 명만이\n깨어나리라.	
VO_Hero_07d_Male_OldGod_MIRROR_START_01	그리고 잠든 도시가 일어날지니...	
VO_Hero_07d_Male_OldGod_NoCards_01	내 덱이 메말랐다!	
VO_Hero_07d_Male_OldGod_Oops_02	속삭임과 함께 혼돈이 찾아오리라.	
VO_Hero_07d_Male_OldGod_Picked_01	다가오는 미래에서 널 구원하리니.	
VO_Hero_07d_Male_OldGod_PIRATE_DAY_01	요... 호... 호...	
VO_Hero_07d_Male_OldGod_Sorry_01	난 속죄하리라.	
VO_Hero_07d_Male_OldGod_Start_01	모든 눈이 뜨이리라!	
VO_Hero_07d_Male_OldGod_START_ARTHAS_01	왕자여, 네 왕관이 너의 미래를 펼칠 것이다.	
VO_Hero_07d_Male_OldGod_START_AZSHARA_01	허영심만이 가득하구나.	
VO_Hero_07d_Male_OldGod_START_DEATHWING_01	세계파괴자여, 심연에서 내 부름을 들었느냐.	
VO_Hero_07d_Male_OldGod_START_DRUID_01	저 깊은 곳에 뿌리내린 것이 악몽을 깨우리라.	
VO_Hero_07d_Male_OldGod_START_GARROSH_01	대족장이여, 내 총애는 네가 무기로 삼을 수 있는 게 아니다.	
VO_Hero_07d_Male_OldGod_START_LADYPRESTOR_01	너의 진정한 모습이 보이는구나.	
VO_Hero_07d_Male_OldGod_START_LADYVASHJ_01	너와 네 여왕에게 많은 축복을 내렸지.	
VO_Hero_07d_Male_OldGod_START_LAZUL_01	오랫동안 너에게 속삭였나니...	
VO_Hero_07d_Male_OldGod_START_MORGL_01	나와 함께 심연으로 와라, 작은 이여.	
VO_Hero_07d_Male_OldGod_START_NEMSY_01	너 또한 심연의 부름을 들었을 터.	
VO_Hero_07d_Male_OldGod_START_SYLVANAS_01	칠흑 같은 네 심장이 원하는 바가 보이는구나.	
VO_Hero_07d_Male_OldGod_START_THUNDERKING_01	티탄의 종이여, 너의 최후가 임박했다.	
VO_Hero_07d_Male_OldGod_Thanks_01	고맙구나.	
VO_Hero_07d_Male_OldGod_Thinking_01	흠...	
VO_Hero_07d_Male_OldGod_Thinking_02	무한한 진실...	
VO_Hero_07d_Male_OldGod_Thinking_04	장막이 일렁인다...	
VO_Hero_07d_Male_OldGod_Threaten_02	나와 함께 꿈에 들어라...	
VO_Hero_07d_Male_OldGod_Time_01	때가 가까워졌노라.	
VO_Hero_07d_Male_OldGod_TRIGGER_BANEOFDOOM_01	그들의 최후가 시작을 알리리라.	
VO_Hero_07d_Male_OldGod_TRIGGER_DECKOFCHAOS_01	미래는 기록되지 않은 역사일 뿐이니...	
VO_Hero_07d_Male_OldGod_TRIGGER_DISCARD_01	심연으로 돌아가라...	
VO_Hero_07d_Male_OldGod_TRIGGER_DRAINLIFE_01	너의 고통이 곧 나의 힘이다.	
VO_Hero_07d_Male_OldGod_TRIGGER_HELLFIRE_01	모두 멸하리라.	
VO_Hero_07d_Male_OldGod_TRIGGER_HEROPOWER_01	희생...	
VO_Hero_07d_Male_OldGod_TRIGGER_HEROPOWER_02	더...	
VO_Hero_07d_Male_OldGod_TRIGGER_HEROPOWER_03	나는 삼킨다...	
VO_Hero_07d_Male_OldGod_TRIGGER_NZOTH_01	나는 무한히 존재한다.	
VO_Hero_07d_Male_OldGod_TRIGGER_OPPONENT_SHADOWFORM_01	그래. 어둠을 받아들여라.	
VO_Hero_07d_Male_OldGod_TRIGGER_PLOTTWIST_01	눈앞에 보이는 모든 것이 거짓이다...	
VO_Hero_07d_Male_OldGod_TRIGGER_SHADOWFLAME_01	너 자신을 내게 바쳐라.	
VO_Hero_07d_Male_OldGod_TRIGGER_SOULFRAGMENT_01	내 눈이 뜨이노라.	
VO_Hero_07d_Male_OldGod_TRIGGER_TWISTEDKNOWLEDGE_01	난 알지 못하는 걸 알고, 보지 못하는 걸 보니라.	
VO_Hero_07d_Male_OldGod_TRIGGER_TWISTINGNETHER_01	공허가 삼킨다.	
VO_Hero_07d_Male_OldGod_Well_Played_01	영광스러운 공포로다!	
VO_Hero_07d_Male_OldGod_WOW_01	무한한 이들마저도 놀라는구나!	
VO_HERO_08_HAPPY_NEW_YEAR_15	새해가 밝았어요!	
VO_HERO_08b_HAPPY_NEW_YEAR_53	즐거운 새해가 되길!	
VO_Hero_08e_Male_Lich_Concede_01	너의 승리로구나.	
VO_Hero_08e_Male_Lich_ERROR_FULL_MINIONS_01	교단에 하수인을 더 들일 수 없다!	
VO_Hero_08e_Male_Lich_ERROR_GENERIC_01	안 된다!	
VO_Hero_08e_Male_Lich_ERROR_HAND_FULL_01	카드가 너무 많다!	
VO_Hero_08e_Male_Lich_ERROR_I_ATTACKED_01	난 이미 공격했다.	
VO_Hero_08e_Male_Lich_ERROR_MINION_ATTACKED_01	그건 다시 공격할 수 없다.	
VO_Hero_08e_Male_Lich_ERROR_NEED_MANA_01	마나가 부족하다.	
VO_Hero_08e_Male_Lich_ERROR_NEED_WEAPON_02	무기가 필요하겠군...	
VO_Hero_08e_Male_Lich_ERROR_PLAY_01	내겐 불가능하다.	
VO_Hero_08e_Male_Lich_ERROR_STEALTH_01	내게서 숨어 있는 놈이다.	
VO_Hero_08e_Male_Lich_ERROR_SUMMON_SICKNESS_01	아직 준비되지 않았다.	
VO_Hero_08e_Male_Lich_ERROR_TARGET_01	그건 대상으로 삼을 수 없다.	
VO_Hero_08e_Male_Lich_ERROR_TAUNT_02	날 도발하는 녀석을 공격해야 한다.	
VO_Hero_08e_Male_Lich_FIRE_FESTIVAL_01	왜 다들 불을 휘두르고 있는 것이냐?	
VO_Hero_08e_Male_Lich_Greetings_01	차디찬 어둠과 마주해라.	
VO_Hero_08e_Male_Lich_HAPPY_HALLOWEEN_01	할로윈 축제로군! 누가 누군지 알아볼 수 없을 정도야.	
VO_Hero_08e_Male_Lich_HAPPY_HOLIDAYS_01	겨울은 내가 가장 좋아하는 계절이다. 추위와 눈, 그리고 선물까지!	
VO_Hero_08e_Male_Lich_HAPPY_NEW_YEAR_01	기쁜 마음으로 새해를 맞이해라!	
VO_Hero_08e_Male_Lich_HAPPY_NEW_YEAR_LUNAR_01	차디찬 복을 마음껏 누려라.	
VO_Hero_08e_Male_Lich_HAPPY_NOBLEGARDEN_01	내 성물함에 알을 넣어둔 녀석이 누구냐?!	
VO_Hero_08e_Male_Lich_LowCards_01	카드가 부족하군.	
VO_Hero_08e_Male_Lich_MIRROR_GREETINGS_01	아, 기꺼이!	
VO_Hero_08e_Male_Lich_MIRROR_START_01	너무 확신하는 거 아닌가?	
VO_Hero_08e_Male_Lich_NoCards_01	카드가 없다!	
VO_Hero_08e_Male_Lich_Oops_01	집중력이 흐트러졌군.	
VO_Hero_08e_Male_Lich_Picked_01	명을 받들라!	
VO_Hero_08e_Male_Lich_PIRATE_DAY_01	이런 얼굴이 있으면 해적기를 따로 만들 필요도 없지!	
VO_Hero_08e_Male_Lich_Sorry_01	참으로 안타깝군.	
VO_Hero_08e_Male_Lich_Start_01	호기심은 죽음만을 불러올 것이다.	
VO_Hero_08e_Male_Lich_Start_Arthas_01	당신의 앞날이 기대가 되는군요.	
VO_Hero_08e_Male_Lich_Start_Jaina_01	넌 여전히 잘못된 선택을 하고 있다.	
VO_Hero_08e_Male_Lich_Start_Sylvanas_01	아직도 저항하고 있느냐...	
VO_Hero_08e_Male_Lich_Thanks_01	고맙구나.	
VO_Hero_08e_Male_Lich_Thinking_01	흠...	
VO_Hero_08e_Male_Lich_Thinking_02	음? 음...	
VO_Hero_08e_Male_Lich_Thinking_04	때가 되면...	
VO_Hero_08e_Male_Lich_Threaten_01	어두운 공허가 널 기다린다.	
VO_Hero_08e_Male_Lich_Time_01	시간이 날 얽매다니!	
VO_Hero_08e_Male_Lich_TRIGGER_Blizzard_01	네놈 뼛속까지 얼려주마!	
VO_Hero_08e_Male_Lich_TRIGGER_Cone_of_Cold_01	너의 영혼은 이제 내 것이다!	
VO_Hero_08e_Male_Lich_TRIGGER_Deep_Freeze_01	거기까지.	
VO_Hero_08e_Male_Lich_TRIGGER_Evocation_01	난 오랜 시간 동안 지식을 갈망했다...	
VO_Hero_08e_Male_Lich_TRIGGER_Font_of_Power_01	얼어붙은 땅의 전사들이여, 일어나라!	
VO_Hero_08e_Male_Lich_TRIGGER_Frost_Nova_01	서두르지 마라...	
VO_Hero_08e_Male_Lich_TRIGGER_Frostbolt_01	자비를 구하라!	
VO_Hero_08e_Male_Lich_TRIGGER_Icicle_01	네 하등한 마법은 내게 상대도 안 된다!	
VO_Hero_08e_Male_Lich_TRIGGER_Snap_Freeze_01	<미친 웃음>	
VO_Hero_08e_Male_Lich_Well_Played_01	훌륭하다, 침입자여.	
VO_Hero_08e_Male_Lich_WOW_01	부정할 수 없는 힘이로다!	
VO_HERO_09_HAPPY_NEW_YEAR_15	신년이 밝았네요!	
VO_HERO_09_Male_Human_Emote_07	보통은 예의를 지키지만… 항상 그러진 않죠.	
VO_HERO_09_Male_Human_Emote_11	왕위는 왕이 내는 카드가 말해줍니다.	
VO_HERO_09a_Attack_15	엘룬을 위하여!	
VO_HERO_09a_CONCEDE_06	끝났군요. 그대가 이겼습니다.	
VO_HERO_09a_ERROR_FULL_MINIONS_25	하수인이 너무 많습니다.	
VO_HERO_09a_ERROR_GENERIC_30	그건 할 수 없습니다.	
VO_HERO_09a_ERROR_HAND_FULL_24	카드가 너무 많습니다!	
VO_HERO_09a_ERROR_I_ATTACKED_22	저는 이미 공격했습니다.	
VO_HERO_09a_ERROR_JUST_PLAYED_23	그 하수인은 다음 턴에 준비될 겁니다.	
VO_HERO_09a_ERROR_MINION_ATTACKED_21	그 하수인은 이미 공격했습니다.	
VO_HERO_09a_ERROR_NEED_MANA_20	마나가 부족합니다.	
VO_HERO_09a_ERROR_NEED_WEAPON_19	무기가 필요합니다.	
VO_HERO_09a_ERROR_PLAY_27	그 카드는 낼 수 없습니다.	
VO_HERO_09a_ERROR_STEALTH_26	은신한 하수인은 선택할 수 없습니다.	
VO_HERO_09a_ERROR_TARGET_28	선택할 수 없는 대상입니다.	
VO_HERO_09a_ERROR_TAUNT_29	도발 능력이 있는 하수인이 가로막고 있습니다.	
VO_Hero_09a_Female_NightElf_Start_Illidan_01	무분별한 무력은 진정한 힘에 비할 바가 못 돼.	
VO_HERO_09a_FIRE_FESTIVAL	한여름 축제를 즐겁게 보내십시오.	
VO_HERO_09a_GREETINGS_03	그대에게 축복을.	
VO_HERO_09a_GREETINGS_RESPONSE	그대에게도 축복이 있길.	
VO_HERO_09a_HALLOWS_END	즐거운 할로윈 축제군요.	
VO_HERO_09a_HAPPY_HOLIDAYS_52	겨울맞이 축제를 즐기십시오!	
VO_HERO_09a_HAPPY_NEW_YEAR_01	함께 새해를 맞이하시죠!	
VO_HERO_09a_HAPPY_NEW_YEAR_LUNAR_53	새해에도 여신의 축복이 가득하길.	
VO_HERO_09a_LOW_CARDS_17	카드가 거의 없습니다.	
VO_HERO_09a_MIRROR_GREETINGS_04	그대에게도 축복이 있길.	
VO_HERO_09a_MIRROR_START_02	여신은 저의 방패십니다.	
VO_HERO_09a_NO_CARDS_18	카드가 없습니다!	
VO_HERO_09a_NOBLEGARDEN	즐거운 귀족의 정원 축제이군요.	
VO_HERO_09a_OOPS_08	실수로군요.	
VO_HERO_09a_PICKED_11	여신께서 부르십니다.	
VO_HERO_09a_PIRATE_DAY	신의 권능: 야르!	
VO_HERO_09a_SORRY_10	용서하세요.	
VO_HERO_09a_START_01	엘룬이여, 제게 힘을 주소서.	
VO_HERO_09a_START_MALFURION	말퓨리온, 내 사랑.	
VO_HERO_09a_THANKS_09	감사합니다.	
VO_HERO_09a_THINK1_12	흠...	
VO_HERO_09a_THINK2_13	이러면 어떨까...	
VO_HERO_09a_THINK3_14	엘룬의 뜻은 무엇일까...	
VO_HERO_09a_THREATEN_05	반드시 후회할 겁니다!	
VO_HERO_09a_TIMER_16	신속하게 결정해야 합니다!	
VO_HERO_09a_WELL_PLAYED_07	좋은 수로군요.	
VO_HERO_09a_WOW_10	훌륭합니다!	
VO_HERO_09b_Female_Troll_Concede_01	네가 이겼다. 너의 운명일지도.	
VO_HERO_09b_Female_Troll_ERROR_FULL_MINIONS_02	하수인이 너무 많아!	
VO_HERO_09b_Female_Troll_ERROR_GENERIC_02	불가능해.	
VO_HERO_09b_Female_Troll_ERROR_HAND_FULL_01	카드가 너무 많아!	
VO_HERO_09b_Female_Troll_ERROR_I_ATTACKED_01	난 이미 공격했어.	
VO_HERO_09b_Female_Troll_ERROR_MINION_ATTACKED_01	그 하수인은 이미 공격했어.	
VO_HERO_09b_Female_Troll_ERROR_NEED_MANA_02	마나가 필요해!	
VO_HERO_09b_Female_Troll_ERROR_NEED_WEAPON_01	무기가 필요해.	
VO_HERO_09b_Female_Troll_ERROR_PLAY_01	그건 낼 수 없어.	
VO_HERO_09b_Female_Troll_ERROR_STEALTH_01	아, 은신하고 있는 녀석이야.	
VO_HERO_09b_Female_Troll_ERROR_SUMMON_SICKNESS_01	그 녀석은 준비할 시간이 필요해.	
VO_HERO_09b_Female_Troll_ERROR_TARGET_01	대상이 없어.	
VO_HERO_09b_Female_Troll_ERROR_TAUNT_01	도발 능력이 있는 하수인을 처리해야 돼.	
VO_HERO_09b_Female_Troll_FIRE_FESTIVAL_01	불꽃축제가 왔어!	
VO_HERO_09b_Female_Troll_Greetings_01	환영한다! 점괘가 어떨지 보고싶나?	
VO_HERO_09b_Female_Troll_HAPPY_HALLOWEEN_01	아, 할로윈 축제라.	
VO_HERO_09b_Female_Troll_HAPPY_HOLIDAYS_01	즐거운 축제로군.	
VO_HERO_09b_Female_Troll_HAPPY_NEW_YEAR_01	새로운 해가 시작된다...	
VO_HERO_09b_Female_Troll_HAPPY_NEW_YEAR_LUNAR_01	새해에도 운수대통하길...	
VO_HERO_09b_Female_Troll_HAPPY_NOBLEGARDEN_01	귀족의 정원 축제를 즐기라고!	
VO_HERO_09b_Female_Troll_LowCards_02	카드가 얼마 없어.	
VO_HERO_09b_Female_Troll_MIRROR_GREETINGS_02	그렇게 말할 줄 알았지.	
VO_HERO_09b_Female_Troll_MIRROR_START_01	그렇다면 결말이 어떨지도 알겠군...	
VO_HERO_09b_Female_Troll_NoCards_02	카드가 없다!	
VO_HERO_09b_Female_Troll_Oops_01	재미난 이야깃거리가 생겼군.	
VO_HERO_09b_Female_Troll_Picked_02	오늘의 점괘는 어떨까?	
VO_HERO_09b_Female_Troll_PIRATE_DAY_01	요, 호, 호!	
VO_HERO_09b_Female_Troll_Sorry_01	미안하게 됐군.	
VO_HERO_09b_Female_Troll_Start_02	이 만남은 예견돼 있었지...	
VO_HERO_09b_Female_Troll_Thanks_01	고마워.	
VO_HERO_09b_Female_Troll_Thinking_06	흠...	
VO_HERO_09b_Female_Troll_Thinking_11	카드의 뜻대로...	
VO_HERO_09b_Female_Troll_Thinking_12	어이 해야 할꼬...?	
VO_HERO_09b_Female_Troll_Threaten_03	너의 운명은 정해졌다!	
VO_HERO_09b_Female_Troll_Time_02	끝이 다가온다.	
VO_HERO_09b_Female_Troll_Well_Played_01	아주 훌륭해!	
VO_HERO_09b_Female_Troll_WOW_01	고대 신이시여!	
VO_HERO_09e_Male_Human_Attack_01	스톰윈드를 위하여!	
VO_HERO_09e_Male_Human_Greetings_01	안녕하신가요?	
VO_HERO_09e_Male_Human_MIRROR_GREETINGS_01	암호를... 안 쓰시는군요?	
VO_HERO_09e_Male_Human_MIRROR_START_01	저도 함께하죠!	
VO_HERO_09e_Male_Human_Oops_01	어떻게 된 거지?	
VO_HERO_09e_Male_Human_Start_01	얼라이언스는 제가 지키겠습니다.	
VO_HERO_09e_Male_Human_Thanks_01	감사합니다.	
VO_HERO_09e_Male_Human_Threaten_01	절 계속 시험하셨다간...	
VO_HERO_09e_Male_Human_Well_Played_01	훌륭한 솜씨군요!	
VO_HERO_09e_Male_Human_Wow_01	놀랍네요. 정말이에요.	
VO_HERO_09f_Male_Human_Attack_01	물러나세요!	
VO_HERO_09f_Male_Human_Greetings_01	반갑습니다.	
VO_HERO_09f_Male_Human_MIRROR_GREETINGS_01	마음에 드는 풍모로군요.	
VO_HERO_09f_Male_Human_MIRROR_START_01	그것도 참 좋은 전략이네요...	
VO_HERO_09f_Male_Human_Oops_01	다음엔 더욱 신중히 생각하세요.	
VO_HERO_09f_Male_Human_Start_01	지혜가 승리를 불러올 것입니다!	
VO_HERO_09f_Male_Human_Thanks_01	당신께 경의를.	
VO_HERO_09f_Male_Human_Threaten_01	기지 또한 하나의 무기입니다.	
VO_HERO_09f_Male_Human_Well_Played_01	묘책이군요.	
VO_HERO_09f_Male_Human_Wow_01	아주 놀랍네요!	
VO_Hero_10_Male_NightElf_Attack_01	복수는 나의 것이다.	
VO_Hero_10_Male_NightElf_Concede_01	이번엔 포기하겠다.	
VO_Hero_10_Male_NightElf_ERROR_FULL_MINIONS_01	하수인을 너무 많이 거느리고 있다.	
VO_Hero_10_Male_NightElf_ERROR_GENERIC_03	불가능하다.	
VO_Hero_10_Male_NightElf_ERROR_HAND_FULL_01	카드가 너무 많다!	
VO_Hero_10_Male_NightElf_ERROR_I_ATTACKED_01	난 이미 일격을 가했다!	
VO_Hero_10_Male_NightElf_ERROR_MINION_ATTACKED_01	그건 다시 공격할 수 없다.	
VO_Hero_10_Male_NightElf_ERROR_NEED_MANA_01	내 마나가 모자라다.	
VO_Hero_10_Male_NightElf_ERROR_NEED_WEAPON_01	무기가 필요하다.	
VO_Hero_10_Male_NightElf_ERROR_PLAY_01	그럴 수 없다.	
VO_Hero_10_Male_NightElf_ERROR_STEALTH_01	그 녀석은 어둠 속에 숨어있다.	
VO_Hero_10_Male_NightElf_ERROR_SUMMON_SICKNESS_01	그 녀석은 준비가 안 됐다.	
VO_Hero_10_Male_NightElf_ERROR_TARGET_01	내 능력 밖이다.	
VO_Hero_10_Male_NightElf_ERROR_TAUNT_01	다른 녀석이 날 도발한다. 감히 나를!	
VO_Hero_10_Male_NightElf_FIRE_FESTIVAL_01	우리의 불꽃은 군단보다 더 밝게 빛나리라!	
VO_Hero_10_Male_NightElf_Greetings_01	사악한 기운이 다가온다.	
VO_Hero_10_Male_NightElf_HAPPY_HALLOWEEN_01	어둠이 다가온다... 할로윈 축제다!	
VO_Hero_10_Male_NightElf_HAPPY_HOLIDAYS_01	배신자에게 축제 따윈 있을 수 없다.	
VO_Hero_10_Male_NightElf_HAPPY_NEW_YEAR_01	올해에는 준비가 되길 바란다.	
VO_Hero_10_Male_NightElf_HAPPY_NEW_YEAR_LUNAR_01	만년 동안 응어리질 복을 받아라!	
VO_Hero_10_Male_NightElf_HAPPY_NOBLEGARDEN_01	알 사냥도 악마 사냥의 연장선이라 할 수 있겠지.	
VO_Hero_10_Male_NightElf_LowCards_01	카드가 슬슬 부족하다...	
VO_Hero_10_Male_NightElf_MIRROR_GREETINGS_01	그래. 네놈이었군.	
VO_Hero_10_Male_NightElf_MIRROR_START_01	감히 내게 말을 거느냐?	
VO_Hero_10_Male_NightElf_NoCards_01	카드가 없다!	
VO_Hero_10_Male_NightElf_Oops_01	실수였나.	
VO_Hero_10_Male_NightElf_Picked_01	난 어둠 속에 갇혀 있었다.	
VO_Hero_10_Male_NightElf_PIRATE_DAY_01	배신의 길을 걸을 선원들은 모여라!	
VO_Hero_10_Male_NightElf_Sorry_01	사과하겠다.	
VO_Hero_10_Male_NightElf_Start_01	여기서 끝내 주마!	
VO_Hero_10_Male_NightElf_Start_Aranna_01	이번엔 주저하지 않겠다.	
VO_Hero_10_Male_NightElf_Start_Arthas_01	아서스, 난 너보다 강하다. 지금도, 그리고 앞으로도.	
VO_Hero_10_Male_NightElf_Start_Maiev_01	사냥꾼을 사냥하려 드느냐.	
VO_Hero_10_Male_NightElf_Start_Malfurion_01	형. 우리 사이의 갈등은 아직 끝난 게 아니야.	
VO_Hero_10_Male_NightElf_Start_Mecha_Jaraxxus_01	정말 끈질긴 악마구나.	
VO_Hero_10_Male_NightElf_Start_Tyrande_01	너에게 나 자신을 증명하겠어.	
VO_Hero_10_Male_NightElf_Start_Vashj_01	우리의 힘을 시험해보자꾸나.	
VO_Hero_10_Male_NightElf_Thanks_01	감사를 표한다.	
VO_Hero_10_Male_NightElf_Thinking_01	흠...	
VO_Hero_10_Male_NightElf_Thinking_02	계속되는 싸움...	
VO_Hero_10_Male_NightElf_Thinking_03	악마? 악마...	
VO_Hero_10_Male_NightElf_Thinking_04	이거 짜증 나는군.	
VO_Hero_10_Male_NightElf_Threaten_01	넌 아직 준비가 안 됐다!	
VO_Hero_10_Male_NightElf_Time_01	시간이 부족하다!	
VO_Hero_10_Male_NightElf_TRIGGER_Command_the_Illidari_01	너희 주인을 섬겨라!	
VO_Hero_10_Male_NightElf_TRIGGER_Inner_Demon_01	우리 모두의 내면에는 악마가 도사리고 있다.	
VO_Hero_10_Male_NightElf_TRIGGER_Mana_Burn_01	재가 되어라.	
VO_Hero_10_Male_NightElf_TRIGGER_Metamorphosis_01	이제 난 완전해졌다!	
VO_Hero_10_Male_NightElf_TRIGGER_Skull_of_Guldan_01	아, 비운의 흑마법사여...	
VO_Hero_10_Male_NightElf_TRIGGER_Spectral_Sight_01	호오... 그렇군...	
VO_Hero_10_Male_NightElf_Well_Played_01	넌 진정한 힘을 가지고 있구나.	
VO_Hero_10_Male_NightElf_WOW_01	이런 게 가능하다니.	
VO_HERO_11_HAPPY_NEW_YEAR_20	새해가 밝았다네!	
VO_HERO_12_HAPPY_NEW_YEAR_20	새로운 해가 밝았다네!	
VO_HERO_13_HAPPY_NEW_YEAR_20	기쁨 가득한 새해를 맞이하세요.	
VO_HERO_14_HAPPY_NEW_YEAR_20	새해가 밝았군요.	
VO_HERO_15_HAPPY_NEW_YEAR_24	<새해가 밝았다옳!>	
VO_HERO_16_Female_Dryad_Concede_01	매번 이길 수는 없는 법이지.	
VO_HERO_16_Female_Dryad_ERROR_01	무기가 필요하다.	
VO_HERO_16_Female_Dryad_ERROR_02	마나가 부족하다!	
VO_HERO_16_Female_Dryad_ERROR_03	그 하수인은 다시 공격할 수 없어!	
VO_HERO_16_Female_Dryad_ERROR_04	난 이미 공격했다.	
VO_HERO_16_Female_Dryad_ERROR_05	그 하수인은 아직 공격할 수 없어.	
VO_HERO_16_Female_Dryad_ERROR_06	카드가 넘쳐나!	
VO_HERO_16_Female_Dryad_ERROR_07	하수인이 너무 많아!	
VO_HERO_16_Female_Dryad_ERROR_08	저 비겁한 하수인이 은신하고 있다.	
VO_HERO_16_Female_Dryad_ERROR_09	그건 할 수 없어.	
VO_HERO_16_Female_Dryad_ERROR_10	불가능해.	
VO_HERO_16_Female_Dryad_ERROR_11	도발 능력이 있는 하수인을 공격해야 한다!	
VO_HERO_16_Female_Dryad_ERROR_12	그렇게는 안 된다.	
VO_HERO_16_Female_Dryad_FIRE_FESTIVAL_01	한여름 축제는 정말 최고야!	
VO_HERO_16_Female_Dryad_Greetings_01	자연의 축복이 함께하길!	
VO_HERO_16_Female_Dryad_GREETINGS_RESPONSE	너에게도 함께하길 바란다!	
VO_HERO_16_Female_Dryad_HAPPY_HALLOWEEN_01	즐거운 할로윈 축제로구나!	
VO_HERO_16_Female_Dryad_HAPPY_HOLIDAYS_01	겨울맞이 축제가 한창이구나!	
VO_HERO_16_Female_Dryad_HAPPY_NEW_YEAR_01	새해를 맞이하자꾸나!	
VO_HERO_16_Female_Dryad_HAPPY_NEW_YEAR_LUNAR_01	새해 복 많이 받거라!	
VO_HERO_16_Female_Dryad_HAPPY_NOBLEGARDEN_01	귀족의 정원 축제를 즐겨라!	
VO_HERO_16_Female_Dryad_LowCards_01	카드가 거의 없다!	
VO_HERO_16_Female_Dryad_MALFURION_START_01	이시누 알라, 대드루이드여.	
VO_HERO_16_Female_Dryad_MIRROR_GREETINGS_01	너에게도 함께하길 바란다!	
VO_HERO_16_Female_Dryad_MIRROR_START_01	자연을 위하여!	
VO_HERO_16_Female_Dryad_NoCards_01	카드가 없다!	
VO_HERO_16_Female_Dryad_Oops_02	착오가 생긴 것 같군.	
VO_HERO_16_Female_Dryad_PIRATE_DAY_01	야르! 나는 해적이다!	
VO_HERO_16_Female_Dryad_Sorry_01	사과하마.	
VO_HERO_16_Female_Dryad_Start_01	숲이 맞서 싸운다.	
VO_HERO_16_Female_Dryad_Thanks_01	네 호의를 받아들이마.	
VO_HERO_16_Female_Dryad_Thinking_01	어디 보자...	
VO_HERO_16_Female_Dryad_Thinking_02	그래, 이러면 어떨까...	
VO_HERO_16_Female_Dryad_Thinking_03	이렇게 하면...	
VO_HERO_16_Female_Dryad_Threaten_01	자연이 받은 고통을 그대로 느껴라!	
VO_HERO_16_Female_Dryad_Time_01	시간이 부족해!	
VO_HERO_16_Female_Dryad_Well_Played_01	훌륭하구나.	
VO_HERO_16_Female_Dryad_WOW_01	놀랍구나!	
VO_HERO_17_Female_Treant_CONCEDE	나무가 쓰러져야 씨앗이 자랄 곳이 있지.	
VO_HERO_17_Female_Treant_ERROR_FULL_MINIONS	여긴 좀 북적이는구나.	
VO_HERO_17_Female_Treant_ERROR_GENERIC	미안하다, 아가. 불가능하구나.	
VO_HERO_17_Female_Treant_ERROR_HAND_FULL	이걸 다 들어야 하니?	
VO_HERO_17_Female_Treant_ERROR_I_ATTACKED	날 쉬게 해다오.	
VO_HERO_17_Female_Treant_ERROR_JUST_PLAYED	저들은 좀 쉬어야 할 것 같구나.	
VO_HERO_17_Female_Treant_ERROR_MINION_ATTACKED	이 아이는 지친 것 같구나.	
VO_HERO_17_Female_Treant_ERROR_NEED_MANA	마나가 부족한 것 같구나.	
VO_HERO_17_Female_Treant_ERROR_NEED_WEAPON	아가, 난 아직 무기가 없단다.	
VO_HERO_17_Female_Treant_ERROR_PLAY	아니, 아니, 그럴 순 없단다.	
VO_HERO_17_Female_Treant_ERROR_STEALTH	눈이 침침해서 잘 안 보이는구나...	
VO_HERO_17_Female_Treant_ERROR_TARGET	이건 할 수 없을 것 같구나.	
VO_HERO_17_Female_Treant_ERROR_TAUNT	저 나쁜 녀석을 먼저 공격해야겠구나.	
VO_HERO_17_Female_Treant_FIRE_FESTIVAL	불꽃놀이를 할 땐 조심하거라.	
VO_HERO_17_Female_Treant_GREETINGS	반갑구나, 얘야.	
VO_HERO_17_Female_Treant_GREETINGS_RESPONSE	음? 오오, 반갑구나!	VO_HERO_17_Female_Treant_MIRROR_GREETINGS_01.wav
VO_HERO_17_Female_Treant_HALLOWS_END	할로윈 축제를 즐기기엔 내가 너무 늙었어.	
VO_HERO_17_Female_Treant_HAPPY_NEW_YEAR_20	또 한 해가 지났구나...	
VO_HERO_17_Female_Treant_LOW_CARDS	흠, 내 카드들이 어디 갔지?	
VO_HERO_17_Female_Treant_LUNAR_NEW_YEAR	새해 복 많이 받거라.	
VO_HERO_17_Female_Treant_MIRROR_START	오늘은 내가 스승이 되어보마.	
VO_HERO_17_Female_Treant_NO_CARDS	내 카드가 다 없어진 것 같구나...	
VO_HERO_17_Female_Treant_NOBLEGARDEN	웃음 가득한 귀족의 정원 축제가 되길!	
VO_HERO_17_Female_Treant_OOPS	아직 잠에서 덜 깬 모양이야.	
VO_HERO_17_Female_Treant_PICKED	내가 옛날 이야기 하나 들려주마...	
VO_HERO_17_Female_Treant_PIRATE_DAY	해적이라고? 재밌어 보이는구나!	
VO_HERO_17_Female_Treant_SORRY	미안하구나, 얘야.	
VO_HERO_17_Female_Treant_START	배움을 얻으러 왔니?	
VO_HERO_17_Female_Treant_START_MALFURION	말퓨리온! 정말 어엿한 드루이드가 되었구나.	
VO_HERO_17_Female_Treant_THANKS	고맙구나, 아가!	
VO_HERO_17_Female_Treant_THINK1	흠...	
VO_HERO_17_Female_Treant_THINK2	아, 그래...	
VO_HERO_17_Female_Treant_THINK3	어떻게 하려고 했더라...?	
VO_HERO_17_Female_Treant_THREATEN	나무를 깨우면 안된단다, 아가.	
VO_HERO_17_Female_Treant_TIMER	서둘러야겠구나!	
VO_HERO_17_Female_Treant_WELL_PLAYED	놀랍구나!	
VO_HERO_17_Female_Treant_WINTERVEIL_GREETINGS	즐거운 겨울맞이 축제 보내거라!	
VO_HERO_17_Female_Treant_WOW	이렇게 기쁠 수가!	
VO_HERO_18_Female_Gnome_Concede_01	대단한데? 이번엔 네가 이겼어!	
VO_HERO_18_Female_Gnome_ERROR_01	무기가 필요하지 않아?	
VO_HERO_18_Female_Gnome_ERROR_03	마나가 부족해!	
VO_HERO_18_Female_Gnome_ERROR_04	걔는 이미 공격했어!	
VO_HERO_18_Female_Gnome_ERROR_06	두 번은 공격 못해!	
VO_HERO_18_Female_Gnome_ERROR_07	쉬이이... 아직 자고 있어.	
VO_HERO_18_Female_Gnome_ERROR_08	어우, 카드가 너무 많아!	
VO_HERO_18_Female_Gnome_ERROR_10	너무 북적거려!	
VO_HERO_18_Female_Gnome_ERROR_12	은신하고 있네!	
VO_HERO_18_Female_Gnome_ERROR_14	음. 안 되겠는데.	
VO_HERO_18_Female_Gnome_ERROR_15	그건 대상으로 지정할 수 없어.	
VO_HERO_18_Female_Gnome_ERROR_17	도발 능력이 있는 하수인이 버티고 있어.	
VO_HERO_18_Female_Gnome_ERROR_19	그건 할 수 없어!	
VO_HERO_18_Female_Gnome_FIRE_FESTIVAL_01	한여름 불꽃놀이는 최고야!	
VO_HERO_18_Female_Gnome_Greetings_01	하이요!	
VO_HERO_18_Female_Gnome_GREETINGS_RESPONSE	안녕!	
VO_HERO_18_Female_Gnome_HAPPY_HALLOWEEN_01	우와, 할로윈 축제야? 히히, 무섭지?	
VO_HERO_18_Female_Gnome_HAPPY_HOLIDAYS_01	즐거운 겨울맞이 축제야!	
VO_HERO_18_Female_Gnome_HAPPY_NEW_YEAR_01	새해가 왔네!	
VO_HERO_18_Female_Gnome_HAPPY_NEW_YEAR_LUNAR_16	새해 복 많이 받아!	
VO_HERO_18_Female_Gnome_LowCards_01	카드가 얼마 없어!	
VO_HERO_18_Female_Gnome_MIRROR_START_01	그래! 완전 재밌게 놀자고!	
VO_HERO_18_Female_Gnome_NOBLEGARDEN	난 귀족의 정원 축제가 정말 좋아!	
VO_HERO_18_Female_Gnome_NoCards_01	카드가 없어!	
VO_HERO_18_Female_Gnome_Oops_02	아이코!	
VO_HERO_18_Female_Gnome_PIRATE_DAY_01	아하하, 난 해적이다! 야르!	
VO_HERO_18_Female_Gnome_Sorry_01	어, 미안해...	
VO_HERO_18_Female_Gnome_Start_01	나랑 신나게 놀자!	
VO_HERO_18_Female_Gnome_Thanks_02	우와, 감동이야!	
VO_HERO_18_Female_Gnome_Thinking_01	흐음...	
VO_HERO_18_Female_Gnome_Thinking_03	음... 난나난나...	
VO_HERO_18_Female_Gnome_Thinking_04	음... 이렇게 하면...	
VO_HERO_18_Female_Gnome_Threaten_01	넌 귀여운 하수인이 될 거야!	
VO_HERO_18_Female_Gnome_Time_01	서둘러!	
VO_HERO_18_Female_Gnome_Well_Played_01	우와, 진짜 잘했어!	
VO_HERO_18_Female_Gnome_WOW_01	정말 멋져!	
VO_ICC08_LichKing_Male_Human_YoungArthas_02	나 자신과 싸워야 하다니.	
VO_INNKEEPER_Male_Dwarf_HERONAME_ANNHYLDE_01	안힐드!	
VO_INNKEEPER_Male_Dwarf_HERONAME_DEATHWING_01	데스윙!	
VO_INNKEEPER_Male_Dwarf_HERONAME_ELISE_02	엘리스!	
VO_Innkeeper_Male_Dwarf_HERONAME_ILLIDAN_01	일리단!	
VO_Innkeeper_Male_Dwarf_HERONAME_KELTHUZAD_01	켈투자드!	
VO_INNKEEPER_Male_Dwarf_HERONAME_LAZUL_01	라줄!	
VO_INNKEEPER_Male_Dwarf_HERONAME_LAZUL_02	라줄!	
VO_INNKEEPER_Male_Dwarf_HERONAME_MECHAJAR_03	메카 자락서스!	
VO_INNKEEPER_Male_Dwarf_HERONAME_NZOTH_02	느조스!	
VO_INNKEEPER_Male_Dwarf_HERONAME_NZOTH_03	느조스!	
VO_INNKEEPER_Male_Dwarf_HERONAME_RASTAKHAN_01	라스타칸!	
VO_INNKEEPER_Male_Dwarf_HERONAME_RASTAKHAN_02	라스타칸!	
VO_INNKEEPER_Male_Dwarf_Heroname_ThunderKing_01	천둥왕!	
VO_INNKEEPER_Male_Naga_HERONAME_VASHJ_01	여군주 바쉬!	
VO_MechaJar_Male_Demon_Concede_01	네가 이겼다... 하지만 네 세계는 여전히 파멸하리라!	
VO_MechaJar_Male_Demon_ERROR_FULL_MINIONS_01	내 전장이 가득 찼다.	
VO_MechaJar_Male_Demon_ERROR_GENERIC_01	그건 할 수 없다.	
VO_MechaJar_Male_Demon_ERROR_HAND_FULL_01	카드가 너무 많다!	
VO_MechaJar_Male_Demon_ERROR_I_ATTACKED_01	난 이미 공격했다.	
VO_MechaJar_Male_Demon_ERROR_MINION_ATTACKED_01	그 하수인은 이미 공격했다.	
VO_MechaJar_Male_Demon_ERROR_NEED_MANA_01	마나가 더 필요하다.	
VO_MechaJar_Male_Demon_ERROR_NEED_WEAPON_01	무기가 없다.	
VO_MechaJar_Male_Demon_ERROR_PLAY_01	그 카드는 낼 수 없다.	
VO_MechaJar_Male_Demon_ERROR_STEALTH_01	저 한심한 하수인이 은신하고 있다.	
VO_MechaJar_Male_Demon_ERROR_SUMMON_SICKNESS_01	그 하수인은 다음 턴에 준비될 것이다.	
VO_MechaJar_Male_Demon_ERROR_TARGET_01	그건 대상으로 삼을 수 없다.	
VO_MechaJar_Male_Demon_ERROR_TAUNT_01	도발 하수인이 가로막고 있다.	
VO_MechaJar_Male_Demon_FIRE_FESTIVAL_01	즐거운 불꽃축제군. 모두가 화염에 휩싸이리라.	
VO_MechaJar_Male_Demon_Greetings_02	망각!	
VO_MechaJar_Male_Demon_HAPPY_HALLOWEEN_01	할로윈 축제가 시작됐다!	
VO_MechaJar_Male_Demon_HAPPY_HOLIDAYS_01	겨울맞이 축제를 즐겨라. 아직 그럴 수 있을 때.	
VO_MechaJar_Male_Demon_HAPPY_NEW_YEAR_01	새해가 밝았다. 너의 마지막 새해가.	
VO_MechaJar_Male_Demon_HAPPY_NEW_YEAR_LUNAR_01	새해 복을 받아라!	
VO_MechaJar_Male_Demon_HAPPY_NOBLEGARDEN_01	귀족의 정원 축제를 진행한다.	
VO_MechaJar_Male_Demon_LowCards_01	내 덱이 곧 종말을 맞이한다.	
VO_MechaJar_Male_Demon_MIRROR_GREETINGS_03	넌 망각을 받아들였을 뿐. 나는 망각 그 자체이니라!	
VO_MechaJar_Male_Demon_MIRROR_START_01	이하동문이다!	
VO_MechaJar_Male_Demon_NoCards_01	카드를 모두 소모했다.	
VO_MechaJar_Male_Demon_Oops_02	오류! 오류!	
VO_MechaJar_Male_Demon_Picked_01	메카 자락서스 가동.	
VO_MechaJar_Male_Demon_PIRATE_DAY_01	요호, 반복, 요호, 해적 모드 가동.	
VO_MechaJar_Male_Demon_Sorry_01	자락서스는... 미안하다!	
VO_MechaJar_Male_Demon_Start_02	붐타는 군단의 메카 군주, 자락서스 님이 상대해 주마!	
VO_MechaJar_Male_Demon_Thanks_01	고맙다.	
VO_MechaJar_Male_Demon_Thinking_01	흠...	
VO_MechaJar_Male_Demon_Thinking_02	파괴해야... 한다...	
VO_MechaJar_Male_Demon_Thinking_05	연산 중...	
VO_MechaJar_Male_Demon_Threaten_04	그렇게 까불더니 무덤을 파는구나!	
VO_MechaJar_Male_Demon_Time_01	시간이 없다.	
VO_MechaJar_Male_Demon_TRIGGER_DOOM_01	종말!	
VO_MechaJar_Male_Demon_TRIGGER_RENOUCEDARKNESS_01	어둠 삭제!	
VO_MechaJar_Male_Demon_Well_Played_01	훌륭하다!	
VO_MechaJar_Male_Demon_WOW_01	놀랍군.	
VO_Story_Hero_Rexxar_Male_Orc-Ogre_Story_Rexxar_Attack_01	이러고 싶진 않았지만... 어쩔 수 없군.	
VO_Story_Hero_Rexxar_Male_Orc-Ogre_Story_Rexxar_Greetings_01	반갑네.	
VO_TBA01_4__Concede	*으르렁*	
VO_TBA01_4__Error_Full_Minions	*으르렁*	
VO_TBA01_4__Error_Generic	*으르렁*	
VO_TBA01_4__Error_Hand_Full	*으르렁*	
VO_TBA01_4__Error_I_Attacked	*으르렁*	
VO_TBA01_4__Error_Just_Played	*으르렁*	
VO_TBA01_4__Error_Minion_Attacked	*으르렁*	
VO_TBA01_4__Error_Need_Mana	*으르렁*	
VO_TBA01_4__Error_Need_Weapon	*으르렁*	
VO_TBA01_4__Error_Play	*으르렁*	
VO_TBA01_4__Error_Stealth	*으르렁*	
VO_TBA01_4__Good_Game	*으르렁*	
VO_TBA01_4__Greetings	게임을 시작하자!	
VO_TBA01_4__Low_Cards	*으르렁*	
VO_TBA01_4__No_Cards	*으르렁*	
VO_TBA01_4__Oops	*사악한 웃음*	
VO_TBA01_4__Sorry	*위협적인 웃음*	
VO_TBA01_4__Start	불타라! 활활!	
VO_TBA01_4__Thanks	*악한 웃음*	
VO_TBA01_4__Threaten	하하하! 보아라! 이게 바로 나, 네파리안의 진정한 힘이다!	
VO_TBA01_4__Timer	*으르렁*	
VO_TBA01_4__Well_Played	*악의 어린 웃음*	
VO_TRLA_204h_Male_Troll_Concede_03	네가 이겼지만... 나는 절대 잊지 않아!	
VO_TRLA_204h_Male_Troll_Greetings_01	아! 이게 누구야!	
VO_TRLA_204h_Male_Troll_LowCards_01	카드가 얼마 없는데...	
VO_TRLA_204h_Male_Troll_Mirror_Greetings_01	누구긴. 너잖아.	
VO_TRLA_204h_Male_Troll_NoCards_01	카드가 없어!	
VO_TRLA_204h_Male_Troll_Oops_01	으... 실수로군.	
VO_TRLA_204h_Male_Troll_Thanks_01	정말 너그럽군.	
VO_TRLA_204h_Male_Troll_Thinking_03	흠...	
VO_TRLA_204h_Male_Troll_Thinking_09	네 녀석을 어떻게 처리해줄까...	
VO_TRLA_204h_Male_Troll_Thinking_10	하. 이건 좀 아플 거다...	
VO_TRLA_204h_Male_Troll_Threaten_01	이 도끼에도 답해 봐라!	
VO_TRLA_204h_Male_Troll_Time_01	서둘러야겠어!	
VO_TRLA_204h_Male_Troll_Well_Played_02	아주 좋았어.	
VO_TRLA_204h_Male_Troll_WOW_01	로아께서도 놀라시겠군!	
VO_ULDA_Brann_Male_Dwarf_Attack_02	역사 속으로 사라지시죠!	
VO_ULDA_Brann_Male_Dwarf_Concede_01	다른 이들이 제 복수를 해줄 겁니다!	
VO_ULDA_Brann_Male_Dwarf_Death_02	손에 넣을 수... 있었는데...	
VO_ULDA_Brann_Male_Dwarf_ERROR_FULL_MINIONS_02	하수인이 너무 많아요.	
VO_ULDA_Brann_Male_Dwarf_ERROR_GENERIC_03	그렇겐 못 해요.	
VO_ULDA_Brann_Male_Dwarf_ERROR_HAND_FULL_01	카드가 너무 많다고요!	
VO_ULDA_Brann_Male_Dwarf_ERROR_I_ATTACKED_01	전 이미 공격했어요.	
VO_ULDA_Brann_Male_Dwarf_ERROR_MINION_ATTACKED_01	그 하수인은 이미 공격했군요.	
VO_ULDA_Brann_Male_Dwarf_ERROR_NEED_MANA_02	그러려면 마나가 더 있어야겠군요.	
VO_ULDA_Brann_Male_Dwarf_ERROR_NEED_WEAPON_01	무기가 필요해요.	
VO_ULDA_Brann_Male_Dwarf_ERROR_PLAY_01	그건 낼 수 없어요.	
VO_ULDA_Brann_Male_Dwarf_ERROR_STEALTH_01	그 하수인은 은신 중이에요.	
VO_ULDA_Brann_Male_Dwarf_ERROR_SUMMON_SICKNESS_01	그 하수인은 준비할 시간이 필요해요.	
VO_ULDA_Brann_Male_Dwarf_ERROR_TARGET_02	대상을 지정해주시죠!	
VO_ULDA_Brann_Male_Dwarf_ERROR_TAUNT_01	도발 능력이 있는 하수인이 가로막고 있어요.	
VO_ULDA_Brann_Male_Dwarf_Greetings_01	거기, 안녕하십니까!	
VO_ULDA_Brann_Male_Dwarf_HAPPY_BIRTHDAY_01	생일 축하드려요!	
VO_ULDA_Brann_Male_Dwarf_HAPPY_BREWFEST_01	아, 가을축제! 가장 신바람 나는 축제죠.	
VO_ULDA_Brann_Male_Dwarf_HAPPY_HALLOWEEN_01	조심하세요. 할로윈 축제가 시작됐습니다!	
VO_ULDA_Brann_Male_Dwarf_HAPPY_HOLIDAYS_01	이 날을 기념하며!	
VO_ULDA_Brann_Male_Dwarf_HAPPY_NEW_YEAR_01	새해가 왔군요!	
VO_ULDA_Brann_Male_Dwarf_HAPPY_NEW_YEAR_LUNAR_01	새해 복 많이 받으세요!	
VO_ULDA_Brann_Male_Dwarf_HAPPY_NOBLEGARDEN_01	알들을 모조리 찾아버리겠습니다.	
VO_ULDA_Brann_Male_Dwarf_LowCards_01	카드가 슬슬 부족한데요.	
VO_ULDA_Brann_Male_Dwarf_MIRROR_GREETINGS_01	아, 반가워요!	
VO_ULDA_Brann_Male_Dwarf_MIRROR_START_01	누가 제 전투의 함성을 복사했나보군요!	
VO_ULDA_Brann_Male_Dwarf_NoCards_01	카드가 없습니다!	
VO_ULDA_Brann_Male_Dwarf_Oops_02	방금 실수는 그냥 잊어도 될 거 같아요.	
VO_ULDA_Brann_Male_Dwarf_Picked_01	해답은 여기 있습니다. 분명해요!	
VO_ULDA_Brann_Male_Dwarf_PIRATE_DAY_01	모두 승선하라! ...안 해도 되고요.	
VO_ULDA_Brann_Male_Dwarf_Sorry_01	아이고, 죄송합니다.	
VO_ULDA_Brann_Male_Dwarf_Start_01	도망갈 곳은 없습니다.	
VO_ULDA_Brann_Male_Dwarf_Thanks_02	고맙습니다!	
VO_ULDA_Brann_Male_Dwarf_Thinking_01	흠...	
VO_ULDA_Brann_Male_Dwarf_Thinking_02	함정일 수도...	
VO_ULDA_Brann_Male_Dwarf_Thinking_03	생각해, 브란...!	
VO_ULDA_Brann_Male_Dwarf_Thinking_04	이거 잘만하면...	
VO_ULDA_Brann_Male_Dwarf_Thinking_05	우린 탐험가... 연맹이다...	
VO_ULDA_Brann_Male_Dwarf_Thinking_06	...함께할 자 어서 오라...	
VO_ULDA_Brann_Male_Dwarf_Threaten_02	절 막기엔 역부족일 겁니다!	
VO_ULDA_Brann_Male_Dwarf_Time_01	시간이 좀 부족한 것 같군요.	
VO_ULDA_Brann_Male_Dwarf_Well_Played_01	아, 바로 그거죠!	
VO_ULDA_Brann_Male_Dwarf_WOW_01	마그니 맙소사!	
VO_ULDA_Elise_Female_NightElf_Concede_02	이럴 땐... 후퇴해야 해요!	
VO_ULDA_Elise_Female_NightElf_Death_02	이렇게는...	
VO_ULDA_Elise_Female_NightElf_ERROR_FULL_MINIONS_01	하수인을 더 관리할 수 없어요.	
VO_ULDA_Elise_Female_NightElf_ERROR_GENERIC_01	불가능하다고요.	
VO_ULDA_Elise_Female_NightElf_ERROR_HAND_FULL_01	카드가 너무 많아요!	
VO_ULDA_Elise_Female_NightElf_ERROR_I_ATTACKED_01	전 이미 공격했어요.	
VO_ULDA_Elise_Female_NightElf_ERROR_MINION_ATTACKED_01	그 하수인은 지친 거 같네요.	
VO_ULDA_Elise_Female_NightElf_ERROR_NEED_MANA_01	마나가 부족해요!	
VO_ULDA_Elise_Female_NightElf_ERROR_NEED_WEAPON_01	우선 무기부터 주실래요?	
VO_ULDA_Elise_Female_NightElf_ERROR_PLAY_01	그럴 순 없겠네요.	
VO_ULDA_Elise_Female_NightElf_ERROR_STEALTH_01	아직 은신 중이에요.	
VO_ULDA_Elise_Female_NightElf_ERROR_SUMMON_SICKNESS_01	잠깐 쉬게 둬야 할 거 같은데요.	
VO_ULDA_Elise_Female_NightElf_ERROR_TARGET_01	제 능력 밖의 일이군요.	
VO_ULDA_Elise_Female_NightElf_ERROR_TAUNT_01	뭔가가 절 도발하고 있어요.	
VO_ULDA_Elise_Female_NightElf_Greetings_01	전 엘리스 스타시커. 기필코 당신을 막겠어요!	
VO_ULDA_Elise_Female_NightElf_HAPPY_BIRTHDAY_01	소중한 날에 소중한 추억을 만드시길.	
VO_ULDA_Elise_Female_NightElf_HAPPY_HALLOWEEN_01	할로윈 축제의 기원은 정말 충격적이더군요!	
VO_ULDA_Elise_Female_NightElf_HAPPY_HOLIDAYS_01	올해에는 착한 일을 많이 하셨나요?	
VO_ULDA_Elise_Female_NightElf_HAPPY_NEW_YEAR_01	즐거운 새해군요!	
VO_ULDA_Elise_Female_NightElf_HAPPY_NEW_YEAR_LUNAR_01	새해에도 복이 가득하시길!	
VO_ULDA_Elise_Female_NightElf_HAPPY_NOBLEGARDEN_01	아, 귀족의 정원 축제는 정말 즐거워요!	
VO_ULDA_Elise_Female_NightElf_LowCards_01	카드가 얼마 없어요.	
VO_ULDA_Elise_Female_NightElf_MIRROR_GREETINGS_01	정말요? 절 놀래키기엔 부족할 것 같은데요.	
VO_ULDA_Elise_Female_NightElf_MIRROR_START_01	보아하니 저 자신이 제 가장 큰 적인가 보네요.	
VO_ULDA_Elise_Female_NightElf_NoCards_01	카드가 없어요!	
VO_ULDA_Elise_Female_NightElf_Oops_01	실수라니.	
VO_ULDA_Elise_Female_NightElf_Picked_01	현장에 나갈 시간이군요.	
VO_ULDA_Elise_Female_NightElf_PIRATE_DAY_01	스타시커 선장, 승선합니다!	
VO_ULDA_Elise_Female_NightElf_Sorry_01	사과드릴게요!	
VO_ULDA_Elise_Female_NightElf_Start_02	탐험가 연맹은 실패하지 않아요!	
VO_ULDA_Elise_Female_NightElf_Thanks_02	진심으로 감사드려요!	
VO_ULDA_Elise_Female_NightElf_Thinking_01	실패할 순 없어...	
VO_ULDA_Elise_Female_NightElf_Thinking_02	중요한 순간이야...	
VO_ULDA_Elise_Female_NightElf_Thinking_03	흠...	
VO_ULDA_Elise_Female_NightElf_Thinking_04	정말 흥미로워...	
VO_ULDA_Elise_Female_NightElf_Threaten_01	경고하겠어요. 전 이 싸움을 위해 끊임없이 연구했다고요.	
VO_ULDA_Elise_Female_NightElf_Time_01	시간이 촉박해요.	
VO_ULDA_Elise_Female_NightElf_Well_Played_01	이 전투는 역사에 길이 남을 거예요.	
VO_ULDA_Elise_Female_NightElf_WOW_01	놀라워요!	
VO_ULDA_Finley_Male_Murloc_Concede_01	오늘은 당신이 승리자군요.	
VO_ULDA_Finley_Male_Murloc_ERROR_FULL_MINIONS_01	공간이 부족합니다.	
VO_ULDA_Finley_Male_Murloc_ERROR_GENERIC_04	그건 예의에 어긋납니다.	
VO_ULDA_Finley_Male_Murloc_ERROR_HAND_FULL_02	카드가 너무 많군요... 오, 이런!	
VO_ULDA_Finley_Male_Murloc_ERROR_I_ATTACKED_02	신사답게 한 턴에 한 번만 공격하시죠.	
VO_ULDA_Finley_Male_Murloc_ERROR_MINION_ATTACKED_01	그 하수인은 이미 공격했습니다.	
VO_ULDA_Finley_Male_Murloc_ERROR_NEED_MANA_02	그러려면 마나가 더 필요하겠군요.	
VO_ULDA_Finley_Male_Murloc_ERROR_NEED_WEAPON_02	우선 무기가 필요합니다.	
VO_ULDA_Finley_Male_Murloc_ERROR_PLAY_01	그건 낼 수 없습니다.	
VO_ULDA_Finley_Male_Murloc_ERROR_STEALTH_01	그 하수인은 은신 중입니다.	
VO_ULDA_Finley_Male_Murloc_ERROR_SUMMON_SICKNESS_01	그 하수인은 준비할 시간이 필요하겠군요.	
VO_ULDA_Finley_Male_Murloc_ERROR_TARGET_02	대상이 필요합니다.	
VO_ULDA_Finley_Male_Murloc_ERROR_TAUNT_02	저 도발 하수인은 문제가 될 것 같군요.	
VO_ULDA_Finley_Male_Murloc_Greetings_01	아! 정말 좋은 날이군요.	
VO_ULDA_Finley_Male_Murloc_HAPPY_BIRTHDAY_01	결투 완료	
VO_ULDA_Finley_Male_Murloc_HAPPY_BREWFEST_01	가을축제라! 축제 본연의 의도에 충실해야겠군요.	
VO_ULDA_Finley_Male_Murloc_HAPPY_HALLOWEEN_01	할로윈 축제라. 정말 오싹한 축제군요.	
VO_ULDA_Finley_Male_Murloc_HAPPY_HOLIDAYS_01	아주 흥겨운 축제로군요!	
VO_ULDA_Finley_Male_Murloc_HAPPY_NEW_YEAR_01	새로운 해가 시작되었습니다!	
VO_ULDA_Finley_Male_Murloc_HAPPY_NEW_YEAR_LUNAR_01	올해에도 만사형통하시길 바랍니다!	
VO_ULDA_Finley_Male_Murloc_HAPPY_NOBLEGARDEN_01	잠시 동안 귀족의 정원의 기원에 대해 생각하는 시간을 가지시죠.	
VO_ULDA_Finley_Male_Murloc_LowCards_01	카드가 매우 부족하군요.	
VO_ULDA_Finley_Male_Murloc_MIRROR_GREETINGS_01	당신도 핀리 므르글턴 경이십니까?	
VO_ULDA_Finley_Male_Murloc_MIRROR_START_01	세상에! 멀록변신수라니!	
VO_ULDA_Finley_Male_Murloc_NoCards_01	카드가 메말랐습니다!	
VO_ULDA_Finley_Male_Murloc_Oops_01	오, 이런. 큰 실수를 했군요.	
VO_ULDA_Finley_Male_Murloc_Picked_02	모험을 떠나기에 좋은 날이군요! 역병만 없다면 좋으련만.	
VO_ULDA_Finley_Male_Murloc_PIRATE_DAY_01	아, 오늘은 해적인 척 하는 겁니까? 음... 야르?	
VO_ULDA_Finley_Male_Murloc_Sorry_01	이거, 사과드려야겠군요.	
VO_ULDA_Finley_Male_Murloc_Start_01	물러나십시오, 악한 자여. 제가 이 세상을 구하겠습니다.	
VO_ULDA_Finley_Male_Murloc_Thanks_01	감사합니다, 친구!	
VO_ULDA_Finley_Male_Murloc_Thinking_01	흠...	
VO_ULDA_Finley_Male_Murloc_Thinking_02	오호라...	
VO_ULDA_Finley_Male_Murloc_Thinking_03	꽤 난처하군요...	
VO_ULDA_Finley_Male_Murloc_Thinking_04	과연...	
VO_ULDA_Finley_Male_Murloc_Thinking_05	상황이 참...	
VO_ULDA_Finley_Male_Murloc_Threaten_03	이젠 봐드리지 않겠습니다!	
VO_ULDA_Finley_Male_Murloc_Time_01	시간이 촉박하군요.	
VO_ULDA_Finley_Male_Murloc_Well_Played_01	묘수로군요.	
VO_ULDA_Finley_Male_Murloc_WOW_01	세상에나!	
VO_ULDA_Reno_Male_Human_Attack_01	<공격>	
VO_ULDA_Reno_Male_Human_Concede_01	절대 포기하지 말고! 도망쳐!	
VO_ULDA_Reno_Male_Human_Death_01	<죽음>	
VO_ULDA_Reno_Male_Human_ERROR_FULL_MINIONS_01	공간이 없어.	
VO_ULDA_Reno_Male_Human_ERROR_GENERIC_02	그럴 수 있다면 이미 그랬겠지.	
VO_ULDA_Reno_Male_Human_ERROR_HAND_FULL_02	이 많은 카드로 뭘 해야 하지?!	
VO_ULDA_Reno_Male_Human_ERROR_I_ATTACKED_02	숨 돌릴 시간이 필요해!	
VO_ULDA_Reno_Male_Human_ERROR_MINION_ATTACKED_01	그 하수인은 이미 공격했어.	
VO_ULDA_Reno_Male_Human_ERROR_NEED_MANA_01	마나가 필요해!	
VO_ULDA_Reno_Male_Human_ERROR_NEED_WEAPON_01	무기가 필요해.	
VO_ULDA_Reno_Male_Human_ERROR_PLAY_01	그건 낼 수 없어.	
VO_ULDA_Reno_Male_Human_ERROR_STEALTH_02	숨어있는 거 같아. 약삭빠른 녀석 같으니.	
VO_ULDA_Reno_Male_Human_ERROR_SUMMON_SICKNESS_01	그 하수인은 준비할 시간이 필요해.	
VO_ULDA_Reno_Male_Human_ERROR_TARGET_01	대상이 없어!	
VO_ULDA_Reno_Male_Human_ERROR_TAUNT_01	도발 능력이 있는 하수인이 가로막고 있어.	
VO_ULDA_Reno_Male_Human_Greetings_01	만나서 반가워, 친구!	
VO_ULDA_Reno_Male_Human_HAPPY_BIRTHDAY_02	생일 축하해!	
VO_ULDA_Reno_Male_Human_HAPPY_BREWFEST_01	가을축제라! 이 축제는 내가 마음껏 즐길 수 있지.	
VO_ULDA_Reno_Male_Human_HAPPY_HALLOWEEN_01	할로윈 축제는 뭔가 으스스하단 말이야.	
VO_ULDA_Reno_Male_Human_HAPPY_HOLIDAYS_01	행복한 축제를 즐기라고!	
VO_ULDA_Reno_Male_Human_HAPPY_NEW_YEAR_01	새해가 밝았어!	
VO_ULDA_Reno_Male_Human_HAPPY_NEW_YEAR_LUNAR_01	새해 복 받고 부자 되라고!	
VO_ULDA_Reno_Male_Human_HAPPY_NOBLEGARDEN_01	귀족의 정원 축제군. 바구니를 넘기라고!	
VO_ULDA_Reno_Male_Human_KISS_01	<키스>	
VO_ULDA_Reno_Male_Human_LowCards_01	카드가 바닥을 드러내는 거 같은데...	
VO_ULDA_Reno_Male_Human_MIRROR_GREETINGS_01	그 모자는 어디서 난 건가?	
VO_ULDA_Reno_Male_Human_MIRROR_START_01	둘 중 하나는 포기하라고.	
VO_ULDA_Reno_Male_Human_NoCards_01	카드가 없어!	
VO_ULDA_Reno_Male_Human_Oops_02	방금 그건 아무도 안 봤으면 좋겠는데.	
VO_ULDA_Reno_Male_Human_Picked_02	내가 나설 차례로군!	
VO_ULDA_Reno_Male_Human_PIRATE_DAY_01	리노 잭슨이 아니라 선장 잭슨이라고!	
VO_ULDA_Reno_Male_Human_Sorry_01	방금 건 사과해야겠네.	
VO_ULDA_Reno_Male_Human_Start_01	우린 부자가 될 거야! 세계도 구하고!	
VO_ULDA_Reno_Male_Human_Thanks_01	아, 고마워.	
VO_ULDA_Reno_Male_Human_Thinking_01	흠...	
VO_ULDA_Reno_Male_Human_Thinking_02	쉽진 않겠는데...	
VO_ULDA_Reno_Male_Human_Thinking_03	정말 미친 생각이지만... 가능해...	
VO_ULDA_Reno_Male_Human_Thinking_04	이보다 더한 것도 견뎌냈잖아...	
VO_ULDA_Reno_Male_Human_Threaten_02	좋게좋게 가자고. 내 방식대로 하기 전에.	
VO_ULDA_Reno_Male_Human_Time_01	빨리 움직여야 할 거 같은데...	
VO_ULDA_Reno_Male_Human_Well_Played_01	아주 잘 대처했어!	
VO_ULDA_Reno_Male_Human_WOW_01	멀록님 맙소사!	
VO_YOD_009_Male_Human_Concede_01	아, 내가 졌군 그래!	
VO_YOD_009_Male_Human_ERROR_FULL_MINIONS_02	하수인이 너무 많아.	
VO_YOD_009_Male_Human_Greetings_01	난 부자가 될 거야!	
VO_YOD_009_Male_Human_LowCards_01	내 마법서가 너무 가벼운데!	
VO_YOD_009_Male_Human_MIRROR_GREETINGS_01	아니, 우린 부자가 될 거야!	
VO_YOD_009_Male_Human_MIRROR_START_01	잠깐! 여긴 내가 먼저 왔다고!	
VO_YOD_009_Male_Human_NoCards_01	카드가 없다니!	
VO_YOD_009_Male_Human_Oops_01	하, 방금 그건 의도한 거야.	
VO_YOD_009_Male_Human_Picked_01	마법 좀 써볼까?	
VO_YOD_009_Male_Human_Sorry_01	어, 이런... 하하, 미안.	
VO_YOD_009_Male_Human_Start_01	탐험할 무덤 어디 없나?	
VO_YOD_009_Male_Human_Thanks_01	고마워. 내가 좀 대단하긴 하지.	
VO_YOD_009_Male_Human_Thinking_01	흠...	
VO_YOD_009_Male_Human_Thinking_03	저거만 시전하면...	
VO_YOD_009_Male_Human_Thinking_04	어떻게 하면 부자가 될까...	
VO_YOD_009_Male_Human_Threaten_01	날 화나게 하면 커다란 주문을 맛보게 될 거라고!	
VO_YOD_009_Male_Human_Time_01	아! 시간이 더 있는 줄 알았는데!	
VO_YOD_009_Male_Human_Well_Played_01	너도 꽤 괜찮은 재주를 가지고 있군 그래!	
VO_YOD_009_Male_Human_WOW_01	놀라워! 나처럼!	
