TAG	TEXT	COMMENT
PRESENCE_ADVENTURE_MODE_BOT	박사 붐의 연구소 둘러보는 중	
PRESENCE_ADVENTURE_MODE_BRM_CLASS_CHALLENGE	검은바위 산 직업별 도전 과제	
PRESENCE_ADVENTURE_MODE_BRM_HEROIC	검은바위 산 (영웅)	
PRESENCE_ADVENTURE_MODE_BRM_NORMAL	검은바위 산	
PRESENCE_ADVENTURE_MODE_DAL	침공 모의 중	
PRESENCE_ADVENTURE_MODE_GIL	괴물 사냥 준비 중	
PRESENCE_ADVENTURE_MODE_ICC_NORMAL	얼음왕관에 들어서는 중	
PRESENCE_ADVENTURE_MODE_KAR_CLASS_CHALLENGE	카라잔 직업별 도전 과제	
PRESENCE_ADVENTURE_MODE_KAR_HEROIC	카라잔 (영웅)	
PRESENCE_ADVENTURE_MODE_KAR_NORMAL	카라잔	
PRESENCE_ADVENTURE_MODE_LOE_CLASS_CHALLENGE	탐험가 연맹 직업별 도전 과제	
PRESENCE_ADVENTURE_MODE_LOE_HEROIC	탐험가 연맹 (영웅)	
PRESENCE_ADVENTURE_MODE_LOE_NORMAL	탐험가 연맹	
PRESENCE_ADVENTURE_MODE_LOOT	미궁 탐험을 준비하는 중	
PRESENCE_ADVENTURE_MODE_NAXX_CLASS_CHALLENGE	낙스라마스 직업별 도전 과제	
PRESENCE_ADVENTURE_MODE_NAXX_HEROIC	낙스라마스 (영웅)	
PRESENCE_ADVENTURE_MODE_NAXX_NORMAL	낙스라마스	
PRESENCE_ADVENTURE_MODE_RETURNING_PLAYER_CHALLENGE	게임에 복귀하는 중!	
PRESENCE_ADVENTURE_MODE_TRL	대난투에 뛰어들 준비 중...	
PRESENCE_SCENARIO_BOTA_CLEAR_BOOM	묘수풀이 푸는 중	
PRESENCE_SCENARIO_BOTA_CLEAR_PUZZLE_1	묘수풀이 푸는 중	
PRESENCE_SCENARIO_BOTA_CLEAR_PUZZLE_2	묘수풀이 푸는 중	
PRESENCE_SCENARIO_BOTA_CLEAR_PUZZLE_3	묘수풀이 푸는 중	
PRESENCE_SCENARIO_BOTA_CLEAR_PUZZLE_4	묘수풀이 푸는 중	
PRESENCE_SCENARIO_BOTA_LETHAL_BOOM	묘수풀이 푸는 중	
PRESENCE_SCENARIO_BOTA_LETHAL_PUZZLE_1	묘수풀이 푸는 중	
PRESENCE_SCENARIO_BOTA_LETHAL_PUZZLE_2	묘수풀이 푸는 중	
PRESENCE_SCENARIO_BOTA_LETHAL_PUZZLE_3	묘수풀이 푸는 중	
PRESENCE_SCENARIO_BOTA_LETHAL_PUZZLE_4	묘수풀이 푸는 중	
PRESENCE_SCENARIO_BOTA_MIRROR_BOOM	묘수풀이 푸는 중	
PRESENCE_SCENARIO_BOTA_MIRROR_PUZZLE_1	묘수풀이 푸는 중	
PRESENCE_SCENARIO_BOTA_MIRROR_PUZZLE_2	묘수풀이 푸는 중	
PRESENCE_SCENARIO_BOTA_MIRROR_PUZZLE_3	묘수풀이 푸는 중	
PRESENCE_SCENARIO_BOTA_MIRROR_PUZZLE_4	묘수풀이 푸는 중	
PRESENCE_SCENARIO_BOTA_SURVIVAL_BOOM	묘수풀이 푸는 중	
PRESENCE_SCENARIO_BOTA_SURVIVAL_PUZZLE_1	묘수풀이 푸는 중	
PRESENCE_SCENARIO_BOTA_SURVIVAL_PUZZLE_2	묘수풀이 푸는 중	
PRESENCE_SCENARIO_BOTA_SURVIVAL_PUZZLE_3	묘수풀이 푸는 중	
PRESENCE_SCENARIO_BOTA_SURVIVAL_PUZZLE_4	묘수풀이 푸는 중	
PRESENCE_SCENARIO_BRM_CLASS_CHALLENGE_DRUID	검은바위 산 드루이드 도전 과제	
PRESENCE_SCENARIO_BRM_CLASS_CHALLENGE_HUNTER	검은바위 산 사냥꾼 도전 과제	
PRESENCE_SCENARIO_BRM_CLASS_CHALLENGE_MAGE	검은바위 산 마법사 도전 과제	
PRESENCE_SCENARIO_BRM_CLASS_CHALLENGE_PALADIN	검은바위 산 성기사 도전 과제	
PRESENCE_SCENARIO_BRM_CLASS_CHALLENGE_PRIEST	검은바위 산 사제 도전 과제	
PRESENCE_SCENARIO_BRM_CLASS_CHALLENGE_ROGUE	검은바위 산 도적 도전 과제	
PRESENCE_SCENARIO_BRM_CLASS_CHALLENGE_SHAMAN	검은바위 산 주술사 도전 과제	
PRESENCE_SCENARIO_BRM_CLASS_CHALLENGE_WARLOCK	검은바위 산 흑마법사 도전 과제	
PRESENCE_SCENARIO_BRM_CLASS_CHALLENGE_WARRIOR	검은바위 산 전사 도전 과제	
PRESENCE_SCENARIO_BRM_HEROIC_SCENARIO_ATRAMEDES	아트라메데스 (영웅)	
PRESENCE_SCENARIO_BRM_HEROIC_SCENARIO_BARON_GEDDON	남작 게돈 (영웅)	
PRESENCE_SCENARIO_BRM_HEROIC_SCENARIO_CHROMAGGUS	크로마구스 (영웅)	
PRESENCE_SCENARIO_BRM_HEROIC_SCENARIO_DARK_IRON_ARENA	검은무쇠 투기장 (영웅)	feel free to shorten long translations since the UI may squeeze text into a tiny (unreadable) font size when text is too long. this string is shown in the Friends List.
PRESENCE_SCENARIO_BRM_HEROIC_SCENARIO_DRAKKISATH	드라키사스 (영웅)	
PRESENCE_SCENARIO_BRM_HEROIC_SCENARIO_GARR	가르 (영웅)	
PRESENCE_SCENARIO_BRM_HEROIC_SCENARIO_GRIM_GUZZLER	험상궂은 주정뱅이 선술집 (영웅)	
PRESENCE_SCENARIO_BRM_HEROIC_SCENARIO_MAJORDOMO	라그나로스 (영웅)	feel free to shorten long translations to 'Heroic Ragnaros' since the UI may squeeze text into a tiny (unreadable) font size when text is too long. this string is shown in the Friends List.
PRESENCE_SCENARIO_BRM_HEROIC_SCENARIO_MALORIAK	말로리악 (영웅)	
PRESENCE_SCENARIO_BRM_HEROIC_SCENARIO_NEFARIAN	군주 빅터 네파리우스 (영웅)	feel free to shorten long translations to 'Heroic Nefarius' since the UI may squeeze text into a tiny (unreadable) font size when text is too long. this string is shown in the Friends List.
PRESENCE_SCENARIO_BRM_HEROIC_SCENARIO_OMNOTRON	만능골렘 (영웅)	
PRESENCE_SCENARIO_BRM_HEROIC_SCENARIO_OMOKK	오모크 (영웅)	
PRESENCE_SCENARIO_BRM_HEROIC_SCENARIO_RAZORGORE	서슬송곳니 (영웅)	
PRESENCE_SCENARIO_BRM_HEROIC_SCENARIO_REND_BLACKHAND	렌드 블랙핸드 (영웅)	
PRESENCE_SCENARIO_BRM_HEROIC_SCENARIO_THAURISSAN	제왕 타우릿산 (영웅)	feel free to shorten long translations to 'Heroic Thaurissan' since the UI may squeeze text into a tiny (unreadable) font size when text is too long. this string is shown in the Friends List.
PRESENCE_SCENARIO_BRM_HEROIC_SCENARIO_VAELASTRASZ	밸라스트라즈 (영웅)	
PRESENCE_SCENARIO_BRM_HEROIC_SCENARIO_ZOMBIE_NEF	네파리안 (영웅)	
PRESENCE_SCENARIO_BRM_NORMAL_SCENARIO_ATRAMEDES	아트라메데스에게 도전 중	
PRESENCE_SCENARIO_BRM_NORMAL_SCENARIO_BARON_GEDDON	남작 게돈에게 도전 중	
PRESENCE_SCENARIO_BRM_NORMAL_SCENARIO_CHROMAGGUS	크로마구스에게 도전 중	
PRESENCE_SCENARIO_BRM_NORMAL_SCENARIO_DARK_IRON_ARENA	검은무쇠 투기장에서 전투 중	feel free to shorten long translations since the UI may squeeze text into a tiny (unreadable) font size when text is too long. this string is shown in the Friends List.
PRESENCE_SCENARIO_BRM_NORMAL_SCENARIO_DRAKKISATH	드라키사스에게 도전 중	
PRESENCE_SCENARIO_BRM_NORMAL_SCENARIO_GARR	가르에게 도전 중	
PRESENCE_SCENARIO_BRM_NORMAL_SCENARIO_GRIM_GUZZLER	코렌 다이어브루에게 도전 중	
PRESENCE_SCENARIO_BRM_NORMAL_SCENARIO_MAJORDOMO	라그나로스에게 도전 중	feel free to shorten long translations to 'Battling Ragnaros' since the UI may squeeze text into a tiny (unreadable) font size when text is too long. this string is shown in the Friends List.
PRESENCE_SCENARIO_BRM_NORMAL_SCENARIO_MALORIAK	말로리악에게 도전 중	
PRESENCE_SCENARIO_BRM_NORMAL_SCENARIO_NEFARIAN	빅터 네파리우스에게 도전 중	feel free to shorten long translations to 'Battling Nefarius' since the UI may squeeze text into a tiny (unreadable) font size when text is too long. this string is shown in the Friends List.
PRESENCE_SCENARIO_BRM_NORMAL_SCENARIO_OMNOTRON	만능골렘에게 도전 중	
PRESENCE_SCENARIO_BRM_NORMAL_SCENARIO_OMOKK	오모크에게 도전 중	
PRESENCE_SCENARIO_BRM_NORMAL_SCENARIO_RAZORGORE	서슬송곳니에게 도전 중	
PRESENCE_SCENARIO_BRM_NORMAL_SCENARIO_REND_BLACKHAND	렌드 블랙핸드에게 도전 중	
PRESENCE_SCENARIO_BRM_NORMAL_SCENARIO_THAURISSAN	제왕 타우릿산에게 도전 중	feel free to shorten long translations to 'Battling Thaurissan' since the UI may squeeze text into a tiny (unreadable) font size when text is too long. this string is shown in the Friends List.
PRESENCE_SCENARIO_BRM_NORMAL_SCENARIO_VAELASTRASZ	밸라스트라즈에게 도전 중	
PRESENCE_SCENARIO_BRM_NORMAL_SCENARIO_ZOMBIE_NEF	네파리안에게 도전 중	
PRESENCE_SCENARIO_DALA_01_BANK	달라란 은행 터는 중	
PRESENCE_SCENARIO_DALA_01_BANK_HEROIC	달라란 은행 터는 중	
PRESENCE_SCENARIO_DALA_02_VIOLET_HOLD	보랏빛 요새의 죄수들을 풀어주는 중	
PRESENCE_SCENARIO_DALA_02_VIOLET_HOLD_HEROIC	보랏빛 요새의 죄수들을 풀어주는 중	
PRESENCE_SCENARIO_DALA_03_STREETS	거리를 장악하는 중	
PRESENCE_SCENARIO_DALA_03_STREETS_HEROIC	거리를 장악하는 중	
PRESENCE_SCENARIO_DALA_04_UNDERBELLY	마법의 뒤안길 침입 중	
PRESENCE_SCENARIO_DALA_04_UNDERBELLY_HEROIC	마법의 뒤안길 침입 중	
PRESENCE_SCENARIO_DALA_05_CITADEL	보랏빛 성채 점령 중	
PRESENCE_SCENARIO_DALA_05_CITADEL_HEROIC	보랏빛 성채 점령 중	
PRESENCE_SCENARIO_DALA_TAVERN	달라란 선술집에서 작당 중	
PRESENCE_SCENARIO_DALA_TAVERN_HEROIC	달라란 선술집에서 작당 중	
PRESENCE_SCENARIO_GIL_BONUS_CHALLENGE	하가사에게 도전하는 중	
PRESENCE_SCENARIO_GIL_DUNGEON	괴물 사냥 중	
PRESENCE_SCENARIO_ICC_NORMAL_DEATHWHISPER	데스위스퍼에게 도전 중	
PRESENCE_SCENARIO_ICC_NORMAL_FINALE	리치 왕에게 도전 중	
PRESENCE_SCENARIO_ICC_NORMAL_LANATHEL	라나텔에게 도전 중	
PRESENCE_SCENARIO_ICC_NORMAL_LICHKING	리치 왕에게 지는 중	
PRESENCE_SCENARIO_ICC_NORMAL_MARROWGAR	매로우가르에게 도전 중	
PRESENCE_SCENARIO_ICC_NORMAL_PUTRICIDE	퓨트리사이드에게 도전 중	
PRESENCE_SCENARIO_ICC_NORMAL_SAURFANG	사울팽에게 도전 중	
PRESENCE_SCENARIO_ICC_NORMAL_SINDRAGOSA	신드라고사에게 도전 중	
PRESENCE_SCENARIO_KAR_CLASS_CHALLENGE_DRUID	카라잔 드루이드 도전 과제	
PRESENCE_SCENARIO_KAR_CLASS_CHALLENGE_HUNTER	카라잔 사냥꾼 도전 과제	
PRESENCE_SCENARIO_KAR_CLASS_CHALLENGE_MAGE	카라잔 마법사 도전 과제	
PRESENCE_SCENARIO_KAR_CLASS_CHALLENGE_PALADIN	카라잔 성기사 도전 과제	
PRESENCE_SCENARIO_KAR_CLASS_CHALLENGE_PRIEST	카라잔 사제 도전 과제	
PRESENCE_SCENARIO_KAR_CLASS_CHALLENGE_ROGUE	카라잔 도적 도전 과제	
PRESENCE_SCENARIO_KAR_CLASS_CHALLENGE_SHAMAN	카라잔 주술사 도전 과제	
PRESENCE_SCENARIO_KAR_CLASS_CHALLENGE_WARLOCK	카라잔 흑마법사 도전 과제	
PRESENCE_SCENARIO_KAR_CLASS_CHALLENGE_WARRIOR	카라잔 전사 도전 과제	
PRESENCE_SCENARIO_KAR_HEROIC_ARAN	아란의 망령 (영웅)	
PRESENCE_SCENARIO_KAR_HEROIC_CHESS	체스 (영웅)	
PRESENCE_SCENARIO_KAR_HEROIC_CRONE	마녀 (영웅)	
PRESENCE_SCENARIO_KAR_HEROIC_CURATOR	전시 관리인 (영웅)	
PRESENCE_SCENARIO_KAR_HEROIC_ILLHOOF	일후프 (영웅)	
PRESENCE_SCENARIO_KAR_HEROIC_JULIANNE	줄리엔 (영웅)	
PRESENCE_SCENARIO_KAR_HEROIC_MIRROR	마법 거울 (영웅)	
PRESENCE_SCENARIO_KAR_HEROIC_NETHERSPITE	황천의 원령 (영웅)	
PRESENCE_SCENARIO_KAR_HEROIC_NIGHTBANE	파멸의 어둠 (영웅)	
PRESENCE_SCENARIO_KAR_HEROIC_PANTRY	식기 골렘 (영웅)	
PRESENCE_SCENARIO_KAR_HEROIC_PORTALS	영웅적으로 메디브를 구출하는 중	
PRESENCE_SCENARIO_KAR_HEROIC_PROLOGUE	말체자르 (영웅)	
PRESENCE_SCENARIO_KAR_HEROIC_WOLF	커다란 나쁜 늑대 (영웅)	
PRESENCE_SCENARIO_KAR_NORMAL_ARAN	아란의 망령에게 도전 중	
PRESENCE_SCENARIO_KAR_NORMAL_CHESS	체스에게 도전 중	
PRESENCE_SCENARIO_KAR_NORMAL_CRONE	마녀에게 도전 중	
PRESENCE_SCENARIO_KAR_NORMAL_CURATOR	전시 관리인에게 도전 중	
PRESENCE_SCENARIO_KAR_NORMAL_ILLHOOF	일후프에게 도전 중	
PRESENCE_SCENARIO_KAR_NORMAL_JULIANNE	줄리엔에게 도전 중	
PRESENCE_SCENARIO_KAR_NORMAL_MIRROR	마법 거울에게 도전 중	
PRESENCE_SCENARIO_KAR_NORMAL_NETHERSPITE	황천의 원령에게 도전 중	
PRESENCE_SCENARIO_KAR_NORMAL_NIGHTBANE	파멸의 어둠에게 도전 중	
PRESENCE_SCENARIO_KAR_NORMAL_PANTRY	식기 골렘에게 도전 중	
PRESENCE_SCENARIO_KAR_NORMAL_PORTALS	메디브 구출하는 중!	
PRESENCE_SCENARIO_KAR_NORMAL_PROLOGUE	말체자르에게 도전 중	
PRESENCE_SCENARIO_KAR_NORMAL_WOLF	커다란 나쁜 늑대에게 도전 중	
PRESENCE_SCENARIO_LOE_CLASS_CHALLENGE_DRUID	탐험가 연맹 드루이드 도전 과제	
PRESENCE_SCENARIO_LOE_CLASS_CHALLENGE_HUNTER	탐험가 연맹 사냥꾼 도전 과제	
PRESENCE_SCENARIO_LOE_CLASS_CHALLENGE_MAGE	탐험가 연맹 마법사 도전 과제	
PRESENCE_SCENARIO_LOE_CLASS_CHALLENGE_PALADIN	탐험가 연맹 성기사 도전 과제	
PRESENCE_SCENARIO_LOE_CLASS_CHALLENGE_PRIEST	탐험가 연맹 사제 도전 과제	
PRESENCE_SCENARIO_LOE_CLASS_CHALLENGE_ROGUE	탐험가 연맹 도적 도전 과제	
PRESENCE_SCENARIO_LOE_CLASS_CHALLENGE_SHAMAN	탐험가 연맹 주술사 도전 과제	
PRESENCE_SCENARIO_LOE_CLASS_CHALLENGE_WARLOCK	탐험가 연맹 흑마법사 도전 과제	
PRESENCE_SCENARIO_LOE_CLASS_CHALLENGE_WARRIOR	탐험가 연맹 전사 도전 과제	
PRESENCE_SCENARIO_LOE_HEROIC_ARCHAEDAS	아카에다스 (영웅)	
PRESENCE_SCENARIO_LOE_HEROIC_GIANTFIN	거대아가미 (영웅)	
PRESENCE_SCENARIO_LOE_HEROIC_LADY_NAZJAR	여군주 나즈자르 (영웅)	
PRESENCE_SCENARIO_LOE_HEROIC_MINE_CART	울다만의 광산 (영웅)	
PRESENCE_SCENARIO_LOE_HEROIC_RAFAAM_1	대도 라팜 (영웅)	
PRESENCE_SCENARIO_LOE_HEROIC_RAFAAM_2	전지전능한 라팜 (영웅)	
PRESENCE_SCENARIO_LOE_HEROIC_SCARVASH	족장 스카바쉬 (영웅)	
PRESENCE_SCENARIO_LOE_HEROIC_SKELESAURUS	뼈다귀사우루스 헥스 (영웅)	
PRESENCE_SCENARIO_LOE_HEROIC_SLITHERSPEAR	군주 갈퀴창날 (영웅)	
PRESENCE_SCENARIO_LOE_HEROIC_STEEL_SENTINEL	강철의 파수꾼 (영웅)	
PRESENCE_SCENARIO_LOE_HEROIC_SUN_RAIDER_PHAERIX	태양의 사냥꾼 패릭스 (영웅)	
PRESENCE_SCENARIO_LOE_HEROIC_TEMPLE_ESCAPE	무너지는 사원 (영웅)	
PRESENCE_SCENARIO_LOE_HEROIC_ZINAAR	지나르 (영웅)	
PRESENCE_SCENARIO_LOE_NORMAL_ARCHAEDAS	아카에다스에게 도전 중	
PRESENCE_SCENARIO_LOE_NORMAL_GIANTFIN	거대아가미에게 도전 중	
PRESENCE_SCENARIO_LOE_NORMAL_LADY_NAZJAR	여군주 나즈자르에게 도전 중	
PRESENCE_SCENARIO_LOE_NORMAL_MINE_CART	울다만의 광산	
PRESENCE_SCENARIO_LOE_NORMAL_RAFAAM_1	대도 라팜에게 도전 중	
PRESENCE_SCENARIO_LOE_NORMAL_RAFAAM_2	전지전능한 라팜에게 도전 중	
PRESENCE_SCENARIO_LOE_NORMAL_SCARVASH	족장 스카바쉬에게 도전 중	
PRESENCE_SCENARIO_LOE_NORMAL_SKELESAURUS	뼈다귀사우루스 헥스에게 도전 중	
PRESENCE_SCENARIO_LOE_NORMAL_SLITHERSPEAR	군주 갈퀴창날에게 도전 중	
PRESENCE_SCENARIO_LOE_NORMAL_STEEL_SENTINEL	강철의 파수꾼에게 도전 중	
PRESENCE_SCENARIO_LOE_NORMAL_SUN_RAIDER_PHAERIX	태양의 사냥꾼 패릭스에게 도전 중	
PRESENCE_SCENARIO_LOE_NORMAL_TEMPLE_ESCAPE	무너지는 사원	
PRESENCE_SCENARIO_LOE_NORMAL_ZINAAR	지나르에게 도전 중	
PRESENCE_SCENARIO_LOOT_DUNGEON	미궁 탐험 중	
PRESENCE_SCENARIO_NAXX_CLASS_CHALLENGE_DRUID	낙스라마스 드루이드 도전 과제	
PRESENCE_SCENARIO_NAXX_CLASS_CHALLENGE_HUNTER	낙스라마스 사냥꾼 도전 과제	
PRESENCE_SCENARIO_NAXX_CLASS_CHALLENGE_MAGE	낙스라마스 마법사 도전 과제	
PRESENCE_SCENARIO_NAXX_CLASS_CHALLENGE_PALADIN	낙스라마스 성기사 도전 과제	
PRESENCE_SCENARIO_NAXX_CLASS_CHALLENGE_PRIEST	낙스라마스 사제 도전 과제	
PRESENCE_SCENARIO_NAXX_CLASS_CHALLENGE_ROGUE	낙스라마스 도적 도전 과제	
PRESENCE_SCENARIO_NAXX_CLASS_CHALLENGE_SHAMAN	낙스라마스 주술사 도전 과제	
PRESENCE_SCENARIO_NAXX_CLASS_CHALLENGE_WARLOCK	낙스라마스 흑마법사 도전 과제	
PRESENCE_SCENARIO_NAXX_CLASS_CHALLENGE_WARRIOR	낙스라마스 전사 도전 과제	
PRESENCE_SCENARIO_NAXX_HEROIC_SCENARIO_ANUBREKHAN	아눕레칸 (영웅)	
PRESENCE_SCENARIO_NAXX_HEROIC_SCENARIO_FAERLINA	귀부인 팰리나 (영웅)	feel free to shorten long translations to 'Heroic Faerlina' since the UI may squeeze text into a tiny (unreadable) font size when text is too long. this string is shown in the Friends List.
PRESENCE_SCENARIO_NAXX_HEROIC_SCENARIO_GLUTH	글루스 (영웅)	
PRESENCE_SCENARIO_NAXX_HEROIC_SCENARIO_GOTHIK	영혼 착취자 고딕 (영웅)	feel free to shorten long translations to 'Heroic Gothik' since the UI may squeeze text into a tiny (unreadable) font size when text is too long. this string is shown in the Friends List.
PRESENCE_SCENARIO_NAXX_HEROIC_SCENARIO_GROBBULUS	그라불루스 (영웅)	
PRESENCE_SCENARIO_NAXX_HEROIC_SCENARIO_HEIGAN	부정의 헤이건 (영웅)	feel free to shorten long translations to 'Heroic Heigan' since the UI may squeeze text into a tiny (unreadable) font size when text is too long. this string is shown in the Friends List.
PRESENCE_SCENARIO_NAXX_HEROIC_SCENARIO_HORSEMEN	4인 기사단 (영웅)	
PRESENCE_SCENARIO_NAXX_HEROIC_SCENARIO_KELTHUZAD	켈투자드 (영웅)	
PRESENCE_SCENARIO_NAXX_HEROIC_SCENARIO_LOATHEB	로데브 (영웅)	
PRESENCE_SCENARIO_NAXX_HEROIC_SCENARIO_MAEXXNA	맥스나 (영웅)	
PRESENCE_SCENARIO_NAXX_HEROIC_SCENARIO_NOTH	역병술사 노스 (영웅)	feel free to shorten long translations to 'Heroic Noth' since the UI may squeeze text into a tiny (unreadable) font size when text is too long. this string is shown in the Friends List.
PRESENCE_SCENARIO_NAXX_HEROIC_SCENARIO_PATCHWERK	패치워크 (영웅)	
PRESENCE_SCENARIO_NAXX_HEROIC_SCENARIO_RAZUVIOUS	훈련교관 라주비어스 (영웅)	feel free to shorten long translations to 'Heroic Razuvious' since the UI may squeeze text into a tiny (unreadable) font size when text is too long. this string is shown in the Friends List.
PRESENCE_SCENARIO_NAXX_HEROIC_SCENARIO_SAPPHIRON	사피론 (영웅)	
PRESENCE_SCENARIO_NAXX_HEROIC_SCENARIO_THADDIUS	타디우스 (영웅)	
PRESENCE_SCENARIO_NAXX_NORMAL_SCENARIO_ANUBREKHAN	아눕레칸에게 도전 중	
PRESENCE_SCENARIO_NAXX_NORMAL_SCENARIO_FAERLINA	팰리나에게 도전 중	feel free to shorten long translations to 'Battling Faerlina' since the UI may squeeze text into a tiny (unreadable) font size when text is too long. this string is shown in the Friends List.
PRESENCE_SCENARIO_NAXX_NORMAL_SCENARIO_GLUTH	글루스에게 도전 중	
PRESENCE_SCENARIO_NAXX_NORMAL_SCENARIO_GOTHIK	고딕에게 도전 중	feel free to shorten long translations to 'Battling Gothik' since the UI may squeeze text into a tiny (unreadable) font size when text is too long. this string is shown in the Friends List.
PRESENCE_SCENARIO_NAXX_NORMAL_SCENARIO_GROBBULUS	그라불루스에게 도전 중	
PRESENCE_SCENARIO_NAXX_NORMAL_SCENARIO_HEIGAN	헤이건에게 도전 중	feel free to shorten long translations to 'Battling Heigan' since the UI may squeeze text into a tiny (unreadable) font size when text is too long. this is string shown in the Friends List.
PRESENCE_SCENARIO_NAXX_NORMAL_SCENARIO_HORSEMEN	4인 기사단에게 도전 중	
PRESENCE_SCENARIO_NAXX_NORMAL_SCENARIO_KELTHUZAD	켈투자드에게 도전 중	
PRESENCE_SCENARIO_NAXX_NORMAL_SCENARIO_LOATHEB	로데브에게 도전 중	
PRESENCE_SCENARIO_NAXX_NORMAL_SCENARIO_MAEXXNA	맥스나에게 도전 중	
PRESENCE_SCENARIO_NAXX_NORMAL_SCENARIO_NOTH	노스에게 도전 중	feel free to shorten long translations to 'Battling Noth' since the UI may squeeze text into a tiny (unreadable) font size when text is too long. this string is shown in the Friends List.
PRESENCE_SCENARIO_NAXX_NORMAL_SCENARIO_PATCHWERK	패치워크에게 도전 중	
PRESENCE_SCENARIO_NAXX_NORMAL_SCENARIO_RAZUVIOUS	라주비어스에게 도전 중	feel free to shorten long translations to 'Battling Razuvious' since the UI may squeeze text into a tiny (unreadable) font size when text is too long. this string is shown in the Friends List.
PRESENCE_SCENARIO_NAXX_NORMAL_SCENARIO_SAPPHIRON	사피론에게 도전 중	
PRESENCE_SCENARIO_NAXX_NORMAL_SCENARIO_THADDIUS	타디우스에게 도전 중	
PRESENCE_SCENARIO_RETURNING_PLAYER_CHALLENGE_1	게임에 복귀하는 중!	
PRESENCE_SCENARIO_RETURNING_PLAYER_CHALLENGE_2	게임에 복귀하는 중!	
PRESENCE_SCENARIO_RETURNING_PLAYER_CHALLENGE_3	게임에 복귀하는 중!	
PRESENCE_SCENARIO_TRL_DUNGEON	구루바시 투기장에서 대난투 중	
PRESENCE_STATUS_ADVENTURE_CHOOSING_MODE	1인 모험 확인 중	
PRESENCE_STATUS_ADVENTURE_SCENARIO_PLAYING_GAME	{0}	{0} replaced with the specific scenario string, via PRESENCE_SCENARIO_NAXX_*
PRESENCE_STATUS_ADVENTURE_SCENARIO_SELECT	{0}	{0} replaced with the adventure mode, via PRESENCE_ADVENTURE_MODE_*, e.g. Naxxramas (Heroic) -- (originally i wanted it to say "Mission Select: Naxxramas Class Challenge" but this got too long for the UI element.)
PRESENCE_STATUS_ARENA_FORGE	투기장 덱 구성 중	
PRESENCE_STATUS_ARENA_GAME	투기장에서 전투 중	
PRESENCE_STATUS_ARENA_IDLE	투기장에서 노닥거리는 중	
PRESENCE_STATUS_ARENA_PURCHASE	투기장에 들어갈지 고민 중	
PRESENCE_STATUS_ARENA_QUEUE	투기장 상대를 찾는 중	
PRESENCE_STATUS_ARENA_REWARD	투기장 보상 획득 중	
PRESENCE_STATUS_COLLECTION	수집품을 살펴보는 중	
PRESENCE_STATUS_CRAFTING	카드 제작 중	
PRESENCE_STATUS_DECKEDITOR	카드 덱 구성 중	
PRESENCE_STATUS_FIRESIDE_BRAWL_SCREEN	와글와글 난투 진입 중	
PRESENCE_STATUS_FRIENDLY_DECKPICKER	친선전 준비 중	
PRESENCE_STATUS_FRIENDLY_GAME	친선전 중	
PRESENCE_STATUS_HUB	메인 메뉴에서 노닥거리는 중	
PRESENCE_STATUS_LOGIN	게임 실행 중	
PRESENCE_STATUS_PACKOPENING	카드 팩을 마구 개봉 중!!!	
PRESENCE_STATUS_PLAY_DECKPICKER	대전 모드 진입 중	
PRESENCE_STATUS_PLAY_GAME	대전 모드 중!	
PRESENCE_STATUS_PLAY_QUEUE	상대 찾는 중	
PRESENCE_STATUS_PRACTICE_DECKPICKER	연습 모드 진입 중	
PRESENCE_STATUS_PRACTICE_GAME	여관주인을 상대로 연습 중	
PRESENCE_STATUS_QUESTLOG	퀘스트 기록 확인 중	
PRESENCE_STATUS_SPECTATING_GAME_ADVENTURE_BRM_CLASS_CHALLENGE	검은바위 산 도전 과제 관전 중!	
PRESENCE_STATUS_SPECTATING_GAME_ADVENTURE_BRM_HEROIC	영웅 난이도 검은바위 산 관전 중!	
PRESENCE_STATUS_SPECTATING_GAME_ADVENTURE_BRM_NORMAL	검은바위 산 관전 중!	
PRESENCE_STATUS_SPECTATING_GAME_ADVENTURE_ICC_NORMAL	얼어붙은 왕좌 관전 중!	
PRESENCE_STATUS_SPECTATING_GAME_ADVENTURE_KAR_CLASS_CHALLENGE	카라잔 도전 과제 관전 중!	
PRESENCE_STATUS_SPECTATING_GAME_ADVENTURE_KAR_HEROIC	영웅 난이도 카라잔 관전 중!	
PRESENCE_STATUS_SPECTATING_GAME_ADVENTURE_KAR_NORMAL	카라잔 관전 중!	
PRESENCE_STATUS_SPECTATING_GAME_ADVENTURE_LOE_CLASS_CHALLENGE	탐험가 연맹 도전 과제 관전 중!	
PRESENCE_STATUS_SPECTATING_GAME_ADVENTURE_LOE_HEROIC	영웅 난이도 탐험가 연맹 관전 중!	
PRESENCE_STATUS_SPECTATING_GAME_ADVENTURE_LOE_NORMAL	탐험가 연맹 관전 중!	
PRESENCE_STATUS_SPECTATING_GAME_ADVENTURE_NAXX_CLASS_CHALLENGE	낙스라마스 도전 과제 관전 중!	
PRESENCE_STATUS_SPECTATING_GAME_ADVENTURE_NAXX_HEROIC	영웅 난이도 낙스라마스 관전 중!	
PRESENCE_STATUS_SPECTATING_GAME_ADVENTURE_NAXX_NORMAL	낙스라마스 관전 중!	
PRESENCE_STATUS_SPECTATING_GAME_ARENA	투기장 관전 중	
PRESENCE_STATUS_SPECTATING_GAME_BOT	묘수풀이 관전하는 중	
PRESENCE_STATUS_SPECTATING_GAME_DAL	달라란 침공 엿보는 중	
PRESENCE_STATUS_SPECTATING_GAME_DAL_HEROIC	달라란 침공 엿보는 중	
PRESENCE_STATUS_SPECTATING_GAME_FRIENDLY	친선전 관전 중	
PRESENCE_STATUS_SPECTATING_GAME_GIL	괴물 사냥 관전 중	
PRESENCE_STATUS_SPECTATING_GAME_GIL_BONUS_CHALLENGE	하가사와의 대결 관전 중	
PRESENCE_STATUS_SPECTATING_GAME_LOOT	미궁 탐험 관전 중	
PRESENCE_STATUS_SPECTATING_GAME_PLAY	대전 모드 관전 중	
PRESENCE_STATUS_SPECTATING_GAME_PRACTICE	연습 모드 관전 중	
PRESENCE_STATUS_SPECTATING_GAME_RETURNING_PLAYER_CHALLENGE	게임에 복귀하는 친구 관전 중!	
PRESENCE_STATUS_SPECTATING_GAME_TAVERN_BRAWL	선술집 난투 관전 중	
PRESENCE_STATUS_SPECTATING_GAME_TRL	대난투 관전 중	
PRESENCE_STATUS_SPECTATING_GAME_TUTORIAL	튜토리얼 관전 중	
PRESENCE_STATUS_STORE	상점 둘러보는 중	
PRESENCE_STATUS_TAVERN_BRAWL_DECKEDITOR	선술집 난투 덱 구성 중	
PRESENCE_STATUS_TAVERN_BRAWL_FRIENDLY_GAME	난투 친선전 중	
PRESENCE_STATUS_TAVERN_BRAWL_FRIENDLY_WAITING	난투 친선전 준비 중	
PRESENCE_STATUS_TAVERN_BRAWL_GAME	선술집 난투 중	
PRESENCE_STATUS_TAVERN_BRAWL_QUEUE	난투 상대 찾는 중	
PRESENCE_STATUS_TAVERN_BRAWL_SCREEN	선술집 난투 진입 중	
PRESENCE_STATUS_TUTORIAL_GAME	{0}에게 도전 중	0 = PRESENCE_TUTORIAL_*
PRESENCE_STATUS_TUTORIAL_PREGAME	처음으로 게임을 시작하는 중	
PRESENCE_STATUS_WAIT_FOR_OPPONENT_RECONNECT	상대방이 재접속하길 기다리는 중	
PRESENCE_STATUS_WELCOMEQUESTS	새로운 퀘스트 확인 중!	
PRESENCE_TUTORIAL_CHO	전승지기 초	
PRESENCE_TUTORIAL_HEMET	헤멧 네싱워리	
PRESENCE_TUTORIAL_HOGGER	들창코	
PRESENCE_TUTORIAL_ILLIDAN	일리단 스톰레이지	
PRESENCE_TUTORIAL_MILLHOUSE	밀하우스 마나스톰	
PRESENCE_TUTORIAL_MUKLA	밀림의 왕 무클라	
