TAG	TEXT	COMMENT
BOH_ANDUIN_06	Ce serviteur fait partie de votre quête ! Battez-le, ainsi que les deux adversaires légendaires suivants.	
BOH_ANDUIN_08	Battez les serviteurs légendaires de Sylvanas pour remporter le combat !	
BOH_GARROSH_05	Le mak’gora commence par une bénédiction d’arme rituelle !	
BOH_GULDAN_01	|4(Tour,Tours) à tenir	
BOH_GULDAN_02	Sorts de chaman restants	
BOH_GULDAN_02b	Jouez des sorts de chaman pour prouver votre valeur au Trône des éléments.	
BOH_GULDAN_08	L’Œil de Sargeras vous observe ! Jouez des cartes coûteuses avant de perdre trop de cristaux de mana.	
BOH_ILLIDAN_01	Serviteurs adverses restant à vaincre	
BOH_ILLIDAN_02	Infligez 40 points de dégâts à des adversaires pour vous emparer du crâne de Gul’dan !	
BOH_ILLIDAN_04	Cristaux de mana à dépenser pour l’Œil de Sargeras	
BOH_ILLIDAN_04b	Dépensez votre mana pour alimenter l’Œil de Sargeras et ainsi pouvoir frapper le roi-liche à distance. Ne laissez pas Malfurion vous mettre des bâtons dans les roues !	
BOH_ILLIDAN_07	Obélisques restant à contrôler	
BOH_ILLIDAN_08	|4(Tour,Tours) à tenir	
BOH_MALFURION_01	Cartes d’entraînements restantes	
BOH_MALFURION_01b	Jouez les cartes que vous recevez de Cénarius pour terminer votre entraînement !	
BOH_REXXAR_02	Détruisez le piège à ours pour gagner la confiance de Misha !	
BOH_THRALL_01	Il s’agit d’un combat contre 3 mini boss ! Vous disposerez d’une nouvelle main et d’un nouveau deck après avoir vaincu le crocilisque capturé.	
BOH_THRALL_01a	Début de la deuxième partie ! Éliminez les deux lions des montagnes pour gagner !	
BOH_THRALL_01b	Début de la troisième partie ! Venez à bout de la brute ogre pour l’emporter.	
BOH_THRALL_02	Triomphez des esprits élémentaires pour remporter l’épreuve.	
BOH_THRALL_06	Alexstrasza vous rendra tous vos points de vie les 3 premières fois que vous subirez des dégâts mortels, mais ne pourra pas vous venir en aide si elle est en sommeil.	
BOH_THRALL_08	Garrosh joue avec des forces dangereuses, et il n’hésitera pas à s’en servir s’il se sent acculé !	
BOH_UTHER_08	|4(tour,tours) à tenir	
BOH_VALEERA_01	Détruisez le totem d’entraînement pour prouver que vous êtes une gladiatrice !	
BOH_VALEERA_08	Ombres silencieuses restant à vaincre	
BOH_VALEERA_08b	Attaquez les ombres silencieuses jusqu’à ce qu’elles n’aient plus de PV afin de réussir l’épreuve de Jorach !	
BOM_DAWNGRASP_01	Tours restants pour faire le deuil	
BOM_DAWNGRASP_07	Tours restants pour survivre	
BOM_GUFF_02	Fissures restant à explorer	
BOM_TAMSIN_07	Anetheron peut arrêter l’armée de Hurlevent. Invoquez 7 démons pour le réveiller.	
BOM_TAMSIN_08	Les serviteurs ne peuvent pas blesser Cornélius. Il a peut-être une autre faiblesse.	
BOTA_PUZZLE_CONGRATULATIONS	Beau travail !	
BOTA_PUZZLE_END_TURN_REMINDER	Recommencez si vous êtes bloqué.	
BOTA_PUZZLE_LOADING	Chargement du casse-tête suivant…	
BOTA_PUZZLE_PROGRESS	Casse-tête {0}/{1}	
BOTA_PUZZLE_RESETTING	Réinitialisation…	
DALA_MISSION_CHAPTER_SUBTEXT_01	Banque de Dalaran	
DALA_MISSION_CHAPTER_SUBTEXT_01_HEROIC	Banque de Dalaran (héroïque)	
DALA_MISSION_CHAPTER_SUBTEXT_02	Le fort Pourpre	
DALA_MISSION_CHAPTER_SUBTEXT_02_HEROIC	Le fort Pourpre (héroïque)	
DALA_MISSION_CHAPTER_SUBTEXT_03	Rues de Dalaran	
DALA_MISSION_CHAPTER_SUBTEXT_03_HEROIC	Rues de Dalaran (héroïque)	
DALA_MISSION_CHAPTER_SUBTEXT_04	Les Entrailles	
DALA_MISSION_CHAPTER_SUBTEXT_04_HEROIC	Les Entrailles (héroïque)	
DALA_MISSION_CHAPTER_SUBTEXT_05	Citadelle du Kirin Tor	
DALA_MISSION_CHAPTER_SUBTEXT_05_HEROIC	Citadelle du Kirin Tor (héroïque)	
DALA_TAVERN_POPUP	Modifiez votre deck d’aventure pour cette virée :\najoutez ou retirez des serviteurs, et bien plus encore !	
DALA_TAVERN_TURN_START	Rencontre pacifique	
DEMON_HUNTER_PROLOGUE_2_PORTAL_POPUP	Détruisez des énergies instables pour stabiliser le portail !	
FB_BUILDABRAWL_001	Par le pouvoir du grand invocateur_!	
FB_BUILDABRAWL_002	Par le masque de Ragnaros_!	
FB_BUILDABRAWL_003	Par le pouvoir de Yogg-Saron_!	
FB_BUILDABRAWL_004	Par le pouvoir des serviteurs_!	
FB_BUILDABRAWL_005	Les caprices du grand invocateur	
FB_BUILDABRAWL_006	Les caprices du bal masqué	
FB_BUILDABRAWL_007	Les caprices de Yogg-Saron	
FB_BUILDABRAWL_008	Les caprices des serviteurs	
FB_BUILDABRAWL_009	La bataille du grand invocateur	
FB_BUILDABRAWL_010	La bataille du bal masqué	
FB_BUILDABRAWL_011	La bataille de Yogg-Saron	
FB_BUILDABRAWL_012	La bataille des serviteurs	
FB_BUILDABRAWL_013	Magie du sang du grand invocateur	
FB_BUILDABRAWL_014	Magie du sang du bal masqué	
FB_BUILDABRAWL_015	Magie du sang de Yogg-Saron	
FB_BUILDABRAWL_016	Magie du sang des serviteurs	
FB_BUILDABRAWL_INTRO	Le Bras de fer actuel est_:	
FB_BUILDABRAWL_NOTSTARTED	Ce Bras de fer Fireside n’a pas encore commencé, contactez votre aubergiste pour lui demander un Brassage de fer !	
FB_CHAMPS_FIREBAT_DRUID	Firebat a débuté la finale avec ce druide… et n’a jamais perdu_! C’est le champion de 2014_!	
FB_CHAMPS_FIREBAT_HUNTER	Firebat a choisi ce deck chasseur pour contrer le deck démoniste de DTwo, et se venger d’avoir perdu son deck voleur…	
FB_CHAMPS_FIREBAT_ROGUE	Firebat a battu le deck prêtre de DTwo à plates coutures en 2014, remportant la victoire avec un commissaire-priseur miracle 12/4_!	
FB_CHAMPS_FIREBAT_WARLOCK	Le deck démoniste de Firebat a été banni de la finale par Tidder Celestial. Que va-t-il faire désormais_?	
FB_CHAMPS_HUNTERACE_MAGE	Hunterace a perdu dans un match miroir avec ce deck Géant des montagnes et Appel de l’invocateur.	
FB_CHAMPS_HUNTERACE_ROGUE	La découverte stratégique de Cambrioleuse des Parias a permis à Hunterace de remporter sa première victoire du match.	
FB_CHAMPS_HUNTERACE_SHAMAN	Hunterace a battu le deck démoniste zoo de Viper, à la fatigue, et remporté le championnat HCT de 2019 !	
FB_CHAMPS_HUNTERACE_WARRIOR	Ce puissant deck guerrier contrôle a été banni des finales. Mais pas aujourd’hui !	
FB_CHAMPS_MERC14	Le deck 14 mercenaires a ravagé la compétition lors du Bras de fer L’embrasement en Europe. Qu’en sera-t-il ici ???	
FB_CHAMPS_OSTKAKA_MAGE	Ostkaka a joué ce deck mage givre contre le deck mage tempo de Hotform, l’incinérant avec des boules de feu. Quelle ironie_!	
FB_CHAMPS_OSTKAKA_ROGUE	Au cours de la dernière partie de la finale de 2015, Ostkaka a vaincu le deck druide de Hotform et est entré au Hall des champions_!	
FB_CHAMPS_OSTKAKA_WARRIOR	Les clients sinistres ont aidé Ostkaka à l’emporter… même sans Officier chanteguerre. Stylé_!	
FB_CHAMPS_PAVEL_DRUID	Pavel a écrasé DrHippi lors d’une partie miroir avec ce deck. Attention aux gros serviteurs_!	
FB_CHAMPS_PAVEL_MAGE	Pavel l’a échappé belle plusieurs fois lors du championnat de 2016 grâce à ce deck mage. Qu’en sera-t-il pour vous_?	
FB_CHAMPS_PAVEL_ROGUE	Le deck voleur de Pavel a parfois du mal contre les decks agressifs, mais il envoie quand même du lourd_!	
FB_CHAMPS_PAVEL_SHAMAN	Le deck chaman de Pavel était toujours banni par ses adversaires. Mais ce n’est pas le cas ici_!	
FB_CHAMPS_PAVEL_WARRIOR	Pavel a joué ce deck guerrier C’Thun deux fois lors de la finale. Il a perdu contre le deck guerrier de DrHippi et gagné contre son druide.	
FB_CHAMPS_TOM60229_DRUID	tom60229 a scellé le sort du championnat 2018 avec ce deck. Refuser de mulligan une carte Fléau ultime a changé le cours de la partie !	
FB_CHAMPS_TOM60229_PRIEST	Le deck prêtre de tom60229 ne contient pas de cartes en double mais comporte de nombreux pièges. Gare aux combos de fin de partie !	
FB_CHAMPS_TOM60229_ROGUE	Attention, révélation : tom60229 a poignardé son propre serviteur pour obtenir un Edwin Van Cleef à 10_ATQ au tour_2. Ça va faire mal !	
FB_CHAMPS_TOM60229_WARLOCK	Banni de la finale, le deck démoniste cube de tom60229 contient quelques surprises pré-équilibrage.	
FB_CHAMPS_VKLIOOON_DRUID	Après un long combat contre le deck chaman quête de bloodyface, le deck Larme d’Ossirian de VKLiooon lui a finalement permis de décrocher la victoire.	
FB_CHAMPS_VKLIOOON_HUNTER	VKLiooon a démarré fort et vaincu le druide quête de bloodyface, faisant d’elle la championne du monde du Hearthstone Global Games de 2019 !	
FB_CHAMPS_VKLIOOON_PRIEST	Le deck prêtre de VKLiooon a été banni du match final des championnats du mode HGG de 2019… mais ce n’est pas le cas ici !	
FB_CHAMPS_VKLIOOON_SHAMAN	Finale des Global Games 2019 : une carte Lièvre du désert suivie de DEUX évolutions ont permis une victoire rapide de VKLiooon contre bloodyface.	
FB_DuelersCardsLeft1	Encore 1 carte avant de pouvoir tirer !	
FB_DuelersCardsLeft2	Encore 2 cartes avant de pouvoir tirer !	
FB_DuelersCardsLeft3	Encore 3 cartes avant de pouvoir tirer !	
FB_DuelersCardsLeft4	Encore 4 cartes avant de pouvoir tirer !	
FB_DuelersCardsLeft5	Encore 5 cartes avant de pouvoir tirer !	
FB_ELO_EVEN	Votre adversaire et vous êtes de même niveau_! Vous obtiendrez donc tous les deux un bonus supérieur_!	
FB_ELO_FAVORED	Vous êtes le favori, votre adversaire recevra donc un bonus supérieur.	
FB_ELO_UNDERDOG	Vous êtes l’outsider, vous pourrez donc choisir un bonus supérieur_!	
FB_IKC_CHOSE_SETUP	Jouez une nouvelle carte. Cette dernière deviendra le choix de l’aubergiste.	
FB_IKC_ENDGAME	Une nouvelle carte a été choisie_! Terminons cette partie.	
FB_IKC_NEWCARD	Garder l’ancienne carte ou utiliser la nouvelle ?	
FB_IKC_SETUP	Aubergiste ! Une petite question…	
FB_JUGGERNAUT_CHOOSE_OPPONENT	Choisissez votre rival, capitaine…	
FB_JUGGERNAUT_DRUID	Druide	
FB_JUGGERNAUT_FIRSTLINE	Feu_!	
FB_JUGGERNAUT_HUNTER	Chasseur	
FB_JUGGERNAUT_MAGE	Mage	
FB_JUGGERNAUT_PALADIN	Paladin	
FB_JUGGERNAUT_PRIEST	Prêtre	
FB_JUGGERNAUT_ROGUE	Voleur	
FB_JUGGERNAUT_SHAMAN	Chaman	
FB_JUGGERNAUT_UNKNOWN	Inconnu	
FB_JUGGERNAUT_WARLOCK	Démoniste	
FB_JUGGERNAUT_WARRIOR	Guerrier	
FB_LK_BOSSSWITCH	Battez le lieutenant du roi-liche pour forcer ce dernier à revenir_!	
FB_LK_DEAD_01	Félicitations_!\nLe roi-liche a été vaincu_!	
FB_LK_DEAD_02	Contactez l’aubergiste de votre Fireside pour l’affronter de nouveau_!	
FB_LK_HERO_01	Roi-liche suprême	
FB_LK_HERO_02	Reine de sang Lana’thel	
FB_LK_HERO_03	Professeur Putricide	
FB_LK_HERO_04	Seigneur Gargamoelle	
FB_LK_HERO_05	Sindragosa	
FB_LK_HEROSWITCH	Au tour du 2e joueur_! Continuez comme ça_!	
FB_LK_INTRO_01	Ce Bras de fer se joue à deux joueurs assis\ndu même côté_!	
FB_LK_INTRO_02	C’est le joueur 1 qui commence.\nJoignez vos forces pour vaincre\nle roi-liche_!	
FB_RAGRAID_01	Félicitations, champions !\nLe Grand méchant Ragnaros a été vaincu !	
FB_TopX_Ban	Choisissez une carte à bannir !	
ICC_01_LICH_KING_SUBTEXT	Légendaire	
ICC_01_TIRION_SUBTEXT	Pas aussi légendaire	
ICC_01_TIRIONTURNS_01	Tours avant l’arrivée de Tirion_: 1	
ICC_01_TIRIONTURNS_02	Tours avant l’arrivée de Tirion_: 2	
ICC_01_TIRIONTURNS_03	Tours avant l’arrivée de Tirion_: 3	
ICC_05_LANATHEL_01	Vous <b>devez</b> mordre un serviteur_! Même si ce n’est pas le vôtre_!	
ICCDruidVictory_01	Autrefois protecteur de la faune et de la flore en Azeroth, Malfurion le Putride préserve désormais l’équilibre naturel en cultivant un jardin mortifère.	
ICCHunterVictory_01	Rexxar libéra les âmes piégées autrefois par le roi-liche et encocha une flèche noire tirée de son carquois. «_Viens, Misha_!_» dit-il. «_La traque commence…_»	
ICCMageVictory_01	La nouvelle liche de givre inspecta son domaine. Des légions de morts-vivants allaient lui permettre d’augmenter encore sa puissance. Elle ne sentit même pas son sang se transformer en glace dans ses veines.	
ICCPaladinVictory_01	Le noble paladin de jadis embrassa pleinement sa nouvelle existence. Menez une vie digne et vous n’aurez rien à craindre de lui. Mais gare à ceux qui cèdent au mal, car ils devront affronter son jugement dans la mort_!	
ICCPriestVictory_01	Le corps du jeune prince s’évapora dans les ombres. «_Je comprends tout désormais_», dit-il, une flamme bleue luisant dans ses yeux. «_J’ai été tellement naïf…_».	
ICCRogueVictory_01	Valeera l’Exsangue disparut dans la nuit. Ses spectres et ses ombres voient tout, et nul n’est à l’abri de ses lames glacées…	
ICCShamanVictory_01	La cacophonie des voix des morts submergea l’esprit du chaman. Le mort-voyant ferma les yeux et prononça cet unique mot_: «_Dormez…_»	
ICCWarlockVictory_01	Gul’dan prit enfin place sur le Trône de glace. La Porte des ténèbres s’ouvrit une fois de plus et une infinité de mondes tremblèrent face à lui.	
ICCWarriorVictory_01	L’ancien chef de guerre de la Horde embrassa son nouveau pouvoir. Les victimes gelées de son armée allaient se relever pour le servir, jusqu’à ce qu’il se rende maître de toutes les terres qu’il avait parcourues.	
LOEA16_2_STAFF_TEXT_CHARGE_0	<b>Pouvoir héroïque passif</b>\nVotre héros est <b>Insensible</b> pendant encore 3 tours.	
LOEA16_2_STAFF_TEXT_CHARGE_1	<b>Pouvoir héroïque passif</b>\nVotre héros est <b>Insensible</b> pendant encore 2 tours.	
LOEA16_2_STAFF_TEXT_CHARGE_2	<b>Pouvoir héroïque passif</b>\nVotre héros est <b>Insensible</b>. Plus qu’un tour !	
LOEA16_2_STAFF_TEXT_CHARGE_EXPLODED	<b>Pouvoir héroïque passif</b>\nBoss invoqué mais votre héros n’est plus <b>Insensible</b>.	
MISSION_AIRSHIPCOUNTERNAME	|4(tour,tours) avant la victoire	
MISSION_DEFAULTCOUNTERNAME	|4(tour,tours) avant de fuir	
MISSION_GLOWING_POOL	Un bassin luminescent	
MISSION_NEFARIAN_TITLE	Tueur de serviteurs stupides, incompétents et décevants	
MISSION_PIT_OF_SPIKES	Une fosse remplie de pointes	
MISSION_PRE_TUTORIAL_WANTED	Recherché	
MISSION_SPAREPARTSCOUNTERNAME	|4(Pièce détachée,Pièces détachées) pour terminer les réparations	
MISSION_STATUES_EYE	L’œil de la statue	
MISSION_TAKE_THE_SHORTCUT	Prendre le raccourci ?	
TB_100TH_BANANA_INFO_OPP	Le deck de votre adversaire est composé de cartes aléatoires. Chaque fois qu’un de ses serviteurs meurt, le héros obtient une banane.	
TB_100TH_BANANA_INFO_YOU	Votre deck est composé de cartes aléatoires. Chaque fois qu’un de vos serviteurs meurt, vous obtenez une banane.	
TB_100TH_BANANA_OPP	Votre adversaire joue un deck de Bataille de bananes, le 2e Bras de fer, lancé le 24 juin 2015.	
TB_100TH_BANANA_YOU	Vous jouez un deck de Bataille de bananes, le 2e Bras de fer, lancé le 24 juin 2015.	
TB_100TH_CLONEBALL_INFO_OPP	Le deck de votre adversaire est composé de plusieurs copies de cartes légendaires aléatoires.	
TB_100TH_CLONEBALL_INFO_YOU	Votre deck est composé de plusieurs copies de cartes légendaires aléatoires.	
TB_100TH_CLONEBALL_OPP	Votre adversaire joue un deck Des clones, la balle et moi, le 52e Bras de fer, lancé le 8 juin 2016.	
TB_100TH_CLONEBALL_YOU	Vous jouez un deck Des clones, la balle et moi, le 52e Bras de fer, lancé le 8 juin 2016.	
TB_100TH_PARTYPORTAL_INFO_OPP	Le deck de ce joueur est composé de cartes de portails aléatoires.	
TB_100TH_PARTYPORTAL_INFO_YOU	Le deck de ce joueur est composé de cartes de portails aléatoires.	
TB_100TH_PARTYPORTAL_OPP	Votre adversaire joue un deck de Portail de la fête, le 64e Bras de fer, lancé le 31 août 2016.	
TB_100TH_PARTYPORTAL_YOU	Vous jouez un deck de Portail de la fête, le 64e Bras de fer, lancé le 31 août 2016.	
TB_100TH_PORTALS_INFO_OPP	Le deck de votre adversaire est principalement composé de cartes Portail instable, avec quelques cartes supplémentaires.	
TB_100TH_PORTALS_INFO_YOU	Votre deck est principalement composé de cartes Portail instable, avec quelques cartes supplémentaires.	
TB_100TH_PORTALS_OPP	Votre adversaire joue un deck de Trop de portails, le 7e Bras de fer, lancé le 29 juillet 2015.	
TB_100TH_PORTALS_YOU	Vous jouez un deck de Trop de portails, le 7e Bras de fer, lancé le 29 juillet 2015.	
TB_100TH_RANDEMONIUM_INFO_OPP	Le deck de votre adversaire est composé de cartes aléatoires qui changent de coût à chaque tour.	
TB_100TH_RANDEMONIUM_INFO_YOU	Votre deck est composé de cartes aléatoires qui changent de coût à chaque tour.	
TB_100TH_RANDOMONIUM_OPP	Votre adversaire joue un deck des Caprices du hasard, le 18e Bras de fer, lancé le 14 octobre 2015.	
TB_100TH_RANDOMONIUM_YOU	Vous jouez un deck des Caprices du hasard, le 18e Bras de fer, lancé le 14 octobre 2015.	
TB_100TH_RAVENIDOL_INFO_OPP	Le deck de votre adversaire est composé de 30 cartes Idole corbeau.	
TB_100TH_RAVENIDOL_INFO_YOU	Votre deck est composé de 30 cartes Idole corbeau.	
TB_100TH_RAVENIDOL_OPP	Votre adversaire joue un deck d’Idoles d’Azeroth, le 45e Bras de fer, lancé le 20 avril 2016.	
TB_100TH_RAVENIDOL_YOU	Vous jouez un deck d’Idoles d’Azeroth, le 45e Bras de fer, lancé le 20 avril 2016.	
TB_100TH_SHIFTER_INFO_OPP	Le deck de votre adversaire est principalement composé de cartes Déphaseur Zerus, avec quelques cartes supplémentaires.	
TB_100TH_SHIFTER_INFO_YOU	Votre deck est principalement composé de cartes Déphaseur Zerus, avec quelques cartes supplémentaires.	
TB_100TH_SHIFTER_OPP	Votre adversaire joue un deck de Phase-stival, le 55e Bras de fer, lancé le 29 juin 2016.	
TB_100TH_SHIFTER_YOU	Vous jouez un deck de Phase-stival, le 55e Bras de fer, lancé le 29 juin 2016.	
TB_100TH_SPELLBAG_INFO_OPP	Le deck de votre adversaire est composé de 30 sorts aléatoires qui invoquent chacun un serviteur quand ils sont joués.	
TB_100TH_SPELLBAG_INFO_YOU	Votre deck est composé de 30 sorts aléatoires qui invoquent chacun un serviteur quand ils sont joués.	
TB_100TH_SPELLBAG_OPP	Votre adversaire joue un deck de Sac de sorts subtilisés de Valeera, le 76e Bras de fer, lancé le 23 novembre 2016.	
TB_100TH_SPELLBAG_YOU	Vous jouez un deck de Sac de sorts subtilisés de Valeera, le 76e Bras de fer, lancé le 23 novembre 2016.	
TB_100TH_YOGG_INFO_OPP	Le deck de votre adversaire est composé de serviteurs aléatoires qui lancent chacun un sort aléatoire quand ils sont joués.	
TB_100TH_YOGG_INFO_YOU	Votre deck est composé de serviteurs aléatoires qui lancent chacun un sort aléatoire quand ils sont joués.	
TB_100TH_YOGG_OPP	Votre adversaire joue un deck de Serviteur de Yogg-Saron, le 57e Bras de fer, lancé le 13 juillet 2016.	
TB_100TH_YOGG_YOU	Vous jouez un deck de Serviteur de Yogg-Saron, le 57e Bras de fer, lancé le 13 juillet 2016.	
TB_207_01	La bataille de Tol Barad	
TB_207_02	La route de briques jaunes	
TB_207_03	Trésor des catacombes	
TB_207_04	Les clones attaquent !	
TB_207_05	Au bal masqué	
TB_207_06	La singularité du Vide	
TB_207_07	Des clones, la balle et moi !	
TB_207_08	Les caprices du hasard	
TB_207_09	Sac de sorts subtilisés	
TB_207_INTRO_01	Votre Bras de fer est :	
TB_207_INTRO_02	Le Bras de fer adverse est :	
TB_CAROUSEL_A	À la fin de chaque tour, les serviteurs tourneront dans le sens des aiguilles d’une montre (vers la gauche).	
TB_CAROUSEL_B	À la fin de chaque tour, les serviteurs tourneront dans le sens inverse aux aiguilles d’une montre (vers la droite).	
TB_DECKBUILDING_FIRSTCARDPLAYED	Une fois que vous avez joué une carte, en place une copie dans votre deck.	
TB_DECKBUILDING_FIRSTENDTURN	Maintenant, replacez votre main dans votre deck et piochez de nouveau.	
TB_DECKBUILDING_FIRSTPICKTHREE	Choisissez une nouvelle carte pour votre main.	
TB_DECKBUILDING_STARTOFGAME	Construisez votre équipe pendant la partie ! Bonne chance !	
TB_DECKBUILDING_STARTOFGAME_START	Commencer	
TB_DECKRECIPE_MSG_DRUID	Modèle de deck_: <b>Golems du Lotus</b>.	
TB_DECKRECIPE_MSG_HUNTER	Modèle de deck_: <b>Bêtes et brigands</b>.	
TB_DECKRECIPE_MSG_MAGE	Modèle de deck_: <b>Mixologie de la Kabale</b>.	
TB_DECKRECIPE_MSG_PALADIN	Modèle de deck_: <b>Main basse sur le marché</b>.	
TB_DECKRECIPE_MSG_PRIEST	Modèle de deck_: <b>Cœur de dragon</b>.	
TB_DECKRECIPE_MSG_ROGUE	Modèle de deck_: <b>Docks de Gadgetzan</b>.	
TB_DECKRECIPE_MSG_SHAMAN	Modèle de deck_: <b>Association de Murlocs</b>.	
TB_DECKRECIPE_MSG_WARLOCK	Modèle de deck_: <b>Démons de la Kabale</b>.	
TB_DECKRECIPE_MSG_WARRIOR	Modèle de deck_: <b>L’empire des Dessoudeurs</b>.	
TB_DECKRECIPE_OG_DRUID	Utilisez les sorts générateurs de mana du druide pour invoquer les serviteurs des Dieux très anciens plus tôt dans la partie.	
TB_DECKRECIPE_OG_HUNTER	Ne craignez pas la mort, héros_; vos serviteurs rempliront leur office, vivants ou pas. Échangez vos serviteurs contre ceux de la grande faucheuse_; vous finirez par écraser votre adversaire.	
TB_DECKRECIPE_OG_MAGE	Lancez autant de sorts que possible, car chacun hâtera le réveil de Yogg-Saron !	
TB_DECKRECIPE_OG_PALADIN	Protégez vos serviteurs avec Bouclier divin et ils pourront affronter deux ennemis d’un coup !	
TB_DECKRECIPE_OG_PRIEST	Soignez vos serviteurs pour leur permettre de vivre jusqu’à l’avènement de l’effroyable C’Thun !	
TB_DECKRECIPE_OG_ROGUE	Échangez vos serviteurs de façon agressive ! La plupart vous confèrent un avantage quand ils sont tués, alors n’hésitez pas à les sacrifier.	
TB_DECKRECIPE_OG_SHAMAN	Invoquez autant de serviteurs que possible puis faites-les évoluer afin de maximiser la valeur de ceux qui ont déjà travaillé pour vous !	
TB_DECKRECIPE_OG_WARLOCK	Renforcez vos armées avec les innombrables serviteurs des Dieux très anciens. Et envahissez le plateau avec les serviteurs les moins chers pour submerger votre adversaire.	
TB_DECKRECIPE_OG_WARRIOR	Protégez-vous pendant que votre dévotion à C’Thun grandit. Cumulez assez d’armure pour rendre vains les efforts de votre adversaire face au Dieu très ancien !	
TB_DPROMO_2NDHERO	Le roi des vaches	
TB_DPROMO_2NDHEROPOPUP	Vous êtes dans le niveau secret_!	
TB_DPROMO_COWKINGEMOTES	Meuh	
TB_DUELERSBRAWL_SUDDEN_DEATH	Mort subite !	
TB_DUELERSBRAWL_TAKE_PACES	Faites 5 pas, puis tirez !	
TB_EVILBRM_CURRENT_BEST_SCORE	Meilleur score\nactuel :	
TB_EVILBRM_NEW_BEST_SCORE	Nouveau\nmeilleur score !	
TB_FIREFEST_FIRST	Mini Ragnaros gagne de l’Attaque quand il incinère un serviteur_!	
TB_FIREFEST_SECOND	Bien joué_! Incinérez-en autant que possible pour obtenir une récompense spéciale_!	
TB_FIREFEST2_01	Ragnaros, seigneur du feu	
TB_FIREFEST2_02	Ahune, seigneur du givre	
TB_GIFTEXCHANGE_GIFTSPAWNED	S’il n’y a pas de caisse de votre côté, en livre une.	
TB_GIFTEXCHANGE_GIFTSTOLEN	Vous avez reçu un cadeau ! Qu’est-ce que ça peut bien être ?	
TB_GIFTEXCHANGE_START	Joyeuse fête du Voile d’hiver_! Attrapez ces cadeaux_!	
TB_HEADLESS_HORSEMAN_POISON	Vous ne pouvez pas empoisonner ce mort-vivant, il est trop puissant_!	
TB_HEADLESSREDUX_01	Vous êtes le Cavalier sans tête, protégez votre cimetière_!	
TB_HEADLESSREDUX_02	Détruisez les aventuriers déguisés Hazel, Johnny et Flynn pour remporter la victoire_!	
TB_HEADLESSREDUX_03	Vous avez pénétré dans le cimetière du Cavalier sans tête_!	
TB_HEADLESSREDUX_04	Protégez les aventuriers déguisés Hazel, Johnny et Flynn pour éviter la défaite_!	
TB_KOBOLDGIFTS_01	Regardez là-haut_! C’est le Grand-père kobold_!	
TB_KOBOLDGIFTS_02	Grand-père kobold reviendra au prochain tour_! Faites-lui de la place_!	
TB_LEAGUE_REVIVAL_01	Sir Finley est enseveli sous le sable ! Dégagez les tas de sables pour le sortir de là !	
TB_LEAGUE_REVIVAL_02	Sir Finley des Sables a été ajouté à votre deck.	
TB_LEAGUE_REVIVAL_03	Travaillez avec Brann pour vaincre le roi Krush l’Indompté !	
TB_LEAGUE_REVIVAL_04	Si le roi Krush vous bat, vous ou Brann, vous perdez tous les deux !	
TB_LEAGUE_REVIVAL_05	Dinodompteur Brann a été ajouté à votre deck.	
TB_LEAGUE_REVIVAL_06	Reno ne sait pas comment utiliser cet objet ! Mettez-lui du plomb dans la cervelle !	
TB_LEAGUE_REVIVAL_07	Relicologue Reno Jackson a été ajouté à votre deck.	
TB_LETHAL_NAME	Un tour de force	
TB_LETHALPUZZLES_FAILURE	Retentez votre chance_!	
TB_LETHALPUZZLES_START	Vous devez vaincre votre adversaire à chaque tour… Bonne chance_!	
TB_LETHALPUZZLES_SUCCESS	Vous avez réussi_!	
TB_MARIN_QUEST	Le joueur qui termine la quête en premier a une longueur d’avance pour s’emparer du trésor_!	
TB_MP_BOSS	Hurlevent décorée	
TB_MP_BOSS2	Ville en fête	
TB_MP_BOSS3	Capitale en fête	
TB_MP_COOP_1STSPELL	Oh oh, on dirait que la Kabale a mis la main sur le punch…	
TB_MP_COOP_2NDSPELL	S’il vous plaît, n’allumez pas les feux d’artifice à l’intérieur_!	
TB_MP_COOP_CRASHER_DISCARD	Le trouble-fête s’ennuie dans la main du joueur et entre en jeu.	
TB_MP_COOP_ENDING	Victoire_! Merci d’avoir célébré l’année du Mammouth avec nous_!	
TB_MP_COOP_FIRST_CRASHER	Attention_! Ces serviteurs essaient de s’inviter à la fête. Débarrassez-vous d’eux_!	
TB_MP_COOP_PINATA	Vous avez réussi_! Maintenant, il faut casser la piñata_! Mais ces trouble-fêtes commencent à devenir incontrôlables…	
TB_MP_COOP_TEXT_START	Utilisez votre pouvoir héroïque pour décorer l’auberge avec le joueur adverse_!	
TB_MP_CROSSROADS	Une minute, c’est qui celui-là_?	
TB_MP_CROSSROADS_CRASHER	Qu’est-ce qu’il fait là_?	
TB_MP_STORMWIND_SUCCESS	Vous avez réussi_! Jusqu’où irez-vous_?	
TB_PICKYOURFATE_BUILDAROUND_FIRSTFATE	Les destins choisis affectent les deux joueurs !	
TB_PICKYOURFATE_BUILDAROUND_NEWFATE	N’oubliez pas, ce bonus n’affecte que vous.	
TB_PICKYOURFATE_BUILDAROUND_OPPONENT_FIRSTFATE	Le destin de votre adversaire vous affecte également !	
TB_PICKYOURFATE_BUILDAROUND_OPPONENTFATE	N’oubliez pas, ce bonus n’affecte que votre adversaire.	
TB_PICKYOURFATE_RANDOM_FIRSTFATE	Les destins choisis affectent les deux joueurs !	
TB_PICKYOURFATE_RANDOM_NEWFATE	Il vous faut un nouveau destin !	
TB_PICKYOURFATE_RANDOM_OPPONENTFATE	Votre adversaire a besoin d’un nouveau destin !	
TB_SHADOWTOWERS_ADJACENTMINIONS	Les serviteurs qui jouxtent une tour sont <b>camouflés</b> et ne peuvent pas attaquer.	
TB_SHADOWTOWERS_SHADOWSPAWNED	S’il n’y a pas de tour d’un côté du plateau de jeu, en invoque une.	
TB_SHADOWTOWERS_SHADOWSPAWNEDNEXT	Les tours manquantes sont remplacées au début du tour de leur propriétaire.	
ULDA_MISSION_CHAPTER_SUBTEXT_01	La cité perdue	
ULDA_MISSION_CHAPTER_SUBTEXT_01_HEROIC	La cité perdue (héroïque)	
ULDA_MISSION_CHAPTER_SUBTEXT_02	Les dunes brûlantes	
ULDA_MISSION_CHAPTER_SUBTEXT_02_HEROIC	Les dunes brûlantes (héroïque)	
ULDA_MISSION_CHAPTER_SUBTEXT_03	La Tombe de Khartut	
ULDA_MISSION_CHAPTER_SUBTEXT_03_HEROIC	La Tombe de Khartut (héroïque)	
ULDA_MISSION_CHAPTER_SUBTEXT_04	Les salles de l’Origine	
ULDA_MISSION_CHAPTER_SUBTEXT_04_HEROIC	Les salles de l’Origine (héroïque)	
ULDA_MISSION_CHAPTER_SUBTEXT_05	Le sanctum intérieur	
ULDA_MISSION_CHAPTER_SUBTEXT_05_HEROIC	Le sanctum intérieur (héroïque)	
