TAG	TEXT	COMMENT
PRESENCE_ADVENTURE_MODE_BOH	Lit le Livre des héros	
PRESENCE_ADVENTURE_MODE_BOM	Lit le Livre des mercenaires	
PRESENCE_ADVENTURE_MODE_BOT	Visite le labo du Dr Boum	
PRESENCE_ADVENTURE_MODE_BRM_CLASS_CHALLENGE	Défi de classe de Rochenoire	
PRESENCE_ADVENTURE_MODE_BRM_HEROIC	Mont Rochenoire (Héroïque)	
PRESENCE_ADVENTURE_MODE_BRM_NORMAL	Mont Rochenoire	
PRESENCE_ADVENTURE_MODE_BTA	Participe à L’épreuve du gangrefeu	
PRESENCE_ADVENTURE_MODE_BTA_HEROIC	Participe à un défi de L’épreuve de gangrefeu	
PRESENCE_ADVENTURE_MODE_BTP	Explore le passé d’Illidan !	
PRESENCE_ADVENTURE_MODE_DAL	Prévoit un casse	
PRESENCE_ADVENTURE_MODE_DRG	S'envole dans la Désolation des dragons	
PRESENCE_ADVENTURE_MODE_GIL	S’équipe pour une chasse aux monstres	
PRESENCE_ADVENTURE_MODE_ICC_NORMAL	Dans la Couronne de glace	
PRESENCE_ADVENTURE_MODE_KAR_CLASS_CHALLENGE	Défi de classe de Karazhan	
PRESENCE_ADVENTURE_MODE_KAR_HEROIC	Karazhan (héroïque)	
PRESENCE_ADVENTURE_MODE_KAR_NORMAL	Karazhan	
PRESENCE_ADVENTURE_MODE_LOE_CLASS_CHALLENGE	Défi de classe de la Ligue des explorateurs	
PRESENCE_ADVENTURE_MODE_LOE_HEROIC	Ligue des explorateurs (héroïque)	
PRESENCE_ADVENTURE_MODE_LOE_NORMAL	Ligue des explorateurs	
PRESENCE_ADVENTURE_MODE_LOOT	S’équipe pour une virée en donjon	
PRESENCE_ADVENTURE_MODE_NAXX_CLASS_CHALLENGE	Défi de classe de Naxxramas	
PRESENCE_ADVENTURE_MODE_NAXX_HEROIC	Naxxramas (héroïque)	
PRESENCE_ADVENTURE_MODE_NAXX_NORMAL	Naxxramas	
PRESENCE_ADVENTURE_MODE_RETURNING_PLAYER_CHALLENGE	Fait son retour en jeu	
PRESENCE_ADVENTURE_MODE_TRL	Se prépare pour les Jeux trolls…	
PRESENCE_ADVENTURE_MODE_ULD	Organise une expédition	
PRESENCE_SCENARIO_BOH_FIGHT_01	Persuade l’archimage Antonidas	
PRESENCE_SCENARIO_BOH_FIGHT_02	Démasque le prince Kael’thas	
PRESENCE_SCENARIO_BOH_FIGHT_03	Se dispute avec le prince Arthas	
PRESENCE_SCENARIO_BOH_FIGHT_04	Calme Grommash Hurlenfer	
PRESENCE_SCENARIO_BOH_FIGHT_05	Trompe Archimonde	
PRESENCE_SCENARIO_BOH_FIGHT_06	Défend Theramore	
PRESENCE_SCENARIO_BOH_FIGHT_07	Tient Thrall pour responsable	
PRESENCE_SCENARIO_BOH_FIGHT_08	Expulse les Saccage-Soleil	
PRESENCE_SCENARIO_BOH10_FIGHT_01	Rencontre un prince	
PRESENCE_SCENARIO_BOH10_FIGHT_02	Vole Tichondrius	
PRESENCE_SCENARIO_BOH10_FIGHT_03	Pille la tombe de Sargeras	
PRESENCE_SCENARIO_BOH10_FIGHT_04	Se chamaille avec Malfurion	
PRESENCE_SCENARIO_BOH10_FIGHT_05	Sauve l’Outreterre	
PRESENCE_SCENARIO_BOH10_FIGHT_06	Insulte Anub’arak	
PRESENCE_SCENARIO_BOH10_FIGHT_07	Défie Arthas en duel	
PRESENCE_SCENARIO_BOH10_FIGHT_08	Se fait trahir par Akama	
PRESENCE_SCENARIO_BOH2_FIGHT_01	Plaide pour l’action	
PRESENCE_SCENARIO_BOH2_FIGHT_02	Persuade le chef de guerre	
PRESENCE_SCENARIO_BOH2_FIGHT_03	Apprivoise Misha	
PRESENCE_SCENARIO_BOH2_FIGHT_04	Restaure l’honneur de Mogrin	
PRESENCE_SCENARIO_BOH2_FIGHT_05	Enquête avec Jaina	
PRESENCE_SCENARIO_BOH2_FIGHT_06	Sauve Baine Sabot-de-Sang	
PRESENCE_SCENARIO_BOH2_FIGHT_07	Repousse l’invasion de Daelin	
PRESENCE_SCENARIO_BOH2_FIGHT_08	Sauve les Mok’Nathal	
PRESENCE_SCENARIO_BOH3_FIGHT_01	Rencontre la grande-mère	
PRESENCE_SCENARIO_BOH3_FIGHT_02	Débat avec Rehgar	
PRESENCE_SCENARIO_BOH3_FIGHT_03	Part à la conquête du Norfendre	
PRESENCE_SCENARIO_BOH3_FIGHT_04	Éteint des feux à Orgrimmar	
PRESENCE_SCENARIO_BOH3_FIGHT_05	Participe à un mak’gora	
PRESENCE_SCENARIO_BOH3_FIGHT_06	Attaque Theramore	
PRESENCE_SCENARIO_BOH3_FIGHT_07	Sonne la Cloche divine	
PRESENCE_SCENARIO_BOH3_FIGHT_08	Subit un siège à Orgrimmar	
PRESENCE_SCENARIO_BOH4_FIGHT_01	Impressionne l’archevêque Faol	
PRESENCE_SCENARIO_BOH4_FIGHT_02	Défend Lordaeron	
PRESENCE_SCENARIO_BOH4_FIGHT_03	Se bat contre Varok Saurcroc	
PRESENCE_SCENARIO_BOH4_FIGHT_04	Détruit la Porte des ténèbres	
PRESENCE_SCENARIO_BOH4_FIGHT_05	Sauve les villageois du maître-lame	
PRESENCE_SCENARIO_BOH4_FIGHT_06	Secourt Âtreval	
PRESENCE_SCENARIO_BOH4_FIGHT_07	Poursuit sa longue marche jusqu’à Stratholme	
PRESENCE_SCENARIO_BOH4_FIGHT_08	Affronte Arthas	
PRESENCE_SCENARIO_BOH5_FIGHT_01	Déçoit Varian	
PRESENCE_SCENARIO_BOH5_FIGHT_02	Persuade Jaina	
PRESENCE_SCENARIO_BOH5_FIGHT_03	Négocie la paix avec Moira	
PRESENCE_SCENARIO_BOH5_FIGHT_04	Apprend de Velen	
PRESENCE_SCENARIO_BOH5_FIGHT_05	Échappe aux griffes de Nazgrim	
PRESENCE_SCENARIO_BOH5_FIGHT_06	Résout les énigmes du roi-singe	
PRESENCE_SCENARIO_BOH5_FIGHT_07	Porte le Maillet harmonique	
PRESENCE_SCENARIO_BOH5_FIGHT_08	Combat pour Lordaeron	
PRESENCE_SCENARIO_BOH6_FIGHT_01	S’entraîne pour l’Arène	
PRESENCE_SCENARIO_BOH6_FIGHT_02	En met plein la vue à Helka	
PRESENCE_SCENARIO_BOH6_FIGHT_03	Affronte des assassins	
PRESENCE_SCENARIO_BOH6_FIGHT_04	Se fait posséder par un démon	
PRESENCE_SCENARIO_BOH6_FIGHT_05	En pleines négociations diplomatiques	
PRESENCE_SCENARIO_BOH6_FIGHT_06	Interroge Garona	
PRESENCE_SCENARIO_BOH6_FIGHT_07	Défie le Marteau du crépuscule	
PRESENCE_SCENARIO_BOH6_FIGHT_08	Apprend les secrets du manoir de Ravenholdt	
PRESENCE_SCENARIO_BOH7_FIGHT_01	Enrichit Landenoire	
PRESENCE_SCENARIO_BOH7_FIGHT_02	Devient un chaman	
PRESENCE_SCENARIO_BOH7_FIGHT_03	Parle à un étranger	
PRESENCE_SCENARIO_BOH7_FIGHT_04	Affronte Mannoroth	
PRESENCE_SCENARIO_BOH7_FIGHT_05	Surclasse Archimonde	
PRESENCE_SCENARIO_BOH7_FIGHT_06	S’occupe d’Aile de mort	
PRESENCE_SCENARIO_BOH7_FIGHT_07	Arrête Jaina	
PRESENCE_SCENARIO_BOH7_FIGHT_08	Rétrograde Garrosh	
PRESENCE_SCENARIO_BOH8_FIGHT_01	Reçoit des instructions	
PRESENCE_SCENARIO_BOH8_FIGHT_02	Affronte la Légion ardente	
PRESENCE_SCENARIO_BOH8_FIGHT_03	Prend part à une querelle fraternelle	
PRESENCE_SCENARIO_BOH8_FIGHT_04	Sauve Nordrassil	
PRESENCE_SCENARIO_BOH8_FIGHT_05	Prend part à une autre querelle fraternelle	
PRESENCE_SCENARIO_BOH8_FIGHT_06	Fait face au Cauchemar d’émeraude	
PRESENCE_SCENARIO_BOH8_FIGHT_07	Garde le Mont Hyjal	
PRESENCE_SCENARIO_BOH8_FIGHT_08	Défend Teldrassil	
PRESENCE_SCENARIO_BOH9_FIGHT_01	Est chassé du clan	
PRESENCE_SCENARIO_BOH9_FIGHT_02	En appelle au Trône des éléments	
PRESENCE_SCENARIO_BOH9_FIGHT_03	Fait la rencontre de Ner’zhul	
PRESENCE_SCENARIO_BOH9_FIGHT_04	Corrompt la Horde	
PRESENCE_SCENARIO_BOH9_FIGHT_05	Est enrôlé par Medivh	
PRESENCE_SCENARIO_BOH9_FIGHT_06	Réchappe à la colère d’Orgrim	
PRESENCE_SCENARIO_BOH9_FIGHT_07	Retrouve Teron’gor	
PRESENCE_SCENARIO_BOH9_FIGHT_08	Recherche la tombe de Sargeras	
PRESENCE_SCENARIO_BOM_FIGHT_01	Affronte Bru’kan	
PRESENCE_SCENARIO_BOM_FIGHT_02	Baguenaude avec Guff	
PRESENCE_SCENARIO_BOM_FIGHT_03	Dompte une bestiole nécrosée	
PRESENCE_SCENARIO_BOM_FIGHT_04	Chasse un monstre rare	
PRESENCE_SCENARIO_BOM_FIGHT_05	Récupère des éclats	
PRESENCE_SCENARIO_BOM_FIGHT_06	Affronte Doublenattes	
PRESENCE_SCENARIO_BOM_FIGHT_07	Recherche Feegly	
PRESENCE_SCENARIO_BOM_FIGHT_08	Affronte Garrosh	
PRESENCE_SCENARIO_BOM2_FIGHT_01	Garde les postes de garde	
PRESENCE_SCENARIO_BOM2_FIGHT_02	Arnaque Serena	
PRESENCE_SCENARIO_BOM2_FIGHT_03	Rencontre les autochtones	
PRESENCE_SCENARIO_BOM2_FIGHT_04	Atteint le quota du jour	
PRESENCE_SCENARIO_BOM2_FIGHT_05	Détourne un déchiqueteur	
PRESENCE_SCENARIO_BOM2_FIGHT_06	Entre par effraction	
PRESENCE_SCENARIO_BOM2_FIGHT_07	S’y prend à six bras contre huit	
PRESENCE_SCENARIO_BOM2_FIGHT_08	Tient un éclat de Lumière	
PRESENCE_SCENARIO_BOM3_FIGHT_01	Aide Hamuul	
PRESENCE_SCENARIO_BOM3_FIGHT_02	Trouve une fissure	
PRESENCE_SCENARIO_BOM3_FIGHT_03	Combat les Kolkars	
PRESENCE_SCENARIO_BOM3_FIGHT_04	Sauve des gueules d’acier des oasis	
PRESENCE_SCENARIO_BOM3_FIGHT_05	Recherche un groupe	
PRESENCE_SCENARIO_BOM3_FIGHT_06	Affronte des seigneurs-Croc	
PRESENCE_SCENARIO_BOM3_FIGHT_07	Rencontre Mutanus	
PRESENCE_SCENARIO_BOM3_FIGHT_08	Négocie avec Naralex	
PRESENCE_SCENARIO_BOM4_FIGHT_01	Protège un paladin	
PRESENCE_SCENARIO_BOM4_FIGHT_02	Triomphe des marginaux	
PRESENCE_SCENARIO_BOM4_FIGHT_03	Prépare sa vengeance	
PRESENCE_SCENARIO_BOM4_FIGHT_04	Forme un groupe	
PRESENCE_SCENARIO_BOM4_FIGHT_05	Combat la Lame-Ardente	
PRESENCE_SCENARIO_BOM4_FIGHT_06	Campe avec Kazakus	
PRESENCE_SCENARIO_BOM4_FIGHT_07	Affronte Lamefeu	
PRESENCE_SCENARIO_BOM4_FIGHT_08	Se mesure à Tamsin	
PRESENCE_SCENARIO_BOM5_FIGHT_01	Débriefe avec Kurtrus	
PRESENCE_SCENARIO_BOM5_FIGHT_02	Marchande avec Double-Crochet	
PRESENCE_SCENARIO_BOM5_FIGHT_03	Attaque Hurlevent	
PRESENCE_SCENARIO_BOM5_FIGHT_04	Affronte des amis	
PRESENCE_SCENARIO_BOM5_FIGHT_05	Défie un fromager	
PRESENCE_SCENARIO_BOM5_FIGHT_06	Combat Xyrella	
PRESENCE_SCENARIO_BOM5_FIGHT_07	Présente Anetheron	
PRESENCE_SCENARIO_BOM5_FIGHT_08	Corrompt Cornélius	
PRESENCE_SCENARIO_BOM6_FIGHT_01	S’entraîne avec sa sœur	
PRESENCE_SCENARIO_BOM6_FIGHT_02	Se bat contre un chasseur de démons	
PRESENCE_SCENARIO_BOM6_FIGHT_03	Rentre à la maison	
PRESENCE_SCENARIO_BOM6_FIGHT_04	Défend le quartier des Nains	
PRESENCE_SCENARIO_BOM6_FIGHT_05	Libère un ami	
PRESENCE_SCENARIO_BOM6_FIGHT_06	Attaque Anetheron	
PRESENCE_SCENARIO_BOM6_FIGHT_07	S’attaque à une monstruosité	
PRESENCE_SCENARIO_BOM6_FIGHT_08	Affronte Tamsin	
PRESENCE_SCENARIO_BOM7_FIGHT_01	Bataille avec Bob	
PRESENCE_SCENARIO_BOM7_FIGHT_02	Révèle le traître	
PRESENCE_SCENARIO_BOM7_FIGHT_03	S’occupe de Lardeur	
PRESENCE_SCENARIO_BOM7_FIGHT_04	Se fait la malle	
PRESENCE_SCENARIO_BOM7_FIGHT_05	S’enfonce dans les Mortemines	
PRESENCE_SCENARIO_BOM7_FIGHT_06	Châtie M. Châtiment	
PRESENCE_SCENARIO_BOM7_FIGHT_07	Cuisine avec Macaron	
PRESENCE_SCENARIO_BOM7_FIGHT_08	Élimine Edwin	
PRESENCE_SCENARIO_BOTA_CLEAR_BOOM	Réfléchit à un casse-tête	
PRESENCE_SCENARIO_BOTA_CLEAR_PUZZLE_1	Réfléchit à un casse-tête	
PRESENCE_SCENARIO_BOTA_CLEAR_PUZZLE_2	Réfléchit à un casse-tête	
PRESENCE_SCENARIO_BOTA_CLEAR_PUZZLE_3	Réfléchit à un casse-tête	
PRESENCE_SCENARIO_BOTA_CLEAR_PUZZLE_4	Réfléchit à un casse-tête	
PRESENCE_SCENARIO_BOTA_LETHAL_BOOM	Réfléchit à un casse-tête	
PRESENCE_SCENARIO_BOTA_LETHAL_PUZZLE_1	Réfléchit à un casse-tête	
PRESENCE_SCENARIO_BOTA_LETHAL_PUZZLE_2	Réfléchit à un casse-tête	
PRESENCE_SCENARIO_BOTA_LETHAL_PUZZLE_3	Réfléchit à un casse-tête	
PRESENCE_SCENARIO_BOTA_LETHAL_PUZZLE_4	Réfléchit à un casse-tête	
PRESENCE_SCENARIO_BOTA_MIRROR_BOOM	Réfléchit à un casse-tête	
PRESENCE_SCENARIO_BOTA_MIRROR_PUZZLE_1	Réfléchit à un casse-tête	
PRESENCE_SCENARIO_BOTA_MIRROR_PUZZLE_2	Réfléchit à un casse-tête	
PRESENCE_SCENARIO_BOTA_MIRROR_PUZZLE_3	Réfléchit à un casse-tête	
PRESENCE_SCENARIO_BOTA_MIRROR_PUZZLE_4	Réfléchit à un casse-tête	
PRESENCE_SCENARIO_BOTA_SURVIVAL_BOOM	Réfléchit à un casse-tête	
PRESENCE_SCENARIO_BOTA_SURVIVAL_PUZZLE_1	Réfléchit à un casse-tête	
PRESENCE_SCENARIO_BOTA_SURVIVAL_PUZZLE_2	Réfléchit à un casse-tête	
PRESENCE_SCENARIO_BOTA_SURVIVAL_PUZZLE_3	Réfléchit à un casse-tête	
PRESENCE_SCENARIO_BOTA_SURVIVAL_PUZZLE_4	Réfléchit à un casse-tête	
PRESENCE_SCENARIO_BRM_CLASS_CHALLENGE_DRUID	Défi de druide de Rochenoire	
PRESENCE_SCENARIO_BRM_CLASS_CHALLENGE_HUNTER	Défi de chasseur de Rochenoire	
PRESENCE_SCENARIO_BRM_CLASS_CHALLENGE_MAGE	Défi de mage de Rochenoire	
PRESENCE_SCENARIO_BRM_CLASS_CHALLENGE_PALADIN	Défi de paladin de Rochenoire	
PRESENCE_SCENARIO_BRM_CLASS_CHALLENGE_PRIEST	Défi de prêtre de Rochenoire	
PRESENCE_SCENARIO_BRM_CLASS_CHALLENGE_ROGUE	Défi de voleur de Rochenoire	
PRESENCE_SCENARIO_BRM_CLASS_CHALLENGE_SHAMAN	Défi de chaman de Rochenoire	
PRESENCE_SCENARIO_BRM_CLASS_CHALLENGE_WARLOCK	Défi de démoniste de Rochenoire	
PRESENCE_SCENARIO_BRM_CLASS_CHALLENGE_WARRIOR	Défi de guerrier de Rochenoire	
PRESENCE_SCENARIO_BRM_HEROIC_SCENARIO_ATRAMEDES	Atramédès (héroïque)	
PRESENCE_SCENARIO_BRM_HEROIC_SCENARIO_BARON_GEDDON	Baron Geddon (héroïque)	
PRESENCE_SCENARIO_BRM_HEROIC_SCENARIO_CHROMAGGUS	Chromaggus (héroïque)	
PRESENCE_SCENARIO_BRM_HEROIC_SCENARIO_DARK_IRON_ARENA	Arène sombrefer (héroïque)	feel free to shorten long translations since the UI may squeeze text into a tiny (unreadable) font size when text is too long. this string is shown in the Friends List.
PRESENCE_SCENARIO_BRM_HEROIC_SCENARIO_DRAKKISATH	Drakkisath (héroïque)	
PRESENCE_SCENARIO_BRM_HEROIC_SCENARIO_GARR	Garr (héroïque)	
PRESENCE_SCENARIO_BRM_HEROIC_SCENARIO_GRIM_GUZZLER	Sinistre écluseur (héroïque)	
PRESENCE_SCENARIO_BRM_HEROIC_SCENARIO_MAJORDOMO	Ragnaros (héroïque)	feel free to shorten long translations to 'Heroic Ragnaros' since the UI may squeeze text into a tiny (unreadable) font size when text is too long. this string is shown in the Friends List.
PRESENCE_SCENARIO_BRM_HEROIC_SCENARIO_MALORIAK	Maloriak (héroïque)	
PRESENCE_SCENARIO_BRM_HEROIC_SCENARIO_NEFARIAN	Victor Nefarius (héroïque)	feel free to shorten long translations to 'Heroic Nefarius' since the UI may squeeze text into a tiny (unreadable) font size when text is too long. this string is shown in the Friends List.
PRESENCE_SCENARIO_BRM_HEROIC_SCENARIO_OMNOTRON	Omnitron (héroïque)	
PRESENCE_SCENARIO_BRM_HEROIC_SCENARIO_OMOKK	Omokk (héroïque)	
PRESENCE_SCENARIO_BRM_HEROIC_SCENARIO_RAZORGORE	Tranchetripe (héroïque)	
PRESENCE_SCENARIO_BRM_HEROIC_SCENARIO_REND_BLACKHAND	Rend Main-Noire (héroïque)	
PRESENCE_SCENARIO_BRM_HEROIC_SCENARIO_THAURISSAN	Empereur Thaurissan (héroique)	feel free to shorten long translations to 'Heroic Thaurissan' since the UI may squeeze text into a tiny (unreadable) font size when text is too long. this string is shown in the Friends List.
PRESENCE_SCENARIO_BRM_HEROIC_SCENARIO_VAELASTRASZ	Vaelastrasz (héroïque)	
PRESENCE_SCENARIO_BRM_HEROIC_SCENARIO_ZOMBIE_NEF	Nefarian (héroïque)	
PRESENCE_SCENARIO_BRM_NORMAL_SCENARIO_ATRAMEDES	Affronte Atramédès	
PRESENCE_SCENARIO_BRM_NORMAL_SCENARIO_BARON_GEDDON	Affronte le baron Geddon	
PRESENCE_SCENARIO_BRM_NORMAL_SCENARIO_CHROMAGGUS	Affronte Chromaggus	
PRESENCE_SCENARIO_BRM_NORMAL_SCENARIO_DARK_IRON_ARENA	Affronte l’arène Sombrefer	feel free to shorten long translations since the UI may squeeze text into a tiny (unreadable) font size when text is too long. this string is shown in the Friends List.
PRESENCE_SCENARIO_BRM_NORMAL_SCENARIO_DRAKKISATH	Affronte Drakkisath	
PRESENCE_SCENARIO_BRM_NORMAL_SCENARIO_GARR	Affronte Garr	
PRESENCE_SCENARIO_BRM_NORMAL_SCENARIO_GRIM_GUZZLER	Affronte le Sinistre écluseur	
PRESENCE_SCENARIO_BRM_NORMAL_SCENARIO_MAJORDOMO	Affronte Ragnaros	feel free to shorten long translations to 'Battling Ragnaros' since the UI may squeeze text into a tiny (unreadable) font size when text is too long. this string is shown in the Friends List.
PRESENCE_SCENARIO_BRM_NORMAL_SCENARIO_MALORIAK	Affronte Maloriak	
PRESENCE_SCENARIO_BRM_NORMAL_SCENARIO_NEFARIAN	Affronte Victor Nefarius	feel free to shorten long translations to 'Battling Nefarius' since the UI may squeeze text into a tiny (unreadable) font size when text is too long. this string is shown in the Friends List.
PRESENCE_SCENARIO_BRM_NORMAL_SCENARIO_OMNOTRON	Affronte Omnitron	
PRESENCE_SCENARIO_BRM_NORMAL_SCENARIO_OMOKK	Affronte Omokk	
PRESENCE_SCENARIO_BRM_NORMAL_SCENARIO_RAZORGORE	Affronte Tranchetripe	
PRESENCE_SCENARIO_BRM_NORMAL_SCENARIO_REND_BLACKHAND	Affronte Rend Main-Noire	
PRESENCE_SCENARIO_BRM_NORMAL_SCENARIO_THAURISSAN	Affronte Thaurissan	feel free to shorten long translations to 'Battling Thaurissan' since the UI may squeeze text into a tiny (unreadable) font size when text is too long. this string is shown in the Friends List.
PRESENCE_SCENARIO_BRM_NORMAL_SCENARIO_VAELASTRASZ	Affronte Vaelastrasz	
PRESENCE_SCENARIO_BRM_NORMAL_SCENARIO_ZOMBIE_NEF	Affronte Nefarian	
PRESENCE_SCENARIO_BTA_COIN_01_INQUISITOR_DAKREL	Explore la péninsule des Flammes infernales	
PRESENCE_SCENARIO_BTA_COIN_02_XUR_GOTH	Explore la péninsule des Flammes infernales	
PRESENCE_SCENARIO_BTA_COIN_03_ZIXOR	Explore la péninsule des Flammes infernales	
PRESENCE_SCENARIO_BTA_COIN_04_BALTHARAK	Explore la péninsule des Flammes infernales	
PRESENCE_SCENARIO_BTA_COIN_05_KANRETHAD_PRIME	Traverse le marécage de Zangar	
PRESENCE_SCENARIO_BTA_COIN_06_BURGRAK_CRUELCHAIN	Traverse le marécage de Zangar	
PRESENCE_SCENARIO_BTA_COIN_07_FELSTORM_RUN	Traverse le marécage de Zangar	
PRESENCE_SCENARIO_BTA_COIN_08_MOTHER_SHAHRAZ	Traverse le marécage de Zangar	
PRESENCE_SCENARIO_BTA_COIN_09_SHAL_JA_OUTCAST	S’entraîne au Temple noir	
PRESENCE_SCENARIO_BTA_COIN_10_KARNUK_OUTCAST	S’entraîne au Temple noir	
PRESENCE_SCENARIO_BTA_COIN_11_JEK_HAZ	S’entraîne au Temple noir	
PRESENCE_SCENARIO_BTA_COIN_12_MAGTHERIDON_PRIME	S’entraîne au Temple noir	
PRESENCE_SCENARIO_BTA_COIN_13_GOK_AMOK	Combat pour Raz-de-Néant	
PRESENCE_SCENARIO_BTA_COIN_14_FLIKK	Combat pour Raz-de-Néant	
PRESENCE_SCENARIO_BTA_COIN_15_BADUU_CORRUPTED	Combat pour Raz-de-Néant	
PRESENCE_SCENARIO_BTA_COIN_16_MECHA_JARAXXUS	Combat pour Raz-de-Néant	
PRESENCE_SCENARIO_BTA_COIN_17_ILLIDAN_STORMRAGE	Défend le destin de l’Outreterre	
PRESENCE_SCENARIO_BTA_HEROIC_COIN_01_KAZZAK	Défie un puissant adversaire de l’Outreterre	
PRESENCE_SCENARIO_BTA_HEROIC_COIN_02_GRUUL	Défie un puissant adversaire de l’Outreterre	
PRESENCE_SCENARIO_BTA_HEROIC_COIN_03_MAGTHERIDON	Défie un puissant adversaire de l’Outreterre	
PRESENCE_SCENARIO_BTA_HEROIC_COIN_04_SUPREMUS	Défie un puissant adversaire de l’Outreterre	
PRESENCE_SCENARIO_BTA_HEROIC_COIN_05_TERON_GOREFIEND	Défie un puissant adversaire de l’Outreterre	
PRESENCE_SCENARIO_BTA_HEROIC_COIN_06_MOTHER_SHARAZ	Défie une puissante adversaire de l’Outreterre	
PRESENCE_SCENARIO_BTA_HEROIC_COIN_07_LADY_VASHJ	Défie une puissante adversaire de l’Outreterre	
PRESENCE_SCENARIO_BTA_HEROIC_COIN_08_KAELTHAS	Défie un puissant adversaire de l’Outreterre	
PRESENCE_SCENARIO_BTA_HEROIC_COIN_09_ILLIDAN	Défie un puissant adversaire de l’Outreterre	
PRESENCE_SCENARIO_BTP_COIN_01_AZZINOTH	Se bat contre la Légion ardente !	
PRESENCE_SCENARIO_BTP_COIN_02_XAVIUS	Change d’allégeance !	
PRESENCE_SCENARIO_BTP_COIN_03_MANNOROTH	Repousse les démons !	
PRESENCE_SCENARIO_BTP_COIN_04_CENARIUS	Se défend contre les accusateurs !	
PRESENCE_SCENARIO_DALA_01_BANK	Vole la banque de Dalaran	
PRESENCE_SCENARIO_DALA_01_BANK_HEROIC	Vole la banque de Dalaran	
PRESENCE_SCENARIO_DALA_02_VIOLET_HOLD	Libère des prisonniers du fort	
PRESENCE_SCENARIO_DALA_02_VIOLET_HOLD_HEROIC	Libère des prisonniers du fort	
PRESENCE_SCENARIO_DALA_03_STREETS	Sème le chaos dans les rues	
PRESENCE_SCENARIO_DALA_03_STREETS_HEROIC	Sème le chaos dans les rues	
PRESENCE_SCENARIO_DALA_04_UNDERBELLY	S’infiltre dans les Entrailles	
PRESENCE_SCENARIO_DALA_04_UNDERBELLY_HEROIC	S’infiltre dans les Entrailles	
PRESENCE_SCENARIO_DALA_05_CITADEL	S’empare de la citadelle Pourpre	
PRESENCE_SCENARIO_DALA_05_CITADEL_HEROIC	S’empare de la citadelle Pourpre	
PRESENCE_SCENARIO_DALA_TAVERN	Complote dans une taverne	
PRESENCE_SCENARIO_DALA_TAVERN_HEROIC	Complote dans une taverne	
PRESENCE_SCENARIO_DRGA_EVIL_CHAPTER_01_COIN_01	Combat dans la Désolation des dragons	
PRESENCE_SCENARIO_DRGA_EVIL_CHAPTER_01_COIN_01_HEROIC	Combat dans la Désolation des dragons	
PRESENCE_SCENARIO_DRGA_EVIL_CHAPTER_01_COIN_02	Combat dans la Désolation des dragons	
PRESENCE_SCENARIO_DRGA_EVIL_CHAPTER_01_COIN_02_HEROIC	Combat dans la Désolation des dragons	
PRESENCE_SCENARIO_DRGA_EVIL_CHAPTER_01_COIN_03	Combat dans la Désolation des dragons	
PRESENCE_SCENARIO_DRGA_EVIL_CHAPTER_01_COIN_03_HEROIC	Combat dans la Désolation des dragons	
PRESENCE_SCENARIO_DRGA_EVIL_CHAPTER_02_COIN_01	Combat dans la Désolation des dragons	
PRESENCE_SCENARIO_DRGA_EVIL_CHAPTER_02_COIN_01_HEROIC	Combat dans la Désolation des dragons	
PRESENCE_SCENARIO_DRGA_EVIL_CHAPTER_02_COIN_02	Combat dans la Désolation des dragons	
PRESENCE_SCENARIO_DRGA_EVIL_CHAPTER_02_COIN_02_HEROIC	Combat dans la Désolation des dragons	
PRESENCE_SCENARIO_DRGA_EVIL_CHAPTER_02_COIN_03	Combat dans la Désolation des dragons	
PRESENCE_SCENARIO_DRGA_EVIL_CHAPTER_02_COIN_03_HEROIC	Combat dans la Désolation des dragons	
PRESENCE_SCENARIO_DRGA_EVIL_CHAPTER_03_COIN_01	Combat dans la Désolation des dragons	
PRESENCE_SCENARIO_DRGA_EVIL_CHAPTER_03_COIN_01_HEROIC	Combat dans la Désolation des dragons	
PRESENCE_SCENARIO_DRGA_EVIL_CHAPTER_03_COIN_02	Combat dans la Désolation des dragons	
PRESENCE_SCENARIO_DRGA_EVIL_CHAPTER_03_COIN_02_HEROIC	Combat dans la Désolation des dragons	
PRESENCE_SCENARIO_DRGA_EVIL_CHAPTER_03_COIN_03	Combat dans la Désolation des dragons	
PRESENCE_SCENARIO_DRGA_EVIL_CHAPTER_03_COIN_03_HEROIC	Combat dans la Désolation des dragons	
PRESENCE_SCENARIO_DRGA_EVIL_CHAPTER_04_COIN_01	Combat dans la Désolation des dragons	
PRESENCE_SCENARIO_DRGA_EVIL_CHAPTER_04_COIN_01_HEROIC	Combat dans la Désolation des dragons	
PRESENCE_SCENARIO_DRGA_EVIL_CHAPTER_04_COIN_02	Combat dans la Désolation des dragons	
PRESENCE_SCENARIO_DRGA_EVIL_CHAPTER_04_COIN_02_HEROIC	Combat dans la Désolation des dragons	
PRESENCE_SCENARIO_DRGA_EVIL_CHAPTER_04_COIN_03	Combat dans la Désolation des dragons	
PRESENCE_SCENARIO_DRGA_EVIL_CHAPTER_04_COIN_03_HEROIC	Combat dans la Désolation des dragons	
PRESENCE_SCENARIO_DRGA_GOOD_CHAPTER_01_COIN_01	Combat dans la Désolation des dragons	
PRESENCE_SCENARIO_DRGA_GOOD_CHAPTER_01_COIN_01_HEROIC	Combat dans la Désolation des dragons	
PRESENCE_SCENARIO_DRGA_GOOD_CHAPTER_01_COIN_02	Combat dans la Désolation des dragons	
PRESENCE_SCENARIO_DRGA_GOOD_CHAPTER_01_COIN_02_HEROIC	Combat dans la Désolation des dragons	
PRESENCE_SCENARIO_DRGA_GOOD_CHAPTER_01_COIN_03	Combat dans la Désolation des dragons	
PRESENCE_SCENARIO_DRGA_GOOD_CHAPTER_01_COIN_03_HEROIC	Combat dans la Désolation des dragons	
PRESENCE_SCENARIO_DRGA_GOOD_CHAPTER_02_COIN_01	Combat dans la Désolation des dragons	
PRESENCE_SCENARIO_DRGA_GOOD_CHAPTER_02_COIN_01_HEROIC	Combat dans la Désolation des dragons	
PRESENCE_SCENARIO_DRGA_GOOD_CHAPTER_02_COIN_02	Combat dans la Désolation des dragons	
PRESENCE_SCENARIO_DRGA_GOOD_CHAPTER_02_COIN_02_HEROIC	Combat dans la Désolation des dragons	
PRESENCE_SCENARIO_DRGA_GOOD_CHAPTER_02_COIN_03	Combat dans la Désolation des dragons	
PRESENCE_SCENARIO_DRGA_GOOD_CHAPTER_02_COIN_03_HEROIC	Combat dans la Désolation des dragons	
PRESENCE_SCENARIO_DRGA_GOOD_CHAPTER_03_COIN_01	Combat dans la Désolation des dragons	
PRESENCE_SCENARIO_DRGA_GOOD_CHAPTER_03_COIN_01_HEROIC	Combat dans la Désolation des dragons	
PRESENCE_SCENARIO_DRGA_GOOD_CHAPTER_03_COIN_02	Combat dans la Désolation des dragons	
PRESENCE_SCENARIO_DRGA_GOOD_CHAPTER_03_COIN_02_HEROIC	Combat dans la Désolation des dragons	
PRESENCE_SCENARIO_DRGA_GOOD_CHAPTER_03_COIN_03	Combat dans la Désolation des dragons	
PRESENCE_SCENARIO_DRGA_GOOD_CHAPTER_03_COIN_03_HEROIC	Combat dans la Désolation des dragons	
PRESENCE_SCENARIO_DRGA_GOOD_CHAPTER_04_COIN_01	Combat dans la Désolation des dragons	
PRESENCE_SCENARIO_DRGA_GOOD_CHAPTER_04_COIN_01_HEROIC	Combat dans la Désolation des dragons	
PRESENCE_SCENARIO_DRGA_GOOD_CHAPTER_04_COIN_02	Combat dans la Désolation des dragons	
PRESENCE_SCENARIO_DRGA_GOOD_CHAPTER_04_COIN_02_HEROIC	Combat dans la Désolation des dragons	
PRESENCE_SCENARIO_DRGA_GOOD_CHAPTER_04_COIN_03	Combat dans la Désolation des dragons	
PRESENCE_SCENARIO_DRGA_GOOD_CHAPTER_04_COIN_03_HEROIC	Combat dans la Désolation des dragons	
PRESENCE_SCENARIO_GIL_BONUS_CHALLENGE	Affronte Hagatha	
PRESENCE_SCENARIO_GIL_DUNGEON	À la chasse aux monstres	
PRESENCE_SCENARIO_ICC_NORMAL_DEATHWHISPER	Affronte dame Murmemort	
PRESENCE_SCENARIO_ICC_NORMAL_FINALE	Affronte le roi-liche	
PRESENCE_SCENARIO_ICC_NORMAL_LANATHEL	Affronte Lana’thel	
PRESENCE_SCENARIO_ICC_NORMAL_LICHKING	Perd contre le roi-liche	
PRESENCE_SCENARIO_ICC_NORMAL_MARROWGAR	Affronte Gargamoelle	
PRESENCE_SCENARIO_ICC_NORMAL_PUTRICIDE	Affronte Putricide	
PRESENCE_SCENARIO_ICC_NORMAL_SAURFANG	Affronte Saurcroc	
PRESENCE_SCENARIO_ICC_NORMAL_SINDRAGOSA	Affronte Sindragosa	
PRESENCE_SCENARIO_KAR_CLASS_CHALLENGE_DRUID	Défi de druide de Karazhan	
PRESENCE_SCENARIO_KAR_CLASS_CHALLENGE_HUNTER	Défi de chasseur de Karazhan	
PRESENCE_SCENARIO_KAR_CLASS_CHALLENGE_MAGE	Défi de mage de Karazhan	
PRESENCE_SCENARIO_KAR_CLASS_CHALLENGE_PALADIN	Défi de paladin de Karazhan	
PRESENCE_SCENARIO_KAR_CLASS_CHALLENGE_PRIEST	Défi de prêtre de Karazhan	
PRESENCE_SCENARIO_KAR_CLASS_CHALLENGE_ROGUE	Défi de voleur de Karazhan	
PRESENCE_SCENARIO_KAR_CLASS_CHALLENGE_SHAMAN	Défi de chaman de Karazhan	
PRESENCE_SCENARIO_KAR_CLASS_CHALLENGE_WARLOCK	Défi de démoniste de Karazhan	
PRESENCE_SCENARIO_KAR_CLASS_CHALLENGE_WARRIOR	Défi de guerrier de Karazhan	
PRESENCE_SCENARIO_KAR_HEROIC_ARAN	Ombre d’Aran (héroïque)	
PRESENCE_SCENARIO_KAR_HEROIC_CHESS	Échiquier (héroïque)	
PRESENCE_SCENARIO_KAR_HEROIC_CRONE	La Mégère (héroïque)	
PRESENCE_SCENARIO_KAR_HEROIC_CURATOR	Conservateur (héroïque)	
PRESENCE_SCENARIO_KAR_HEROIC_ILLHOOF	Malsabot (héroïque)	
PRESENCE_SCENARIO_KAR_HEROIC_JULIANNE	Julianne (héroïque)	
PRESENCE_SCENARIO_KAR_HEROIC_MIRROR	Miroir magique (héroïque)	
PRESENCE_SCENARIO_KAR_HEROIC_NETHERSPITE	Dédain-du-Néant (héroïque)	
PRESENCE_SCENARIO_KAR_HEROIC_NIGHTBANE	Plaie-de-nuit (héroïque)	
PRESENCE_SCENARIO_KAR_HEROIC_PANTRY	Golem d’argenterie (héroïque)	
PRESENCE_SCENARIO_KAR_HEROIC_PORTALS	Libère Medivh ! (héroïque)	
PRESENCE_SCENARIO_KAR_HEROIC_PROLOGUE	Malchezaar (héroïque)	
PRESENCE_SCENARIO_KAR_HEROIC_WOLF	Grand Méchant Loup (héroïque)	
PRESENCE_SCENARIO_KAR_NORMAL_ARAN	Affronte l’Ombre d’Aran	
PRESENCE_SCENARIO_KAR_NORMAL_CHESS	Affronte l’Échiquier	
PRESENCE_SCENARIO_KAR_NORMAL_CRONE	Affronte la Mégère	
PRESENCE_SCENARIO_KAR_NORMAL_CURATOR	Affronte le Conservateur	
PRESENCE_SCENARIO_KAR_NORMAL_ILLHOOF	Affronte Malsabot	
PRESENCE_SCENARIO_KAR_NORMAL_JULIANNE	Affronte Julianne	
PRESENCE_SCENARIO_KAR_NORMAL_MIRROR	Affronte le Miroir magique	
PRESENCE_SCENARIO_KAR_NORMAL_NETHERSPITE	Affronte Dédain-du-Néant	
PRESENCE_SCENARIO_KAR_NORMAL_NIGHTBANE	Affronte Plaie-de-nuit	
PRESENCE_SCENARIO_KAR_NORMAL_PANTRY	Affronte le Golem d’argenterie	
PRESENCE_SCENARIO_KAR_NORMAL_PORTALS	Libère Medivh !	
PRESENCE_SCENARIO_KAR_NORMAL_PROLOGUE	Affronte Malchezaar	
PRESENCE_SCENARIO_KAR_NORMAL_WOLF	Affronte le Grand Méchant Loup	
PRESENCE_SCENARIO_LOE_CLASS_CHALLENGE_DRUID	Défi de druide de la Ligue	
PRESENCE_SCENARIO_LOE_CLASS_CHALLENGE_HUNTER	Défi de chasseur de la Ligue	
PRESENCE_SCENARIO_LOE_CLASS_CHALLENGE_MAGE	Défi de mage de la Ligue	
PRESENCE_SCENARIO_LOE_CLASS_CHALLENGE_PALADIN	Défi de paladin de la Ligue	
PRESENCE_SCENARIO_LOE_CLASS_CHALLENGE_PRIEST	Défi de prêtre de la Ligue	
PRESENCE_SCENARIO_LOE_CLASS_CHALLENGE_ROGUE	Défi de voleur de la Ligue	
PRESENCE_SCENARIO_LOE_CLASS_CHALLENGE_SHAMAN	Défi de chaman de la Ligue	
PRESENCE_SCENARIO_LOE_CLASS_CHALLENGE_WARLOCK	Défi de démoniste de la Ligue	
PRESENCE_SCENARIO_LOE_CLASS_CHALLENGE_WARRIOR	Défi de guerrier de la Ligue	
PRESENCE_SCENARIO_LOE_HEROIC_ARCHAEDAS	Archaedas (héroïque)	
PRESENCE_SCENARIO_LOE_HEROIC_GIANTFIN	Aileron-Géant (héroïque)	
PRESENCE_SCENARIO_LOE_HEROIC_LADY_NAZJAR	Dame Naz’jar (héroïque)	
PRESENCE_SCENARIO_LOE_HEROIC_MINE_CART	Course en chariot de mine (héroïque)	
PRESENCE_SCENARIO_LOE_HEROIC_RAFAAM_1	Prince voleur Rafaam (héroïque)	
PRESENCE_SCENARIO_LOE_HEROIC_RAFAAM_2	Rafaam déchaîné (héroïque)	
PRESENCE_SCENARIO_LOE_HEROIC_SCARVASH	Chef Scarvash (héroïque)	
PRESENCE_SCENARIO_LOE_HEROIC_SKELESAURUS	Squeletosaurus Hex (héroïque)	
PRESENCE_SCENARIO_LOE_HEROIC_SLITHERSPEAR	Seigneur Ondulance (héroïque)	
PRESENCE_SCENARIO_LOE_HEROIC_STEEL_SENTINEL	La Sentinelle d’acier (héroïque)	
PRESENCE_SCENARIO_LOE_HEROIC_SUN_RAIDER_PHAERIX	Écumeur du soleil Phaerix (héroïque)	
PRESENCE_SCENARIO_LOE_HEROIC_TEMPLE_ESCAPE	Fuite du temple (héroïque)	
PRESENCE_SCENARIO_LOE_HEROIC_ZINAAR	Zinaar (héroïque)	
PRESENCE_SCENARIO_LOE_NORMAL_ARCHAEDAS	Affronte Archaedas	
PRESENCE_SCENARIO_LOE_NORMAL_GIANTFIN	Affronte Aileron-Géant	
PRESENCE_SCENARIO_LOE_NORMAL_LADY_NAZJAR	Affronte Dame Naz’jar	
PRESENCE_SCENARIO_LOE_NORMAL_MINE_CART	Course en chariot de mine	
PRESENCE_SCENARIO_LOE_NORMAL_RAFAAM_1	Affronte le prince voleur Rafaam	
PRESENCE_SCENARIO_LOE_NORMAL_RAFAAM_2	Affronte Rafaam déchaîné	
PRESENCE_SCENARIO_LOE_NORMAL_SCARVASH	Affronte le chef Scarvash	
PRESENCE_SCENARIO_LOE_NORMAL_SKELESAURUS	Affronte Squeletosaurus Hex	
PRESENCE_SCENARIO_LOE_NORMAL_SLITHERSPEAR	Affronte le seigneur Ondulance	
PRESENCE_SCENARIO_LOE_NORMAL_STEEL_SENTINEL	Affronte la Sentinelle d’acier	
PRESENCE_SCENARIO_LOE_NORMAL_SUN_RAIDER_PHAERIX	Affronte l’écumeur du soleil Phaerix	
PRESENCE_SCENARIO_LOE_NORMAL_TEMPLE_ESCAPE	Fuite du temple	
PRESENCE_SCENARIO_LOE_NORMAL_ZINAAR	Affronte Zinaar	
PRESENCE_SCENARIO_LOOT_DUNGEON	Fait une virée en donjon	
PRESENCE_SCENARIO_NAXX_CLASS_CHALLENGE_DRUID	Défi de druide de Naxxramas	
PRESENCE_SCENARIO_NAXX_CLASS_CHALLENGE_HUNTER	Défi de chasseur de Naxxramas	
PRESENCE_SCENARIO_NAXX_CLASS_CHALLENGE_MAGE	Défi de mage de Naxxramas	
PRESENCE_SCENARIO_NAXX_CLASS_CHALLENGE_PALADIN	Défi de paladin de Naxxramas	
PRESENCE_SCENARIO_NAXX_CLASS_CHALLENGE_PRIEST	Défi de prêtre de Naxxramas	
PRESENCE_SCENARIO_NAXX_CLASS_CHALLENGE_ROGUE	Défi de voleur de Naxxramas	
PRESENCE_SCENARIO_NAXX_CLASS_CHALLENGE_SHAMAN	Défi de chaman de Naxxramas	
PRESENCE_SCENARIO_NAXX_CLASS_CHALLENGE_WARLOCK	Défi de démoniste de Naxxramas	
PRESENCE_SCENARIO_NAXX_CLASS_CHALLENGE_WARRIOR	Défi de guerrier de Naxxramas	
PRESENCE_SCENARIO_NAXX_HEROIC_SCENARIO_ANUBREKHAN	Anub’Rekhan (héroïque)	
PRESENCE_SCENARIO_NAXX_HEROIC_SCENARIO_FAERLINA	Faerlina (héroïque)	feel free to shorten long translations to 'Heroic Faerlina' since the UI may squeeze text into a tiny (unreadable) font size when text is too long. this string is shown in the Friends List.
PRESENCE_SCENARIO_NAXX_HEROIC_SCENARIO_GLUTH	Gluth (héroïque)	
PRESENCE_SCENARIO_NAXX_HEROIC_SCENARIO_GOTHIK	Gothik (héroïque)	feel free to shorten long translations to 'Heroic Gothik' since the UI may squeeze text into a tiny (unreadable) font size when text is too long. this string is shown in the Friends List.
PRESENCE_SCENARIO_NAXX_HEROIC_SCENARIO_GROBBULUS	Grobbulus (héroïque)	
PRESENCE_SCENARIO_NAXX_HEROIC_SCENARIO_HEIGAN	Heigan (héroïque)	feel free to shorten long translations to 'Heroic Heigan' since the UI may squeeze text into a tiny (unreadable) font size when text is too long. this string is shown in the Friends List.
PRESENCE_SCENARIO_NAXX_HEROIC_SCENARIO_HORSEMEN	Les quatre cavaliers (héroïque)	
PRESENCE_SCENARIO_NAXX_HEROIC_SCENARIO_KELTHUZAD	Kel’Thuzad (héroïque)	
PRESENCE_SCENARIO_NAXX_HEROIC_SCENARIO_LOATHEB	Horreb (héroïque)	
PRESENCE_SCENARIO_NAXX_HEROIC_SCENARIO_MAEXXNA	Maexxna (héroïque)	
PRESENCE_SCENARIO_NAXX_HEROIC_SCENARIO_NOTH	Noth (héroïque)	feel free to shorten long translations to 'Heroic Noth' since the UI may squeeze text into a tiny (unreadable) font size when text is too long. this string is shown in the Friends List.
PRESENCE_SCENARIO_NAXX_HEROIC_SCENARIO_PATCHWERK	Le Recousu (héroïque)	
PRESENCE_SCENARIO_NAXX_HEROIC_SCENARIO_RAZUVIOUS	Razuvious (héroïque)	feel free to shorten long translations to 'Heroic Razuvious' since the UI may squeeze text into a tiny (unreadable) font size when text is too long. this string is shown in the Friends List.
PRESENCE_SCENARIO_NAXX_HEROIC_SCENARIO_SAPPHIRON	Saphiron (héroïque)	
PRESENCE_SCENARIO_NAXX_HEROIC_SCENARIO_THADDIUS	Thaddius (héroïque)	
PRESENCE_SCENARIO_NAXX_NORMAL_SCENARIO_ANUBREKHAN	Affronte Anub’Rekhan	
PRESENCE_SCENARIO_NAXX_NORMAL_SCENARIO_FAERLINA	Affronte Faerlina	feel free to shorten long translations to 'Battling Faerlina' since the UI may squeeze text into a tiny (unreadable) font size when text is too long. this string is shown in the Friends List.
PRESENCE_SCENARIO_NAXX_NORMAL_SCENARIO_GLUTH	Affronte Gluth	
PRESENCE_SCENARIO_NAXX_NORMAL_SCENARIO_GOTHIK	Affronte Gothik	feel free to shorten long translations to 'Battling Gothik' since the UI may squeeze text into a tiny (unreadable) font size when text is too long. this string is shown in the Friends List.
PRESENCE_SCENARIO_NAXX_NORMAL_SCENARIO_GROBBULUS	Affronte Grobbulus	
PRESENCE_SCENARIO_NAXX_NORMAL_SCENARIO_HEIGAN	Affronte Heigan	feel free to shorten long translations to 'Battling Heigan' since the UI may squeeze text into a tiny (unreadable) font size when text is too long. this is string shown in the Friends List.
PRESENCE_SCENARIO_NAXX_NORMAL_SCENARIO_HORSEMEN	Affronte les quatre cavaliers	
PRESENCE_SCENARIO_NAXX_NORMAL_SCENARIO_KELTHUZAD	Affronte Kel’Thuzad	
PRESENCE_SCENARIO_NAXX_NORMAL_SCENARIO_LOATHEB	Affronte Horreb	
PRESENCE_SCENARIO_NAXX_NORMAL_SCENARIO_MAEXXNA	Affronte Maexxna	
PRESENCE_SCENARIO_NAXX_NORMAL_SCENARIO_NOTH	Affronte Noth	feel free to shorten long translations to 'Battling Noth' since the UI may squeeze text into a tiny (unreadable) font size when text is too long. this string is shown in the Friends List.
PRESENCE_SCENARIO_NAXX_NORMAL_SCENARIO_PATCHWERK	Affronte le Recousu	
PRESENCE_SCENARIO_NAXX_NORMAL_SCENARIO_RAZUVIOUS	Affronte Razuvious	feel free to shorten long translations to 'Battling Razuvious' since the UI may squeeze text into a tiny (unreadable) font size when text is too long. this string is shown in the Friends List.
PRESENCE_SCENARIO_NAXX_NORMAL_SCENARIO_SAPPHIRON	Affronte Saphiron	
PRESENCE_SCENARIO_NAXX_NORMAL_SCENARIO_THADDIUS	Affronte Thaddius	
PRESENCE_SCENARIO_RETURNING_PLAYER_CHALLENGE_1	Fait son retour en jeu	
PRESENCE_SCENARIO_RETURNING_PLAYER_CHALLENGE_2	Fait son retour en jeu	
PRESENCE_SCENARIO_RETURNING_PLAYER_CHALLENGE_3	Fait son retour en jeu	
PRESENCE_SCENARIO_TRL_DUNGEON	Joue dans l’arène des Gurubashi	
PRESENCE_SCENARIO_ULD_01_CITY	Explore la cité perdue	
PRESENCE_SCENARIO_ULD_01_CITY_HEROIC	Explore la cité perdue	
PRESENCE_SCENARIO_ULD_02_DESERT	Erre dans le désert	
PRESENCE_SCENARIO_ULD_02_DESERT_HEROIC	Erre dans le désert	
PRESENCE_SCENARIO_ULD_03_TOMB	Met au jour les tombes	
PRESENCE_SCENARIO_ULD_03_TOMB_HEROIC	Met au jour les tombes	
PRESENCE_SCENARIO_ULD_04_HALLS	Déambule dans les salles	
PRESENCE_SCENARIO_ULD_04_HALLS_HEROIC	Déambule dans les salles	
PRESENCE_SCENARIO_ULD_05_SANCTUM	Combat dans le sanctum	
PRESENCE_SCENARIO_ULD_05_SANCTUM_HEROIC	Combat dans le sanctum	
PRESENCE_SCENARIO_ULD_TAVERN	Flâne dans le bazar	
PRESENCE_SCENARIO_ULD_TAVERN_HEROIC	Flâne dans le bazar	
PRESENCE_STATUS_ADVENTURE_CHOOSING_MODE	Cherche une aventure	
PRESENCE_STATUS_ADVENTURE_SCENARIO_PLAYING_GAME	{0}	{0} replaced with the specific scenario string, via PRESENCE_SCENARIO_NAXX_*
PRESENCE_STATUS_ADVENTURE_SCENARIO_SELECT	{0}	{0} replaced with the adventure mode, via PRESENCE_ADVENTURE_MODE_*, e.g. Naxxramas (Heroic) -- (originally i wanted it to say "Mission Select: Naxxramas Class Challenge" but this got too long for the UI element.)
PRESENCE_STATUS_ARENA_FORGE	Crée un deck d’Arène	
PRESENCE_STATUS_ARENA_GAME	Se bat dans l’Arène	
PRESENCE_STATUS_ARENA_IDLE	Dans l’Arène	
PRESENCE_STATUS_ARENA_PURCHASE	Va entrer dans l’Arène	
PRESENCE_STATUS_ARENA_QUEUE	Cherche un adversaire d’Arène	
PRESENCE_STATUS_ARENA_REWARD	Obtient des récompenses d’Arène	
PRESENCE_STATUS_BATTLEGROUNDS_GAME	Est en plein champ de bataille	
PRESENCE_STATUS_BATTLEGROUNDS_QUEUE	Cherche des adversaires de champ de bataille	
PRESENCE_STATUS_BATTLEGROUNDS_SCREEN	Dans le mode Champs de bataille	
PRESENCE_STATUS_COLLECTION	Consulte sa collection	
PRESENCE_STATUS_CRAFTING	Crée des cartes	
PRESENCE_STATUS_DECKEDITOR	Crée un deck	
PRESENCE_STATUS_DUELS_FORGE	Crée un deck de duels	
PRESENCE_STATUS_DUELS_GAME	Se bat dans un duel épique	
PRESENCE_STATUS_DUELS_IDLE	Va faire un duel	
PRESENCE_STATUS_DUELS_PURCHASE	Va commencer une série de Duels	
PRESENCE_STATUS_DUELS_QUEUE	Cherche un adversaire de Duels	
PRESENCE_STATUS_DUELS_REWARD	Obtient des récompenses de duels	
PRESENCE_STATUS_FIRESIDE_BRAWL_SCREEN	Va faire un Bras de fer Fireside	
PRESENCE_STATUS_FRIENDLY_DECKPICKER	Va défier un de ses contacts	
PRESENCE_STATUS_FRIENDLY_GAME	Se bat contre un contact	
PRESENCE_STATUS_HUB	Dans le menu principal	
PRESENCE_STATUS_LOGIN	Démarre le jeu	
PRESENCE_STATUS_MERCENARIES_COLLECTION	Consulte sa collection de mercenaires	
PRESENCE_STATUS_MERCENARIES_FRIENDLY_GAME	Affronte un ami dans le mode Mercenaires	
PRESENCE_STATUS_MERCENARIES_FRIENDLY_LOBBY	Va défier un de ses contacts	
PRESENCE_STATUS_MERCENARIES_GAME	Participe à un match de mercenaires	
PRESENCE_STATUS_MERCENARIES_MAP	Explore une carte de mercenaires	
PRESENCE_STATUS_MERCENARIES_PLAY_SCREEN	Choisit une équipe de mercenaires	
PRESENCE_STATUS_MERCENARIES_QUEUE	Cherche des mercenaires adverses	
PRESENCE_STATUS_MERCENARIES_TEAM_EDITOR	Compose une équipe de mercenaires	
PRESENCE_STATUS_MERCENARIES_VILLAGE	Passe du temps au village des mercenaires	
PRESENCE_STATUS_MERCENARIES_VILLAGE_BUILDING_MANAGER	Se trouve à l’atelier des mercenaires	
PRESENCE_STATUS_MERCENARIES_VILLAGE_MAILBOX	Consulte la boîte aux lettres des mercenaires	
PRESENCE_STATUS_MERCENARIES_VILLAGE_PVE_BOUNTIES	Consulte le panneau de primes des mercenaires	
PRESENCE_STATUS_MERCENARIES_VILLAGE_PVE_ZONES	Se trouve au point de voyage des mercenaires	
PRESENCE_STATUS_MERCENARIES_VILLAGE_PVP	Se trouve à la fosse de combat de mercenaires	
PRESENCE_STATUS_MERCENARIES_VILLAGE_TASKBOARD	Consulte le panneau des tâches de mercenaire	
PRESENCE_STATUS_PACKOPENING	Ouvre des paquets de cartes !	
PRESENCE_STATUS_PLAY_CASUAL_CLASSIC	Se bat en Partie non classée classique !	
PRESENCE_STATUS_PLAY_CASUAL_STANDARD	Se bat en Partie non classée standard !	
PRESENCE_STATUS_PLAY_CASUAL_WILD	Se bat en Partie non classée libre !	
PRESENCE_STATUS_PLAY_DECKPICKER	Passe en mode traditionnel de Hearthstone	
PRESENCE_STATUS_PLAY_GAME	Joue un match en mode traditionnel de Hearthstone	
PRESENCE_STATUS_PLAY_QUEUE	Cherche un adversaire	
PRESENCE_STATUS_PLAY_RANKED_CLASSIC	Se bat en Partie classée classique !	
PRESENCE_STATUS_PLAY_RANKED_STANDARD	Se bat en Partie classée standard !	
PRESENCE_STATUS_PLAY_RANKED_WILD	Se bat en Partie classée libre !	
PRESENCE_STATUS_PRACTICE_DECKPICKER	En mode Entraînement	
PRESENCE_STATUS_PRACTICE_GAME	S’entraîne contre l’aubergiste	
PRESENCE_STATUS_QUESTLOG	Consulte son journal	
PRESENCE_STATUS_SPECTATING_GAME_ADVENTURE_BRM_CLASS_CHALLENGE	Regarde un défi de Rochenoire	
PRESENCE_STATUS_SPECTATING_GAME_ADVENTURE_BRM_HEROIC	Regarde une héroïque de Rochenoire	
PRESENCE_STATUS_SPECTATING_GAME_ADVENTURE_BRM_NORMAL	Regarde une partie de Rochenoire	
PRESENCE_STATUS_SPECTATING_GAME_ADVENTURE_ICC_NORMAL	Regarde une partie du Trône de glace	
PRESENCE_STATUS_SPECTATING_GAME_ADVENTURE_KAR_CLASS_CHALLENGE	Regarde un défi de Karazhan	
PRESENCE_STATUS_SPECTATING_GAME_ADVENTURE_KAR_HEROIC	Regarde une héroïque de Karazhan	
PRESENCE_STATUS_SPECTATING_GAME_ADVENTURE_KAR_NORMAL	Regarde une partie de Karazhan	
PRESENCE_STATUS_SPECTATING_GAME_ADVENTURE_LOE_CLASS_CHALLENGE	Regarde un défi de la Ligue !	
PRESENCE_STATUS_SPECTATING_GAME_ADVENTURE_LOE_HEROIC	Regarde une héroïque de la Ligue	
PRESENCE_STATUS_SPECTATING_GAME_ADVENTURE_LOE_NORMAL	Regarde une partie de la Ligue !	
PRESENCE_STATUS_SPECTATING_GAME_ADVENTURE_NAXX_CLASS_CHALLENGE	Regarde un défi de Naxxramas	
PRESENCE_STATUS_SPECTATING_GAME_ADVENTURE_NAXX_HEROIC	Regarde une héroïque de Naxxramas	
PRESENCE_STATUS_SPECTATING_GAME_ADVENTURE_NAXX_NORMAL	Regarde une partie de Naxxramas	
PRESENCE_STATUS_SPECTATING_GAME_ARENA	Regarde une partie en Arène	
PRESENCE_STATUS_SPECTATING_GAME_BATTLEGROUNDS	Regarde un champ de bataille	
PRESENCE_STATUS_SPECTATING_GAME_BOH	Observe le Livre des héros	
PRESENCE_STATUS_SPECTATING_GAME_BOM	Observe le Livre des mercenaires	
PRESENCE_STATUS_SPECTATING_GAME_BOT	Joue les partenaires de labo	
PRESENCE_STATUS_SPECTATING_GAME_BTA	Regarde une partie de L’épreuve du gangrefeu	
PRESENCE_STATUS_SPECTATING_GAME_BTA_HEROIC	Regarde un défi de L’épreuve du gangrefeu	
PRESENCE_STATUS_SPECTATING_GAME_BTP	Regarde une partie du prologue	
PRESENCE_STATUS_SPECTATING_GAME_DAL	Espionne un casse à Dalaran	
PRESENCE_STATUS_SPECTATING_GAME_DAL_HEROIC	Espionne un casse à Dalaran	
PRESENCE_STATUS_SPECTATING_GAME_DRG	Regarde une partie dans la Désolation	
PRESENCE_STATUS_SPECTATING_GAME_DRG_HEROIC	Regarde une partie dans la Désolation	
PRESENCE_STATUS_SPECTATING_GAME_DUELS	Regarde une partie du mode Duels	
PRESENCE_STATUS_SPECTATING_GAME_FRIENDLY	Regarde un duel amical	
PRESENCE_STATUS_SPECTATING_GAME_GIL	Regarde une chasse aux monstres	
PRESENCE_STATUS_SPECTATING_GAME_GIL_BONUS_CHALLENGE	Regarde un combat contre Hagatha	
PRESENCE_STATUS_SPECTATING_GAME_LOOT	Regarde une virée en donjon	
PRESENCE_STATUS_SPECTATING_GAME_MERCENARIES	Regarde un match de mercenaires	
PRESENCE_STATUS_SPECTATING_GAME_PLAY	Regarde une partie en mode traditionnel de Hearthstone	
PRESENCE_STATUS_SPECTATING_GAME_PRACTICE	Regarde un entraînement	
PRESENCE_STATUS_SPECTATING_GAME_RETURNING_PLAYER_CHALLENGE	Regarde un ami faire son retour	
PRESENCE_STATUS_SPECTATING_GAME_TAVERN_BRAWL	Regarde un Bras de fer	
PRESENCE_STATUS_SPECTATING_GAME_TRL	Regarde une partie des Jeux	
PRESENCE_STATUS_SPECTATING_GAME_TUTORIAL	Regarde une partie du didacticiel	
PRESENCE_STATUS_SPECTATING_GAME_ULD	Observe les tombes	
PRESENCE_STATUS_SPECTATING_GAME_ULD_HEROIC	Observe les tombes	
PRESENCE_STATUS_STORE	Dans la boutique	
PRESENCE_STATUS_TAVERN_BRAWL_DECKEDITOR	Prépare un deck de Bras de fer	
PRESENCE_STATUS_TAVERN_BRAWL_FRIENDLY_GAME	Bras de fer avec un ami	
PRESENCE_STATUS_TAVERN_BRAWL_FRIENDLY_WAITING	Va faire un Bras de fer avec un ami	
PRESENCE_STATUS_TAVERN_BRAWL_GAME	Fait un Bras de fer	
PRESENCE_STATUS_TAVERN_BRAWL_QUEUE	Cherche un adversaire au Bras de fer	
PRESENCE_STATUS_TAVERN_BRAWL_SCREEN	Va faire un Bras de fer	
PRESENCE_STATUS_TUTORIAL_GAME	Tente de battre {0}	0 = PRESENCE_TUTORIAL_*
PRESENCE_STATUS_TUTORIAL_PREGAME	Lance le jeu pour la 1re fois	
PRESENCE_STATUS_VIEWING_JOURNAL	Consulte le journal	
PRESENCE_STATUS_WAIT_FOR_OPPONENT_RECONNECT	En attente de reconnexion de l’adversaire	
PRESENCE_STATUS_WELCOMEQUESTS	Réfléchit aux nouvelles quêtes !	
PRESENCE_TUTORIAL_CHO	Chroniqueur Cho	
PRESENCE_TUTORIAL_HEMET	Hemet Nesingwary	
PRESENCE_TUTORIAL_HOGGER	Lardeur	
PRESENCE_TUTORIAL_ILLIDAN	Illidan Hurlorage	
PRESENCE_TUTORIAL_MILLHOUSE	Millhouse Tempête-de-Mana	
PRESENCE_TUTORIAL_MUKLA	Roi Mukla	
