TAG	TEXT	COMMENT
GLOBAL_AADC_BUTTON_PRIVACY	隐私	
GLOBAL_AADC_BUTTON_PRIVACYSETTINGS	隐私设置	
GLOBAL_AADC_CHATSETTINGS_DISABLEDESCRIPTION	禁用聊天功能后，你将无法和好友收发消息。	
GLOBAL_AADC_CHATSETTINGS_DISABLEHEADER	关闭聊天消息	
GLOBAL_AADC_CHATSETTINGS_ENABLEDESCRIPTION	开启聊天功能后，你可以和好友收发消息。请注意，不要泄露个人信息。	
GLOBAL_AADC_CHATSETTINGS_ENABLEHEADER	开启聊天消息	
GLOBAL_AADC_CHATSETTINGS_SETTINGSUPDATED	聊天设置已更新	
GLOBAL_AADC_CHATSETTINGS_TITLE	聊天设置	
GLOBAL_AADC_CHATSETTINGS_UPDATINGSETTINGS	正在更新聊天设置	
GLOBAL_AADC_CHATWARNING	请注意，不要在聊天中泄露个人信息。	
GLOBAL_AADC_FRIENDSETTINGS_DISABLEDESCRIPTION	关闭附近的好友功能后，你附近的玩家将无法在好友列表中观看你的游戏活动。	
GLOBAL_AADC_FRIENDSETTINGS_DISABLEHEADER	关闭附近的好友	
GLOBAL_AADC_FRIENDSETTINGS_ENABLEDESCRIPTION	启用附近的好友功能后，你附近的玩家将可以在好友列表中观看你的游戏活动。	
GLOBAL_AADC_FRIENDSETTINGS_ENABLEHEADER	开启附近的好友	
GLOBAL_AADC_FRIENDSETTINGS_SETTINGSUPDATED	附近的好友已更新	
GLOBAL_AADC_FRIENDSETTINGS_TITLE	好友设置	
GLOBAL_AADC_FRIENDSETTINGS_UPDATINGSETTINGS	正在更新附近的好友	
GLOBAL_AADC_LOCATIONSERVICES_DISABLEDESCRIPTION	禁用定位服务后，你将无法举办或参与炉边聚会。	
GLOBAL_AADC_LOCATIONSERVICES_DISABLEHEADER	关闭定位服务	
GLOBAL_AADC_LOCATIONSERVICES_ENABLEDESCRIPTION	启用定位服务后，你可以找到附近的玩家及使用炉边聚会功能。	
GLOBAL_AADC_LOCATIONSERVICES_ENABLEHEADER	开启定位服务	
GLOBAL_AADC_LOCATIONSERVICES_SETTINGSUPDATED	定位设置已更新	
GLOBAL_AADC_LOCATIONSERVICES_TITLE	定位设置	
GLOBAL_AADC_LOCATIONSERVICES_UPDATINGSETTINGS	正在更新定位设置	
GLOBAL_AADC_PARENTALLOCK_DESCRIPTION	更改此选项需要你的父母或监护人在战网上更新你的隐私设置。	
GLOBAL_AADC_PRIVACYSETTINGSMENU_PRIVACYRIGHTS	隐私权利	
GLOBAL_AADC_PRIVACYSETTINGSPOPUP_DEVICE_LOCATIONSETTINGS	启用定位设置	
GLOBAL_AADC_PRIVACYSETTINGSPOPUP_DEVICE_PUSHNOTIFICATIONS	启用推送通知	
GLOBAL_AADC_PRIVACYSETTINGSPOPUP_SECTIONHEADER_DEVICE	设备选项	
GLOBAL_AADC_PRIVACYSETTINGSPOPUP_SECTIONHEADER_SOCIAL	社交选项	
GLOBAL_AADC_PRIVACYSETTINGSPOPUP_SOCIAL_CHATMESSAGES	启用聊天消息	
GLOBAL_AADC_PRIVACYSETTINGSPOPUP_SOCIAL_NEARBYFRIENDS	启用附近的好友	
GLOBAL_AADC_PRIVACYSETTINGSPOPUP_SOCIAL_SPECIALOFFERS	启用个性化商店推荐	
GLOBAL_AADC_PUSHNOTIFICATIONS_DISABLEDESCRIPTION	禁用推送通知后，《炉石传说》不会向你的设备发送通知。	
GLOBAL_AADC_PUSHNOTIFICATIONS_DISABLEHEADER	关闭推送通知	
GLOBAL_AADC_PUSHNOTIFICATIONS_ENABLEDESCRIPTION	启用推送通知后，《炉石传说》会向你的设备发送通知。	
GLOBAL_AADC_PUSHNOTIFICATIONS_ENABLEHEADER	开启推送通知	
GLOBAL_AADC_PUSHNOTIFICATIONS_SETTINGSUPDATED	通知设置已更新	
GLOBAL_AADC_PUSHNOTIFICATIONS_TITLE	通知设置	
GLOBAL_AADC_PUSHNOTIFICATIONS_UPDATINGSETTINGS	正在更新通知设置	
GLOBAL_AADC_SHOPSETTINGS_DISABLEDESCRIPTION	禁用个性化商店推荐后，商店中的商品将不会根据你的游戏情况有所调整。	
GLOBAL_AADC_SHOPSETTINGS_DISABLEHEADER	关闭个性化推荐	
GLOBAL_AADC_SHOPSETTINGS_ENABLEDESCRIPTION	启用个性化商店推荐后，商店中的商品将会根据你的游戏情况有所调整。	
GLOBAL_AADC_SHOPSETTINGS_ENABLEHEADER	开启个性化推荐	
GLOBAL_AADC_SHOPSETTINGS_SETTINGSUPDATED	商店设置已更新	
GLOBAL_AADC_SHOPSETTINGS_TITLE	商店设置	
GLOBAL_AADC_SHOPSETTINGS_UPDATINGSETTINGS	正在更新商店设置	
GLOBAL_AADC_UPDATESETTINGSPOPUP_DESCRIPTION	你的社交和设备选项现已全部启用，包括聊天消息、商店和个性化推荐。	
GLOBAL_AADC_UPDATESETTINGSPOPUP_TITLE	设置已更新	
GLOBAL_ACCOUNT	账号	
GLOBAL_ADDFRIEND_BUTTON	加为好友	
GLOBAL_ADDFRIEND_ERROR_ALREADY_FRIEND	该玩家已经是你的好友了。	
GLOBAL_ADDFRIEND_ERROR_MALFORMED	你必须输入一个邮件地址或者战网昵称。	
GLOBAL_ADDFRIEND_HEADER	添加好友	
GLOBAL_ADDFRIEND_INSTRUCTION	输入战网昵称或邮件地址。	
GLOBAL_ADDFRIEND_SENT_CONFIRMATION	添加好友请求已发送。	
GLOBAL_ADVENTURE_CHOOSE_BUTTON_TEXT	选择	
GLOBAL_ADVENTURE_DESC_HEADER	冒险模式	
GLOBAL_ADVENTURE_TRAY_HEADER	选择一种冒险模式	
GLOBAL_APPROXIMATE_DATETIME	约{0}	0=time string
GLOBAL_APPROXIMATE_DATETIME_RANGE	约{0}-{1}	0=min seconds 1=max seconds string
GLOBAL_ARENA_MEDAL_0	新手钥匙	
GLOBAL_ARENA_MEDAL_1	学徒钥匙	
GLOBAL_ARENA_MEDAL_10	霜脉钥匙	
GLOBAL_ARENA_MEDAL_11	熔火钥匙	
GLOBAL_ARENA_MEDAL_12	光铸钥匙	
GLOBAL_ARENA_MEDAL_2	工匠钥匙	
GLOBAL_ARENA_MEDAL_3	青铜钥匙	
GLOBAL_ARENA_MEDAL_4	白银钥匙	
GLOBAL_ARENA_MEDAL_5	黄金钥匙	
GLOBAL_ARENA_MEDAL_6	白金钥匙	
GLOBAL_ARENA_MEDAL_7	钻石钥匙	
GLOBAL_ARENA_MEDAL_8	勇士钥匙	
GLOBAL_ARENA_MEDAL_9	红玉钥匙	
GLOBAL_ARENA_SEASON_ERROR_NOT_ACTIVE	抱歉，你所指定的竞技模式当前无法使用。请等待几分钟之后再进行尝试。	
GLOBAL_ASSET_DOWNLOAD	下载资料	
GLOBAL_ASSET_DOWNLOAD_ALERT	已禁止在游戏进行时下载资料。	
GLOBAL_ASSET_DOWNLOAD_AWAITING_FETCH	正在检查更新……	
GLOBAL_ASSET_DOWNLOAD_AWAITING_OTHER_DOWNLOAD	等待中	
GLOBAL_ASSET_DOWNLOAD_AWAITING_WIFI	需要WiFi	
GLOBAL_ASSET_DOWNLOAD_BYTE_SYMBOL	B	
GLOBAL_ASSET_DOWNLOAD_CELLULAR_DATA_BODY	用蜂窝数据下载。	
GLOBAL_ASSET_DOWNLOAD_CELLULAR_DATA_HEADER	蜂窝数据	
GLOBAL_ASSET_DOWNLOAD_CELLULAR_POPUP_ADDITIONAL_BODY	未检测到Wi-Fi网络。是否通过蜂窝数据来下载剩余额外的{0}数据？	
GLOBAL_ASSET_DOWNLOAD_CELLULAR_POPUP_HEADER	蜂窝数据	
GLOBAL_ASSET_DOWNLOAD_CELLULAR_POPUP_INITIAL_BODY	未检测到Wi-Fi网络。是否通过蜂窝数据来下载剩余所需的{0}数据？	
GLOBAL_ASSET_DOWNLOAD_COMPLETE	完成	
GLOBAL_ASSET_DOWNLOAD_DETAILS_AUDIO	音频	
GLOBAL_ASSET_DOWNLOAD_DETAILS_HIGHRES	高分辨率纹理	
GLOBAL_ASSET_DOWNLOAD_DISABLED	已关闭	
GLOBAL_ASSET_DOWNLOAD_ENABLE_DOWNLOAD_BODY	允许《炉石传说》下载资料。	
GLOBAL_ASSET_DOWNLOAD_ENABLE_DOWNLOAD_HEADER	开启下载	
GLOBAL_ASSET_DOWNLOAD_ENABLED	已开启	
GLOBAL_ASSET_DOWNLOAD_ERROR_AGENT_IMPEDED	连接速度缓慢	
GLOBAL_ASSET_DOWNLOAD_ERROR_CELLULAR_DISABLED	蜂窝数据已关闭	
GLOBAL_ASSET_DOWNLOAD_ERROR_DOWNLOAD_DISABLED	下载已关闭	
GLOBAL_ASSET_DOWNLOAD_ERROR_OUT_OF_STORAGE	存储空间不足	
GLOBAL_ASSET_DOWNLOAD_GIGABYTE_SYMBOL	GB	
GLOBAL_ASSET_DOWNLOAD_INTENTION_PAUSED	{0} (已暂停)	
GLOBAL_ASSET_DOWNLOAD_IOS_REQ_POPUP_BODY	现在可以下载。是否下载剩余的{0}数据？	
GLOBAL_ASSET_DOWNLOAD_IOS_REQ_POPUP_HEADER	其他数据	
GLOBAL_ASSET_DOWNLOAD_KILOBYTE_SYMBOL	KB	
GLOBAL_ASSET_DOWNLOAD_MEGABYTE_SYMBOL	MB	
GLOBAL_ASSET_DOWNLOAD_PAUSED	已暂停	
GLOBAL_ASSET_DOWNLOAD_SETTINGS	设置	
GLOBAL_ASSET_DOWNLOAD_STATUS	还剩 {0} @ {1}/秒	
GLOBAL_ASSET_DOWNLOAD_STATUS_DECIMAL_FORMAT	{0}.{1} {2}	
GLOBAL_ASSET_DOWNLOAD_STATUS_SHORT	{0} @ {1}/秒	
GLOBAL_ASSET_INTENTION_DONE	完成	
GLOBAL_ASSET_INTENTION_DOWNLOADING_EXPANSION_MUSIC	其余音效（2/3）	
GLOBAL_ASSET_INTENTION_DOWNLOADING_FONTS	字体	
GLOBAL_ASSET_INTENTION_DOWNLOADING_HERO_MUSIC	英雄配乐	
GLOBAL_ASSET_INTENTION_DOWNLOADING_HIGH_RES_PORTRAITS	高分辨率卡牌原画	
GLOBAL_ASSET_INTENTION_DOWNLOADING_LEGEND_STINGERS	其余音效（1/3）	
GLOBAL_ASSET_INTENTION_DOWNLOADING_MINION_PLAY_SOUNDS	随从音效	
GLOBAL_ASSET_INTENTION_DOWNLOADING_MISSION_SOUNDS	冒险模式音效	
GLOBAL_ASSET_INTENTION_DOWNLOADING_OTHER_MINION_SOUNDS	其余音效（3/3）	
GLOBAL_ASSET_INTENTION_DOWNLOADING_PREMIUM_ANIMATIONS	金卡动画	
GLOBAL_ASSET_INTENTION_DOWNLOADING_SPELL_SOUNDS	法术音效	
GLOBAL_ASSET_INTENTION_UNINITIALIZED	开始	
GLOBAL_ATTACK	攻击力	
GLOBAL_BACK	返回	
GLOBAL_BASIC_DECK_NAME	{0}	0=class name
GLOBAL_BATTLEGROUNDS	酒馆战棋	
GLOBAL_BETA_REIMBURSEMENT_DETAILS	这些金币是对你过去消费的补偿。非常感谢！	
GLOBAL_BETA_REIMBURSEMENT_HEADLINE	账号清理补偿	
GLOBAL_BRAWLISEUM	乱斗角斗场	
GLOBAL_BUTTON_AWESOME	太棒了！	
GLOBAL_BUTTON_BUY	购买	
GLOBAL_BUTTON_CLOSE	关闭	
GLOBAL_BUTTON_CONVERT	转换	
GLOBAL_BUTTON_GO	出发	
GLOBAL_BUTTON_INFO_LETTER	i	
GLOBAL_BUTTON_LATER	以后再说	
GLOBAL_BUTTON_NEXT	继续	
GLOBAL_BUTTON_NO	否	
GLOBAL_BUTTON_NOT_NOW	稍后再说	
GLOBAL_BUTTON_OK	确定	
GLOBAL_BUTTON_OR	或	
GLOBAL_BUTTON_OWNED	已拥有	
GLOBAL_BUTTON_YES	是	
GLOBAL_CANCEL	取消	
GLOBAL_CARD_SET_BAR	贫瘠之地的锤炼	
GLOBAL_CARD_SET_BAR_SEARCHABLE_SHORTHAND_NAMES	贫瘠 之地	This is a space-separated list indicating all of the allowable search keywords that can be used in Collection Manager screen's text-search feature to narrow down the cards to this specific Card Set via shorthand names (note: the full name above is also used for this feature). Also note: letter case is ignored.
GLOBAL_CARD_SET_BAR_SHORT	贫瘠之地	
GLOBAL_CARD_SET_BASIC	基本	
GLOBAL_CARD_SET_BOOMSDAY	砰砰计划	
GLOBAL_CARD_SET_BOOMSDAY_SEARCHABLE_SHORTHAND_NAMES	砰砰 计划	This is a space-separated list indicating all of the allowable search keywords that can be used in Collection Manager screen's text-search feature to narrow down the cards to this specific Card Set via shorthand names (note: the full name above is also used for this feature). Also note: letter case is ignored.
GLOBAL_CARD_SET_BOOMSDAY_SHORT	砰砰计划	
GLOBAL_CARD_SET_BRM	黑石山的火焰	
GLOBAL_CARD_SET_BRM_SEARCHABLE_SHORTHAND_NAMES	黑石山	This is a space-separated list indicating all of the allowable search keywords that can be used in Collection Manager screen's text-search feature to narrow down the cards to this specific Card Set via shorthand names (note: the full name above is also used for this feature). Also note: letter case is ignored.
GLOBAL_CARD_SET_BT	外域的灰烬	
GLOBAL_CARD_SET_BT_SEARCHABLE_SHORTHAND_NAMES	外域 灰烬	This is a space-separated list indicating all of the allowable search keywords that can be used in Collection Manager screen's text-search feature to narrow down the cards to this specific Card Set via shorthand names (note: the full name above is also used for this feature). Also note: letter case is ignored.
GLOBAL_CARD_SET_BT_SHORT	外域	
GLOBAL_CARD_SET_CORE	核心	
GLOBAL_CARD_SET_CORE_SEARCHABLE_SHORTHAND_NAMES	核心	This is a space-separated list indicating all of the allowable search keywords that can be used in Collection Manager screen's text-search feature to narrow down the cards to this specific Card Set via shorthand names (note: the full name above is also used for this feature). Also note: letter case is ignored.
GLOBAL_CARD_SET_CORE_SHORT	核心	
GLOBAL_CARD_SET_DALARAN	暗影崛起	
GLOBAL_CARD_SET_DALARAN_SEARCHABLE_SHORTHAND_NAMES	暗影 崛起	This is a space-separated list indicating all of the allowable search keywords that can be used in Collection Manager screen's text-search feature to narrow down the cards to this specific Card Set via shorthand names (note: the full name above is also used for this feature). Also note: letter case is ignored.
GLOBAL_CARD_SET_DALARAN_SHORT	暗影崛起	
GLOBAL_CARD_SET_DEBUG	调试	
GLOBAL_CARD_SET_DED		
GLOBAL_CARD_SET_DED_SEARCHABLE_SHORTHAND_NAMES	死矿	This is a space-separated list indicating all of the allowable search keywords that can be used in Collection Manager screen's text-search feature to narrow down the cards to this specific Card Set via shorthand names (note: the full name above is also used for this feature). Also note: letter case is ignored.
GLOBAL_CARD_SET_DED_SHORT	死亡矿井	
GLOBAL_CARD_SET_DHI	恶魔猎手新兵	
GLOBAL_CARD_SET_DHI_SEARCHABLE_SHORTHAND_NAMES	恶魔猎手 新兵	This is a space-separated list indicating all of the allowable search keywords that can be used in Collection Manager screen's text-search feature to narrow down the cards to this specific Card Set via shorthand names (note: the full name above is also used for this feature). Also note: letter case is ignored.
GLOBAL_CARD_SET_DHI_SHORT	新兵	
GLOBAL_CARD_SET_DMF	疯狂的暗月马戏团	
GLOBAL_CARD_SET_DMF_SEARCHABLE_SHORTHAND_NAMES	dmf	This is a space-separated list indicating all of the allowable search keywords that can be used in Collection Manager screen's text-search feature to narrow down the cards to this specific Card Set via shorthand names (note: the full name above is also used for this feature). Also note: letter case is ignored.
GLOBAL_CARD_SET_DMF_SHORT	暗月马戏团	
GLOBAL_CARD_SET_DRG	巨龙降临	
GLOBAL_CARD_SET_DRG_SEARCHABLE_SHORTHAND_NAMES	巨龙 降临	This is a space-separated list indicating all of the allowable search keywords that can be used in Collection Manager screen's text-search feature to narrow down the cards to this specific Card Set via shorthand names (note: the full name above is also used for this feature). Also note: letter case is ignored.
GLOBAL_CARD_SET_DRG_SHORT	巨龙降临	
GLOBAL_CARD_SET_EXPERT1	经典	
GLOBAL_CARD_SET_GANGS	龙争虎斗加基森	
GLOBAL_CARD_SET_GANGS_RESERVE	加基森保留	
GLOBAL_CARD_SET_GANGS_SEARCHABLE_SHORTHAND_NAMES	龙争虎斗 加基森	This is a space-separated list indicating all of the allowable search keywords that can be used in Collection Manager screen's text-search feature to narrow down the cards to this specific Card Set via shorthand names (note: the full name above is also used for this feature). Also note: letter case is ignored.
GLOBAL_CARD_SET_GANGS_SHORT	加基森	
GLOBAL_CARD_SET_GILNEAS	女巫森林	
GLOBAL_CARD_SET_GILNEAS_SEARCHABLE_SHORTHAND_NAMES	女巫 森林	This is a space-separated list indicating all of the allowable search keywords that can be used in Collection Manager screen's text-search feature to narrow down the cards to this specific Card Set via shorthand names (note: the full name above is also used for this feature). Also note: letter case is ignored.
GLOBAL_CARD_SET_GILNEAS_SHORT	女巫森林	
GLOBAL_CARD_SET_GVG	地精大战侏儒	
GLOBAL_CARD_SET_GVG_SEARCHABLE_SHORTHAND_NAMES	地精 大战 侏儒	This is a space-separated list indicating all of the allowable search keywords that can be used in Collection Manager screen's text-search feature to narrow down the cards to this specific Card Set via shorthand names (note: the full name above is also used for this feature). Also note: letter case is ignored.
GLOBAL_CARD_SET_HOF	荣誉室	
GLOBAL_CARD_SET_ICECROWN	冰封王座的骑士	
GLOBAL_CARD_SET_ICECROWN_SHORT	冰封王座	
GLOBAL_CARD_SET_KARA	卡拉赞之夜	
GLOBAL_CARD_SET_KARA_RESERVE	卡拉赞保留	
GLOBAL_CARD_SET_KARA_SHORT	卡拉赞	
GLOBAL_CARD_SET_LEGACY	怀旧	
GLOBAL_CARD_SET_LEGACY_SEARCHABLE_SHORTHAND_NAMES	lgcy	This is a space-separated list indicating all of the allowable search keywords that can be used in Collection Manager screen's text-search feature to narrow down the cards to this specific Card Set via shorthand names (note: the full name above is also used for this feature). Also note: letter case is ignored.
GLOBAL_CARD_SET_LEGACY_SHORT	怀旧	
GLOBAL_CARD_SET_LOE	探险者协会	
GLOBAL_CARD_SET_LOE_SEARCHABLE_SHORTHAND_NAMES	探险者 协会	This is a space-separated list indicating all of the allowable search keywords that can be used in Collection Manager screen's text-search feature to narrow down the cards to this specific Card Set via shorthand names (note: the full name above is also used for this feature). Also note: letter case is ignored.
GLOBAL_CARD_SET_LOE_SHORT	探险者协会	
GLOBAL_CARD_SET_LOOTAPALOOZA	狗头人与地下世界	
GLOBAL_CARD_SET_LOOTAPALOOZA_SEARCHABLE_SHORTHAND_NAMES	狗头人 地下世界	This is a space-separated list indicating all of the allowable search keywords that can be used in Collection Manager screen's text-search feature to narrow down the cards to this specific Card Set via shorthand names (note: the full name above is also used for this feature). Also note: letter case is ignored.
GLOBAL_CARD_SET_LOOTAPALOOZA_SHORT	狗头人	
GLOBAL_CARD_SET_NAXX	纳克萨玛斯	
GLOBAL_CARD_SET_NAXX_SEARCHABLE_SHORTHAND_NAMES	纳克萨玛斯 诅咒	This is a space-separated list indicating all of the allowable search keywords that can be used in Collection Manager screen's text-search feature to narrow down the cards to this specific Card Set via shorthand names (note: the full name above is also used for this feature). Also note: letter case is ignored.
GLOBAL_CARD_SET_OG	上古之神的低语	
GLOBAL_CARD_SET_OG_RESERVE	上古之神保留	
GLOBAL_CARD_SET_OG_SEARCHABLE_SHORTHAND_NAMES	上古之神 低语	This is a space-separated list indicating all of the allowable search keywords that can be used in Collection Manager screen's text-search feature to narrow down the cards to this specific Card Set via shorthand names (note: the full name above is also used for this feature). Also note: letter case is ignored.  For Whispers of the Old Gods, 'tog' should be available in all locales; wotog and wog are additional English shorthands, which should be replaced by locale specific variants.
GLOBAL_CARD_SET_OG_SHORT	上古之神	
GLOBAL_CARD_SET_PROMO	纪念	
GLOBAL_CARD_SET_SCH	通灵学园	
GLOBAL_CARD_SET_SCH_SEARCHABLE_SHORTHAND_NAMES	通灵 学园	This is a space-separated list indicating all of the allowable search keywords that can be used in Collection Manager screen's text-search feature to narrow down the cards to this specific Card Set via shorthand names (note: the full name above is also used for this feature). Also note: letter case is ignored.
GLOBAL_CARD_SET_SCH_SHORT	通灵学园	
GLOBAL_CARD_SET_SW	暴风城下的集结	
GLOBAL_CARD_SET_SW_SEARCHABLE_SHORTHAND_NAMES	暴风城	uis
GLOBAL_CARD_SET_SW_SHORT	暴风城	
GLOBAL_CARD_SET_TGT	冠军的试炼	
GLOBAL_CARD_SET_TGT_SEARCHABLE_SHORTHAND_NAMES	冠军 试炼	This is a space-separated list indicating all of the allowable search keywords that can be used in Collection Manager screen's text-search feature to narrow down the cards to this specific Card Set via shorthand names (note: the full name above is also used for this feature). Also note: letter case is ignored.
GLOBAL_CARD_SET_TGT_SHORT	冠军的试炼	
GLOBAL_CARD_SET_TROLL	拉斯塔哈的大乱斗	
GLOBAL_CARD_SET_TROLL_SEARCHABLE_SHORTHAND_NAMES	拉斯塔哈 大乱斗	This is a space-separated list indicating all of the allowable search keywords that can be used in Collection Manager screen's text-search feature to narrow down the cards to this specific Card Set via shorthand names (note: the full name above is also used for this feature). Also note: letter case is ignored.
GLOBAL_CARD_SET_TROLL_SHORT	大乱斗	
GLOBAL_CARD_SET_ULDUM	奥丹姆奇兵	
GLOBAL_CARD_SET_ULDUM_SEARCHABLE_SHORTHAND_NAMES	奥丹姆 奇兵	This is a space-separated list indicating all of the allowable search keywords that can be used in Collection Manager screen's text-search feature to narrow down the cards to this specific Card Set via shorthand names (note: the full name above is also used for this feature). Also note: letter case is ignored.
GLOBAL_CARD_SET_ULDUM_SHORT	奥丹姆	
GLOBAL_CARD_SET_UNGORO	勇闯安戈洛	
GLOBAL_CARD_SET_UNGORO_SHORT	安戈洛	
GLOBAL_CARD_SET_VANILLA	经典	
GLOBAL_CARD_SET_VANILLA_FORMAT_SEARCHABLE_SHORTHAND_NAMES	经典模式	This is a space-separated list indicating all of the allowable search keywords that can be used in Collection Manager screen's text-search feature to narrow down the cards to this specific Card Set via shorthand names (note: the full name above is also used for this feature). Also note: letter case is ignored.
GLOBAL_CARD_SET_VANILLA_FORMAT_SHORT	经典	
GLOBAL_CARD_SET_WC	哀嚎洞穴	
GLOBAL_CARD_SET_WC_SEARCHABLE_SHORTHAND_NAMES	wc	This is a space-separated list indicating all of the allowable search keywords that can be used in Collection Manager screen's text-search feature to narrow down the cards to this specific Card Set via shorthand names (note: the full name above is also used for this feature). Also note: letter case is ignored.
GLOBAL_CARD_SET_WC_SHORT	哀嚎洞穴	
GLOBAL_CARD_SET_WILD_EVENT	狂野模式活动	
GLOBAL_CARD_SET_WILD_EVENT_SHORT	狂野模式活动	
GLOBAL_CARD_SET_YOD	迦拉克隆的觉醒	
GLOBAL_CARD_SET_YOD_SHORT	迦拉克隆的觉醒	
GLOBAL_CARDTYPE_ENCHANTMENT	强化	
GLOBAL_CARDTYPE_HERO	英雄	
GLOBAL_CARDTYPE_HEROPOWER	英雄技能	
GLOBAL_CARDTYPE_ITEM	物品	
GLOBAL_CARDTYPE_MINION	随从	
GLOBAL_CARDTYPE_SPELL	法术	
GLOBAL_CARDTYPE_TOKEN	替代物	
GLOBAL_CARDTYPE_WEAPON	武器	
GLOBAL_CHAT_BUBBLE_RECEIVER_NAME	发送给：{0}	0=player name
GLOBAL_CHAT_CHALLENGE	挑战	
GLOBAL_CHAT_NO_FRIENDS_ONLINE	现在你没有任何好友在线。	
GLOBAL_CHAT_NO_RECENT_CONVERSATIONS	在好友列表中和好友进行交谈。	
GLOBAL_CHAT_RECEIVER_OFFLINE	{0}下线了。	0=player name
GLOBAL_CHAT_RECEIVER_ONLINE	{0}上线了。	0=player name
GLOBAL_CHAT_SENDER_APPEAR_OFFLINE	当处于隐身状态时，你无法发送聊天消息。	
GLOBAL_CHAT_SENDER_OFFLINE	当前处于离线状态。	
GLOBAL_CHOOSE_PAYMENT	选择支付方式	
GLOBAL_CLASS_DEATHKNIGHT	死亡骑士	
GLOBAL_CLASS_DEMONHUNTER	恶魔猎手	
GLOBAL_CLASS_DRUID	德鲁伊	
GLOBAL_CLASS_HUNTER	猎人	
GLOBAL_CLASS_MAGE	法师	
GLOBAL_CLASS_NEUTRAL	中立	
GLOBAL_CLASS_PALADIN	圣骑士	
GLOBAL_CLASS_PRIEST	牧师	
GLOBAL_CLASS_ROGUE	潜行者	
GLOBAL_CLASS_SHAMAN	萨满祭司	
GLOBAL_CLASS_WARLOCK	术士	
GLOBAL_CLASS_WARRIOR	战士	
GLOBAL_CLASSIC	经典模式	
GLOBAL_CLICK_TO_CONTINUE	点击继续	
GLOBAL_CLICK_TO_CONTINUE_TOUCH	点击继续	
GLOBAL_COLLECTION_GOLDEN	金色	
GLOBAL_COMMA_SEPARATOR	，	
GLOBAL_CONCEDE	认输	
GLOBAL_CONFIRM	确认	
GLOBAL_CONTINUE	继续	
GLOBAL_COST	消耗	
GLOBAL_CREATE	制作	
GLOBAL_CURRENT_DATE	{0:yyyy/MM/dd}	see http://msdn.microsoft.com/en-us/library/8kb3ddd4.aspx
GLOBAL_CURRENT_TIME	{0:HH:mm}	see http://msdn.microsoft.com/en-us/library/8kb3ddd4.aspx
GLOBAL_CURRENT_TIME_AM	上午	
GLOBAL_CURRENT_TIME_AND_DATE_DEV	{0} ({1} - {2})	
GLOBAL_CURRENT_TIME_PM	下午	
GLOBAL_DATETIME_AFK_DAY	离开超过一天	
GLOBAL_DATETIME_AFK_DAYS	离开{0}天	
GLOBAL_DATETIME_AFK_HOURS	离开{0}小时	
GLOBAL_DATETIME_AFK_MINUTES	离开{0}分钟	
GLOBAL_DATETIME_AFK_MONTH	离开多于一个月	
GLOBAL_DATETIME_AFK_SECONDS	离开少于一分钟	
GLOBAL_DATETIME_AFK_WEEKS	离开{0}周	
GLOBAL_DATETIME_COMING_SOON	敬请期待	
GLOBAL_DATETIME_COMING_SOON_DAYS	将在{0}天后开放	
GLOBAL_DATETIME_COMING_SOON_HOURS	将在{0}小时后开放	
GLOBAL_DATETIME_COMING_SOON_MINUTES	将在一小时内开放	
GLOBAL_DATETIME_COMING_SOON_WEEKS	{0}周后开启	
GLOBAL_DATETIME_FRIENDREQUEST_DAY	昨天	
GLOBAL_DATETIME_FRIENDREQUEST_DAYS	{0}天以前	
GLOBAL_DATETIME_FRIENDREQUEST_HOURS	{0}小时以前	
GLOBAL_DATETIME_FRIENDREQUEST_MINUTES	{0}分钟以前	
GLOBAL_DATETIME_FRIENDREQUEST_MONTH	一个多月以前	
GLOBAL_DATETIME_FRIENDREQUEST_SECONDS	小于一分钟以前	
GLOBAL_DATETIME_FRIENDREQUEST_WEEKS	{0}周前	
GLOBAL_DATETIME_GREATER_THAN_X_MINUTES	> {0}分钟	
GLOBAL_DATETIME_LASTONLINE_DAY	上次在线：昨天	
GLOBAL_DATETIME_LASTONLINE_DAYS	上次在线：{0}天以前	
GLOBAL_DATETIME_LASTONLINE_HOURS	上次在线：{0}小时以前	
GLOBAL_DATETIME_LASTONLINE_MINUTES	上次在线：{0}分钟以前	
GLOBAL_DATETIME_LASTONLINE_MONTH	上次在线：一个多月以前	
GLOBAL_DATETIME_LASTONLINE_SECONDS	上次在线：小于一分钟以前	
GLOBAL_DATETIME_LASTONLINE_WEEKS	上次在线：{0}周前	
GLOBAL_DATETIME_SPINNER_DAY	>1天	
GLOBAL_DATETIME_SPINNER_DAYS	{0}天	
GLOBAL_DATETIME_SPINNER_HOURS	{0}小时	
GLOBAL_DATETIME_SPINNER_MINUTES	{0}分钟	
GLOBAL_DATETIME_SPINNER_MONTH	>1个月	
GLOBAL_DATETIME_SPINNER_SECONDS	{0}秒 	
GLOBAL_DATETIME_SPINNER_WEEKS	{0}周	
GLOBAL_DATETIME_SPLASHSCREEN_DAY	>1天	
GLOBAL_DATETIME_SPLASHSCREEN_DAYS	{0}天	
GLOBAL_DATETIME_SPLASHSCREEN_HOURS	{0}小时	
GLOBAL_DATETIME_SPLASHSCREEN_MINUTES	{0}分钟	
GLOBAL_DATETIME_SPLASHSCREEN_MONTH	>1个月	
GLOBAL_DATETIME_SPLASHSCREEN_SECONDS	<1分钟	
GLOBAL_DATETIME_SPLASHSCREEN_WEEKS	{0}周	
GLOBAL_DATETIME_UNLOCKS_SOON_WEEKS	{0}周后解锁	
GLOBAL_DECK_SHARE_ACCEPT_REQUEST	分享	
GLOBAL_DECK_SHARE_DECLINE_REQUEST	拒绝	
GLOBAL_DECK_SHARE_ERROR	分享套牌时发生错误。	
GLOBAL_DECK_SHARE_HEADER	分享套牌？	
GLOBAL_DECK_SHARE_REQUEST_CANCELED	{0}取消了邀你分享套牌的请求。	0=friend name
GLOBAL_DECK_SHARE_REQUEST_DECLINED	{0}拒绝了与你分享套牌的请求。	0=friend name
GLOBAL_DECK_SHARE_REQUEST_WAITING_RESPONSE	等待{0}回应你分享套牌的请求。	
GLOBAL_DECK_SHARE_REQUESTED	{0}想要借用你的一副套牌。	0=friend name
GLOBAL_DEFAULT_ALERT_HEADER	警告	
GLOBAL_DEMO_COMPLETE_BODY	感谢你尝试《炉石传说》的演示版游戏！	
GLOBAL_DEMO_COMPLETE_HEADER	祝贺你！	
GLOBAL_DEMO_DISCLAIMER	该版本的《炉石传说》仅用于部分游戏内容展示。	
GLOBAL_DEMO_LEARN_MORE	了解更多	
GLOBAL_DISABLE	禁用	
GLOBAL_DONE	完成	
GLOBAL_ENABLE	启用	
GLOBAL_END_GAME	结束游戏	
GLOBAL_ENTER	确认	
GLOBAL_ERROR	发生错误	
GLOBAL_ERROR_ACCOUNT_LICENSES	在读取你的账号内容时出现了一些错误，有些内容可能无法正确显示。对此我们深表歉意！在你下次登录游戏的时候，我们会再次尝试读取这些内容。	
GLOBAL_ERROR_ASSET_CREATE_PERSISTENT_DATA_PATH	无法在{0}创建数据储存文件夹。	0=folder path
GLOBAL_ERROR_ASSET_DOWNLOAD_FAILED	下载数组{0}失败。	0=asset name
GLOBAL_ERROR_ASSET_INCORRECT_DATA	数组{0}包含错误数据。	0=asset name
GLOBAL_ERROR_ASSET_LOAD_FAILED	载入数据{0}失败。	0=asset name
GLOBAL_ERROR_ASSET_MANIFEST	载入清单数据失败	
GLOBAL_ERROR_ASSET_NO_FILE_PATH	无法为数组{0}找到文件路径。	0=asset name
GLOBAL_ERROR_CURRENCY_INVALID	用户试图使用无效的货币进行购买。	
GLOBAL_ERROR_FIND_GAME_SCENARIO_INCORRECT_NUM_PLAYERS	开始游戏时发生错误。该模式玩家数量过多。	
GLOBAL_ERROR_FIND_GAME_SCENARIO_MISCONFIGURED	开始游戏时发生错误。该模式数据配置有误。	
GLOBAL_ERROR_FIND_GAME_SCENARIO_NO_DECK_SPECIFIED	开始游戏时发生错误。有玩家未指定套牌。	
GLOBAL_ERROR_GAME_DENIED	开始游戏时发生了错误。请等待几分钟然后再试。	
GLOBAL_ERROR_GAME_OPPONENT_TIMEOUT	由于你的对手无法连接，游戏无法继续。请再试一次。	
GLOBAL_ERROR_GENERIC_HEADER	发生错误	
GLOBAL_ERROR_INACTIVITY_KICK	距离你的上一次操作已经过了很长时间，游戏连接中断。请在你做好准备后重新运行游戏！	
GLOBAL_ERROR_NETWORK_ACCOUNT_BANNED	你的账号已被永封。请前往https://security.blizzard.cn/usercenter来了解详细情况。	
GLOBAL_ERROR_NETWORK_ACCOUNT_CURFEW_REACHED	[防沉迷]根据国家相关法律法规，晚22：00至次日早8：00期间，未成年玩家不能登录游戏。	
GLOBAL_ERROR_NETWORK_ACCOUNT_INVALID_NID	抱歉，在通过实名认证前你无法继续。请参考https://www.battlenet.com.cn/support/zh/article/210633页面以了解详情。	
GLOBAL_ERROR_NETWORK_ACCOUNT_PLAYTIME_EXCEEDED	[防沉迷]根据国家相关法律法规，未成年玩家每天在线时长不得超过1.5小时。今天你的在线时长已达上限，请合理安排游戏时间。	
GLOBAL_ERROR_NETWORK_ACCOUNT_SUSPENDED	你的账号已被暂封。请前往https://security.blizzard.cn/usercenter来了解详细情况。	
GLOBAL_ERROR_NETWORK_ADMIN_KICKED	你已被暴雪战网服务移除。请重新启动《炉石传说》，尝试重新连接服务器。	
GLOBAL_ERROR_NETWORK_ADVENTURE_RECONNECT_TIMEOUT	你的游戏已保存。重新启动《炉石传说》以继续游戏。	
GLOBAL_ERROR_NETWORK_CONNECTION_TIMEOUT	你的连接已超时。请检查网络连接。	
GLOBAL_ERROR_NETWORK_DISCONNECT	你与暴雪战网服务断开连接。请重新启动《炉石传说》，尝试重新连接服务器。	
GLOBAL_ERROR_NETWORK_DISCONNECT_GAME_SERVER	你与《炉石传说》游戏服务断开连接。	
GLOBAL_ERROR_NETWORK_DISCONNECT_GENERIC	你已经断开连接。	
GLOBAL_ERROR_NETWORK_DUPLICATE_LOGIN	该暴雪战网通行证已经在另一个设备上登录了《炉石传说》。\n\n该客户端将会断开连接，因为在同一时间只能支持一个连接。	
GLOBAL_ERROR_NETWORK_GENERIC	发生一个内部网络错误。	
GLOBAL_ERROR_NETWORK_INCORRECT_REGION	你的暴雪战网通行证无法参与本地区的《炉石传说》测试。请在《炉石传说》在该地区开始测试之后，再试一次！	
GLOBAL_ERROR_NETWORK_LOGIN_FAILURE	无法通过暴雪战网服务进行登录。请等待几分钟并再次尝试。	
GLOBAL_ERROR_NETWORK_LOST_GAME_CONNECTION	你的游戏与暴雪战网服务断开连接。你可以尝试再次启动游戏来重新连接。	
GLOBAL_ERROR_NETWORK_NO_CONNECTION	无法连接。请检查网络连接。	
GLOBAL_ERROR_NETWORK_NO_GAME_SERVER	抱歉，我们无法为你启动游戏！请再试一次。	
GLOBAL_ERROR_NETWORK_PARENTAL_CONTROLS	由于家长监护系统的限制，该账号目前无法使用。	
GLOBAL_ERROR_NETWORK_PHONE_LOCK	请拨打您的暴雪战网手机安全锁号码来允许此次登录。\n台湾： 0800-303-585\n香港： 396-54666	
GLOBAL_ERROR_NETWORK_RISK_ACCOUNT_LOCKED	你的账号已被锁定。请前往https://security.blizzard.cn/usercenter来了解详细情况。	
GLOBAL_ERROR_NETWORK_SPAM	由于你在短时间内发送请求过多，你与暴雪战网服务断开了连接。请重新启动《炉石传说》，尝试重新连接服务器。	
GLOBAL_ERROR_NETWORK_TITLE	网络错误	
GLOBAL_ERROR_NETWORK_UNAVAILABLE_NEW_VERSION	你的账号正在使用较新版本的客户端。请在更新完成前稍等片刻再行游戏。	
GLOBAL_ERROR_NETWORK_UNAVAILABLE_OFFLINE	《炉石传说》现在处于离线状态。请等待几分钟后再次尝试。	
GLOBAL_ERROR_NETWORK_UNAVAILABLE_UNKNOWN	哎哟！调皮的小精灵干扰了《炉石传说》与服务器的连接。请稍等片刻，在它们消散之后再次尝试。	
GLOBAL_ERROR_NETWORK_UNAVAILABLE_UPGRADE	《炉石传说》已更新，请下载最新版本。	
GLOBAL_ERROR_NETWORK_UTIL_TIMEOUT	你的游戏向《炉石传说》设备服务发送的请求已超时。请重新启动《炉石传说》，尝试重新连接。	
GLOBAL_ERROR_NO_MAGE_PRECON	在读取你的卡牌收藏时遇到了一些网络问题。请重新运行《炉石传说》来查看你的收藏，并继续对战！	
GLOBAL_ERROR_STREAMING_ASSET_TIMEOUT	等待流媒体系统超时，正在载入数组{0}。	0=asset name
GLOBAL_ERROR_UNKNOWN_ERROR	哎哟！调皮的小精灵干扰了《炉石传说》与暴雪战网服务的连接。请稍等片刻，在它们消散之后再次启动游戏。	
GLOBAL_EXIT	离开	
GLOBAL_FEATURE_DISABLED_MESSAGE_BATTLEGROUNDS	抱歉，酒馆战棋已被暂时禁用。	
GLOBAL_FEATURE_DISABLED_MESSAGE_COLLECTION	抱歉，收藏功能已被暂时禁用。	
GLOBAL_FEATURE_DISABLED_MESSAGE_FORGE	抱歉，竞技模式已被暂时禁用。	
GLOBAL_FEATURE_DISABLED_MESSAGE_PLAY	抱歉，对战模式已被暂时禁用。	
GLOBAL_FEATURE_DISABLED_MESSAGE_PRACTICE	抱歉，练习模式已被暂时禁用。	
GLOBAL_FEATURE_DISABLED_TITLE	禁用	
GLOBAL_FINISH	完成	
GLOBAL_FIRESIDE_BRAWL	炉边乱斗	
GLOBAL_FIRESIDE_GATHERING	炉边聚会	
GLOBAL_FIRESIDE_GATHERING_CHOOSE_HEADER	选择一个选项	
GLOBAL_FIRESIDE_GATHERING_DEFAULT_TAVERN_NAME	炉边聚会	
GLOBAL_FIRESIDE_GATHERING_FIRST_TIME_TAVERN_NAME	{0}的酒馆	0=innkeeper battle tag
GLOBAL_FIRESIDE_GATHERING_PATRON_LIST_FOOTER_TEXT_LARGE_SCALE	参加本次炉边聚会的玩家总数：{0}+	This is shown on the Friends List button whenever player is checked into a large scale Fireside Gathering (one that doesn't show the full patron list). the design decision was to show 99+ regardless of how many people are actually checked in.
GLOBAL_FIRESIDE_GATHERING_PATRON_LIST_FOOTER_TEXT_SOFT_LIMIT	参加本次炉边聚会的玩家总数：{0}	0=The number of patrons up to 99.
GLOBAL_FIRESIDE_GATHERING_REUNPACK	更新设置	
GLOBAL_FIRESIDE_GATHERING_SOCIAL_BUTTON_LARGE_SCALE_LABEL	<size=32>99<size=26>+</size></size>	This is shown on the Friends List button whenever player is checked into a large scale Fireside Gathering (one that doesn't show the full patron list). the design decision was to show 99+ regardless of how many people are actually checked in. NOTE: the size tag was used in enUS to shrink the + sign, to make sure 99+ fit into the small button.
GLOBAL_FORGE_END_DONE	完成	
GLOBAL_FORGE_END_JOKE_0	这可真带劲儿！	
GLOBAL_FORGE_END_JOKE_1	我无话可说！	
GLOBAL_FORGE_END_JOKE_2	我不信！	
GLOBAL_FORGE_END_JOKE_3	你可真有两下子。	
GLOBAL_FORGE_END_JOKE_4	你敢再试试吗？	
GLOBAL_FORGE_END_JOKE_5	值得庆祝！	
GLOBAL_FORGE_END_JOKE_6	那个回合太精彩了！	
GLOBAL_FORGE_END_JOKE_7	看好了！	
GLOBAL_FORGE_END_JOKE_8	这还没结束！哦，等等。好吧，结束了。	
GLOBAL_FORGE_END_TITLE	完成竞技模式比赛	
GLOBAL_FRIEND_CHALLENGE_ACCEPT	接受	
GLOBAL_FRIEND_CHALLENGE_BODY_BACON	在一场战棋派对中，向你发起邀请的是：	
GLOBAL_FRIEND_CHALLENGE_BODY1	以下好友向你发起了挑战：	
GLOBAL_FRIEND_CHALLENGE_BODY1_STANDARD	在一场标准游戏中，向你发起挑战的是：	
GLOBAL_FRIEND_CHALLENGE_BODY1_WILD	在一场狂野游戏中，向你发起挑战的是：	
GLOBAL_FRIEND_CHALLENGE_BODY2	是否接受挑战？	
GLOBAL_FRIEND_CHALLENGE_DECLINE	拒绝	
GLOBAL_FRIEND_CHALLENGE_FIRESIDE_BRAWL_BODY1	有人邀请你进行炉边乱斗：	
GLOBAL_FRIEND_CHALLENGE_HEADER	发起挑战	
GLOBAL_FRIEND_CHALLENGE_NEARBY_PLAYER_NOTE	你可以在好友列表中屏蔽来自周围玩家的邀请。	
GLOBAL_FRIEND_CHALLENGE_OPPONENT_CANCELED	{0}取消了挑战。	0=friend name
GLOBAL_FRIEND_CHALLENGE_OPPONENT_DECLINED	{0}拒绝了你的挑战。	0=friend name
GLOBAL_FRIEND_CHALLENGE_OPPONENT_FRIEND_REMOVED	由于{0}不再是你的好友，挑战被取消。	0=friend name
GLOBAL_FRIEND_CHALLENGE_OPPONENT_WAITING_DECK	你正在等待{0}选择套牌。	0=friend name
GLOBAL_FRIEND_CHALLENGE_OPPONENT_WAITING_RESPONSE	你正在等待{0}响应你的挑战。	0=friend name
GLOBAL_FRIEND_CHALLENGE_QUEUE_CANCELED	挑战已取消。	
GLOBAL_FRIEND_CHALLENGE_TAVERN_BRAWL_BODY1	在一场旅店乱斗中，向你发起挑战的是：	
GLOBAL_FRIEND_CHALLENGE_TAVERN_BRAWL_HEADER	乱斗挑战	
GLOBAL_FRIEND_CHALLENGE_TAVERN_BRAWL_OPPONENT_WAITING_READY	你正在等待{0}加入乱斗模式。	0=friend name
GLOBAL_FRIEND_CHALLENGE_TAVERN_BRAWL_RECIPIENT_NO_VALID_DECK_RECIPIENT	{0}想要和你进行一场乱斗模式较量！在乱斗模式中构筑一副套牌来接受挑战。	
GLOBAL_FRIEND_CHALLENGE_TAVERN_BRAWL_RECIPIENT_NO_VALID_DECK_SENDER	你的好友还没有构筑好乱斗模式套牌。请在其套牌构筑完毕后再次尝试。	
GLOBAL_FRIEND_CHALLENGE_TAVERN_BRAWL_RECIPIENT_NOT_UNLOCKED_SENDER	你的好友还没有解锁乱斗模式。请在其解锁后再次尝试。	
GLOBAL_FRIEND_CHALLENGE_TITLE	友谊赛	
GLOBAL_FRIENDLIST_ADD_FRIEND_BUTTON	添加	
GLOBAL_FRIENDLIST_BATTLEGROUNDS_TOOLTIP_INVITE_BODY	邀请{0}和你一同进行酒馆战棋。	0=player name
GLOBAL_FRIENDLIST_BATTLEGROUNDS_TOOLTIP_INVITE_HEADER	邀请	
GLOBAL_FRIENDLIST_BATTLEGROUNDS_TOOLTIP_KICK_BODY	将{0}移出你的战棋派对。	0=player name
GLOBAL_FRIENDLIST_BATTLEGROUNDS_TOOLTIP_KICK_HEADER	移除	
GLOBAL_FRIENDLIST_BUSYSTATUS	忙碌	
GLOBAL_FRIENDLIST_CHALLENGE_BUTTON_AVAILABLE	挑战{0}，进行一场《炉石传说》对战。	0=player name
GLOBAL_FRIENDLIST_CHALLENGE_BUTTON_BATTLEGROUNDS_LOCKED	完成酒馆战棋教学后解锁。	
GLOBAL_FRIENDLIST_CHALLENGE_BUTTON_BATTLEGROUNDS_PARTY_MEMBER	你无法在战棋派对中发起挑战。	
GLOBAL_FRIENDLIST_CHALLENGE_BUTTON_EARLY_ACCESS	该模式目前需要抢先体验权限。	
GLOBAL_FRIENDLIST_CHALLENGE_BUTTON_HEADER	好友挑战	
GLOBAL_FRIENDLIST_CHALLENGE_BUTTON_IM_APPEARING_OFFLINE	你现在无法挑战{0}。当前处于隐身状态。	0=player name
GLOBAL_FRIENDLIST_CHALLENGE_BUTTON_IM_UNAVAILABLE	你现在无法挑战{0}。请返回主菜单。	0=player name
GLOBAL_FRIENDLIST_CHALLENGE_BUTTON_MODE_UNAVAILABLE	目前无法在此模式中挑战好友。	
GLOBAL_FRIENDLIST_CHALLENGE_BUTTON_TAVERN_BRAWL_LOCKED	完成传统对战教学，并且有一个职业达到20级后解锁。	
GLOBAL_FRIENDLIST_CHALLENGE_BUTTON_THEYRE_UNAVAILABLE	你现在无法挑战{0}。请等待他们返回主菜单。	0=player name
GLOBAL_FRIENDLIST_CHALLENGE_BUTTON_TRADITIONAL_LOCKED	完成传统对战教学后解锁。	
GLOBAL_FRIENDLIST_CHALLENGE_CHALLENGEE_NO_BATTLEGROUNDS_EARLY_ACCESS	该玩家没有酒馆战棋抢先体验权限。	
GLOBAL_FRIENDLIST_CHALLENGE_CHALLENGEE_NO_CLASSIC_DECK	该玩家没有经典套牌。	
GLOBAL_FRIENDLIST_CHALLENGE_CHALLENGEE_NO_DECK	该玩家没有套牌。	
GLOBAL_FRIENDLIST_CHALLENGE_CHALLENGEE_NO_STANDARD_DECK	该玩家没有标准套牌。	
GLOBAL_FRIENDLIST_CHALLENGE_CHALLENGEE_NO_TAVERN_BRAWL_DECK	该玩家尚未组建一副应用于乱斗模式的套牌。	
GLOBAL_FRIENDLIST_CHALLENGE_CHALLENGEE_NOT_SEEN_WILD	该玩家尚未解锁狂野模式。	
GLOBAL_FRIENDLIST_CHALLENGE_CHALLENGEE_TAVERN_BRAWL_LOCKED	该玩家尚未解锁乱斗模式。	
GLOBAL_FRIENDLIST_CHALLENGE_CHALLENGEE_USER_IS_BUSY	该玩家目前忙碌中。	
GLOBAL_FRIENDLIST_CHALLENGE_CHALLENGER_NO_CLASSIC_DECK	你没有任何经典套牌。	
GLOBAL_FRIENDLIST_CHALLENGE_CHALLENGER_NO_DECK	你需要先组建一副套牌。	
GLOBAL_FRIENDLIST_CHALLENGE_CHALLENGER_NO_STANDARD_DECK	你没有任何标准套牌。	
GLOBAL_FRIENDLIST_CHALLENGE_CHALLENGER_NO_TAVERN_BRAWL_DECK	你需要先为本周的乱斗模式组建一副套牌。	
GLOBAL_FRIENDLIST_CHALLENGE_CHALLENGER_TAVERN_BRAWL_LOCKED	使用任意职业达到20级，即可解锁乱斗模式。	
GLOBAL_FRIENDLIST_CHALLENGE_MENU_CLASSIC_DUEL_BUTTON	经典模式	
GLOBAL_FRIENDLIST_CHALLENGE_MENU_DUEL_BUTTON	对决	
GLOBAL_FRIENDLIST_CHALLENGE_MENU_STANDARD_DUEL_BUTTON	标准模式	
GLOBAL_FRIENDLIST_CHALLENGE_MENU_WILD_DUEL_BUTTON	狂野模式	
GLOBAL_FRIENDLIST_CHALLENGE_TOOLTIP_NO_TAVERN_BRAWL	乱斗模式当前无法使用。请稍后再试！	
GLOBAL_FRIENDLIST_CHALLENGE_TOOLTIP_TAVERN_BRAWL_NOT_CHALLENGEABLE	本周的乱斗模式无法进行好友挑战。	
GLOBAL_FRIENDLIST_CURRENT_GAMES_HEADER	进行中的对战 -  {0}	0=number of friends you have unfinished games with
GLOBAL_FRIENDLIST_FRIENDS_HEADER	好友 - {0}/{1}在线	0=number of online friends 1=number of offline friends
GLOBAL_FRIENDLIST_FRIENDS_HEADER_ALL_ONLINE	好友 - {0}在线	
GLOBAL_FRIENDLIST_LASTPLAYED	上一个对手：	
GLOBAL_FRIENDLIST_MYSTATUS	在线	
GLOBAL_FRIENDLIST_NEARBY_PLAYERS_DISABLED_HEADER	附近的玩家（已禁用）	
GLOBAL_FRIENDLIST_NEARBY_PLAYERS_HEADER	附近的玩家（{0}）	0=number of players
GLOBAL_FRIENDLIST_REMOVE_FRIEND_ALERT_MESSAGE	你确实想要移除{0}吗？	0=friend name
GLOBAL_FRIENDLIST_REMOVE_FRIEND_BUTTON	移除	
GLOBAL_FRIENDLIST_REQUEST_SENT_TIME	发送于：{0}	0=one of the GLOBAL_DATETIME_ELAPSED_ strings
GLOBAL_FRIENDLIST_REQUESTS_HEADER	好友邀请（{0}）	0=number of received friend requests
GLOBAL_FRIENDLIST_SPECTATE_MENU_DESCRIPTION	{0}正在进行一场对战。	0=player name
GLOBAL_FRIENDLIST_SPECTATE_TOOLTIP_AVAILABLE_HEADER	观看这场对战	
GLOBAL_FRIENDLIST_SPECTATE_TOOLTIP_AVAILABLE_TEXT	点击开始观看该玩家的对战。	
GLOBAL_FRIENDLIST_SPECTATE_TOOLTIP_AVAILABLE_TEXT_TOUCH	点击此处开始观看该玩家的对战。	
GLOBAL_FRIENDLIST_SPECTATE_TOOLTIP_INVITE_HEADER	邀请观看	
GLOBAL_FRIENDLIST_SPECTATE_TOOLTIP_INVITE_OTHER_SIDE_HEADER	观看对手	
GLOBAL_FRIENDLIST_SPECTATE_TOOLTIP_INVITE_OTHER_SIDE_TEXT	点击向{0}展示你的手牌。	0=player name
GLOBAL_FRIENDLIST_SPECTATE_TOOLTIP_INVITE_OTHER_SIDE_TEXT_TOUCH	点击向{0}展示你的手牌。	0=player name
GLOBAL_FRIENDLIST_SPECTATE_TOOLTIP_INVITE_TEXT	邀请{0}观看你的游戏。	0=player name
GLOBAL_FRIENDLIST_SPECTATE_TOOLTIP_INVITED_HEADER	邀请观看	
GLOBAL_FRIENDLIST_SPECTATE_TOOLTIP_INVITED_TEXT	你已经邀请{0}观看你的游戏。	0=player name
GLOBAL_FRIENDLIST_SPECTATE_TOOLTIP_KICK_HEADER	移除	
GLOBAL_FRIENDLIST_SPECTATE_TOOLTIP_KICK_TEXT	{0}正在观看你的游戏。点击此处将该观众移除。	
GLOBAL_FRIENDLIST_SPECTATE_TOOLTIP_KICK_TEXT_TOUCH	{0}正在观看你的游戏。点击此处将该观众移除。	
GLOBAL_FRIENDLIST_SPECTATE_TOOLTIP_PREVIOUSLY_KICKED_HEADER	无法观看	
GLOBAL_FRIENDLIST_SPECTATE_TOOLTIP_PREVIOUSLY_KICKED_TEXT	你曾经在观看该玩家的游戏时被移除。你无法再次观看该玩家的游戏。	
GLOBAL_FRIENDLIST_SPECTATE_TOOLTIP_RECEIVED_INVITE_TEXT	{0}邀请你观看游戏。点击此处开始观看。	
GLOBAL_FRIENDLIST_SPECTATE_TOOLTIP_RECEIVED_INVITE_TEXT_TOUCH	{0}邀请你观看游戏。点击此处开始观看。	
GLOBAL_FRIENDLIST_SPECTATE_TOOLTIP_SPECTATING_HEADER	正处于观众模式	
GLOBAL_FRIENDLIST_SPECTATE_TOOLTIP_SPECTATING_TEXT	你正在观看该玩家的比赛。	
GLOBAL_FRIENDLYCHALLENGE_QUEST_REWARD_AT_LIMIT	你获得的友谊赛任务奖励已达每日上限。	
GLOBAL_FRIENDLYCHALLENGE_REWARD_CONCEDED_YOUR_OPPONENT	由于对手过早地离开游戏，你将无法获得奖励。	
GLOBAL_FRIENDLYCHALLENGE_REWARD_CONCEDED_YOURSELF	你过早地离开游戏，无法获得奖励。	
GLOBAL_GAME_MENU	游戏菜单	
GLOBAL_GAME_QUEUE_TIME_IN_QUEUE	排队时间	
GLOBAL_GAME_QUEUE_WAIT_TIME	等待时间	
GLOBAL_GOLD_REWARD_ALREADY_CAPPED	今天你已经获得{0}金币了。	
GLOBAL_GOLD_REWARD_BAD_RATING	你或者你的对手没有达到能够获得金币的排名要求。	
GLOBAL_GOLD_REWARD_OVER_CAIS	由于防沉迷系统的限制，你无法再获得更多金币了。	
GLOBAL_GOLD_REWARD_SHORT_GAME_BY_TIME	你刚才进行的对战没有达到能够获得金币的时间要求。	
GLOBAL_HEALTH	生命值	
GLOBAL_HEALTHY_GAMING_CHINA_CAIS_ACTIVE	您的账号受到防沉迷系统限制。	
GLOBAL_HEALTHY_GAMING_CHINA_LESS_THAN_THREE_HOURS	您累计在线时间已满{0}小时。	
GLOBAL_HEALTHY_GAMING_CHINA_MORE_THAN_FIVE_HOURS	您已进入不健康游戏时间，为了您的健康，请您立即下线休息。如不下线，您的身体将受到损害，您的收益已降为零，直到您的累计下线时间满5小时后，才能恢复正常。	
GLOBAL_HEALTHY_GAMING_CHINA_MORE_THAN_FIVE_HOURS_PHONE	您已进入不健康游戏时间，为了您的健康，请您立即下线休息。如不下线，您的身体将受到损害，\n您的收益已降为零，直到您的累计下线时间满5小时后，才能恢复正常。	
GLOBAL_HEALTHY_GAMING_CHINA_STARTUP_MESSAGE	抵制不良游戏，拒绝盗版游戏。\n注意自我保护，谨防上当受骗。\n适度游戏益脑，沉迷游戏伤身。\n合理安排时间，享受健康生活。	
GLOBAL_HEALTHY_GAMING_CHINA_STARTUP_SUBTEXT	ISBN：978-7-900262-36-3 版署批号：新出审字[2013]1510号 沪网文[2017]9633-727号 文网进字[2013]029号 著作权：暴雪娱乐有限公司 出版单位：金报电子音像出版中心	
GLOBAL_HEALTHY_GAMING_CHINA_THREE_HOURS	您累计在线时间已满{0}小时，请您下线休息，做适当身体活动。	
GLOBAL_HEALTHY_GAMING_CHINA_THREE_TO_FIVE_HOURS	您已经进入疲劳游戏时间，您的游戏收益将降为正常值的0%，为了您的健康，请尽快下线休息，做适当身体活动，合理安排学习生活。	
GLOBAL_HEALTHY_GAMING_CHINA_THREE_TO_FIVE_HOURS_PHONE	您已经进入疲劳游戏时间，您的游戏收益将降为正常值的0%，为了您的健康，\n请尽快下线休息，做适当身体活动，合理安排学习生活。	
GLOBAL_HEALTHY_GAMING_KOREA_STARTUP_MESSAGE	본 게임물은 만 12세 이용가 게임으로서 해당 연령 미만의 청소년이 이용하기에 부적절합니다. 반드시 보호자의 지도 감독이 필요합니다.	
GLOBAL_HEALTHY_GAMING_TOAST	게임을 플레이한지 {0}시간 지났습니다. 과도한 게임이용은 정상적인 일상생활에 지장을 줄 수 있습니다	
GLOBAL_HEALTHY_GAMING_TOAST_OVER_THRESHOLD	你的游戏时间已经持续了{0}小时。请立刻休息一下。	0=hours
GLOBAL_HELP	帮助	
GLOBAL_HERO_LEVEL_NEXT_REWARD_TITLE	到达{0}级后可获得奖励	0=level
GLOBAL_HERO_LEVEL_REWARD_ARCANE_DUST	{0}点奥术之尘	0=amount
GLOBAL_HERO_LEVEL_REWARD_BOOSTER	{0}加速卡牌包	0=booster type
GLOBAL_HERO_LEVEL_REWARD_GOLD	{0}金币	0=amount
GLOBAL_HERO_LEVEL_REWARD_GOLDEN_CARD	{0}{1}	0=flair 1=card name
GLOBAL_HERO_WINS	获胜局数：{0}/{1}	0=number of games this class has won 1=number of wins to get golden
GLOBAL_HERO_WINS_PAST_MAX	获胜局数：{0}	0=number of games this class has won
GLOBAL_HERO_WINS_PAST_MAX_PHONE	获胜局数：\n{0}	0=number of games this class has won
GLOBAL_HERO_WINS_PHONE	获胜局数：{0}/{1}	0=number of games this class has won 1=number of wins to get golden
GLOBAL_HEROIC_BRAWL	英雄乱斗模式	
GLOBAL_HIDE	隐藏	
GLOBAL_IN_PROGRESS_REWARD_CHEST_INSTRUCTIONS	再赢得{0}场对战才能获得赛季宝箱！\n（宝箱将于下个月解锁）	
GLOBAL_JOIN	加入	
GLOBAL_KEYWORD_ADAPT	进化	
GLOBAL_KEYWORD_ADAPT_TEXT	在三个增益中选择其一。	
GLOBAL_KEYWORD_AUTOATTACK	自动攻击	
GLOBAL_KEYWORD_AUTOATTACK_TEXT	无法控制，但会在你的回合结束时进行自动攻击。	
GLOBAL_KEYWORD_AUTOCAST	自动施放	
GLOBAL_KEYWORD_AUTOCAST_TEXT	这个英雄技能必须在每个回合都要使用。	
GLOBAL_KEYWORD_AVENGE	复仇（X）	
GLOBAL_KEYWORD_AVENGE_TEXT	在X个友方随从死亡后，它会产生一些效果。	
GLOBAL_KEYWORD_BATTLECRY	战吼	
GLOBAL_KEYWORD_BATTLECRY_TEXT	当你从你的手牌中使用它的时候，它会产生一些效果。	
GLOBAL_KEYWORD_BLOOD_GEM	鲜血宝石	
GLOBAL_KEYWORD_BLOOD_GEM_TEXT	法术牌，使一个友方随从获得+1/+1。	
GLOBAL_KEYWORD_BOSS	首领	
GLOBAL_KEYWORD_BOSS_TEXT	玩家需要携手合作来对抗首领。	
GLOBAL_KEYWORD_CASTS_WHEN_DRAWN	抽到时施放	
GLOBAL_KEYWORD_CASTS_WHEN_DRAWN_TEXT	抽到时自动施放，然后再抽一张牌。	
GLOBAL_KEYWORD_CHARGE	冲锋	
GLOBAL_KEYWORD_CHARGE_TEXT	可以立即发起攻击。	
GLOBAL_KEYWORD_COMBO	连击	
GLOBAL_KEYWORD_COMBO_TEXT	如果在本回合中你已经使用过其他牌，它会产生额外的效果。	
GLOBAL_KEYWORD_CORRUPT	腐蚀	
GLOBAL_KEYWORD_CORRUPT_TEXT	当它在你的手牌中时，使用一张法力值消耗更高的牌就会使其升级。	
GLOBAL_KEYWORD_CORRUPTEDCARD	已腐蚀	
GLOBAL_KEYWORD_CORRUPTEDCARD_TEXT	法力值消耗更高的卡牌已使其升级。	
GLOBAL_KEYWORD_COUNTER	反制	
GLOBAL_KEYWORD_COUNTER_TEXT	被反制的牌不会产生任何效果。	
GLOBAL_KEYWORD_CTHUN	上古之神克苏恩	
GLOBAL_KEYWORD_CTHUN_TEXT	无论克苏恩位于何处，哪怕是在你的牌库里，依然会获得对应的加成效果！	
GLOBAL_KEYWORD_DEATHRATTLE	亡语	
GLOBAL_KEYWORD_DEATHRATTLE_TEXT	在其死亡时会产生一些效果。	
GLOBAL_KEYWORD_DISCOVER	发现	
GLOBAL_KEYWORD_DISCOVER_TEXT	在三张卡牌中选择其一置入你的手牌。	
GLOBAL_KEYWORD_DIVINE_SHIELD	圣盾	
GLOBAL_KEYWORD_DIVINE_SHIELD_REF_TEXT	被圣盾保护的随从免疫其受到的第一次伤害。	
GLOBAL_KEYWORD_DIVINE_SHIELD_TEXT	该随从免疫其受到的第一次伤害。	
GLOBAL_KEYWORD_DORMANT	休眠	
GLOBAL_KEYWORD_DORMANT_TEXT	双方玩家都无法触及。	
GLOBAL_KEYWORD_ECHO	回响	
GLOBAL_KEYWORD_ECHO_TEXT	使用此牌的回合内可反复使用。复制牌的法力值消耗不能低于（1）点。	
GLOBAL_KEYWORD_EMPOWER	祈求	
GLOBAL_KEYWORD_EMPOWER_PRIEST	祈求：牧师	
GLOBAL_KEYWORD_EMPOWER_PRIEST_TEXT	使用迦拉克隆的技能。<i>（随机将一张牧师随从牌置入你的手牌。）</i>	
GLOBAL_KEYWORD_EMPOWER_ROGUE	祈求：潜行者	
GLOBAL_KEYWORD_EMPOWER_ROGUE_COLLECTION_TEXT	使用迦拉克隆的技能。<i>（将一张跟班牌置入你的手牌。）</i>	
GLOBAL_KEYWORD_EMPOWER_ROGUE_TEXT	使用迦拉克隆的技能。<i>（将一张<b>跟班</b>牌置入你的手牌。）</i>	
GLOBAL_KEYWORD_EMPOWER_SHAMAN	祈求：萨满祭司	
GLOBAL_KEYWORD_EMPOWER_SHAMAN_COLLECTION_TEXT	使用迦拉克隆的技能。<i>（召唤一个2/1并具有突袭的元素。）</i>	
GLOBAL_KEYWORD_EMPOWER_SHAMAN_TEXT	使用迦拉克隆的技能。<i>（召唤一个2/1并具有<b>突袭</b>的元素。）</i>	
GLOBAL_KEYWORD_EMPOWER_TEXT	使用迦拉克隆的技能。	
GLOBAL_KEYWORD_EMPOWER_WARLOCK	祈求：术士	
GLOBAL_KEYWORD_EMPOWER_WARLOCK_TEXT	使用迦拉克隆的技能。<i>（召唤两个1/1的小鬼。）</i>	
GLOBAL_KEYWORD_EMPOWER_WARRIOR	祈求：战士	
GLOBAL_KEYWORD_EMPOWER_WARRIOR_TEXT	使用迦拉克隆的技能。<i>（在本回合中，使你的英雄获得+3攻击力。）</i>	
GLOBAL_KEYWORD_ENRAGED_TOOLTIP	激怒	
GLOBAL_KEYWORD_ENRAGED_TOOLTIP_TEXT	该随从在受伤时会具有新的属性。	
GLOBAL_KEYWORD_EVILZUG	跟班	
GLOBAL_KEYWORD_EVILZUG_TEXT	跟班是一类法力值消耗为（1）点的具有战吼的随从。	
GLOBAL_KEYWORD_FATIGUE	疲劳	
GLOBAL_KEYWORD_FATIGUE_TEXT	如果牌库中没有卡牌，在抽牌时会受到伤害。	
GLOBAL_KEYWORD_FLOOPY	软泥教授弗洛普	
GLOBAL_KEYWORD_FLOOPY_TEXT	当你使用一张随从牌时变形。	
GLOBAL_KEYWORD_FREEZE	冻结	
GLOBAL_KEYWORD_FREEZE_TEXT	被冻结的角色失去他们的下一次攻击机会。	
GLOBAL_KEYWORD_FRENZY	暴怒	
GLOBAL_KEYWORD_FRENZY_TEXT	该随从第一次受到伤害并存活后触发的一次性效果。	
GLOBAL_KEYWORD_FROZEN	被冻结	
GLOBAL_KEYWORD_FROZEN_TEXT	无法进行其下一次攻击。	
GLOBAL_KEYWORD_GALAKROND	迦拉克隆	
GLOBAL_KEYWORD_GALAKROND_COLLECTION_TEXT	该卡牌可应用于牧师、潜行者、萨满祭司、术士或战士套牌。	
GLOBAL_KEYWORD_GRIMY_GOONS	污手党	
GLOBAL_KEYWORD_GRIMY_GOONS_COLLECTION_TEXT	该卡牌可应用于猎人、圣骑士或战士套牌。	
GLOBAL_KEYWORD_IMMUNE	免疫	
GLOBAL_KEYWORD_IMMUNE_REF_TEXT	具有免疫的角色不会受到伤害。	
GLOBAL_KEYWORD_IMMUNE_TEXT	无法对其造成伤害	
GLOBAL_KEYWORD_INSPIRE	激励	
GLOBAL_KEYWORD_INSPIRE_TEXT	在你使用英雄技能后才会触发效果。	
GLOBAL_KEYWORD_JADE_GOLEM	青玉魔像	
GLOBAL_KEYWORD_JADE_GOLEM_COLLECTION_TEXT	你的第一个青玉魔像为1/1。之后的青玉魔像在原有基础上+1/+1。	
GLOBAL_KEYWORD_JADE_GOLEM_TEXT	之后的青玉魔像在原有基础上+1/+1。	
GLOBAL_KEYWORD_JADE_LOTUS	玉莲帮	
GLOBAL_KEYWORD_JADE_LOTUS_COLLECTION_TEXT	该卡牌可应用于德鲁伊、潜行者或萨满祭司套牌。	
GLOBAL_KEYWORD_KABAL	暗金教	
GLOBAL_KEYWORD_KABAL_COLLECTION_TEXT	该卡牌可应用于牧师、法师或术士套牌。	
GLOBAL_KEYWORD_LIFESTEAL	吸血	
GLOBAL_KEYWORD_LIFESTEAL_TEXT	造成伤害的同时，为你的英雄恢复等量的生命值。	
GLOBAL_KEYWORD_MEGAWINDFURY	超级风怒	
GLOBAL_KEYWORD_MEGAWINDFURY_TEXT	每个回合能够攻击四次。	
GLOBAL_KEYWORD_MINION_TYPE_REFERENCE	随从类型	
GLOBAL_KEYWORD_MINION_TYPE_REFERENCE_TEXT	野兽、恶魔、龙、机械、鱼人、海盗和图腾。	
GLOBAL_KEYWORD_MODULAR	磁力	
GLOBAL_KEYWORD_MODULAR_TEXT	将具有磁力的牌置于机械牌的左侧可使其合体！	
GLOBAL_KEYWORD_OFFHAND	副手	
GLOBAL_KEYWORD_OFFHAND_TEXT	无法破坏。无法被强化。	
GLOBAL_KEYWORD_OUTCAST	流放	
GLOBAL_KEYWORD_OUTCAST_TEXT	在手牌中的最左或最右侧使用时触发的额外效果。	
GLOBAL_KEYWORD_OVERKILL	超杀	
GLOBAL_KEYWORD_OVERKILL_TEXT	如果这张牌在你的回合中造成了过量的伤害，它会产生额外的效果。	
GLOBAL_KEYWORD_OVERLOAD	过载：X	
GLOBAL_KEYWORD_OVERLOAD_REF_TEXT	具有过载效果的卡牌会在下一个回合限制你的法力值。	
GLOBAL_KEYWORD_OVERLOAD_TEXT	下个回合你的法力值减少X点。	
GLOBAL_KEYWORD_PASSIVE	被动	
GLOBAL_KEYWORD_PASSIVE_TEXT	在当前的冒险中会一直生效。	
GLOBAL_KEYWORD_POISONOUS	剧毒	
GLOBAL_KEYWORD_POISONOUS_TEXT	消灭任何受到其伤害的随从。	
GLOBAL_KEYWORD_QUEST	任务	
GLOBAL_KEYWORD_QUEST_TEXT	会出现在起始手牌中。完成任务，获取奖励。	
GLOBAL_KEYWORD_QUESTLINE	任务线	
GLOBAL_KEYWORD_QUESTLINE_TEXT	会出现在起始手牌中。完成任务，获取奖励，最多3步！	
GLOBAL_KEYWORD_REBORN	复生	
GLOBAL_KEYWORD_REBORN_TEXT	在其首次死亡时复活，并具有1点生命值。	
GLOBAL_KEYWORD_RECRUIT	招募	
GLOBAL_KEYWORD_RECRUIT_TEXT	从你的牌库中召唤一个随从。	
GLOBAL_KEYWORD_REFRESH	刷新	
GLOBAL_KEYWORD_REFRESH_TEXT	让鲍勃的酒馆坐进新的随从。	
GLOBAL_KEYWORD_RUSH	突袭	
GLOBAL_KEYWORD_RUSH_TEXT	可以立即攻击随从。	
GLOBAL_KEYWORD_SECRET	奥秘	
GLOBAL_KEYWORD_SECRET_TEXT	在对手的回合发生某些特殊情况时展示并产生效果。	
GLOBAL_KEYWORD_SHIFTING_MINION_TEXT	在你的回合开始时，这张牌会变成一张新的随从牌。	
GLOBAL_KEYWORD_SHIFTING_SPELL_TEXT	在你的回合开始时，这张牌会变成一张新的法术牌。	
GLOBAL_KEYWORD_SHIFTING_TEXT	在你的回合开始时，这张牌会变成一张新的卡牌。	
GLOBAL_KEYWORD_SHIFTING_WEAPON_TEXT	在你的回合开始时，这张牌会变成一张新的武器牌。	
GLOBAL_KEYWORD_SHRINE	神龛	
GLOBAL_KEYWORD_SHRINE_TEXT	死亡后三回合重建。	
GLOBAL_KEYWORD_SIDEQUEST	支线任务	
GLOBAL_KEYWORD_SIDEQUEST_TEXT	完成任务，获取奖励。	
GLOBAL_KEYWORD_SILENCE	沉默	
GLOBAL_KEYWORD_SILENCE_TEXT	移除所有卡牌描述和强化。	
GLOBAL_KEYWORD_SPAREPART	备用零件	
GLOBAL_KEYWORD_SPAREPART_TEXT	备用零件是一些法力值消耗为（1）点的法术，使用它们能够产生一些效果。	
GLOBAL_KEYWORD_SPELLBURST	法术迸发	
GLOBAL_KEYWORD_SPELLBURST_TEXT	在你施放一个法术后触发的一次性效果。	
GLOBAL_KEYWORD_SPELLPOWER	法术伤害	
GLOBAL_KEYWORD_SPELLPOWER_ARCANE	奥术法术伤害	
GLOBAL_KEYWORD_SPELLPOWER_ARCANE_REF_TEXT	你的奥术法术能造成额外的伤害。	
GLOBAL_KEYWORD_SPELLPOWER_ARCANE_TEXT	你的奥术法术牌造成{0}点额外伤害。	0=amount of spell damage
GLOBAL_KEYWORD_SPELLPOWER_FEL	邪能法术伤害	
GLOBAL_KEYWORD_SPELLPOWER_FEL_REF_TEXT	你的邪能法术能造成额外的伤害。	
GLOBAL_KEYWORD_SPELLPOWER_FEL_TEXT	你的邪能法术牌造成{0}点额外伤害。	0=amount of spell damage
GLOBAL_KEYWORD_SPELLPOWER_FIRE	火焰法术伤害	
GLOBAL_KEYWORD_SPELLPOWER_FIRE_REF_TEXT	你的火焰法术能造成额外的伤害。	
GLOBAL_KEYWORD_SPELLPOWER_FIRE_TEXT	你的火焰法术牌造成{0}点额外伤害。	0=amount of spell damage
GLOBAL_KEYWORD_SPELLPOWER_FROST	冰霜法术伤害	
GLOBAL_KEYWORD_SPELLPOWER_FROST_REF_TEXT	你的冰霜法术能造成额外的伤害。	
GLOBAL_KEYWORD_SPELLPOWER_FROST_TEXT	你的冰霜法术牌造成{0}点额外伤害。	0=amount of spell damage
GLOBAL_KEYWORD_SPELLPOWER_HOLY	神圣法术伤害	
GLOBAL_KEYWORD_SPELLPOWER_HOLY_REF_TEXT	你的神圣法术能造成额外的伤害。	
GLOBAL_KEYWORD_SPELLPOWER_HOLY_TEXT	你的神圣法术牌造成{0}点额外伤害。	0=amount of spell damage
GLOBAL_KEYWORD_SPELLPOWER_NATURE	自然法术伤害	
GLOBAL_KEYWORD_SPELLPOWER_NATURE_REF_TEXT	你的自然法术能造成额外的伤害。	
GLOBAL_KEYWORD_SPELLPOWER_NATURE_TEXT	你的自然法术牌造成{0}点额外伤害。	0=amount of spell damage
GLOBAL_KEYWORD_SPELLPOWER_PHYSICAL	物理法术伤害	
GLOBAL_KEYWORD_SPELLPOWER_PHYSICAL_REF_TEXT	你的物理法术能造成额外的伤害。	
GLOBAL_KEYWORD_SPELLPOWER_PHYSICAL_TEXT	你的物理法术牌造成{0}点额外伤害。	0=amount of spell damage
GLOBAL_KEYWORD_SPELLPOWER_REF_TEXT	你的法术能造成额外的伤害。	
GLOBAL_KEYWORD_SPELLPOWER_SHADOW	暗影法术伤害	
GLOBAL_KEYWORD_SPELLPOWER_SHADOW_REF_TEXT	你的暗影法术能造成额外的伤害。	
GLOBAL_KEYWORD_SPELLPOWER_SHADOW_TEXT	你的暗影法术牌造成{0}点额外伤害。	0=amount of spell damage
GLOBAL_KEYWORD_SPELLPOWER_TEXT	你的法术牌造成{0}点额外伤害。	0=amount of spell damage
GLOBAL_KEYWORD_START_OF_COMBAT	战斗开始时	
GLOBAL_KEYWORD_START_OF_COMBAT_TEXT	会在战斗阶段开始时产生某些效果。	
GLOBAL_KEYWORD_START_OF_GAME	对战开始时	
GLOBAL_KEYWORD_START_OF_GAME_TEXT	对战一开始就会产生某种作用。	
GLOBAL_KEYWORD_STEALTH	潜行	
GLOBAL_KEYWORD_STEALTH_REF_TEXT	无法被攻击或被指定为目标，直到其开始攻击为止。	
GLOBAL_KEYWORD_STEALTH_TEXT	无法被攻击或被指定为目标，直到其开始攻击为止。	
GLOBAL_KEYWORD_TAUNT	嘲讽	
GLOBAL_KEYWORD_TAUNT_REF_TEXT	敌人必须攻击具有嘲讽的随从。	
GLOBAL_KEYWORD_TAUNT_TEXT	敌人必须攻击该随从。	
GLOBAL_KEYWORD_TOOL	工具	
GLOBAL_KEYWORD_TOOL_TEXT	拥有主动能力的道具。	
GLOBAL_KEYWORD_TRADE	可交易	
GLOBAL_KEYWORD_TRADE_TEXT	可以将此牌拖向牌库，消耗1点法力值将其洗入牌库并抽一张牌。	
GLOBAL_KEYWORD_TWINSPELL	双生法术	
GLOBAL_KEYWORD_TWINSPELL_TEXT	可以被施放两次。	
GLOBAL_KEYWORD_WILD	狂野	
GLOBAL_KEYWORD_WILD_TEXT	进入狂野模式的卡牌将无法在标准模式中使用。	
GLOBAL_KEYWORD_WINDFURY	风怒	
GLOBAL_KEYWORD_WINDFURY_TEXT	每个回合能够攻击两次。	
GLOBAL_LANGUAGE_CHANGE_CONFIRM_MESSAGE	此项操作将使当前游戏中断。你确定吗？	
GLOBAL_LANGUAGE_CHANGE_CONFIRM_TITLE	变更语言？	
GLOBAL_LANGUAGE_CHANGE_OUT_OF_SPACE_MESSAGE	你的设备需要{0}的空间才能继续。	
GLOBAL_LANGUAGE_CHANGE_OUT_OF_SPACE_TITLE	存储空间不足！	
GLOBAL_LANGUAGE_DOWNLOAD_VOICE_PACK	下载语音包	
GLOBAL_LANGUAGE_DROPDOWN	语言	
GLOBAL_LANGUAGE_NATIVE_DEDE	Deutsch	The name of the language IN THAT LANGUAGE.
GLOBAL_LANGUAGE_NATIVE_ENGB	English (UK)	The name of the language IN THAT LANGUAGE.
GLOBAL_LANGUAGE_NATIVE_ENUS	English	The name of the language IN THAT LANGUAGE.
GLOBAL_LANGUAGE_NATIVE_ESES	Español (España)	The name of the language IN THAT LANGUAGE.
GLOBAL_LANGUAGE_NATIVE_ESMX	Español (Latinoamérica)	The name of the language IN THAT LANGUAGE.
GLOBAL_LANGUAGE_NATIVE_FRFR	Français	The name of the language IN THAT LANGUAGE.
GLOBAL_LANGUAGE_NATIVE_ITIT	Italiano	The name of the language IN THAT LANGUAGE.
GLOBAL_LANGUAGE_NATIVE_JAJP	日本語	The name of the language IN THAT LANGUAGE.
GLOBAL_LANGUAGE_NATIVE_KOKR	한국어	The name of the language IN THAT LANGUAGE.
GLOBAL_LANGUAGE_NATIVE_PLPL	Polski	The name of the language IN THAT LANGUAGE.
GLOBAL_LANGUAGE_NATIVE_PTBR	Português (Brasil)	The name of the language IN THAT LANGUAGE.
GLOBAL_LANGUAGE_NATIVE_RURU	Русский	The name of the language IN THAT LANGUAGE.
GLOBAL_LANGUAGE_NATIVE_THTH	ภาษาไทย	The name of the laugnage IN THAT LANGUAGE.
GLOBAL_LANGUAGE_NATIVE_ZHCN	中文（简体）	The name of the language IN THAT LANGUAGE.
GLOBAL_LANGUAGE_NATIVE_ZHTW	繁體中文(台灣)	The name of the language IN THAT LANGUAGE.
GLOBAL_LEAVE	离开	
GLOBAL_LEAVE_SPECTATOR_MODE	离开	
GLOBAL_LOCATIONS	了解更多	
GLOBAL_LOGIN	登录	
GLOBAL_LOGIN_CONFIRM_MESSAGE	你将丢失当前游戏进度。你确定吗？	
GLOBAL_LOGIN_CONFIRM_TITLE	是否登录？	
GLOBAL_LOGO_COPYRIGHT	炉石传说 - 魔兽英雄传 ©2021 暴雪娱乐有限公司版权所有 由上海网之易网络科技发展有限公司运营	
GLOBAL_LOGOUT	退出	
GLOBAL_LOGOUT_CONFIRM_MESSAGE	确定退出？	
GLOBAL_LOGOUT_CONFIRM_TITLE	是否退出？	
GLOBAL_LOSSES	失败	
GLOBAL_MEDAL_0	传说	
GLOBAL_MEDAL_1	旅店老板	
GLOBAL_MEDAL_10	食人魔法师	
GLOBAL_MEDAL_11	王牌猎人	
GLOBAL_MEDAL_12	战歌指挥官	
GLOBAL_MEDAL_13	恐怖海盗	
GLOBAL_MEDAL_14	团队领袖	
GLOBAL_MEDAL_15	银月城卫兵	
GLOBAL_MEDAL_16	任务达人	
GLOBAL_MEDAL_17	牛头人战士	
GLOBAL_MEDAL_18	巫师学徒	
GLOBAL_MEDAL_19	工程师学徒	
GLOBAL_MEDAL_2	黑骑士	
GLOBAL_MEDAL_20	持盾卫士	
GLOBAL_MEDAL_21	南海船工	
GLOBAL_MEDAL_22	鱼人袭击者	
GLOBAL_MEDAL_23	银色侍从	
GLOBAL_MEDAL_24	麻风侏儒	
GLOBAL_MEDAL_25	愤怒的小鸡	
GLOBAL_MEDAL_3	熔核巨人	
GLOBAL_MEDAL_4	山岭巨人	
GLOBAL_MEDAL_5	海巨人	
GLOBAL_MEDAL_6	战争古树	
GLOBAL_MEDAL_7	烈日行者	
GLOBAL_MEDAL_8	霜狼督军	
GLOBAL_MEDAL_9	白银之手骑士	
GLOBAL_MEDAL_ARENA_TOOLTIP_BODY	这是你在竞技模式中获得的最高等级钥匙。\n胜利场数：{0}	0=num wins
GLOBAL_MEDAL_REWARD_CONGRATULATIONS	祝贺你！	
GLOBAL_MEDAL_REWARD_DESCRIPTION	上周赢得奖章	
GLOBAL_MEDAL_TOOLTIP_BEST_RANK_CLASSIC	经典模式等级：{0}	
GLOBAL_MEDAL_TOOLTIP_BEST_RANK_STANDARD	标准模式等级：{0}	
GLOBAL_MEDAL_TOOLTIP_BEST_RANK_WILD	狂野模式等级：{0}	
GLOBAL_MEDAL_TOOLTIP_BODY_ARENA_GRAND_MASTER	你成为了竞技场的勇士！	
GLOBAL_MEDAL_TOOLTIP_BODY_CLASSIC	赢得经典模式对战胜利，晋升至更高排名！	
GLOBAL_MEDAL_TOOLTIP_BODY_LEGEND	你就是传说！每场对战都会改变你在这个等级中的排名。	
GLOBAL_MEDAL_TOOLTIP_BODY_STANDARD	赢得标准模式对战胜利，晋升至更高排名！	
GLOBAL_MEDAL_TOOLTIP_BODY_WILD	赢得狂野模式对战胜利，晋升至更高排名！	
GLOBAL_MEDAL_TOOLTIP_HEADER	{0}奖章	0=medal name
GLOBAL_MEDAL_TOURNAMENT_TOOLTIP_BODY	本赛季排名对战模式前{0}%	0=rank percentile
GLOBAL_MINI_SET_BAR	哀嚎洞穴	
GLOBAL_MINI_SET_DMF	暗月竞速赛	
GLOBAL_MOBILE_ERROR_ANDROID_PHONE_DETECTED	抱歉，《炉石传说》目前只能在6寸或更大的安卓平板电脑上运行。	
GLOBAL_MOBILE_ERROR_BREAKING_NEWS	重大新闻：\n\n{0}	
GLOBAL_MOBILE_ERROR_LOGON_WEB_TIMEOUT	距离你的上一次操作已经过了很长时间，游戏连接中断。	
GLOBAL_MOBILE_ERROR_NETWORK_DISCONNECT	你已经断开连接。	
GLOBAL_MOBILE_ERROR_NETWORK_SPAM	由于你在短时间内发送请求过多，你已经断开了连接。	
GLOBAL_MOBILE_ERROR_NETWORK_UTIL_TIMEOUT	你向《炉石传说》服务器发送的数据请求已超时。	
GLOBAL_MOBILE_ERROR_UNSUPPORTED_IOS_PHONE_DETECTED	抱歉，《炉石传说》需要iPhone6s或iPod Touch7或更新的设备。	
GLOBAL_MOBILE_ERROR_UNSUPPORTED_IOS_TABLET_DETECTED	抱歉，《炉石传说》需要iPad5，iPad Air2，iPad mini4或更新的设备。	
GLOBAL_MOBILE_LOG_IN_TOOLTIP	请登录您的账号	
GLOBAL_MOBILE_LOGIN_POINTER	在此登录	
GLOBAL_MOBILE_RESTART_APPLICATION	请重新启动应用程序	
GLOBAL_MOBILE_TAP_TO_RECONNECT	点击屏幕重新连接。	
GLOBAL_MOBILE_TAP_TO_UPDATE	点击任意位置进行更新	
GLOBAL_MOBILECHAT_NOTIFICATION_MULLIGAIN	对战开始	
GLOBAL_MOBILECHAT_NOTIFICATION_TURN_COUNTDOWN	时间耗尽	
GLOBAL_MOBILECHAT_NOTIFICATION_YOUR_TURN	你的回合	
GLOBAL_MOBILECHAT_RETURN_TO_GAME	关闭	
GLOBAL_MOBILECHAT_RETURN_TO_MENU	回到菜单	
GLOBAL_MORE	更多	
GLOBAL_MY_NUM_WINS	{0}	0=number of games this player has won
GLOBAL_NOT_AVAILABLE	无法使用	
GLOBAL_OFF	关闭	
GLOBAL_OFFLINE	离线	
GLOBAL_OKAY	确定	
GLOBAL_ON	开启	
GLOBAL_OPTIONS	选项	
GLOBAL_OPTIONS_CARDBACK_LABEL	选择你的卡牌背面图案	
GLOBAL_OPTIONS_CHOOSE_CARD_BACK	选择卡牌背面图案	
GLOBAL_OPTIONS_CINEMATIC	视频欣赏	
GLOBAL_OPTIONS_CREDITS	制作人员	
GLOBAL_OPTIONS_GRAPHICS_FULLSCREEN_LABEL	全屏幕	
GLOBAL_OPTIONS_GRAPHICS_LABEL	图像	
GLOBAL_OPTIONS_GRAPHICS_QUALITY_HIGH	高	
GLOBAL_OPTIONS_GRAPHICS_QUALITY_LABEL	画质	
GLOBAL_OPTIONS_GRAPHICS_QUALITY_LOW	低	
GLOBAL_OPTIONS_GRAPHICS_QUALITY_MEDIUM	中	
GLOBAL_OPTIONS_GRAPHICS_RESOLUTION_CUSTOM	自定义	
GLOBAL_OPTIONS_GRAPHICS_RESOLUTION_LABEL	分辨率	
GLOBAL_OPTIONS_MISCELLANEOUS_LABEL	其他	
GLOBAL_OPTIONS_NEARBY_PLAYERS	允许挑战附近的玩家 - 好友列表	
GLOBAL_OPTIONS_OTHER_LABEL	其他	
GLOBAL_OPTIONS_PREFERENCES_LABEL	偏好设定	
GLOBAL_OPTIONS_PRIVACY_POLICY	管理隐私和账号	
GLOBAL_OPTIONS_PUBLIC_CHAT_ENABLED	恶意聊天	
GLOBAL_OPTIONS_RESTORE_PURCHASES	恢复已购项目	
GLOBAL_OPTIONS_RESTORE_PURCHASES_POPUP_TEXT	找不到之前购买过的项目？请确认登录账号是否正确。	
GLOBAL_OPTIONS_SCREEN_SHAKE	开启屏幕抖动	
GLOBAL_OPTIONS_SKIP_NPR	跳过学徒阶段	
GLOBAL_OPTIONS_SKIP_TO_RANK_25	直接跳至25级	
GLOBAL_OPTIONS_SOUND_IN_BACKGROUND	背景声效	
GLOBAL_OPTIONS_SOUND_LABEL	声音	
GLOBAL_OPTIONS_SOUND_MASTER_VOLUME_LABEL	主音量	
GLOBAL_OPTIONS_SOUND_MUSIC_VOLUME_LABEL	音乐音量	
GLOBAL_OPTIONS_SPECTATOR_OPEN_JOIN	允许好友观看我的对战	
GLOBAL_PLAY	开始	
GLOBAL_PLAY_RANKED	开始	
GLOBAL_PLAY_STANDARD	标准\n对战	
GLOBAL_PLAY_WAITING	等待中	
GLOBAL_PLAY_WILD	狂野\n对战	
GLOBAL_PLAYER_MIGRATION_RESTART_BODY	你的账号数据需要更新。\n请重新启动游戏。	
GLOBAL_PLAYER_MIGRATION_RESTART_HEADER	需要账号更新	
GLOBAL_PLAYER_PLAYER	玩家	this is the word for generic "Player" - this will be used when there a player's name is unknown at the time.
GLOBAL_PRACTICE_MAX_LEVEL_REACHED	最高练习等级	
GLOBAL_PROGRAMNAME_BLACKOPS4	黑色行动4	
GLOBAL_PROGRAMNAME_BLACKOPSCOLDWAR	黑色行动冷战	
GLOBAL_PROGRAMNAME_CRASHBANDICOOT4	Crash Bandicoot 4	
GLOBAL_PROGRAMNAME_DESTINY2	命运2	
GLOBAL_PROGRAMNAME_DIABLO2R	Diablo II: Resurrected	
GLOBAL_PROGRAMNAME_DIABLO3	暗黑破坏神III	
GLOBAL_PROGRAMNAME_HEARTHSTONE	炉石传说	
GLOBAL_PROGRAMNAME_HEROES	《风暴英雄》	
GLOBAL_PROGRAMNAME_MODERNWARFARE	现代战争	
GLOBAL_PROGRAMNAME_MODERNWARFARE2_REMASTER	MW2CR	
GLOBAL_PROGRAMNAME_OVERWATCH	守望先锋	
GLOBAL_PROGRAMNAME_PHOENIX	在线	
GLOBAL_PROGRAMNAME_STARCRAFT	星际争霸	
GLOBAL_PROGRAMNAME_STARCRAFT2	星际争霸II	
GLOBAL_PROGRAMNAME_WARCRAFT3	《魔兽争霸III：重制版》	
GLOBAL_PROGRAMNAME_WOW	魔兽世界	
GLOBAL_PROGRESSION_ACHIEVEMENT_COMPLETION	已完成{0}	
GLOBAL_PROGRESSION_ACHIEVEMENT_COMPLETION_DATE	{0:yyyy/MM/dd}	see http://msdn.microsoft.com/en-us/library/8kb3ddd4.aspx
GLOBAL_PROGRESSION_ACHIEVEMENT_COMPLETION_PERCENTAGE	{0}%	
GLOBAL_PROGRESSION_ACHIEVEMENT_SUBCATEGORY_NAME	{0} - {1}	
GLOBAL_PROGRESSION_DAILY_QUESTS_POPUP_TITLE	你的任务	
GLOBAL_PROGRESSION_POINTS	{0}点成就点数	
GLOBAL_PROGRESSION_PROFILE_ARENA_STAT_TOOLTIP	竞技模式中的最高胜场。	
GLOBAL_PROGRESSION_PROFILE_ARENA_STAT_TOOLTIP_TITLE	竞技模式	
GLOBAL_PROGRESSION_PROFILE_ARENA_WINS	{0}场胜利	
GLOBAL_PROGRESSION_PROFILE_BATTLEGROUNDS_STAT_TOOLTIP	赢得对战，提升你的等级。获得前四名即可计入任务中的胜场！	
GLOBAL_PROGRESSION_PROFILE_BATTLEGROUNDS_STAT_TOOLTIP_TITLE	酒馆战棋	
GLOBAL_PROGRESSION_PROFILE_BATTLEGROUNDS_TOP4	获得{0}次前四名	
GLOBAL_PROGRESSION_PROFILE_GAME_MODES	其他模式	
GLOBAL_PROGRESSION_PROFILE_PLAY_MODE	对战模式	
GLOBAL_PROGRESSION_PROFILE_PVPDR_CASUAL_STAT_TITLE	休闲对决	
GLOBAL_PROGRESSION_PROFILE_PVPDR_CASUAL_STAT_TOOLTIP	这是你在休闲或英雄对决模式中的最高等级。	
GLOBAL_PROGRESSION_PROFILE_PVPDR_CASUAL_STAT_TOOLTIP_TITLE	对决模式（休闲）	
GLOBAL_PROGRESSION_PROFILE_PVPDR_HEROIC_STAT_TITLE	英雄对决	
GLOBAL_PROGRESSION_PROFILE_PVPDR_HEROIC_STAT_TOOLTIP	这是你在休闲或英雄对决模式中的最高等级。	
GLOBAL_PROGRESSION_PROFILE_PVPDR_HEROIC_STAT_TOOLTIP_TITLE	对决模式（英雄）	
GLOBAL_PROGRESSION_PROFILE_RANKED_STAT_TOOLTIP	排名模式对战的总胜场。	
GLOBAL_PROGRESSION_PROFILE_TOTAL_WINS	总计{0}场胜利	
GLOBAL_PROGRESSION_PROGRESS_MESSAGE	{0} / {1}	
GLOBAL_PROGRESSION_QUEST_TIME_UNTIL_NEXT	{0}后获得新的任务	
GLOBAL_PROGRESSION_RANKED_REWARDS_TOOLTIP	每个赛季你都会获得奖励，内容取决于你在标准，狂野或经典模式中的最高等级。	
GLOBAL_PROGRESSION_RANKED_REWARDS_TOOLTIP_TITLE	等级奖励	
GLOBAL_PROGRESSION_REWARD_SUMMARY	{0}\n{1}	
GLOBAL_PROGRESSION_REWARD_TRACK_XP	{0}奖励经验值	
GLOBAL_PROGRESSION_TIER_MESSAGE	{0}/{1}	
GLOBAL_PROGRESSION_TOOLTIP_CLASS_DEFAULT_DESC	等级 {0}	
GLOBAL_PROGRESSION_TOOLTIP_GOLDEN_WINS_DESC	使用{1}在排名模式，竞技模式或对决模式中赢得{0}场对战，就能够获得相应的金色经典英雄！	{0}=win count {1}=class name
GLOBAL_PROGRESSION_TOOLTIP_PREMIUM_WINS_DESC	使用{1}在排名模式，竞技模式或对决模式中赢得{0}场对战，就能够获得{2}！	{0}=win count {1}=class name {2}=hero card name
GLOBAL_PROGRESSION_TOOLTIP_PREMIUM_WINS_DONE_DESC	使用{1}在排名模式，竞技模式或对决模式中赢得了{0}场对战，你获得了{2}！	{0}=win count {1}=class name {2}=hero card name
GLOBAL_PROGRESSION_TOOLTIP_TOTAL_CLASS_WINS	{0}总胜场	{0}=class name
GLOBAL_PROGRESSION_WEEKLY_QUESTS_POPUP_TITLE	你的每周任务	
GLOBAL_PVPDR_SEASON_ERROR_NOT_ACTIVE	抱歉，所需的对决赛季不可用。请稍后再试。	
GLOBAL_QUEST_PROGRESS_COUNT	{0}/{1}	0=progress,1=max progress
GLOBAL_QUIT	退出	
GLOBAL_RACE_ALL	全部	
GLOBAL_RACE_ALL_BATTLEGROUNDS	融合怪	This should be the plural of DAL_087t
GLOBAL_RACE_BLOODELF	血精灵	
GLOBAL_RACE_BLOODELF_BATTLEGROUNDS	血精灵	
GLOBAL_RACE_DEMON	恶魔	
GLOBAL_RACE_DEMON_BATTLEGROUNDS	恶魔	
GLOBAL_RACE_DRAENEI	火焰	
GLOBAL_RACE_DRAENEI_BATTLEGROUNDS	火焰	
GLOBAL_RACE_DRAGON	龙	
GLOBAL_RACE_DRAGON_BATTLEGROUNDS	龙	
GLOBAL_RACE_DWARF	矮人	
GLOBAL_RACE_DWARF_BATTLEGROUNDS	矮人	
GLOBAL_RACE_EGG	卵	
GLOBAL_RACE_EGG_BATTLEGROUNDS	卵	
GLOBAL_RACE_ELEMENTAL	元素	
GLOBAL_RACE_ELEMENTAL_BATTLEGROUNDS	元素	
GLOBAL_RACE_GNOME	侏儒	
GLOBAL_RACE_GNOME_BATTLEGROUNDS	侏儒	
GLOBAL_RACE_GOBLIN	地精	
GLOBAL_RACE_GOBLIN_BATTLEGROUNDS	地精	
GLOBAL_RACE_HUMAN	人类	
GLOBAL_RACE_HUMAN_BATTLEGROUNDS	人类	
GLOBAL_RACE_MECHANICAL	机械	
GLOBAL_RACE_MECHANICAL_BATTLEGROUNDS	机械	
GLOBAL_RACE_MIXED_BATTLEGROUNDS	混合随从	
GLOBAL_RACE_MURLOC	鱼人	
GLOBAL_RACE_MURLOC_BATTLEGROUNDS	鱼人	
GLOBAL_RACE_NERUBIAN	蛛魔	
GLOBAL_RACE_NERUBIAN_BATTLEGROUNDS	蛛魔	
GLOBAL_RACE_NIGHTELF	暗夜精灵	
GLOBAL_RACE_NIGHTELF_BATTLEGROUNDS	暗夜精灵	
GLOBAL_RACE_OGRE	食人魔	
GLOBAL_RACE_OGRE_BATTLEGROUNDS	食人魔	
GLOBAL_RACE_ORC	兽人	
GLOBAL_RACE_ORC_BATTLEGROUNDS	兽人	
GLOBAL_RACE_PET	野兽	
GLOBAL_RACE_PET_BATTLEGROUNDS	野兽	
GLOBAL_RACE_PIRATE	海盗	
GLOBAL_RACE_PIRATE_BATTLEGROUNDS	海盗	
GLOBAL_RACE_QUILBOAR	野猪人	
GLOBAL_RACE_QUILBOARS_BATTLEGROUNDS	野猪人	
GLOBAL_RACE_SCOURGE	天灾军团	
GLOBAL_RACE_SCOURGE_BATTLEGROUNDS	天灾	
GLOBAL_RACE_TAUREN	异教徒	
GLOBAL_RACE_TAUREN_BATTLEGROUNDS	牛头人	
GLOBAL_RACE_TOTEM	图腾	
GLOBAL_RACE_TOTEM_BATTLEGROUNDS	图腾	
GLOBAL_RACE_TROLL	巨魔	
GLOBAL_RACE_TROLL_BATTLEGROUNDS	巨魔	
GLOBAL_RACE_UNDEAD	亡灵	
GLOBAL_RACE_UNDEAD_BATTLEGROUNDS	亡灵	
GLOBAL_RACE_WORGEN	狼人	
GLOBAL_RACE_WORGEN_BATTLEGROUNDS	狼人	
GLOBAL_RANK_CANT_LOSE_LEVEL	在这个等级你不会降级。	
GLOBAL_RANK_PROMOTION_DESC	你已升到了25级！	
GLOBAL_RANK_SCRUB_RANK_DESC	在这个等级你不会损失星数。	
GLOBAL_RANK_STAR_MULT	额外的星数x{0}	
GLOBAL_RANK_STAR_MULT_STREAK	连胜奖励：额外星数x2	
GLOBAL_RANK_WIN_STREAK	连胜奖励：额外的星数！	
GLOBAL_RANKED	排名模式	
GLOBAL_RARITY_COMMON	普通	
GLOBAL_RARITY_EPIC	史诗	
GLOBAL_RARITY_FREE	免费	
GLOBAL_RARITY_LEGENDARY	传说	
GLOBAL_RARITY_RARE	稀有	
GLOBAL_RECONNECT_EXIT_BUTTON	退出游戏	
GLOBAL_RECONNECT_RECONNECTED	重新连接成功。正在继续...	
GLOBAL_RECONNECT_RECONNECTED_HEADER	已重新连接	
GLOBAL_RECONNECT_RECONNECTED_LOGIN	重新连接到了你的上一局对战。正在继续...	
GLOBAL_RECONNECT_RECONNECTING	你的对战由于断线而中断。正在重新连接……	
GLOBAL_RECONNECT_RECONNECTING_HEADER	正在重新连接	
GLOBAL_RECONNECT_RECONNECTING_LOGIN	你的上一局对战由于断线而中断。正在重新连接……	
GLOBAL_RECONNECT_TIMEOUT	无法重新连接到游戏。	
GLOBAL_RECONNECT_TIMEOUT_HEADER	发生错误	
GLOBAL_REFRESH	刷新	
GLOBAL_REGION_AMERICAS	美洲和东南亚	
GLOBAL_REGION_ASIA	亚洲	
GLOBAL_REGION_CHINA	中国	
GLOBAL_REGION_EUROPE	欧洲	
GLOBAL_RELAUNCH_APPLICATION_AFTER_INSTALLAPK	正在尝试安装新客户端。如果新客户端未能成功安装，请重新启动《炉石传说》。	
GLOBAL_REMAINING_DATETIME	剩余时间{0}	0=time string
GLOBAL_REMINDER_CARDBACK_SEASON_END_DIALOG	赢得{0}场对战，获得赛季卡背图案。	
GLOBAL_REMINDER_CHEST_QUESTION_MARK	?	Label for unearned chest, assuming "?" universally means unknown, it doesn't need to be localized
GLOBAL_REMINDER_CHEST_SEASON_END_DIALOG	赢得5场对战获得赛季宝箱。	
GLOBAL_RESTART	重新开始	
GLOBAL_RESUME_GAME	继续	
GLOBAL_RETRY	重试	
GLOBAL_RETURNING_PLAYER_GENERATED_DECK	旅店老板的套牌	
GLOBAL_REWARD_ARCANE_DUST_HEADLINE	获得奥术之尘！	
GLOBAL_REWARD_ARCANE_ORBS_HEADLINE	获得了奥术宝珠！	
GLOBAL_REWARD_ARENA_TICKET_ADMIT	参赛券	the word 'admit' in capital letters - displayed like "Admit 1" and looks like a movie/fair ticket. this is the Arena Ticket reward visual.
GLOBAL_REWARD_ARENA_TICKET_AUTHORIZED_BY	授予人	a label that shows up in the Arena Ticket under the Player's name indicating this ticket reward was granted by some guy.
GLOBAL_REWARD_ARENA_TICKET_ENTRANT	参赛者	a label that shows up in the Arena Ticket under the Player's name to say this person is allowed entrance into the Arena.
GLOBAL_REWARD_ARENA_TICKET_HEADLINE	免费的通票！	
GLOBAL_REWARD_ARENA_TICKET_LABEL	竞技模式	
GLOBAL_REWARD_ARENA_TICKET_STORE_COUNT_1	1	
GLOBAL_REWARD_ARENA_TICKET_TITLE	旅店通票	
GLOBAL_REWARD_BATTLEGROUNDS_GUIDE_HEADLINE	酒馆战棋调酒师已解锁	
GLOBAL_REWARD_BATTLEGROUNDS_HERO_HEADLINE	酒馆战棋英雄皮肤已解锁	
GLOBAL_REWARD_BONUS_CHALLENGE_HEADLINE	最终挑战已解锁	
GLOBAL_REWARD_BOOSTER_DETAILS_OUT_OF_BAND	由于推广活动的奖励，你获得了{0}包\n卡牌包。	0=count
GLOBAL_REWARD_BOOSTER_DETAILS_PRESALE_OUT_OF_BAND	你从网页购买的{0}包卡牌包很快就可以开启了！	0=count
GLOBAL_REWARD_BOOSTER_HEADLINE_GENERIC	获得卡牌包！	
GLOBAL_REWARD_BOOSTER_HEADLINE_MULTIPLE	获得{0}包\n卡牌包！	
GLOBAL_REWARD_BOOSTER_HEADLINE_OUT_OF_BAND	获得卡牌包！	
GLOBAL_REWARD_BOOSTER_HEADLINE_OUT_OF_BAND_MULTI	获得卡牌包！	
GLOBAL_REWARD_CARD_BACK_HEADLINE	获得卡牌背面\n图案！	
GLOBAL_REWARD_CARD_COUNT_MULTIPLIER	x	
GLOBAL_REWARD_CARD_DETAILS_TUTORIAL01	干得好！	
GLOBAL_REWARD_CARD_DETAILS_TUTORIAL02	挺厉害的嘛。	
GLOBAL_REWARD_CARD_DETAILS_TUTORIAL03	连战连胜！	
GLOBAL_REWARD_CARD_DETAILS_TUTORIAL04	真是难以置信。	
GLOBAL_REWARD_CARD_DETAILS_TUTORIAL05	太棒啦！	
GLOBAL_REWARD_CARD_DETAILS_TUTORIAL06	干得好！	
GLOBAL_REWARD_CARD_HEADLINE	奖励	
GLOBAL_REWARD_CARD_LEVEL_UP	使用{1}达到{0}级后解锁	0=# level, 1=class
GLOBAL_REWARD_CHEST_HEADER	你获得了排名对战奖励！	
GLOBAL_REWARD_CHEST_INSTRUCTIONS	你可以在赛季结束时打开相应的宝箱。\n在排名模式中取得更好的成绩来升级你的宝箱品质！	
GLOBAL_REWARD_CHEST_TIER1	海巨人金质宝箱	
GLOBAL_REWARD_CHEST_TIER1_EARNED	你获得了海巨人金质宝箱！	
GLOBAL_REWARD_CHEST_TIER2	食人魔法师银质宝箱	
GLOBAL_REWARD_CHEST_TIER2_EARNED	你获得了食人魔法师银质宝箱！	
GLOBAL_REWARD_CHEST_TIER3	守护者铜质宝箱	
GLOBAL_REWARD_CHEST_TIER3_EARNED	你获得了守护者铜质宝箱！	
GLOBAL_REWARD_CHEST_TIER4	持盾卫士木质宝箱	
GLOBAL_REWARD_CHEST_TIER4_EARNED	你获得了持盾卫士木质宝箱！	
GLOBAL_REWARD_CHEST_TIER5	愤怒的小鸡木质宝箱	
GLOBAL_REWARD_CHEST_TIER5_EARNED	你获得了愤怒的小鸡木质宝箱！	
GLOBAL_REWARD_CHEST_TIER6	旅客的布质背包	
GLOBAL_REWARD_CHEST_TIER6_EARNED	你获得了旅客的布质背包！	
GLOBAL_REWARD_CLASS_CHALLENGE_DETAIL	{0}	0=first class
GLOBAL_REWARD_CLASS_CHALLENGE_DETAIL_DOUBLE	{0}和{1}	0=first class, 1=second class
GLOBAL_REWARD_CLASS_CHALLENGE_HEADLINE	职业挑战已解锁	
GLOBAL_REWARD_CORE_CARD_DETAILS	{0}/{1}张{2}卡牌已解锁	0=# cards unlocked, 1=# cards possible to unlock, 2=class
GLOBAL_REWARD_FORGE_DETAILS_OUT_OF_BAND	由于推广活动的奖励，你获得了{0}次竞技模式入场机会。	0=count
GLOBAL_REWARD_FORGE_HEADLINE	获得竞技模式入场费	
GLOBAL_REWARD_FORGE_UNLOCKED_HEADLINE	竞技模式已解锁！	
GLOBAL_REWARD_FORGE_UNLOCKED_SOURCE	进入竞技模式奖励	
GLOBAL_REWARD_GOLD_HEADLINE	获得金币！	
GLOBAL_REWARD_GOLD_SOURCE_IGR	网吧登录奖励	
GLOBAL_REWARD_GOLD_SOURCE_IGR_DATED	{0}网吧登录奖励	0=GLOBAL_CURRENT_DATE
GLOBAL_REWARD_GOLD_SOURCE_TOURNEY	获得{0}场乱斗模式，酒馆战棋或对战模式比赛胜利后解锁	
GLOBAL_REWARD_GOLDEN_HERO_HEADLINE	金色英雄已解锁	
GLOBAL_REWARD_HEARTHSTEED_HEADLINE	炉石天马坐骑	
GLOBAL_REWARD_HERO_DETAILS	{0}/{1}位英雄已解锁	
GLOBAL_REWARD_HERO_HEADLINE	{0}已解锁	
GLOBAL_REWARD_HEROES_CARD_MOUNT_HEADLINE	炉石飞毯	
GLOBAL_REWARD_PROGRESS	{0}/{1}场胜利	0=current wins,1=required wins
GLOBAL_SCAN	查找	
GLOBAL_SCREENSHOT_COMPLETE	截图已被保存到桌面	
GLOBAL_SCREENSHOT_COMPLETE_SPECIFIC_DIRECTORY	屏幕截图已保存至{0}	0=The directory that the file was saved to
GLOBAL_SEASON_CHEST_BANNER	赛季宝箱	Default label for the banner in the end game screen that is placed above the in progress chest
GLOBAL_SEASON_END_BEST_EVER_ABOVE_MAX	根据你的以往战绩，你将从{0}级或更高的级别开始游戏。	0=rank
GLOBAL_SEASON_END_BONUS_STAR_BOOST	额外的星数奖励将你提升至	
GLOBAL_SEASON_END_BONUS_STAR_TITLE	你的上赛季排名使你获得	
GLOBAL_SEASON_END_BONUS_STARS_LABEL	额外的星数	
GLOBAL_SEASON_END_CHEST_INSTRUCTIONS	点击打开	
GLOBAL_SEASON_END_CHEST_INSTRUCTIONS_TOUCH	点击打开。	
GLOBAL_SEASON_END_NEW_CARD_BACK	你获得了新的卡牌背面图案	
GLOBAL_SEASON_END_NEW_CARDBACK_TITLE	新赛季卡背图案！	
GLOBAL_SEASON_END_NEW_CARDBACK_TITLE_PHONE	新赛季\n卡背图案！	
GLOBAL_SEASON_END_NEW_SEASON	{0}已经开始！	0=season name
GLOBAL_SEASON_END_PERCENTILE_LABEL	你已经成为了排名前{0}%的玩家！	0=rank percentile
GLOBAL_SEASON_END_RANK_LABEL	你获得了排名：	
GLOBAL_SEASON_END_STAR_MULTIPLIER_LABEL	额外的星数	
GLOBAL_SEASON_END_STAR_MULTIPLIER_TITLE	你在上赛季排名模式中的战绩使你获得	
GLOBAL_SEASON_END_WELCOME	欢迎	
GLOBAL_SET_BASIC	基本系列	
GLOBAL_SET_EXPERT1	经典	
GLOBAL_SET_ROTATION_ROLLOVER_BODY_DESKTOP	炉石新年到！\n重新启动游戏，一起来庆祝吧。	
GLOBAL_SET_ROTATION_ROLLOVER_BODY_MOBILE	炉石新年到！\n重新启动游戏，一起来庆祝吧。	
GLOBAL_SET_ROTATION_ROLLOVER_HEADER	新年快乐！	
GLOBAL_SHOW	显示	
GLOBAL_SHUTDOWN_TOAST	<color=#{0}>暴雪战网服务将于{1}分钟后关闭</color>	0=color, 1=minutes
GLOBAL_SKIP	跳过	
GLOBAL_SKIP_TUTORIAL	离开教程	
GLOBAL_SOCIAL_TOAST_FRIEND_ACHIEVEMENT	<color=#{0}>{1}</color>完成了<color=#FFD451>{2}</color>	0=name color,1=player name,2=achievement name
GLOBAL_SOCIAL_TOAST_FRIEND_ACHIEVEMENT_TIER	<color=#{0}>{1}</color>完成了<color=#FFD451>{2}（等级{3}）</color>	0=name color,1=player name,2=achievement name,3=tier
GLOBAL_SOCIAL_TOAST_FRIEND_ARENA_COMPLETE	<color=#{0}>{1}</color>在竞技模式中的比赛结束了。({2}-{3})	0=name color,1=player name,2=Arena Wins,3=Arena Losses
GLOBAL_SOCIAL_TOAST_FRIEND_ARENA_START	<color=#{0}>{1}</color>在竞技模式中的比赛开始了。	0=name color,1=player name
GLOBAL_SOCIAL_TOAST_FRIEND_ARENA_START_WITH_MANY_WINS	<color=#{0}>{1}</color>在竞技模式中的比赛开始了，并已经赢得{2}胜！	0=name color,1=player name,2=Arena Wins
GLOBAL_SOCIAL_TOAST_FRIEND_BRAWLISEUM_COMPLETE	<color=#{0}>{1}</color>在乱斗角斗场中的比赛结束了。({2}-{3})	0=name color,1=player name,2=Brawl Wins,3=Brawl Losses
GLOBAL_SOCIAL_TOAST_FRIEND_BRAWLISEUM_START	<color=#{0}>{1}</color>在乱斗角斗场中的比赛开始了。	0=name color,1=player name
GLOBAL_SOCIAL_TOAST_FRIEND_BRAWLISEUM_START_WITH_MANY_WINS	<color=#{0}>{1}</color>在乱斗角斗场中的比赛开始了，并已经赢得{2}胜！	0=name color,1=player name,2=Brawl Wins
GLOBAL_SOCIAL_TOAST_FRIEND_DRUID_LEVEL	<color=#{0}>{1}</color>成为了一个{2}级的德鲁伊。	0=name color,1=player name,2=level
GLOBAL_SOCIAL_TOAST_FRIEND_DUEL_START	<color=#{0}>{1}</color>在对决模式中的比赛开始了。	0=name color,1=player name
GLOBAL_SOCIAL_TOAST_FRIEND_GOLDEN_LEGENDARY	<color=#{0}>{1}</color>打开卡牌包获得了<color=#{3}>金色的{2}</color>！	0=name color,1=player name,2=card name,3=Golden Color
GLOBAL_SOCIAL_TOAST_FRIEND_HEROIC_BRAWL_COMPLETE	<color=#{0}>{1}</color>在英雄乱斗模式中的比赛结束了。({2}-{3})	0=name color,1=player name,2=Heroic brawl Wins,3=Heroic brawl Losses
GLOBAL_SOCIAL_TOAST_FRIEND_HEROIC_BRAWL_START	<color=#{0}>{1}</color>在英雄乱斗模式中的比赛开始了。	0=name color,1=player name
GLOBAL_SOCIAL_TOAST_FRIEND_HEROIC_BRAWL_START_WITH_MANY_WINS	<color=#{0}>{1}</color>在英雄乱斗模式中的比赛开始了，并已经赢得{2}胜！	0=name color,1=player name,2=Heroic brawl Wins
GLOBAL_SOCIAL_TOAST_FRIEND_HUNTER_LEVEL	<color=#{0}>{1}</color>成为了一个{2}级的猎人。	0=name color,1=player name,2=level
GLOBAL_SOCIAL_TOAST_FRIEND_ILLIDAN_COMPLETE	<color=#{0}>{1}</color>击败了伊利丹·怒风！	0=name color,1=player name
GLOBAL_SOCIAL_TOAST_FRIEND_LEGENDARY	<color=#{0}>{1}</color>打开卡牌包获得了<color=#{3}>{2}</color>！	0=name color,1=player name,2=card name
GLOBAL_SOCIAL_TOAST_FRIEND_MAGE_LEVEL	<color=#{0}>{1}</color>成为了一个{2}级的法师。	0=name color,1=player name,2=level
GLOBAL_SOCIAL_TOAST_FRIEND_OFFLINE	<color=#{0}>{1}</color>下线了。	0=name color,1=player name
GLOBAL_SOCIAL_TOAST_FRIEND_ONLINE	<color=#{0}>{1}</color>上线了。	0=name color,1=player name
GLOBAL_SOCIAL_TOAST_FRIEND_PALADIN_LEVEL	<color=#{0}>{1}</color>成为了一个{2}级的圣骑士。	0=name color,1=player name,2=level
GLOBAL_SOCIAL_TOAST_FRIEND_PRIEST_LEVEL	<color=#{0}>{1}</color>成为了一个{2}的牧师。	0=name color,1=player name,2=level
GLOBAL_SOCIAL_TOAST_FRIEND_RANK_EARNED	<color=#{0}>{1}</color>的等级达到了{2}！	0=name color,1=player name,2=medal name
GLOBAL_SOCIAL_TOAST_FRIEND_RANK_EARNED_CLASSIC	<color=#{0}>{1}</color>在经典模式中的等级达到了{2}！	0=name color,1=player name,2=medal name
GLOBAL_SOCIAL_TOAST_FRIEND_RANK_EARNED_WILD	<color=#{0}>{1}</color>在狂野模式中的等级达到了{2}！	0=name color,1=player name,2=medal name
GLOBAL_SOCIAL_TOAST_FRIEND_RANK_LEGEND	<color=#{0}>{1}</color>成为了传说级牌手！	0=name color,1=player name
GLOBAL_SOCIAL_TOAST_FRIEND_RANK_LEGEND_CLASSIC	<color=#{0}>{1}</color>在经典对战中成为了传说级牌手！	0=name color,1=player name
GLOBAL_SOCIAL_TOAST_FRIEND_RANK_LEGEND_WILD	<color=#{0}>{1}</color>在狂野对战中成为了传说级牌手！	0=name color,1=player name
GLOBAL_SOCIAL_TOAST_FRIEND_REQUEST	<color=#{0}>{1}</color>向你发送了好友邀请。	0=name color,1=player name
GLOBAL_SOCIAL_TOAST_FRIEND_ROGUE_LEVEL	<color=#{0}>{1}</color>成为了一个{2}级的潜行者。	0=name color,1=player name,2=level
GLOBAL_SOCIAL_TOAST_FRIEND_SHAMAN_LEVEL	<color=#{0}>{1}</color>成为了一个{2}级的萨满祭司。	0=name color,1=player name,2=level
GLOBAL_SOCIAL_TOAST_FRIEND_WARLOCK_LEVEL	<color=#{0}>{1}</color>成为了一个{2}级的术士。	0=name color,1=player name,2=level
GLOBAL_SOCIAL_TOAST_FRIEND_WARRIOR_LEVEL	<color=#{0}>{1}</color>成为了一个{2}级的战士。	0=name color,1=player name,2=level
GLOBAL_SOCIAL_TOAST_RECENT_OPPONENT_FRIEND_REQUEST	一位最近交过手的对手想要成为你的好友。	
GLOBAL_SOCIAL_TOAST_SPECTATOR_ADDED	<color=#{0}>{1}</color>现在开始观看你的比赛。	0=name color,1=player name
GLOBAL_SOCIAL_TOAST_SPECTATOR_INVITE_RECEIVED	<color=#{0}>{1}</color> 邀请你观看这场对战！	0=name color,1=player name
GLOBAL_SOCIAL_TOAST_SPECTATOR_INVITE_SENT	已向<color=#{0}>{1}</color>发出比赛观看邀请。	0=name color,1=player name
GLOBAL_SOCIAL_TOAST_SPECTATOR_REMOVED	<color=#{0}>{1}</color>不再观看你的比赛。	0=name color,1=player name
GLOBAL_SPECTATE	观看	
GLOBAL_SPECTATOR_COUNT_PANEL_HEADER	观看比赛	
GLOBAL_SPECTATOR_COUNT_PANEL_TEXT_ONE	{0}正在观看你的游戏。	0=player name, this is shown when there's only 1 person spectating you.
GLOBAL_SPECTATOR_ERROR_CANNOT_SPECTATE_2_GAMES	无法同时观战两场不同的对战。	
GLOBAL_SPECTATOR_ERROR_CREATE_PARTY_TEXT	试图创建观众群组时发生错误。	
GLOBAL_SPECTATOR_ERROR_LEAVE_FOR_SPECTATE_PLAYER_TEXT	在尝试离开上一个观众群组，准备观看{0}的游戏时发生错误。	0=player name
GLOBAL_SPECTATOR_KICK_PROMPT_HEADER	移除观众	
GLOBAL_SPECTATOR_KICK_PROMPT_TEXT	你确定想要移除观众{0}吗？如果你在选项中关闭“允许好友观看我的游戏”，就能够阻止其他玩家观看你的游戏。	0=player name
GLOBAL_SPECTATOR_LEAVE_PROMPT_HEADER	离开观众模式	
GLOBAL_SPECTATOR_LEAVE_PROMPT_TEXT	你确定想要退出观众模式吗？	
GLOBAL_SPECTATOR_MODE_INDICATOR_TEXT	观众模式	text that shows up on the bottom left of screen showing that you're currently in Spectator Mode.
GLOBAL_SPECTATOR_REMOVED_PROMPT_APPEAR_OFFLINE_TEXT	你处在隐身状态下，已被移除出观众模式。	
GLOBAL_SPECTATOR_REMOVED_PROMPT_HEADER	已移除	
GLOBAL_SPECTATOR_REMOVED_PROMPT_TEXT	你已被移除，无法继续观看。	
GLOBAL_SPECTATOR_SERVER_REJECTED_HEADER	观众断开连接	
GLOBAL_SPECTATOR_SERVER_REJECTED_TEXT	你想要观看的这场对战已经结束，或者观众席已满，或者刚被设置成不允许观看。	
GLOBAL_SPECTATOR_WAITING_FOR_NEXT_GAME_HEADER	观众模式	
GLOBAL_SPECTATOR_WAITING_FOR_NEXT_GAME_TEXT	等待下一场对战开始。\n\n{0}{1}	0=player name, 1=player's current activity -- will be filled in with values PRESENCE_STATUS_* and PRESENCE_SCENARIO_*_NORMAL_SCENARIO_* from PRESENCE.txt (e.g. "Jane Doe is Heading into Play Mode")
GLOBAL_SPECTATOR_WAITING_FOR_NEXT_GAME_TEXT_BATTLING	等待下一场对战开始。\n\n{0}正在与{1}对战	0=player name, 1=player's current activity -- will be filled in with values PRESENCE_SCENARIO_*_HEROIC_* from PRESENCE.txt (e.g. "Jane Doe is Battling Heroic Gothik the Harvester")
GLOBAL_SPECTATOR_WAITING_FOR_NEXT_GAME_TEXT_ENTERING	等待下一场对战开始。\n\n{0}正在进入{1}	0=player name, 1=player's current activity -- will be filled in with values PRESENCE_ADVENTURE_MODE_* from PRESENCE.txt (e.g. "Jane Doe is entering Naxxramas")
GLOBAL_SPECTATOR_WAITING_FOR_NEXT_GAME_TEXT_OFFLINE	等待下一场对战开始。\n\n{0}已经下线	0=player name; shown when player is offline.
GLOBAL_SPECTATOR_WAITING_FOR_NEXT_GAME_TEXT_ONLINE	等待下一场对战开始。\n\n{0}已上线	0=player name; shown when there is no current activity string available.
GLOBAL_SPECTATOR_WAITING_FOR_NEXT_GAME_TEXT_PLAYING	等待下一场对战开始。\n\n{0}正在进行{1}	0=player name, 1=player's current activity -- will be filled in with values PRESENCE_SCENARIO_*_CLASS_CHALLENGE_* from PRESENCE.txt (e.g. "Jane Doe is playing Naxxramas Paladin Challenge")
GLOBAL_SPECTATOR_WAITING_FOR_NEXT_GAME_TIMEOUT	你正在观看的玩家没有及时开始下一场对战。你已经退出了观众模式。	
GLOBAL_SPELL_SCHOOL_ARCANE	奥术	
GLOBAL_SPELL_SCHOOL_FEL	邪能	
GLOBAL_SPELL_SCHOOL_FIRE	火焰	
GLOBAL_SPELL_SCHOOL_FROST	冰霜	
GLOBAL_SPELL_SCHOOL_HOLY	神圣	
GLOBAL_SPELL_SCHOOL_NATURE	自然	
GLOBAL_SPELL_SCHOOL_PHYSICAL_COMBAT	物理	
GLOBAL_SPELL_SCHOOL_SHADOW	暗影	
GLOBAL_SPLASH_CLOSED_RECONNECTING	正在重新连接	
GLOBAL_SPLASH_CLOSED_SIGN_TITLE	关闭	
GLOBAL_STANDARD	标准模式	
GLOBAL_STORE_MOBILE_NAME_AMAZON	亚马逊应用商店	
GLOBAL_STORE_MOBILE_NAME_APPLE	苹果应用商店	
GLOBAL_STORE_MOBILE_NAME_DEFAULT	暴雪战网商城	
GLOBAL_STORE_MOBILE_NAME_GOOGLE	谷歌应用商店	
GLOBAL_SUPPORT	用户支持	
GLOBAL_SWITCH_ACCOUNT	切换账号	
GLOBAL_TAVERN_BRAWL	乱斗模式	
GLOBAL_TAVERN_BRAWL_ERROR_NOT_ACTIVE	抱歉，当前的乱斗模式尚未正式开启。请等待几分钟然后再试。	
GLOBAL_TAVERN_BRAWL_ERROR_SEASON_INCREMENTED	抱歉，当前的乱斗模式比赛已经结束。新一轮的比赛马上就会开始！	
GLOBAL_TOOLTIP_FRIEND_BUTTON_DESC	和你的好友聊天或发起挑战	
GLOBAL_TOOLTIP_FRIEND_BUTTON_HEADER	好友	
GLOBAL_TOOLTIP_MENU_DESC	查看选项中的内容，你可以从那里退出游戏，或进行更多的设置。	
GLOBAL_TOOLTIP_MENU_HEADER	游戏菜单	
GLOBAL_TOOLTIP_MENU_OFFLINE_DESC	当前处于离线状态。点击此处重新连接。	
GLOBAL_TOOLTIP_MENU_OFFLINE_HEADER	离线	
GLOBAL_TUTORIAL_ATTACK	攻击力	
GLOBAL_TUTORIAL_ATTACKER	攻击者	
GLOBAL_TUTORIAL_COST	消耗	
GLOBAL_TUTORIAL_DEFENDER	防御者	
GLOBAL_TUTORIAL_HEALTH	生命值	
GLOBAL_TUTORIAL_HERO_POWER	英雄技能	
GLOBAL_TUTORIAL_MINION	随从	
GLOBAL_TUTORIAL_TAUNT	嘲讽	
GLOBAL_TUTORIAL_TAUNT_DESCRIPTION	敌人必须攻击这个随从	
GLOBAL_TUTORIAL_USED	已使用	
GLOBAL_TUTORIAL_YOUR_MANA	你的法力值	
GLOBAL_TUTORIAL_YOUR_TURN	你的回合	
GLOBAL_UPDATE	更新	
GLOBAL_VERSION	版本	
GLOBAL_WAIT_FOR_OPPONENT_RECONNECT	等待对手重新连接……（{0}分{1}秒）\n你可以前往选项菜单结束这场游戏。	
GLOBAL_WAIT_FOR_OPPONENT_RECONNECT_HEADER	比赛暂停	
GLOBAL_WAIT_FOR_OPPONENT_RECONNECT_SPECTATOR	等待选手重新连接……（{0}分{1}秒）	
GLOBAL_WILD	狂野模式	
GLOBAL_WINS	胜利	
