TAG	TEXT	COMMENT
BOTA_PUZZLE_CONGRATULATIONS	你真棒	
BOTA_PUZZLE_END_TURN_REMINDER	要是卡住了就重新来过吧。	
BOTA_PUZZLE_LOADING	谜题载入中	
BOTA_PUZZLE_PROGRESS	谜题 {0}/{1}	
BOTA_PUZZLE_RESETTING	谜题重置中	
DALA_MISSION_CHAPTER_SUBTEXT_01	达拉然银行	
DALA_MISSION_CHAPTER_SUBTEXT_01_HEROIC	达拉然银行（英雄难度）	
DALA_MISSION_CHAPTER_SUBTEXT_02	紫罗兰监狱	
DALA_MISSION_CHAPTER_SUBTEXT_02_HEROIC	紫罗兰监狱（英雄难度）	
DALA_MISSION_CHAPTER_SUBTEXT_03	达拉然街道	
DALA_MISSION_CHAPTER_SUBTEXT_03_HEROIC	达拉然街道（英雄难度）	
DALA_MISSION_CHAPTER_SUBTEXT_04	下水道	
DALA_MISSION_CHAPTER_SUBTEXT_04_HEROIC	下水道（英雄难度）	
DALA_MISSION_CHAPTER_SUBTEXT_05	肯瑞托城堡	
DALA_MISSION_CHAPTER_SUBTEXT_05_HEROIC	肯瑞托城堡（英雄难度）	
DALA_TAVERN_POPUP	调整你在本次冒险中的套牌：\n增删随从以及更多操作！	
DALA_TAVERN_TURN_START	轻松时刻	
FB_BUILDABRAWL_001	大召唤师的恩赐	
FB_BUILDABRAWL_002	炎魔之王的化装舞会	
FB_BUILDABRAWL_003	古神的恩赐	
FB_BUILDABRAWL_004	火线突击的恩赐	
FB_BUILDABRAWL_005	异乎寻常的召唤师角逐赛	
FB_BUILDABRAWL_006	异乎寻常的化装舞会	
FB_BUILDABRAWL_007	异乎寻常的试镜会	
FB_BUILDABRAWL_008	异乎寻常的火线突击	
FB_BUILDABRAWL_009	大召唤师之战	
FB_BUILDABRAWL_010	化装舞会之战	
FB_BUILDABRAWL_011	古神试镜会之战	
FB_BUILDABRAWL_012	火线突击之战	
FB_BUILDABRAWL_013	鲜血召唤师角逐赛	
FB_BUILDABRAWL_014	鲜血化装舞会	
FB_BUILDABRAWL_015	鲜血古神试镜会	
FB_BUILDABRAWL_016	鲜血火线突击	
FB_BUILDABRAWL_INTRO	当前的乱斗模式为：	
FB_BUILDABRAWL_NOTSTARTED	炉边乱斗尚未开始，请联系你的旅店老板来自建乱斗！	
FB_CHAMPS_FIREBAT_DRUID	Firebat在总决赛中首先使用了德鲁伊套牌……然后就一直没有输过！他成为了2014年的冠军！	
FB_CHAMPS_FIREBAT_HUNTER	Firebat的潜行者套牌丢掉了首局之后，选择了这套猎人套牌来对抗DTwo的术士套牌。	
FB_CHAMPS_FIREBAT_ROGUE	2014年，Firebat用这套套牌击败了DTwo的牧师套牌，奇迹般地依靠着12/4的加基森拍卖师完成了斩杀！	
FB_CHAMPS_FIREBAT_WARLOCK	在决赛中，小鱼鱼大仙人禁掉了Firebat的术士套牌。现在，这套套牌会有怎样的表现呢？	
FB_CHAMPS_OSTKAKA_MAGE	Ostkaka用这套冰法套牌对抗Hotform的节奏法套牌，最后却靠火球术打出的伤害赢得了胜利。多么讽刺！	
FB_CHAMPS_OSTKAKA_ROGUE	在2015年决赛的最后一场比赛中，Ostkaka击败了Hotform的德鲁伊套牌，跻身冠军大厅！	
FB_CHAMPS_OSTKAKA_WARRIOR	恐怖的奴隶主帮助Ostkaka获得了胜利……哪怕没有战歌指挥官也一样。这才是卡牌游戏的真正魅力！	
FB_CHAMPS_PAVEL_DRUID	遥想当年，Pavel在内战中战胜了DrHippi。小心那些巨型随从！	
FB_CHAMPS_PAVEL_MAGE	2016年，Pavel的法师曾在比赛中获得多个赛点。你的表现会怎么样呢？	
FB_CHAMPS_PAVEL_ROGUE	面对对手极具攻击性的套牌，Pavel的潜行者套牌数临险境，但他打出了精彩的一击！	
FB_CHAMPS_PAVEL_SHAMAN	Pavel的萨满祭司套牌总是被对手禁用，但在这里就不会！	
FB_CHAMPS_PAVEL_WARRIOR	Pavel的这副克苏恩战士套牌在决赛中出场了两次，输给了DrHippi的战士套牌，但战胜了对手的德鲁伊套牌。	
FB_CHAMPS_TOM60229_DRUID	tom60229靠着这副套牌拿下了2018年的世界锦标赛冠军。起手留一张终极感染，最终改写整局对战。	
FB_CHAMPS_TOM60229_PRIEST	tom60229的牧师套牌并不脏，但也机关重重。小心那些后期套路！	
FB_CHAMPS_TOM60229_ROGUE	剧透：tom60229用这副套牌在第二回合背刺了自己的随从，拍了一个10点攻击力的范克里夫。当心了！	
FB_CHAMPS_TOM60229_WARLOCK	这副套牌未能在决赛中露面。tom60229的这套魔块术还有一些削弱前版本的小惊喜在里面。	
FB_DuelersCardsLeft1	还剩1张牌你就能出手！	
FB_DuelersCardsLeft2	还剩2张牌你就能出手！	
FB_DuelersCardsLeft3	还剩3张牌你就能出手！	
FB_DuelersCardsLeft4	还剩4张牌你就能出手！	
FB_DuelersCardsLeft5	还剩5张牌你就能出手！	
FB_ELO_EVEN	你和你对手的实力旗鼓相当，因此双方都可选择一个强化效果加成！	
FB_ELO_FAVORED	你是赢家，因此你的对手可以获得一个强化效果加成。	
FB_ELO_UNDERDOG	你是输家，因此你可以选择一个强化效果\n加成！	
FB_IKC_CHOSE_SETUP	打出一张新的卡牌，它会成为旅店老板的选择。	
FB_IKC_ENDGAME	你已经选择了新的卡牌！结束这场游戏吧。	
FB_IKC_NEWCARD	保留原来的卡牌，还是使用新的？	
FB_IKC_SETUP	旅店老板！我有个问题……	
FB_JUGGERNAUT_CHOOSE_OPPONENT	选择敌方的船长……	
FB_JUGGERNAUT_DRUID	德鲁伊	
FB_JUGGERNAUT_FIRSTLINE	射击！	
FB_JUGGERNAUT_HUNTER	猎人	
FB_JUGGERNAUT_MAGE	法师	
FB_JUGGERNAUT_PALADIN	圣骑士	
FB_JUGGERNAUT_PRIEST	牧师	
FB_JUGGERNAUT_ROGUE	潜行者	
FB_JUGGERNAUT_SHAMAN	萨满祭司	
FB_JUGGERNAUT_UNKNOWN	未知	
FB_JUGGERNAUT_WARLOCK	术士	
FB_JUGGERNAUT_WARRIOR	战士	
FB_LK_BOSSSWITCH	击败巫妖王的副官，逼迫他出来应战！	
FB_LK_DEAD_01	祝贺你们，勇士！\n你们击败了巫妖王！	
FB_LK_DEAD_02	在炉边聚会中寻找旅店老板，再次进行挑战！	
FB_LK_HERO_01	超级巫妖王	
FB_LK_HERO_02	鲜血女王兰娜瑟尔	
FB_LK_HERO_03	普崔塞德教授	
FB_LK_HERO_04	玛洛加尔领主	
FB_LK_HERO_05	辛达苟萨	
FB_LK_HEROSWITCH	玩家2的回合！再接再厉！	
FB_LK_INTRO_01	在这次乱斗中，两位玩家要通力合作\n推荐玩家坐在一起进行游戏！	
FB_LK_INTRO_02	玩家1先手\n你们要联合起来\n击败巫妖王！	
FB_TopX_Ban	请选择一张禁用的卡牌！	
ICC_01_LICH_KING_SUBTEXT	传说	
ICC_01_TIRION_SUBTEXT	不那么传说	
ICC_01_TIRIONTURNS_01	1回合后提里奥抵达战场	
ICC_01_TIRIONTURNS_02	2回合后提里奥抵达战场	
ICC_01_TIRIONTURNS_03	3回合后提里奥抵达战场	
ICC_05_LANATHEL_01	你<b>必须</b>撕咬一个随从！哪怕不是你的随从！	
ICCDruidVictory_01	一度滋养着艾泽拉斯荒野的玛法里奥如今成为了污染者，在对死亡花园的守护中平衡着大自然。	
ICCHunterVictory_01	雷克萨释放了被巫妖王囚禁的灵魂。随后他从箭囊中抽出一支漆黑的箭矢。“走吧，米莎！”他说道，“狩猎开始了……”	
ICCMageVictory_01	新加冕的冰霜女巫审视着她的国度。不计其数的亡灵成为她新的力量，而她却丝毫感受不到体内渐渐冰冷的鲜血。	
ICCPaladinVictory_01	曾经高贵的圣骑士接受了他新的命运。那些磊落一生的人无需惧怕他。但恶人，则将在死亡之际面对他的审判……	
ICCPriestVictory_01	年轻王子的身躯逐渐融入暗影。“我现在终于看清了，”他的双眼燃烧着蓝色的火焰，“我以前是多么天真……”	
ICCRogueVictory_01	虚空之影瓦莉拉消失在夜色中。她的分身与阴影全知全能，没有人能够逃脱她那冰冷的刀刃……	
ICCShamanVictory_01	无数亡者的尖叫淹没了萨满的脑海。死亡先知阖上眼睛，只吐出一个词：“沉睡……”	
ICCWarlockVictory_01	古尔丹终于坐上了冰封王座。黑暗之门已再次打开，无数世界将在他面前瑟瑟发抖。	
ICCWarriorVictory_01	曾经的部落大酋长接受了新的力量。死在他军队手中的尸体将重返世间，为其效力，直到他成为俯视众生的唯一主宰。	
LOEA16_2_STAFF_TEXT_CHARGE_0	<b>被动英雄技能</b>\n你的英雄获得<b>免疫</b>，还有三个回合。	
LOEA16_2_STAFF_TEXT_CHARGE_1	<b>被动英雄技能</b>\n你的英雄获得<b>免疫</b>，还有两个回合。	
LOEA16_2_STAFF_TEXT_CHARGE_2	<b>被动英雄技能</b>\n你的英雄获得<b>免疫</b>，还有一个回合！	
LOEA16_2_STAFF_TEXT_CHARGE_EXPLODED	<b>被动英雄技能</b>\n召唤一个首领，但会失去<b>免疫</b>。	
MISSION_DEFAULTCOUNTERNAME	逃亡回合	
MISSION_GLOWING_POOL	发光的水池	
MISSION_NEFARIAN_TITLE	傻瓜、废物以及垃圾随从的克星	
MISSION_PIT_OF_SPIKES	钉刺陷阱	
MISSION_PRE_TUTORIAL_WANTED	缉拿	
MISSION_STATUES_EYE	雕像之眼	
MISSION_TAKE_THE_SHORTCUT	选择捷径？	
TB_100TH_BANANA_INFO_OPP	你对手的套牌由随机卡牌组成。每当对手的随从死亡时，他就会获得一根香蕉。	
TB_100TH_BANANA_INFO_YOU	你的套牌由随机卡牌组成。每当你的随从死亡时，你就会获得一根香蕉。	
TB_100TH_BANANA_OPP	你的对手使用的是第2场乱斗模式——香蕉大乱斗，该乱斗初次登场时间为2015年6月24日。	
TB_100TH_BANANA_YOU	你使用的是第2场乱斗模式——香蕉大乱斗，该乱斗初次登场时间为2015年6月24日。	
TB_100TH_CLONEBALL_INFO_OPP	你对手的套牌由随机传说卡牌组成，且每张牌有数个复制。	
TB_100TH_CLONEBALL_INFO_YOU	你的套牌由随机传说卡牌组成，且每张牌有数个复制。	
TB_100TH_CLONEBALL_OPP	你的对手使用的是第52场乱斗模式——克隆球大赛，该乱斗初次登场时间为2016年6月8日。	
TB_100TH_CLONEBALL_YOU	你使用的是第52场乱斗模式——克隆球大赛，该乱斗初次登场时间为2016年6月8日。	
TB_100TH_PARTYPORTAL_INFO_OPP	该玩家的套牌由随机传送门卡牌组成。	
TB_100TH_PARTYPORTAL_INFO_YOU	该玩家的套牌由随机传送门卡牌组成。	
TB_100TH_PARTYPORTAL_OPP	你的对手使用的是第64场乱斗模式——派对传送门，该乱斗初次登场时间为2016年8月31日。	
TB_100TH_PARTYPORTAL_YOU	你使用的是第64场乱斗模式——派对传送门，该乱斗初次登场时间为2016年8月31日。	
TB_100TH_PORTALS_INFO_OPP	你对手的套牌除了些许法术牌之外，其他都是不稳定的传送门。	
TB_100TH_PORTALS_INFO_YOU	你的套牌除了些许法术牌之外，其他都是不稳定的传送门。	
TB_100TH_PORTALS_OPP	你的对手使用的是第7场乱斗模式——遍地传送门，该乱斗初次登场时间为2015年7月29日。	
TB_100TH_PORTALS_YOU	你使用的是第7场乱斗模式——遍地传送门，该乱斗初次登场时间为2015年7月29日。	
TB_100TH_RANDEMONIUM_INFO_OPP	你对手的套牌由随机卡牌组成，其法力值消耗每个回合都是随机的。	
TB_100TH_RANDEMONIUM_INFO_YOU	你的套牌由随机卡牌组成，其法力值消耗每个回合都是随机的。	
TB_100TH_RANDOMONIUM_OPP	你的对手使用的是第18场乱斗模式——异乎寻常的法力风暴，该乱斗初次登场时间为2015年10月14日。	
TB_100TH_RANDOMONIUM_YOU	你使用的是第18场乱斗模式——异乎寻常的法力风暴，该乱斗初次登场时间为2015年10月14日。	
TB_100TH_RAVENIDOL_INFO_OPP	你对手的套牌由30张乌鸦神像组成。	
TB_100TH_RAVENIDOL_INFO_YOU	你的套牌由30张乌鸦神像组成。	
TB_100TH_RAVENIDOL_OPP	你的对手使用的是第45场乱斗模式——发现之旅，该乱斗初次登场时间为2016年4月20日。	
TB_100TH_RAVENIDOL_YOU	你使用的是第45场乱斗模式——发现之旅，该乱斗初次登场时间为2016年4月20日。	
TB_100TH_SHIFTER_INFO_OPP	你对手的套牌除了些许法术牌之外，其他都是百变泽鲁斯。	
TB_100TH_SHIFTER_INFO_YOU	你的套牌除了些许法术牌之外，其他都是百变泽鲁斯。	
TB_100TH_SHIFTER_OPP	你的对手使用的是第55场乱斗模式——我变我变我变变变，该乱斗初次登场时间为2016年6月29日。	
TB_100TH_SHIFTER_YOU	你使用的是第55场乱斗模式——我变我变我变变变，该乱斗初次登场时间为2016年6月29日。	
TB_100TH_SPELLBAG_INFO_OPP	你对手的套牌由30张随机法术牌组成，使用法术牌会随机召唤与其法力值消耗相同的一个随从。	
TB_100TH_SPELLBAG_INFO_YOU	你的套牌由30张随机法术牌组成，使用法术牌会随机召唤与其法力值消耗相同的一个随从。	
TB_100TH_SPELLBAG_OPP	你的对手使用的是第76场乱斗模式——瓦莉拉的小秘密，该乱斗初次登场时间为2016年11月23日。	
TB_100TH_SPELLBAG_YOU	你使用的是第76场乱斗模式——瓦莉拉的小秘密，该乱斗初次登场时间为2016年11月23日。	
TB_100TH_YOGG_INFO_OPP	你对手的套牌由随机随从牌组成，使用随从牌会随机施放一个法术。	
TB_100TH_YOGG_INFO_YOU	你的套牌由随机随从牌组成，使用随从牌会随机施放一个法术。	
TB_100TH_YOGG_OPP	你的对手使用的是第57场乱斗模式——古神试镜会，该乱斗初次登场时间为2016年7月13日。	
TB_100TH_YOGG_YOU	你使用的是第57场乱斗模式——古神试镜会，该乱斗初次登场时间为2016年7月13日。	
TB_207_01	托尔巴拉德之战	
TB_207_02	绿野大作战	
TB_207_03	地下宝藏！	
TB_207_04	克隆人的进攻！	
TB_207_05	化装舞会	
TB_207_06	虚空奇点	
TB_207_07	克隆球大赛	
TB_207_08	异乎寻常的法力风暴	
TB_207_09	偷来的小秘密	
TB_207_INTRO_01	你的乱斗模式是：	
TB_207_INTRO_02	对手的乱斗模式是：	
TB_DECKBUILDING_FIRSTCARDPLAYED	在你使用一张牌后，将一个复制洗入你的牌库。	
TB_DECKBUILDING_FIRSTENDTURN	将你的手牌洗回牌库，并重新抽牌。	
TB_DECKBUILDING_FIRSTPICKTHREE	为你的手牌挑选一张新的卡牌。	
TB_DECKBUILDING_STARTOFGAME	组建一副套牌去迎接挑战吧！祝你好运！	
TB_DECKBUILDING_STARTOFGAME_START	开始！	
TB_DECKRECIPE_MSG_DRUID	套牌模板：<b>玉莲战将</b>。	
TB_DECKRECIPE_MSG_HUNTER	套牌模板：<b>武装野兽</b>。	
TB_DECKRECIPE_MSG_MAGE	套牌模板：<b>暗金奥义</b>。	
TB_DECKRECIPE_MSG_PALADIN	套牌模板：<b>穷街陋市</b>。	
TB_DECKRECIPE_MSG_PRIEST	套牌模板：<b>藏龙出击</b>。	
TB_DECKRECIPE_MSG_ROGUE	套牌模板：<b>黑帆军团</b>。	
TB_DECKRECIPE_MSG_SHAMAN	套牌模板：<b>鱼人浪潮</b>。	
TB_DECKRECIPE_MSG_WARLOCK	套牌模板：<b>暗流涌动</b>。	
TB_DECKRECIPE_MSG_WARRIOR	套牌模板：<b>污手帝国</b>。	
TB_DECKRECIPE_OG_DRUID	利用德鲁伊独有的法术来产生法力水晶，从而在早期召唤出上古之神的仆从来碾压对手。	
TB_DECKRECIPE_OG_HUNTER	别担心，英雄。因为你的随从无论是生是死，都会助你一臂之力的。大胆地用你的随从和对方进行交换吧，你会赢得最终的胜利！	
TB_DECKRECIPE_OG_MAGE	尽情施展魔法吧！因为你用得越多，苏醒的尤格-萨隆就会越厉害！	
TB_DECKRECIPE_OG_PALADIN	用圣盾保护你的随从，使其免疫受到的第一次伤害，从而有效地进行持续作战！	
TB_DECKRECIPE_OG_PRIEST	为你的随从进行治疗，让他们能够活着看到实力恐怖的克苏恩降临于世！	
TB_DECKRECIPE_OG_ROGUE	尽管用你的随从与对手进行交换吧！他们中的大多数在死亡时会给予你特殊效果，所以牺牲也是值得的。	
TB_DECKRECIPE_OG_SHAMAN	召唤出尽可能多的随从，然后将其强化！经过强化后的随从绝对会让你之前的投资物超所值！	
TB_DECKRECIPE_OG_WARLOCK	用上古之神无穷无尽的爪牙来扩充你的部队，用小型的随从来淹没你的对手。	
TB_DECKRECIPE_OG_WARRIOR	控制场面，叠加护甲，在侍奉克苏恩的同时保护好自己。等到上古之神登场后，让你的对手灰飞烟灭。	
TB_DPROMO_2NDHERO	奶牛王	
TB_DPROMO_2NDHEROPOPUP	欢迎来到隐藏关卡！	
TB_DPROMO_COWKINGEMOTES	哞	
TB_DUELERSBRAWL_SUDDEN_DEATH	绝杀时刻！	
TB_DUELERSBRAWL_TAKE_PACES	各走5步，然后出手！	
TB_FIREFEST_FIRST	迷你拉格纳罗斯每次烧死随从后就会提高\n攻击力！	
TB_FIREFEST_SECOND	打得不错！多献祭几个随从，就能获得特别的奖励！	
TB_FIREFEST2_01	炎魔之王拉格纳罗斯	
TB_FIREFEST2_02	冰霜之王埃霍恩	
TB_GIFTEXCHANGE_GIFTSPAWNED	如果你这边没有大礼包，那一定在另一边。	
TB_GIFTEXCHANGE_GIFTSTOLEN	你领到了一份礼物！会是什么呢……	
TB_GIFTEXCHANGE_START	冬幕节快乐！好礼送不停！	
TB_HEADLESS_HORSEMAN_POISON	你没法毒死这个亡灵，他太强了！	
TB_HEADLESSREDUX_01	你就是无头骑士，保护你的墓地！	
TB_HEADLESSREDUX_02	消灭乔装打扮的冒险者哈吉尔、强尼和弗林，即可获得胜利！	
TB_HEADLESSREDUX_03	你闯入了无头骑士的墓地！	
TB_HEADLESSREDUX_04	保护乔装打扮的冒险者哈吉尔、强尼和弗林，否则你会战败！	
TB_KOBOLDGIFTS_01	“看天上！是狗头人爷爷！”	
TB_KOBOLDGIFTS_02	“狗头人爷爷会在下一回合回来！给他腾个地方！”	
TB_LETHAL_NAME	成败在此一举	
TB_LETHALPUZZLES_FAILURE	再试一次吧！	
TB_LETHALPUZZLES_START	每一轮你都得击败对手…祝你好运！	
TB_LETHALPUZZLES_SUCCESS	你成功了！	
TB_MARIN_QUEST	谁先完成任务，谁就有机会抢先得到宝藏！	
TB_MP_BOSS	装饰过的暴风城	
TB_MP_BOSS2	派对之所	
TB_MP_BOSS3	派对之都	
TB_MP_COOP_1STSPELL	噢糟糕，暗金教的家伙好像在酒里下了药…	
TB_MP_COOP_2NDSPELL	室内严禁燃放烟花爆竹！	
TB_MP_COOP_CRASHER_DISCARD	派对捣蛋鬼在玩家的手牌里闲得发慌，决定自行离开。	
TB_MP_COOP_ENDING	成功啦！感谢你能和我们一起庆祝猛犸年！	
TB_MP_COOP_FIRST_CRASHER	当心，那些家伙想毁掉派对！给他们点颜色\n瞧瞧！	
TB_MP_COOP_PINATA	你办到了，砸彩罐时间到！但是派对捣蛋鬼也开始躁动不安…	
TB_MP_COOP_TEXT_START	和其他玩家一起用英雄技能来装饰旅店。	
TB_MP_CROSSROADS	等等，那家伙是谁？	
TB_MP_CROSSROADS_CRASHER	他在这做什么？	
TB_MP_STORMWIND_SUCCESS	你成功了！还能继续打破记录吗？	
TB_PICKYOURFATE_BUILDAROUND_FIRSTFATE	命运的选择对双方玩家都会产生影响！	
TB_PICKYOURFATE_BUILDAROUND_NEWFATE	请记住，该加成只会对你产生影响。	
TB_PICKYOURFATE_BUILDAROUND_OPPONENT_FIRSTFATE	对手选择的命运也会对你产生影响！	
TB_PICKYOURFATE_BUILDAROUND_OPPONENTFATE	请记住，该加成只会对你的对手产生影响。	
TB_PICKYOURFATE_RANDOM_FIRSTFATE	命运的选择对双方玩家都会产生影响！	
TB_PICKYOURFATE_RANDOM_NEWFATE	你需要一个新的命运！	
TB_PICKYOURFATE_RANDOM_OPPONENTFATE	你的对手需要一个新的命运！	
TB_SHADOWTOWERS_ADJACENTMINIONS	在塔旁边的随从会获得<b>潜行</b>，且无法攻击。	
TB_SHADOWTOWERS_SHADOWSPAWNED	如果有一方没有塔了，就会为其召唤一座新的塔。	
TB_SHADOWTOWERS_SHADOWSPAWNEDNEXT	在拥有者的回合开始时，会替换掉遗失的塔。	
