TAG	TEXT	COMMENT
PRESENCE_ADVENTURE_MODE_BOH	正在阅读英雄之书	
PRESENCE_ADVENTURE_MODE_BOM	正在阅读佣兵之书	
PRESENCE_ADVENTURE_MODE_BOT	正在游览砰砰实验室	
PRESENCE_ADVENTURE_MODE_BRM_CLASS_CHALLENGE	黑石山职业挑战	
PRESENCE_ADVENTURE_MODE_BRM_HEROIC	黑石山（英雄难度）	
PRESENCE_ADVENTURE_MODE_BRM_NORMAL	黑石山	
PRESENCE_ADVENTURE_MODE_BTA	正在进入邪火试炼	
PRESENCE_ADVENTURE_MODE_BTA_HEROIC	正在进入邪火试炼挑战模式	
PRESENCE_ADVENTURE_MODE_BTP	正在探索伊利丹的过去！	
PRESENCE_ADVENTURE_MODE_DAL	正在谋划大劫案	
PRESENCE_ADVENTURE_MODE_DRG	正在从龙骨荒野起飞	
PRESENCE_ADVENTURE_MODE_GIL	正在准备怪物狩猎	
PRESENCE_ADVENTURE_MODE_ICC_NORMAL	正在探索冰冠堡垒	
PRESENCE_ADVENTURE_MODE_KAR_CLASS_CHALLENGE	卡拉赞职业挑战	
PRESENCE_ADVENTURE_MODE_KAR_HEROIC	卡拉赞（英雄难度）	
PRESENCE_ADVENTURE_MODE_KAR_NORMAL	卡拉赞	
PRESENCE_ADVENTURE_MODE_LOE_CLASS_CHALLENGE	探险者协会职业挑战	
PRESENCE_ADVENTURE_MODE_LOE_HEROIC	探险者协会（英雄难度）	
PRESENCE_ADVENTURE_MODE_LOE_NORMAL	探险者协会	
PRESENCE_ADVENTURE_MODE_LOOT	正在为地下城冒险作准备	
PRESENCE_ADVENTURE_MODE_NAXX_CLASS_CHALLENGE	纳克萨玛斯职业挑战	
PRESENCE_ADVENTURE_MODE_NAXX_HEROIC	纳克萨玛斯（英雄难度）	
PRESENCE_ADVENTURE_MODE_NAXX_NORMAL	纳克萨玛斯	
PRESENCE_ADVENTURE_MODE_RETURNING_PLAYER_CHALLENGE	正在进行一场回归挑战	
PRESENCE_ADVENTURE_MODE_RLK	正在探索阿尔萨斯的过去！	
PRESENCE_ADVENTURE_MODE_TRL	正在准备一场挑战	
PRESENCE_ADVENTURE_MODE_ULD	正在筹划探险远征	
PRESENCE_SCENARIO_BOH_FIGHT_01	正在说服大法师安东尼达斯	
PRESENCE_SCENARIO_BOH_FIGHT_02	正在和凯尔萨斯王子会面	
PRESENCE_SCENARIO_BOH_FIGHT_03	正在和阿尔萨斯王子争吵	
PRESENCE_SCENARIO_BOH_FIGHT_04	正在平复格罗玛什·地狱咆哮	
PRESENCE_SCENARIO_BOH_FIGHT_05	正在智取阿克蒙德	
PRESENCE_SCENARIO_BOH_FIGHT_06	正在保卫塞拉摩	
PRESENCE_SCENARIO_BOH_FIGHT_07	正在向萨尔问责	
PRESENCE_SCENARIO_BOH_FIGHT_08	正在驱逐夺日者	
PRESENCE_SCENARIO_BOH10_FIGHT_01	正在与王子会面	
PRESENCE_SCENARIO_BOH10_FIGHT_02	正在从提克迪奥斯处盗窃	
PRESENCE_SCENARIO_BOH10_FIGHT_03	正在袭击萨格拉斯之墓	
PRESENCE_SCENARIO_BOH10_FIGHT_04	正在与玛法里奥争吵	
PRESENCE_SCENARIO_BOH10_FIGHT_05	正在拯救外域	
PRESENCE_SCENARIO_BOH10_FIGHT_06	正在羞辱阿努巴拉克	
PRESENCE_SCENARIO_BOH10_FIGHT_07	正在与阿尔萨斯对决	
PRESENCE_SCENARIO_BOH10_FIGHT_08	正在被阿卡玛背叛	
PRESENCE_SCENARIO_BOH11_FIGHT_01	正在开启探寻之旅	
PRESENCE_SCENARIO_BOH11_FIGHT_02	正在抵御海盗	
PRESENCE_SCENARIO_BOH11_FIGHT_03	正在与钩牙交涉	
PRESENCE_SCENARIO_BOH11_FIGHT_04	正在维修海兽号	
PRESENCE_SCENARIO_BOH11_FIGHT_05A	正在熬过风暴	
PRESENCE_SCENARIO_BOH11_FIGHT_05B	正在夺回暮色号	
PRESENCE_SCENARIO_BOH11_FIGHT_06	正在营救玛雅船长	
PRESENCE_SCENARIO_BOH11_FIGHT_07	正在套牢海怪	
PRESENCE_SCENARIO_BOH11_FIGHT_08	正在再次维修海兽号	
PRESENCE_SCENARIO_BOH11_FIGHT_09A	正在遭遇鱼人	
PRESENCE_SCENARIO_BOH11_FIGHT_09B	正在见证家人重逢	
PRESENCE_SCENARIO_BOH11_FIGHT_10A	正在与纳迦争论	
PRESENCE_SCENARIO_BOH11_FIGHT_10B	正在证明价值	
PRESENCE_SCENARIO_BOH11_FIGHT_11	正在回想过去	
PRESENCE_SCENARIO_BOH11_FIGHT_12	正在面对现在	
PRESENCE_SCENARIO_BOH11_FIGHT_13	正在永恒王宫受困	
PRESENCE_SCENARIO_BOH11_FIGHT_14	正在最后一次维修海兽号	
PRESENCE_SCENARIO_BOH11_FIGHT_15	正在与扎恩拉对峙	
PRESENCE_SCENARIO_BOH11_FIGHT_16	正在取悦艾萨拉女王	
PRESENCE_SCENARIO_BOH11_PROLOGUE	正在招募船员	
PRESENCE_SCENARIO_BOH2_FIGHT_01	正在争论行动路线	
PRESENCE_SCENARIO_BOH2_FIGHT_02	正在说服大酋长	
PRESENCE_SCENARIO_BOH2_FIGHT_03	正在帮助米莎	
PRESENCE_SCENARIO_BOH2_FIGHT_04	正在维护莫戈林的荣耀	
PRESENCE_SCENARIO_BOH2_FIGHT_05	正在和吉安娜调查	
PRESENCE_SCENARIO_BOH2_FIGHT_06	正在营救贝恩·血蹄	
PRESENCE_SCENARIO_BOH2_FIGHT_07	正在击退戴林的入侵	
PRESENCE_SCENARIO_BOH2_FIGHT_08	正在拯救莫克纳萨	
PRESENCE_SCENARIO_BOH3_FIGHT_01	正在与盖亚安祖母会面	
PRESENCE_SCENARIO_BOH3_FIGHT_02	正在与雷加尔争辩	
PRESENCE_SCENARIO_BOH3_FIGHT_03	正在征讨诺森德	
PRESENCE_SCENARIO_BOH3_FIGHT_04	正在奥格瑞玛灭火	
PRESENCE_SCENARIO_BOH3_FIGHT_05	正在荣耀决斗	
PRESENCE_SCENARIO_BOH3_FIGHT_06	正在进攻塞拉摩	
PRESENCE_SCENARIO_BOH3_FIGHT_07	正在敲响圣钟	
PRESENCE_SCENARIO_BOH3_FIGHT_08	正在奥格瑞玛被围	
PRESENCE_SCENARIO_BOH4_FIGHT_01	正在赢得大主教法奥的信赖	
PRESENCE_SCENARIO_BOH4_FIGHT_02	正在保卫洛丹伦	
PRESENCE_SCENARIO_BOH4_FIGHT_03	正在与瓦罗克·萨鲁法尔决斗	
PRESENCE_SCENARIO_BOH4_FIGHT_04	正在摧毁黑暗之门	
PRESENCE_SCENARIO_BOH4_FIGHT_05	正在从剑圣手中拯救村民	
PRESENCE_SCENARIO_BOH4_FIGHT_06	正在救援壁炉谷	
PRESENCE_SCENARIO_BOH4_FIGHT_07	正在向斯坦索姆进发	
PRESENCE_SCENARIO_BOH4_FIGHT_08	正在面对阿尔萨斯	
PRESENCE_SCENARIO_BOH5_FIGHT_01	正在惹瓦里安生气	
PRESENCE_SCENARIO_BOH5_FIGHT_02	正在劝说吉安娜	
PRESENCE_SCENARIO_BOH5_FIGHT_03	正在和茉艾拉和谈	
PRESENCE_SCENARIO_BOH5_FIGHT_04	正在向维伦学习	
PRESENCE_SCENARIO_BOH5_FIGHT_05	正在摆脱纳兹格林	
PRESENCE_SCENARIO_BOH5_FIGHT_06	正在破解美猴王的谜题	
PRESENCE_SCENARIO_BOH5_FIGHT_07	正在挥动祥和钟杵	
PRESENCE_SCENARIO_BOH5_FIGHT_08	正在为洛丹伦而战	
PRESENCE_SCENARIO_BOH6_FIGHT_01	正在接受竞技训练	
PRESENCE_SCENARIO_BOH6_FIGHT_02	正在向赫尔卡展示实力	
PRESENCE_SCENARIO_BOH6_FIGHT_03	正在对阵来袭的刺客	
PRESENCE_SCENARIO_BOH6_FIGHT_04	正在遭受恶魔附身	
PRESENCE_SCENARIO_BOH6_FIGHT_05	正在参与外交谈判	
PRESENCE_SCENARIO_BOH6_FIGHT_06	正在审问迦罗娜	
PRESENCE_SCENARIO_BOH6_FIGHT_07	正在迎战暮光之锤	
PRESENCE_SCENARIO_BOH6_FIGHT_08	正在了解拉文霍德的秘密	
PRESENCE_SCENARIO_BOH7_FIGHT_01	正在受布莱克摩尔剥削	
PRESENCE_SCENARIO_BOH7_FIGHT_02	正在学习萨满之道	
PRESENCE_SCENARIO_BOH7_FIGHT_03	正在与陌生人交谈	
PRESENCE_SCENARIO_BOH7_FIGHT_04	正在迎战玛诺洛斯	
PRESENCE_SCENARIO_BOH7_FIGHT_05	正在力战阿克蒙德	
PRESENCE_SCENARIO_BOH7_FIGHT_06	正在对阵死亡之翼	
PRESENCE_SCENARIO_BOH7_FIGHT_07	正在阻止吉安娜	
PRESENCE_SCENARIO_BOH7_FIGHT_08	正在罢黜加尔鲁什	
PRESENCE_SCENARIO_BOH8_FIGHT_01	正在接受教导	
PRESENCE_SCENARIO_BOH8_FIGHT_02	正在迎战燃烧军团	
PRESENCE_SCENARIO_BOH8_FIGHT_03	正在与兄弟争执	
PRESENCE_SCENARIO_BOH8_FIGHT_04	正在拯救诺达希尔	
PRESENCE_SCENARIO_BOH8_FIGHT_05	正在与兄弟再次争执	
PRESENCE_SCENARIO_BOH8_FIGHT_06	正在面对翡翠梦魇	
PRESENCE_SCENARIO_BOH8_FIGHT_07	正在守护海加尔山	
PRESENCE_SCENARIO_BOH8_FIGHT_08	正在保卫泰达希尔	
PRESENCE_SCENARIO_BOH9_FIGHT_01	正在被赶出氏族	
PRESENCE_SCENARIO_BOH9_FIGHT_02	正在向元素王座祈求	
PRESENCE_SCENARIO_BOH9_FIGHT_03	正在面见耐奥祖	
PRESENCE_SCENARIO_BOH9_FIGHT_04	正在腐蚀部落	
PRESENCE_SCENARIO_BOH9_FIGHT_05	正在接受麦迪文的召唤	
PRESENCE_SCENARIO_BOH9_FIGHT_06	正在面对奥格瑞姆的怒火	
PRESENCE_SCENARIO_BOH9_FIGHT_07	正在与塔隆戈尔重逢	
PRESENCE_SCENARIO_BOH9_FIGHT_08	正在探索萨格拉斯之墓	
PRESENCE_SCENARIO_BOM_FIGHT_01	正在对战布鲁坎	
PRESENCE_SCENARIO_BOM_FIGHT_02	正在和古夫游逛	
PRESENCE_SCENARIO_BOM_FIGHT_03	正在驯服亡灵野猪人	
PRESENCE_SCENARIO_BOM_FIGHT_04	正在狩猎稀有的猎物	
PRESENCE_SCENARIO_BOM_FIGHT_05	正在保护碎片	
PRESENCE_SCENARIO_BOM_FIGHT_06	正在对付双辫将军	
PRESENCE_SCENARIO_BOM_FIGHT_07	正在寻找费格雷	
PRESENCE_SCENARIO_BOM_FIGHT_08	正在面对加尔鲁什	
PRESENCE_SCENARIO_BOM10_FIGHT_01	正在纪念一位佣兵	
PRESENCE_SCENARIO_BOM10_FIGHT_02	正在向洛瑟玛讨教	
PRESENCE_SCENARIO_BOM10_FIGHT_03	正在紧跟瓦里安国王	
PRESENCE_SCENARIO_BOM10_FIGHT_04	正在进入奥妮克希亚的巢穴	
PRESENCE_SCENARIO_BOM10_FIGHT_05	正在雏龙群中奋战	
PRESENCE_SCENARIO_BOM10_FIGHT_06	正在对阵龙巢之母	
PRESENCE_SCENARIO_BOM10_FIGHT_07	正在摆脱敌人	
PRESENCE_SCENARIO_BOM10_FIGHT_08	正在与纳鲁沟通	
PRESENCE_SCENARIO_BOM2_FIGHT_01	正在观察哨所	
PRESENCE_SCENARIO_BOM2_FIGHT_02	正在诓骗塞瑞娜	
PRESENCE_SCENARIO_BOM2_FIGHT_03	正在和当地人会面	
PRESENCE_SCENARIO_BOM2_FIGHT_04	正在完成今日指标	
PRESENCE_SCENARIO_BOM2_FIGHT_05	正在劫持伐木机	
PRESENCE_SCENARIO_BOM2_FIGHT_06	正在突破闯入	
PRESENCE_SCENARIO_BOM2_FIGHT_07	正在解决八爪机械	
PRESENCE_SCENARIO_BOM2_FIGHT_08	正在握持圣光碎片	
PRESENCE_SCENARIO_BOM3_FIGHT_01	正在帮助哈缪尔	
PRESENCE_SCENARIO_BOM3_FIGHT_02	正在寻找裂隙	
PRESENCE_SCENARIO_BOM3_FIGHT_03	正在和科卡尔作战	
PRESENCE_SCENARIO_BOM3_FIGHT_04	正在保护钳嘴龟	
PRESENCE_SCENARIO_BOM3_FIGHT_05	正在寻求组队	
PRESENCE_SCENARIO_BOM3_FIGHT_06	正在对战毒牙之王	
PRESENCE_SCENARIO_BOM3_FIGHT_07	正在面见穆坦努斯	
PRESENCE_SCENARIO_BOM3_FIGHT_08	正在和纳拉雷克斯交谈	
PRESENCE_SCENARIO_BOM4_FIGHT_01	正在保护圣骑士	
PRESENCE_SCENARIO_BOM4_FIGHT_02	正在应对流放者	
PRESENCE_SCENARIO_BOM4_FIGHT_03	正在预演复仇	
PRESENCE_SCENARIO_BOM4_FIGHT_04	正在集结小队	
PRESENCE_SCENARIO_BOM4_FIGHT_05	正在对战火刃氏族	
PRESENCE_SCENARIO_BOM4_FIGHT_06	正在和卡扎库斯扎营	
PRESENCE_SCENARIO_BOM4_FIGHT_07	正在和尼尔鲁战斗	
PRESENCE_SCENARIO_BOM4_FIGHT_08	正在与塔姆辛纠缠	
PRESENCE_SCENARIO_BOM5_FIGHT_01	正在向库尔特鲁斯讲述	
PRESENCE_SCENARIO_BOM5_FIGHT_02	正在和钩牙讨价还价	
PRESENCE_SCENARIO_BOM5_FIGHT_03	正在暴风城施暴	
PRESENCE_SCENARIO_BOM5_FIGHT_04	正在与朋友交战	
PRESENCE_SCENARIO_BOM5_FIGHT_05	正在挑战奶酪商	
PRESENCE_SCENARIO_BOM5_FIGHT_06	正在迎战泽瑞拉	
PRESENCE_SCENARIO_BOM5_FIGHT_07	正在招来安纳塞隆	
PRESENCE_SCENARIO_BOM5_FIGHT_08	正在腐蚀考内留斯	
PRESENCE_SCENARIO_BOM6_FIGHT_01	正在姐妹对练	
PRESENCE_SCENARIO_BOM6_FIGHT_02	正在与恶魔猎手对决	
PRESENCE_SCENARIO_BOM6_FIGHT_03	正在回家路上	
PRESENCE_SCENARIO_BOM6_FIGHT_04	正在保卫矮人区	
PRESENCE_SCENARIO_BOM6_FIGHT_05	正在解救朋友	
PRESENCE_SCENARIO_BOM6_FIGHT_06	正在攻击安纳塞隆	
PRESENCE_SCENARIO_BOM6_FIGHT_07	正在与怪物厮斗	
PRESENCE_SCENARIO_BOM6_FIGHT_08	正在挑战塔姆辛	
PRESENCE_SCENARIO_BOM7_FIGHT_01	正在对战鲍勃	
PRESENCE_SCENARIO_BOM7_FIGHT_02	正在揪出叛徒	
PRESENCE_SCENARIO_BOM7_FIGHT_03	正在解决霍格	
PRESENCE_SCENARIO_BOM7_FIGHT_04	正在破出困局	
PRESENCE_SCENARIO_BOM7_FIGHT_05	正在深入死亡矿井	
PRESENCE_SCENARIO_BOM7_FIGHT_06	正在重殴重拳先生	
PRESENCE_SCENARIO_BOM7_FIGHT_07	正在和曲奇一起下厨	
PRESENCE_SCENARIO_BOM7_FIGHT_08	正在抹杀艾德温	
PRESENCE_SCENARIO_BOM8_FIGHT_01	正在劝服范达尔	
PRESENCE_SCENARIO_BOM8_FIGHT_02	正在调查深铁矿洞	
PRESENCE_SCENARIO_BOM8_FIGHT_03	正在对付部落	
PRESENCE_SCENARIO_BOM8_FIGHT_04	正在营火旁烹饪	
PRESENCE_SCENARIO_BOM8_FIGHT_05	正在征战平原征战	
PRESENCE_SCENARIO_BOM8_FIGHT_06	正在封锁桥梁	
PRESENCE_SCENARIO_BOM8_FIGHT_07	正在为佣兵破冰	
PRESENCE_SCENARIO_BOM8_FIGHT_08	正在了解真相	
PRESENCE_SCENARIO_BOM9_FIGHT_01	正在应对恐惧巫妖	
PRESENCE_SCENARIO_BOM9_FIGHT_02	正在清理营火	
PRESENCE_SCENARIO_BOM9_FIGHT_03	正在对战艾克曼	
PRESENCE_SCENARIO_BOM9_FIGHT_04	正在拿走蜡烛	
PRESENCE_SCENARIO_BOM9_FIGHT_05	正在回忆往事	
PRESENCE_SCENARIO_BOM9_FIGHT_06	正在制服洛克霍拉	
PRESENCE_SCENARIO_BOM9_FIGHT_07	正在消弭纷争	
PRESENCE_SCENARIO_BOM9_FIGHT_08	正在终结巫妖	
PRESENCE_SCENARIO_BOTA_CLEAR_BOOM	正在破解一个谜题	
PRESENCE_SCENARIO_BOTA_CLEAR_PUZZLE_1	正在破解一个谜题	
PRESENCE_SCENARIO_BOTA_CLEAR_PUZZLE_2	正在破解一个谜题	
PRESENCE_SCENARIO_BOTA_CLEAR_PUZZLE_3	正在破解一个谜题	
PRESENCE_SCENARIO_BOTA_CLEAR_PUZZLE_4	正在破解一个谜题	
PRESENCE_SCENARIO_BOTA_LETHAL_BOOM	正在破解一个谜题	
PRESENCE_SCENARIO_BOTA_LETHAL_PUZZLE_1	正在破解一个谜题	
PRESENCE_SCENARIO_BOTA_LETHAL_PUZZLE_2	正在破解一个谜题	
PRESENCE_SCENARIO_BOTA_LETHAL_PUZZLE_3	正在破解一个谜题	
PRESENCE_SCENARIO_BOTA_LETHAL_PUZZLE_4	正在破解一个谜题	
PRESENCE_SCENARIO_BOTA_MIRROR_BOOM	正在破解一个谜题	
PRESENCE_SCENARIO_BOTA_MIRROR_PUZZLE_1	正在破解一个谜题	
PRESENCE_SCENARIO_BOTA_MIRROR_PUZZLE_2	正在破解一个谜题	
PRESENCE_SCENARIO_BOTA_MIRROR_PUZZLE_3	正在破解一个谜题	
PRESENCE_SCENARIO_BOTA_MIRROR_PUZZLE_4	正在破解一个谜题	
PRESENCE_SCENARIO_BOTA_SURVIVAL_BOOM	正在破解一个谜题	
PRESENCE_SCENARIO_BOTA_SURVIVAL_PUZZLE_1	正在破解一个谜题	
PRESENCE_SCENARIO_BOTA_SURVIVAL_PUZZLE_2	正在破解一个谜题	
PRESENCE_SCENARIO_BOTA_SURVIVAL_PUZZLE_3	正在破解一个谜题	
PRESENCE_SCENARIO_BOTA_SURVIVAL_PUZZLE_4	正在破解一个谜题	
PRESENCE_SCENARIO_BRM_CLASS_CHALLENGE_DRUID	黑石山德鲁伊职业挑战	
PRESENCE_SCENARIO_BRM_CLASS_CHALLENGE_HUNTER	黑石山猎人职业挑战	
PRESENCE_SCENARIO_BRM_CLASS_CHALLENGE_MAGE	黑石山法师职业挑战	
PRESENCE_SCENARIO_BRM_CLASS_CHALLENGE_PALADIN	黑石山圣骑士职业挑战	
PRESENCE_SCENARIO_BRM_CLASS_CHALLENGE_PRIEST	黑石山牧师职业挑战	
PRESENCE_SCENARIO_BRM_CLASS_CHALLENGE_ROGUE	黑石山潜行者职业挑战	
PRESENCE_SCENARIO_BRM_CLASS_CHALLENGE_SHAMAN	黑石山萨满祭司职业挑战	
PRESENCE_SCENARIO_BRM_CLASS_CHALLENGE_WARLOCK	黑石山术士职业挑战	
PRESENCE_SCENARIO_BRM_CLASS_CHALLENGE_WARRIOR	黑石山战士职业挑战	
PRESENCE_SCENARIO_BRM_HEROIC_SCENARIO_ATRAMEDES	英雄难度艾卓曼德斯	
PRESENCE_SCENARIO_BRM_HEROIC_SCENARIO_BARON_GEDDON	英雄难度迦顿男爵	
PRESENCE_SCENARIO_BRM_HEROIC_SCENARIO_CHROMAGGUS	英雄难度克洛玛古斯	
PRESENCE_SCENARIO_BRM_HEROIC_SCENARIO_DARK_IRON_ARENA	英雄难度黑铁竞技场	feel free to shorten long translations since the UI may squeeze text into a tiny (unreadable) font size when text is too long. this string is shown in the Friends List.
PRESENCE_SCENARIO_BRM_HEROIC_SCENARIO_DRAKKISATH	英雄难度达基萨斯	
PRESENCE_SCENARIO_BRM_HEROIC_SCENARIO_GARR	英雄难度加尔	
PRESENCE_SCENARIO_BRM_HEROIC_SCENARIO_GRIM_GUZZLER	英雄难度黑铁酒吧	
PRESENCE_SCENARIO_BRM_HEROIC_SCENARIO_MAJORDOMO	英雄难度炎魔之王拉格纳罗斯	feel free to shorten long translations to 'Heroic Ragnaros' since the UI may squeeze text into a tiny (unreadable) font size when text is too long. this string is shown in the Friends List.
PRESENCE_SCENARIO_BRM_HEROIC_SCENARIO_MALORIAK	英雄难度马洛拉克	
PRESENCE_SCENARIO_BRM_HEROIC_SCENARIO_NEFARIAN	英雄难度维克多·奈法里奥斯	feel free to shorten long translations to 'Heroic Nefarius' since the UI may squeeze text into a tiny (unreadable) font size when text is too long. this string is shown in the Friends List.
PRESENCE_SCENARIO_BRM_HEROIC_SCENARIO_OMNOTRON	英雄难度全能金刚	
PRESENCE_SCENARIO_BRM_HEROIC_SCENARIO_OMOKK	英雄难度欧莫克	
PRESENCE_SCENARIO_BRM_HEROIC_SCENARIO_RAZORGORE	英雄难度拉佐格尔	
PRESENCE_SCENARIO_BRM_HEROIC_SCENARIO_REND_BLACKHAND	英雄难度雷德·黑手	
PRESENCE_SCENARIO_BRM_HEROIC_SCENARIO_THAURISSAN	英雄难度索瑞森大帝	feel free to shorten long translations to 'Heroic Thaurissan' since the UI may squeeze text into a tiny (unreadable) font size when text is too long. this string is shown in the Friends List.
PRESENCE_SCENARIO_BRM_HEROIC_SCENARIO_VAELASTRASZ	英雄难度瓦拉斯塔兹	
PRESENCE_SCENARIO_BRM_HEROIC_SCENARIO_ZOMBIE_NEF	英雄难度奈法利安	
PRESENCE_SCENARIO_BRM_NORMAL_SCENARIO_ATRAMEDES	正在与艾卓曼德斯交战	
PRESENCE_SCENARIO_BRM_NORMAL_SCENARIO_BARON_GEDDON	正在与迦顿男爵交战	
PRESENCE_SCENARIO_BRM_NORMAL_SCENARIO_CHROMAGGUS	正在与克洛玛古斯交战	
PRESENCE_SCENARIO_BRM_NORMAL_SCENARIO_DARK_IRON_ARENA	正在黑铁竞技场中战斗	feel free to shorten long translations since the UI may squeeze text into a tiny (unreadable) font size when text is too long. this string is shown in the Friends List.
PRESENCE_SCENARIO_BRM_NORMAL_SCENARIO_DRAKKISATH	正在与达基萨斯交战	
PRESENCE_SCENARIO_BRM_NORMAL_SCENARIO_GARR	正在与加尔交战	
PRESENCE_SCENARIO_BRM_NORMAL_SCENARIO_GRIM_GUZZLER	正在黑铁酒吧中战斗	
PRESENCE_SCENARIO_BRM_NORMAL_SCENARIO_MAJORDOMO	正在与拉格纳罗斯交战	feel free to shorten long translations to 'Battling Ragnaros' since the UI may squeeze text into a tiny (unreadable) font size when text is too long. this string is shown in the Friends List.
PRESENCE_SCENARIO_BRM_NORMAL_SCENARIO_MALORIAK	正在与马洛拉克交战	
PRESENCE_SCENARIO_BRM_NORMAL_SCENARIO_NEFARIAN	正在与奈法里奥斯交战	feel free to shorten long translations to 'Battling Nefarius' since the UI may squeeze text into a tiny (unreadable) font size when text is too long. this string is shown in the Friends List.
PRESENCE_SCENARIO_BRM_NORMAL_SCENARIO_OMNOTRON	正在与全能金刚交战	
PRESENCE_SCENARIO_BRM_NORMAL_SCENARIO_OMOKK	正在与欧莫克交战	
PRESENCE_SCENARIO_BRM_NORMAL_SCENARIO_RAZORGORE	正在与拉佐格尔交战	
PRESENCE_SCENARIO_BRM_NORMAL_SCENARIO_REND_BLACKHAND	正在与雷德·黑手交战	
PRESENCE_SCENARIO_BRM_NORMAL_SCENARIO_THAURISSAN	正在与索瑞森大帝交战	feel free to shorten long translations to 'Battling Thaurissan' since the UI may squeeze text into a tiny (unreadable) font size when text is too long. this string is shown in the Friends List.
PRESENCE_SCENARIO_BRM_NORMAL_SCENARIO_VAELASTRASZ	正在与瓦拉斯塔兹交战	
PRESENCE_SCENARIO_BRM_NORMAL_SCENARIO_ZOMBIE_NEF	正在与奈法利安交战	
PRESENCE_SCENARIO_BTA_COIN_01_INQUISITOR_DAKREL	正在探索地狱火半岛	
PRESENCE_SCENARIO_BTA_COIN_02_XUR_GOTH	正在探索地狱火半岛	
PRESENCE_SCENARIO_BTA_COIN_03_ZIXOR	正在探索地狱火半岛	
PRESENCE_SCENARIO_BTA_COIN_04_BALTHARAK	正在探索地狱火半岛	
PRESENCE_SCENARIO_BTA_COIN_05_KANRETHAD_PRIME	正在穿过赞加沼泽	
PRESENCE_SCENARIO_BTA_COIN_06_BURGRAK_CRUELCHAIN	正在穿过赞加沼泽	
PRESENCE_SCENARIO_BTA_COIN_07_FELSTORM_RUN	正在穿过赞加沼泽	
PRESENCE_SCENARIO_BTA_COIN_08_MOTHER_SHAHRAZ	正在穿过赞加沼泽	
PRESENCE_SCENARIO_BTA_COIN_09_SHAL_JA_OUTCAST	正在黑暗神殿训练	
PRESENCE_SCENARIO_BTA_COIN_10_KARNUK_OUTCAST	正在黑暗神殿训练	
PRESENCE_SCENARIO_BTA_COIN_11_JEK_HAZ	正在黑暗神殿训练	
PRESENCE_SCENARIO_BTA_COIN_12_MAGTHERIDON_PRIME	正在黑暗神殿训练	
PRESENCE_SCENARIO_BTA_COIN_13_GOK_AMOK	正在虚空风暴战斗	
PRESENCE_SCENARIO_BTA_COIN_14_FLIKK	正在虚空风暴战斗	
PRESENCE_SCENARIO_BTA_COIN_15_BADUU_CORRUPTED	正在虚空风暴战斗	
PRESENCE_SCENARIO_BTA_COIN_16_MECHA_JARAXXUS	正在虚空风暴战斗	
PRESENCE_SCENARIO_BTA_COIN_17_ILLIDAN_STORMRAGE	正在守护外域的命运	
PRESENCE_SCENARIO_BTA_HEROIC_COIN_01_KAZZAK	正在挑战外域的强者	
PRESENCE_SCENARIO_BTA_HEROIC_COIN_02_GRUUL	正在挑战外域的强者	
PRESENCE_SCENARIO_BTA_HEROIC_COIN_03_MAGTHERIDON	正在挑战外域的强者	
PRESENCE_SCENARIO_BTA_HEROIC_COIN_04_SUPREMUS	正在挑战外域的强者	
PRESENCE_SCENARIO_BTA_HEROIC_COIN_05_TERON_GOREFIEND	正在挑战外域的强者	
PRESENCE_SCENARIO_BTA_HEROIC_COIN_06_MOTHER_SHARAZ	正在挑战外域的强者	
PRESENCE_SCENARIO_BTA_HEROIC_COIN_07_LADY_VASHJ	正在挑战外域的强者	
PRESENCE_SCENARIO_BTA_HEROIC_COIN_08_KAELTHAS	正在挑战外域的强者	
PRESENCE_SCENARIO_BTA_HEROIC_COIN_09_ILLIDAN	正在挑战外域的强者	
PRESENCE_SCENARIO_BTP_COIN_01_AZZINOTH	正在抗击军团！	
PRESENCE_SCENARIO_BTP_COIN_02_XAVIUS	正在背弃忠诚！	
PRESENCE_SCENARIO_BTP_COIN_03_MANNOROTH	正在驱逐恶魔！	
PRESENCE_SCENARIO_BTP_COIN_04_CENARIUS	正在直面问责！	
PRESENCE_SCENARIO_DALA_01_BANK	正在劫掠达拉然银行	
PRESENCE_SCENARIO_DALA_01_BANK_HEROIC	正在劫掠达拉然银行	
PRESENCE_SCENARIO_DALA_02_VIOLET_HOLD	正在打开紫罗兰监狱	
PRESENCE_SCENARIO_DALA_02_VIOLET_HOLD_HEROIC	正在打开紫罗兰监狱	
PRESENCE_SCENARIO_DALA_03_STREETS	正在扰乱达拉然街道	
PRESENCE_SCENARIO_DALA_03_STREETS_HEROIC	正在扰乱达拉然街道	
PRESENCE_SCENARIO_DALA_04_UNDERBELLY	正在潜入达拉然下水道	
PRESENCE_SCENARIO_DALA_04_UNDERBELLY_HEROIC	正在潜入达拉然下水道	
PRESENCE_SCENARIO_DALA_05_CITADEL	正在攻占紫罗兰城堡	
PRESENCE_SCENARIO_DALA_05_CITADEL_HEROIC	正在攻占紫罗兰城堡	
PRESENCE_SCENARIO_DALA_TAVERN	正在达拉然的旅店密谋	
PRESENCE_SCENARIO_DALA_TAVERN_HEROIC	正在达拉然的旅店密谋	
PRESENCE_SCENARIO_DRGA_EVIL_CHAPTER_01_COIN_01	正在龙骨荒野上空激战	
PRESENCE_SCENARIO_DRGA_EVIL_CHAPTER_01_COIN_01_HEROIC	正在龙骨荒野上空激战	
PRESENCE_SCENARIO_DRGA_EVIL_CHAPTER_01_COIN_02	正在龙骨荒野上空激战	
PRESENCE_SCENARIO_DRGA_EVIL_CHAPTER_01_COIN_02_HEROIC	正在龙骨荒野上空激战	
PRESENCE_SCENARIO_DRGA_EVIL_CHAPTER_01_COIN_03	正在龙骨荒野上空激战	
PRESENCE_SCENARIO_DRGA_EVIL_CHAPTER_01_COIN_03_HEROIC	正在龙骨荒野上空激战	
PRESENCE_SCENARIO_DRGA_EVIL_CHAPTER_02_COIN_01	正在龙骨荒野上空激战	
PRESENCE_SCENARIO_DRGA_EVIL_CHAPTER_02_COIN_01_HEROIC	正在龙骨荒野上空激战	
PRESENCE_SCENARIO_DRGA_EVIL_CHAPTER_02_COIN_02	正在龙骨荒野上空激战	
PRESENCE_SCENARIO_DRGA_EVIL_CHAPTER_02_COIN_02_HEROIC	正在龙骨荒野上空激战	
PRESENCE_SCENARIO_DRGA_EVIL_CHAPTER_02_COIN_03	正在龙骨荒野上空激战	
PRESENCE_SCENARIO_DRGA_EVIL_CHAPTER_02_COIN_03_HEROIC	正在龙骨荒野上空激战	
PRESENCE_SCENARIO_DRGA_EVIL_CHAPTER_03_COIN_01	正在龙骨荒野上空激战	
PRESENCE_SCENARIO_DRGA_EVIL_CHAPTER_03_COIN_01_HEROIC	正在龙骨荒野上空激战	
PRESENCE_SCENARIO_DRGA_EVIL_CHAPTER_03_COIN_02	正在龙骨荒野上空激战	
PRESENCE_SCENARIO_DRGA_EVIL_CHAPTER_03_COIN_02_HEROIC	正在龙骨荒野上空激战	
PRESENCE_SCENARIO_DRGA_EVIL_CHAPTER_03_COIN_03	正在龙骨荒野上空激战	
PRESENCE_SCENARIO_DRGA_EVIL_CHAPTER_03_COIN_03_HEROIC	正在龙骨荒野上空激战	
PRESENCE_SCENARIO_DRGA_EVIL_CHAPTER_04_COIN_01	正在龙骨荒野上空激战	
PRESENCE_SCENARIO_DRGA_EVIL_CHAPTER_04_COIN_01_HEROIC	正在龙骨荒野上空激战	
PRESENCE_SCENARIO_DRGA_EVIL_CHAPTER_04_COIN_02	正在龙骨荒野上空激战	
PRESENCE_SCENARIO_DRGA_EVIL_CHAPTER_04_COIN_02_HEROIC	正在龙骨荒野上空激战	
PRESENCE_SCENARIO_DRGA_EVIL_CHAPTER_04_COIN_03	正在龙骨荒野上空激战	
PRESENCE_SCENARIO_DRGA_EVIL_CHAPTER_04_COIN_03_HEROIC	正在龙骨荒野上空激战	
PRESENCE_SCENARIO_DRGA_GOOD_CHAPTER_01_COIN_01	正在龙骨荒野上空激战	
PRESENCE_SCENARIO_DRGA_GOOD_CHAPTER_01_COIN_01_HEROIC	正在龙骨荒野上空激战	
PRESENCE_SCENARIO_DRGA_GOOD_CHAPTER_01_COIN_02	正在龙骨荒野上空激战	
PRESENCE_SCENARIO_DRGA_GOOD_CHAPTER_01_COIN_02_HEROIC	正在龙骨荒野上空激战	
PRESENCE_SCENARIO_DRGA_GOOD_CHAPTER_01_COIN_03	正在龙骨荒野上空激战	
PRESENCE_SCENARIO_DRGA_GOOD_CHAPTER_01_COIN_03_HEROIC	正在龙骨荒野上空激战	
PRESENCE_SCENARIO_DRGA_GOOD_CHAPTER_02_COIN_01	正在龙骨荒野上空激战	
PRESENCE_SCENARIO_DRGA_GOOD_CHAPTER_02_COIN_01_HEROIC	正在龙骨荒野上空激战	
PRESENCE_SCENARIO_DRGA_GOOD_CHAPTER_02_COIN_02	正在龙骨荒野上空激战	
PRESENCE_SCENARIO_DRGA_GOOD_CHAPTER_02_COIN_02_HEROIC	正在龙骨荒野上空激战	
PRESENCE_SCENARIO_DRGA_GOOD_CHAPTER_02_COIN_03	正在龙骨荒野上空激战	
PRESENCE_SCENARIO_DRGA_GOOD_CHAPTER_02_COIN_03_HEROIC	正在龙骨荒野上空激战	
PRESENCE_SCENARIO_DRGA_GOOD_CHAPTER_03_COIN_01	正在龙骨荒野上空激战	
PRESENCE_SCENARIO_DRGA_GOOD_CHAPTER_03_COIN_01_HEROIC	正在龙骨荒野上空激战	
PRESENCE_SCENARIO_DRGA_GOOD_CHAPTER_03_COIN_02	正在龙骨荒野上空激战	
PRESENCE_SCENARIO_DRGA_GOOD_CHAPTER_03_COIN_02_HEROIC	正在龙骨荒野上空激战	
PRESENCE_SCENARIO_DRGA_GOOD_CHAPTER_03_COIN_03	正在龙骨荒野上空激战	
PRESENCE_SCENARIO_DRGA_GOOD_CHAPTER_03_COIN_03_HEROIC	正在龙骨荒野上空激战	
PRESENCE_SCENARIO_DRGA_GOOD_CHAPTER_04_COIN_01	正在龙骨荒野上空激战	
PRESENCE_SCENARIO_DRGA_GOOD_CHAPTER_04_COIN_01_HEROIC	正在龙骨荒野上空激战	
PRESENCE_SCENARIO_DRGA_GOOD_CHAPTER_04_COIN_02	正在龙骨荒野上空激战	
PRESENCE_SCENARIO_DRGA_GOOD_CHAPTER_04_COIN_02_HEROIC	正在龙骨荒野上空激战	
PRESENCE_SCENARIO_DRGA_GOOD_CHAPTER_04_COIN_03	正在龙骨荒野上空激战	
PRESENCE_SCENARIO_DRGA_GOOD_CHAPTER_04_COIN_03_HEROIC	正在龙骨荒野上空激战	
PRESENCE_SCENARIO_GIL_BONUS_CHALLENGE	正在与哈加莎交战	
PRESENCE_SCENARIO_GIL_DUNGEON	正在进行怪物狩猎	
PRESENCE_SCENARIO_ICC_NORMAL_DEATHWHISPER	正在与亡语者女士交战	
PRESENCE_SCENARIO_ICC_NORMAL_FINALE	正在与巫妖王交战	
PRESENCE_SCENARIO_ICC_NORMAL_LANATHEL	正在与兰娜瑟尔交战	
PRESENCE_SCENARIO_ICC_NORMAL_LICHKING	正在输给巫妖王	
PRESENCE_SCENARIO_ICC_NORMAL_MARROWGAR	正在与玛洛加尔交战	
PRESENCE_SCENARIO_ICC_NORMAL_PUTRICIDE	正在与普崔塞德交战	
PRESENCE_SCENARIO_ICC_NORMAL_SAURFANG	正在与萨鲁法尔交战	
PRESENCE_SCENARIO_ICC_NORMAL_SINDRAGOSA	正在与辛达苟萨交战	
PRESENCE_SCENARIO_KAR_CLASS_CHALLENGE_DRUID	卡拉赞德鲁伊职业挑战	
PRESENCE_SCENARIO_KAR_CLASS_CHALLENGE_HUNTER	卡拉赞猎人职业挑战	
PRESENCE_SCENARIO_KAR_CLASS_CHALLENGE_MAGE	卡拉赞法师职业挑战	
PRESENCE_SCENARIO_KAR_CLASS_CHALLENGE_PALADIN	卡拉赞圣骑士职业挑战	
PRESENCE_SCENARIO_KAR_CLASS_CHALLENGE_PRIEST	卡拉赞牧师职业挑战	
PRESENCE_SCENARIO_KAR_CLASS_CHALLENGE_ROGUE	卡拉赞潜行者职业挑战	
PRESENCE_SCENARIO_KAR_CLASS_CHALLENGE_SHAMAN	卡拉赞萨满祭司职业挑战	
PRESENCE_SCENARIO_KAR_CLASS_CHALLENGE_WARLOCK	卡拉赞术士职业挑战	
PRESENCE_SCENARIO_KAR_CLASS_CHALLENGE_WARRIOR	卡拉赞战士职业挑战	
PRESENCE_SCENARIO_KAR_HEROIC_ARAN	英雄难度埃兰之影	
PRESENCE_SCENARIO_KAR_HEROIC_CHESS	英雄难度象棋	
PRESENCE_SCENARIO_KAR_HEROIC_CRONE	英雄难度巫婆	
PRESENCE_SCENARIO_KAR_HEROIC_CURATOR	英雄难度馆长	
PRESENCE_SCENARIO_KAR_HEROIC_ILLHOOF	英雄难度邪蹄	
PRESENCE_SCENARIO_KAR_HEROIC_JULIANNE	英雄难度朱丽叶	
PRESENCE_SCENARIO_KAR_HEROIC_MIRROR	英雄难度魔镜	
PRESENCE_SCENARIO_KAR_HEROIC_NETHERSPITE	英雄难度虚空幽龙	
PRESENCE_SCENARIO_KAR_HEROIC_NIGHTBANE	英雄难度夜之魇	
PRESENCE_SCENARIO_KAR_HEROIC_PANTRY	英雄难度镀银魔像	
PRESENCE_SCENARIO_KAR_HEROIC_PORTALS	英雄难度营救麦迪文	
PRESENCE_SCENARIO_KAR_HEROIC_PROLOGUE	英雄难度玛克扎尔	
PRESENCE_SCENARIO_KAR_HEROIC_WOLF	英雄难度大灰狼	
PRESENCE_SCENARIO_KAR_NORMAL_ARAN	正在与埃兰之影交战	
PRESENCE_SCENARIO_KAR_NORMAL_CHESS	正在与象棋交战	
PRESENCE_SCENARIO_KAR_NORMAL_CRONE	正在与巫婆交战	
PRESENCE_SCENARIO_KAR_NORMAL_CURATOR	正在与馆长交战	
PRESENCE_SCENARIO_KAR_NORMAL_ILLHOOF	正在与邪蹄交战	
PRESENCE_SCENARIO_KAR_NORMAL_JULIANNE	正在与朱丽叶交战	
PRESENCE_SCENARIO_KAR_NORMAL_MIRROR	正在与魔镜交战	
PRESENCE_SCENARIO_KAR_NORMAL_NETHERSPITE	正在与虚空幽龙交战	
PRESENCE_SCENARIO_KAR_NORMAL_NIGHTBANE	正在与夜之魇交战	
PRESENCE_SCENARIO_KAR_NORMAL_PANTRY	正在与镀银魔像交战	
PRESENCE_SCENARIO_KAR_NORMAL_PORTALS	正在营救麦迪文	
PRESENCE_SCENARIO_KAR_NORMAL_PROLOGUE	正在与玛克扎尔交战	
PRESENCE_SCENARIO_KAR_NORMAL_WOLF	正在与大灰狼交战	
PRESENCE_SCENARIO_LOE_CLASS_CHALLENGE_DRUID	探险者协会德鲁伊职业挑战	
PRESENCE_SCENARIO_LOE_CLASS_CHALLENGE_HUNTER	探险者协会猎人职业挑战	
PRESENCE_SCENARIO_LOE_CLASS_CHALLENGE_MAGE	探险者协会法师职业挑战	
PRESENCE_SCENARIO_LOE_CLASS_CHALLENGE_PALADIN	探险者协会圣骑士职业挑战	
PRESENCE_SCENARIO_LOE_CLASS_CHALLENGE_PRIEST	探险者协会牧师职业挑战	
PRESENCE_SCENARIO_LOE_CLASS_CHALLENGE_ROGUE	探险者协会潜行者职业挑战	
PRESENCE_SCENARIO_LOE_CLASS_CHALLENGE_SHAMAN	探险者协会萨满祭司职业挑战	
PRESENCE_SCENARIO_LOE_CLASS_CHALLENGE_WARLOCK	探险者协会术士职业挑战	
PRESENCE_SCENARIO_LOE_CLASS_CHALLENGE_WARRIOR	探险者协会战士职业挑战	
PRESENCE_SCENARIO_LOE_HEROIC_ARCHAEDAS	英雄难度阿扎达斯	
PRESENCE_SCENARIO_LOE_HEROIC_GIANTFIN	英雄难度老蓟皮	
PRESENCE_SCENARIO_LOE_HEROIC_LADY_NAZJAR	英雄难度纳兹夏尔女士	
PRESENCE_SCENARIO_LOE_HEROIC_MINE_CART	英雄难度云霄矿车	
PRESENCE_SCENARIO_LOE_HEROIC_RAFAAM_1	英雄难度虚灵大盗拉法姆	
PRESENCE_SCENARIO_LOE_HEROIC_RAFAAM_2	英雄难度终极形态拉法姆	
PRESENCE_SCENARIO_LOE_HEROIC_SCARVASH	英雄难度斯卡瓦什酋长	
PRESENCE_SCENARIO_LOE_HEROIC_SKELESAURUS	英雄难度骨龙海克斯	
PRESENCE_SCENARIO_LOE_HEROIC_SLITHERSPEAR	英雄难度滑矛领主	
PRESENCE_SCENARIO_LOE_HEROIC_STEEL_SENTINEL	英雄难度钢铁卫士	
PRESENCE_SCENARIO_LOE_HEROIC_SUN_RAIDER_PHAERIX	英雄难度菲利克斯·掠日者	
PRESENCE_SCENARIO_LOE_HEROIC_TEMPLE_ESCAPE	英雄难度神庙逃亡	
PRESENCE_SCENARIO_LOE_HEROIC_ZINAAR	英雄难度辛纳尔	
PRESENCE_SCENARIO_LOE_NORMAL_ARCHAEDAS	正在与阿扎达斯交战	
PRESENCE_SCENARIO_LOE_NORMAL_GIANTFIN	正在与老蓟皮交战	
PRESENCE_SCENARIO_LOE_NORMAL_LADY_NAZJAR	正在与纳兹夏尔女士交战	
PRESENCE_SCENARIO_LOE_NORMAL_MINE_CART	云霄矿车	
PRESENCE_SCENARIO_LOE_NORMAL_RAFAAM_1	正在与虚灵大盗拉法姆交战	
PRESENCE_SCENARIO_LOE_NORMAL_RAFAAM_2	正在与终极形态拉法姆交战	
PRESENCE_SCENARIO_LOE_NORMAL_SCARVASH	正在与斯卡瓦什酋长交战	
PRESENCE_SCENARIO_LOE_NORMAL_SKELESAURUS	正在与骨龙海克斯交战	
PRESENCE_SCENARIO_LOE_NORMAL_SLITHERSPEAR	正在与滑矛领主交战	
PRESENCE_SCENARIO_LOE_NORMAL_STEEL_SENTINEL	正在与钢铁卫士交战	
PRESENCE_SCENARIO_LOE_NORMAL_SUN_RAIDER_PHAERIX	正在与菲利克斯交战	
PRESENCE_SCENARIO_LOE_NORMAL_TEMPLE_ESCAPE	神庙逃亡	
PRESENCE_SCENARIO_LOE_NORMAL_ZINAAR	正在与辛纳尔交战	
PRESENCE_SCENARIO_LOOT_DUNGEON	正在进行地下城冒险	
PRESENCE_SCENARIO_NAXX_CLASS_CHALLENGE_DRUID	纳克萨玛斯德鲁伊职业挑战	
PRESENCE_SCENARIO_NAXX_CLASS_CHALLENGE_HUNTER	纳克萨玛斯猎人职业挑战	
PRESENCE_SCENARIO_NAXX_CLASS_CHALLENGE_MAGE	纳克萨玛斯法师职业挑战	
PRESENCE_SCENARIO_NAXX_CLASS_CHALLENGE_PALADIN	纳克萨玛斯圣骑士职业挑战	
PRESENCE_SCENARIO_NAXX_CLASS_CHALLENGE_PRIEST	纳克萨玛斯牧师职业挑战	
PRESENCE_SCENARIO_NAXX_CLASS_CHALLENGE_ROGUE	纳克萨玛斯潜行者职业挑战	
PRESENCE_SCENARIO_NAXX_CLASS_CHALLENGE_SHAMAN	纳克萨玛斯萨满祭司职业挑战	
PRESENCE_SCENARIO_NAXX_CLASS_CHALLENGE_WARLOCK	纳克萨玛斯术士职业挑战	
PRESENCE_SCENARIO_NAXX_CLASS_CHALLENGE_WARRIOR	纳克萨玛斯战士职业挑战	
PRESENCE_SCENARIO_NAXX_HEROIC_SCENARIO_ANUBREKHAN	英雄难度阿努布雷坎	
PRESENCE_SCENARIO_NAXX_HEROIC_SCENARIO_FAERLINA	英雄难度法琳娜	feel free to shorten long translations to 'Heroic Faerlina' since the UI may squeeze text into a tiny (unreadable) font size when text is too long. this string is shown in the Friends List.
PRESENCE_SCENARIO_NAXX_HEROIC_SCENARIO_GLUTH	英雄难度格拉斯	
PRESENCE_SCENARIO_NAXX_HEROIC_SCENARIO_GOTHIK	英雄难度戈提克	feel free to shorten long translations to 'Heroic Gothik' since the UI may squeeze text into a tiny (unreadable) font size when text is too long. this string is shown in the Friends List.
PRESENCE_SCENARIO_NAXX_HEROIC_SCENARIO_GROBBULUS	英雄难度格罗布鲁斯	
PRESENCE_SCENARIO_NAXX_HEROIC_SCENARIO_HEIGAN	英雄难度希尔盖	feel free to shorten long translations to 'Heroic Heigan' since the UI may squeeze text into a tiny (unreadable) font size when text is too long. this string is shown in the Friends List.
PRESENCE_SCENARIO_NAXX_HEROIC_SCENARIO_HORSEMEN	英雄难度天启四骑士	
PRESENCE_SCENARIO_NAXX_HEROIC_SCENARIO_KELTHUZAD	英雄难度克尔苏加德	
PRESENCE_SCENARIO_NAXX_HEROIC_SCENARIO_LOATHEB	英雄难度洛欧塞布	
PRESENCE_SCENARIO_NAXX_HEROIC_SCENARIO_MAEXXNA	英雄难度迈克斯纳	
PRESENCE_SCENARIO_NAXX_HEROIC_SCENARIO_NOTH	英雄难度诺斯	feel free to shorten long translations to 'Heroic Noth' since the UI may squeeze text into a tiny (unreadable) font size when text is too long. this string is shown in the Friends List.
PRESENCE_SCENARIO_NAXX_HEROIC_SCENARIO_PATCHWERK	英雄难度帕奇维克	
PRESENCE_SCENARIO_NAXX_HEROIC_SCENARIO_RAZUVIOUS	英雄难度拉苏维奥斯	feel free to shorten long translations to 'Heroic Razuvious' since the UI may squeeze text into a tiny (unreadable) font size when text is too long. this string is shown in the Friends List.
PRESENCE_SCENARIO_NAXX_HEROIC_SCENARIO_SAPPHIRON	英雄难度萨菲隆	
PRESENCE_SCENARIO_NAXX_HEROIC_SCENARIO_THADDIUS	英雄难度塔迪乌斯	
PRESENCE_SCENARIO_NAXX_NORMAL_SCENARIO_ANUBREKHAN	正在与阿努布雷坎交战	
PRESENCE_SCENARIO_NAXX_NORMAL_SCENARIO_FAERLINA	正在与法琳娜交战	feel free to shorten long translations to 'Battling Faerlina' since the UI may squeeze text into a tiny (unreadable) font size when text is too long. this string is shown in the Friends List.
PRESENCE_SCENARIO_NAXX_NORMAL_SCENARIO_GLUTH	正在与格拉斯交战	
PRESENCE_SCENARIO_NAXX_NORMAL_SCENARIO_GOTHIK	正在与戈提克交战	feel free to shorten long translations to 'Battling Gothik' since the UI may squeeze text into a tiny (unreadable) font size when text is too long. this string is shown in the Friends List.
PRESENCE_SCENARIO_NAXX_NORMAL_SCENARIO_GROBBULUS	正在与格罗布鲁斯交战	
PRESENCE_SCENARIO_NAXX_NORMAL_SCENARIO_HEIGAN	正在与希尔盖交战	feel free to shorten long translations to 'Battling Heigan' since the UI may squeeze text into a tiny (unreadable) font size when text is too long. this is string shown in the Friends List.
PRESENCE_SCENARIO_NAXX_NORMAL_SCENARIO_HORSEMEN	正在与天启四骑士交战	
PRESENCE_SCENARIO_NAXX_NORMAL_SCENARIO_KELTHUZAD	正在与克尔苏加德交战	
PRESENCE_SCENARIO_NAXX_NORMAL_SCENARIO_LOATHEB	正在与洛欧塞布交战	
PRESENCE_SCENARIO_NAXX_NORMAL_SCENARIO_MAEXXNA	正在与迈克斯纳交战	
PRESENCE_SCENARIO_NAXX_NORMAL_SCENARIO_NOTH	正在与诺斯交战	feel free to shorten long translations to 'Battling Noth' since the UI may squeeze text into a tiny (unreadable) font size when text is too long. this string is shown in the Friends List.
PRESENCE_SCENARIO_NAXX_NORMAL_SCENARIO_PATCHWERK	正在与帕奇维克交战	
PRESENCE_SCENARIO_NAXX_NORMAL_SCENARIO_RAZUVIOUS	正在与拉苏维奥斯交战	feel free to shorten long translations to 'Battling Razuvious' since the UI may squeeze text into a tiny (unreadable) font size when text is too long. this string is shown in the Friends List.
PRESENCE_SCENARIO_NAXX_NORMAL_SCENARIO_SAPPHIRON	正在与萨菲隆交战	
PRESENCE_SCENARIO_NAXX_NORMAL_SCENARIO_THADDIUS	正在与塔迪乌斯交战	
PRESENCE_SCENARIO_RETURNING_PLAYER_CHALLENGE_1	正在进行一场回归挑战	
PRESENCE_SCENARIO_RETURNING_PLAYER_CHALLENGE_2	正在进行一场回归挑战	
PRESENCE_SCENARIO_RETURNING_PLAYER_CHALLENGE_3	正在进行一场回归挑战	
PRESENCE_SCENARIO_RLK_FIGHT_01	正在挥动霜之哀伤	
PRESENCE_SCENARIO_RLK_FIGHT_02	正在会见导师	
PRESENCE_SCENARIO_RLK_FIGHT_03	正在压向银月城	
PRESENCE_SCENARIO_RLK_FIGHT_04	正在夺取冰封王座	
PRESENCE_SCENARIO_TRL_DUNGEON	正在古拉巴什进行挑战	
PRESENCE_SCENARIO_ULD_01_CITY	正在探索失落之城	
PRESENCE_SCENARIO_ULD_01_CITY_HEROIC	正在探索失落之城	
PRESENCE_SCENARIO_ULD_02_DESERT	正在沙漠中乱闯	
PRESENCE_SCENARIO_ULD_02_DESERT_HEROIC	正在沙漠中乱闯	
PRESENCE_SCENARIO_ULD_03_TOMB	正在挖掘古墓	
PRESENCE_SCENARIO_ULD_03_TOMB_HEROIC	正在挖掘古墓	
PRESENCE_SCENARIO_ULD_04_HALLS	正在大厅中漫步	
PRESENCE_SCENARIO_ULD_04_HALLS_HEROIC	正在大厅中漫步	
PRESENCE_SCENARIO_ULD_05_SANCTUM	正在圣殿中战斗	
PRESENCE_SCENARIO_ULD_05_SANCTUM_HEROIC	正在圣殿中战斗	
PRESENCE_SCENARIO_ULD_TAVERN	正在集市购物	
PRESENCE_SCENARIO_ULD_TAVERN_HEROIC	正在集市购物	
PRESENCE_STATUS_ADVENTURE_CHOOSING_MODE	正在查看冒险模式	
PRESENCE_STATUS_ADVENTURE_SCENARIO_PLAYING_GAME	{0}	{0} replaced with the specific scenario string, via PRESENCE_SCENARIO_NAXX_*
PRESENCE_STATUS_ADVENTURE_SCENARIO_SELECT	{0}	{0} replaced with the adventure mode, via PRESENCE_ADVENTURE_MODE_*, e.g. Naxxramas (Heroic) -- (originally i wanted it to say "Mission Select: Naxxramas Class Challenge" but this got too long for the UI element.)
PRESENCE_STATUS_ARENA_FORGE	正在打造竞技模式套牌	
PRESENCE_STATUS_ARENA_GAME	正在进行竞技模式比赛	
PRESENCE_STATUS_ARENA_IDLE	正在竞技模式中逗留	
PRESENCE_STATUS_ARENA_PURCHASE	正在考虑进入竞技模式	
PRESENCE_STATUS_ARENA_QUEUE	正在寻找竞技模式对手	
PRESENCE_STATUS_ARENA_REWARD	正在打开竞技模式奖励	
PRESENCE_STATUS_BATTLEGROUNDS_GAME	正在酒馆战棋中搏杀！	
PRESENCE_STATUS_BATTLEGROUNDS_QUEUE	正在寻找酒馆战棋对手	
PRESENCE_STATUS_BATTLEGROUNDS_SCREEN	正在战棋酒馆中闲逛	
PRESENCE_STATUS_COLLECTION	正在浏览卡牌收藏	
PRESENCE_STATUS_CRAFTING	正在制作卡牌	
PRESENCE_STATUS_DECKEDITOR	正在构筑套牌	
PRESENCE_STATUS_DUELS_PURCHASE	正在考虑来场对决	
PRESENCE_STATUS_FIRESIDE_BRAWL_SCREEN	正在进入炉边乱斗	
PRESENCE_STATUS_FRIENDLY_DECKPICKER	正在准备和好友切磋	
PRESENCE_STATUS_FRIENDLY_GAME	正在和好友切磋	
PRESENCE_STATUS_HUB	正在浏览主菜单	
PRESENCE_STATUS_LOGIN	正在打开游戏	
PRESENCE_STATUS_MERCENARIES_COLLECTION	正在浏览佣兵收藏	
PRESENCE_STATUS_MERCENARIES_FRIENDLY_GAME	正在佣兵战纪中和好友对战	
PRESENCE_STATUS_MERCENARIES_FRIENDLY_LOBBY	正在准备和好友切磋	
PRESENCE_STATUS_MERCENARIES_GAME	正在进行佣兵战纪对战	
PRESENCE_STATUS_MERCENARIES_MAP	正在佣兵战纪的地图中探险	
PRESENCE_STATUS_MERCENARIES_PLAY_SCREEN	正在选择佣兵队伍	
PRESENCE_STATUS_MERCENARIES_QUEUE	正在寻找佣兵战纪的对手	
PRESENCE_STATUS_MERCENARIES_TEAM_EDITOR	正在组建佣兵队伍	
PRESENCE_STATUS_MERCENARIES_VILLAGE	正在佣兵的村庄中逗留	
PRESENCE_STATUS_MERCENARIES_VILLAGE_BUILDING_MANAGER	正在查看佣兵的工坊	
PRESENCE_STATUS_MERCENARIES_VILLAGE_MAILBOX	正在查看佣兵的信箱	
PRESENCE_STATUS_MERCENARIES_VILLAGE_PVE_BOUNTIES	正在查看佣兵的悬赏榜	
PRESENCE_STATUS_MERCENARIES_VILLAGE_PVE_ZONES	正在进入佣兵的旅行点	
PRESENCE_STATUS_MERCENARIES_VILLAGE_PVP	正在进入佣兵的决斗场	
PRESENCE_STATUS_MERCENARIES_VILLAGE_TASKBOARD	正在查看佣兵的任务栏	
PRESENCE_STATUS_PACKOPENING	正在打开卡牌包	
PRESENCE_STATUS_PLAY_BATTLEGROUNDS_DUOS	正在战棋双打中搏杀！	
PRESENCE_STATUS_PLAY_CASUAL_CLASSIC	正在进行经典休闲对战	
PRESENCE_STATUS_PLAY_CASUAL_STANDARD	正在进行标准休闲对战	
PRESENCE_STATUS_PLAY_CASUAL_TWIST	正在进行幻变休闲对战	
PRESENCE_STATUS_PLAY_CASUAL_WILD	正在进行狂野休闲对战	
PRESENCE_STATUS_PLAY_DECKPICKER	正在进入传统对战	
PRESENCE_STATUS_PLAY_GAME	正在进行传统对战	
PRESENCE_STATUS_PLAY_QUEUE	正在寻找对手	
PRESENCE_STATUS_PLAY_RANKED_CLASSIC	正在进行经典排名对战	
PRESENCE_STATUS_PLAY_RANKED_STANDARD	正在进行标准排名对战	
PRESENCE_STATUS_PLAY_RANKED_TWIST	正在进行幻变排名对战	
PRESENCE_STATUS_PLAY_RANKED_WILD	正在进行狂野排名对战	
PRESENCE_STATUS_PRACTICE_DECKPICKER	正在进入练习模式	
PRESENCE_STATUS_PRACTICE_GAME	正在与旅店老板进行练习	
PRESENCE_STATUS_QUESTLOG	正在查看任务记录	
PRESENCE_STATUS_SPECTATING_GAME_ADVENTURE_BRM_CLASS_CHALLENGE	正在观看一场黑石山职业挑战	
PRESENCE_STATUS_SPECTATING_GAME_ADVENTURE_BRM_HEROIC	正在观看一场英雄难度黑石山对战	
PRESENCE_STATUS_SPECTATING_GAME_ADVENTURE_BRM_NORMAL	正在观看一场黑石山对战	
PRESENCE_STATUS_SPECTATING_GAME_ADVENTURE_ICC_NORMAL	正在观看一场冰封王座对战	
PRESENCE_STATUS_SPECTATING_GAME_ADVENTURE_KAR_CLASS_CHALLENGE	正在观看一场卡拉赞职业挑战	
PRESENCE_STATUS_SPECTATING_GAME_ADVENTURE_KAR_HEROIC	正在观看一场英雄难度卡拉赞对战	
PRESENCE_STATUS_SPECTATING_GAME_ADVENTURE_KAR_NORMAL	正在观看一场卡拉赞对战	
PRESENCE_STATUS_SPECTATING_GAME_ADVENTURE_LOE_CLASS_CHALLENGE	正在观看一场探险者协会职业挑战	
PRESENCE_STATUS_SPECTATING_GAME_ADVENTURE_LOE_HEROIC	正在观看一场英雄难度探险者协会对战	
PRESENCE_STATUS_SPECTATING_GAME_ADVENTURE_LOE_NORMAL	正在观看一场探险者协会对战	
PRESENCE_STATUS_SPECTATING_GAME_ADVENTURE_NAXX_CLASS_CHALLENGE	正在观看一场纳克萨玛斯职业挑战	
PRESENCE_STATUS_SPECTATING_GAME_ADVENTURE_NAXX_HEROIC	正在观看一场英雄难度纳克萨玛斯对战	
PRESENCE_STATUS_SPECTATING_GAME_ADVENTURE_NAXX_NORMAL	正在观看一场纳克萨玛斯对战	
PRESENCE_STATUS_SPECTATING_GAME_ARENA	正在观看一场竞技模式对战	
PRESENCE_STATUS_SPECTATING_GAME_BATTLEGROUNDS	正在观看一局酒馆战棋	
PRESENCE_STATUS_SPECTATING_GAME_BOH	正在观看英雄之书对战	
PRESENCE_STATUS_SPECTATING_GAME_BOM	正在观看佣兵之书对战	
PRESENCE_STATUS_SPECTATING_GAME_BOT	正在充当实验伙伴	
PRESENCE_STATUS_SPECTATING_GAME_BTA	正在观看邪火试炼	
PRESENCE_STATUS_SPECTATING_GAME_BTA_HEROIC	正在观看邪火试炼挑战模式	
PRESENCE_STATUS_SPECTATING_GAME_BTP	正在观看序章	
PRESENCE_STATUS_SPECTATING_GAME_DAL	正在偷窥一场达拉然大劫案	
PRESENCE_STATUS_SPECTATING_GAME_DAL_HEROIC	正在偷窥一场达拉然大劫案	
PRESENCE_STATUS_SPECTATING_GAME_DRG	正在观看巨龙空战	
PRESENCE_STATUS_SPECTATING_GAME_DRG_HEROIC	正在观看巨龙空战	
PRESENCE_STATUS_SPECTATING_GAME_FRIENDLY	正在观看一场友谊赛对战	
PRESENCE_STATUS_SPECTATING_GAME_GIL	正在观看怪物狩猎	
PRESENCE_STATUS_SPECTATING_GAME_GIL_BONUS_CHALLENGE	正在观看与哈加莎对战	
PRESENCE_STATUS_SPECTATING_GAME_LOOT	正在观看地下城冒险	
PRESENCE_STATUS_SPECTATING_GAME_MERCENARIES	正在观看一场佣兵战纪对战	
PRESENCE_STATUS_SPECTATING_GAME_PLAY	正在观看传统对战	
PRESENCE_STATUS_SPECTATING_GAME_PLAY_CASUAL_CLASSIC	正在观看休闲经典对战	
PRESENCE_STATUS_SPECTATING_GAME_PLAY_CASUAL_STANDARD	正在观看休闲标准对战	
PRESENCE_STATUS_SPECTATING_GAME_PLAY_CASUAL_TWIST	正在观看幻变休闲对战	
PRESENCE_STATUS_SPECTATING_GAME_PLAY_CASUAL_WILD	正在观看休闲狂野对战	
PRESENCE_STATUS_SPECTATING_GAME_PLAY_RANKED_CLASSIC	正在观看排名经典对战	
PRESENCE_STATUS_SPECTATING_GAME_PLAY_RANKED_STANDARD	正在观看排名标准对战	
PRESENCE_STATUS_SPECTATING_GAME_PLAY_RANKED_TWIST	正在观看排名幻变对战	
PRESENCE_STATUS_SPECTATING_GAME_PLAY_RANKED_WILD	正在观看排名狂野对战	
PRESENCE_STATUS_SPECTATING_GAME_PRACTICE	正在观看一场练习模式对战	
PRESENCE_STATUS_SPECTATING_GAME_RETURNING_PLAYER_CHALLENGE	正在观看一场好友回归挑战	
PRESENCE_STATUS_SPECTATING_GAME_RLK	正在观看序章	
PRESENCE_STATUS_SPECTATING_GAME_TAVERN_BRAWL	正在观看一场乱斗	
PRESENCE_STATUS_SPECTATING_GAME_TRL	正在观看一场挑战	
PRESENCE_STATUS_SPECTATING_GAME_TUTORIAL	正在观看一场教学对战	
PRESENCE_STATUS_SPECTATING_GAME_ULD	正在考察古墓	
PRESENCE_STATUS_SPECTATING_GAME_ULD_HEROIC	正在考察古墓	
PRESENCE_STATUS_STORE	正在逛商店	
PRESENCE_STATUS_TAVERN_BRAWL_DECKEDITOR	准备一副乱斗模式套牌	
PRESENCE_STATUS_TAVERN_BRAWL_FRIENDLY_GAME	正在和好友进行一场乱斗	
PRESENCE_STATUS_TAVERN_BRAWL_FRIENDLY_WAITING	准备和好友进行一场乱斗	
PRESENCE_STATUS_TAVERN_BRAWL_GAME	正在进行一场乱斗	
PRESENCE_STATUS_TAVERN_BRAWL_QUEUE	正在寻找乱斗模式的对手	
PRESENCE_STATUS_TAVERN_BRAWL_SCREEN	正在进入乱斗模式	
PRESENCE_STATUS_TUTORIAL_GAME	正在试图击败{0}	0 = PRESENCE_TUTORIAL_*
PRESENCE_STATUS_TUTORIAL_PREGAME	首次进入游戏	
PRESENCE_STATUS_VIEWING_JOURNAL	正在查看旅程	
PRESENCE_STATUS_WAIT_FOR_OPPONENT_RECONNECT	等待对手重新连接	
PRESENCE_STATUS_WELCOMEQUESTS	正在查看任务	
PRESENCE_TUTORIAL_GARROSH	加尔鲁什·地狱咆哮	
PRESENCE_TUTORIAL_LICH_KING	巫妖王	
PRESENCE_TUTORIAL_REXXAR	雷克萨	
