TAG	TEXT	COMMENT
TUTORIAL01_HOGGER_01	*笑声*	
TUTORIAL01_HOGGER_02	*鼻息*	
TUTORIAL01_HOGGER_04	哈哈哈，嗷	
TUTORIAL01_HOGGER_05	呵呵呵呵呵哈哈	
TUTORIAL01_HOGGER_06	呵呵呵呵呵嚯嚯	
TUTORIAL01_HOGGER_07	哈哈哈哈	
TUTORIAL01_HOGGER_08	啊啊啊呃	
TUTORIAL01_JAINA_01	放马过来吧！	
TUTORIAL01_JAINA_02	我需要一些将士来为我作战。	
TUTORIAL01_JAINA_03	轮到你了，豺狼人。	
TUTORIAL01_JAINA_04	你会后悔的！	
TUTORIAL01_JAINA_05	太好了。	
TUTORIAL01_JAINA_06	嗯！又一张随从牌，正是我需要的。	
TUTORIAL01_JAINA_07	你的一举一动都在我掌握之中。	
TUTORIAL01_JAINA_09	哈哈！发起致命一击的时候到了！	
TUTORIAL01_JAINA_10	5点攻击力？真是个大家伙！	
TUTORIAL01_JAINA_13	回到监狱去吧，霍格。	
TUTORIAL01_JAINA_15	哼！这还不足以杀死我的随从！	
TUTORIAL01_JAINA_16	下面就轮到你了，霍格！	
TUTORIAL01_JAINA_17	嗯...我应该攻击豺狼人，还是直接攻击霍格呢？	
TUTORIAL01_JAINA_18	我可以杀了这个豺狼人大块头，或者直取主将。	
TUTORIAL01_JAINA_19	一张法术牌！它只能使用一次，所以我应该好好利用它...	
TUTORIAL01_JAINA_20	哼，至少他这个回合一张牌都没有用...	
TUTORIAL01_JAINA_21	两张牌？他一定是蓄谋已久了。	
TUTORIAL02_JAINA_03	什么？	
TUTORIAL02_JAINA_04	我必须等待一个回合，恢复我的法力值。	
TUTORIAL02_JAINA_05	我需要更多的法力值来使用它。	
TUTORIAL02_JAINA_07	更多手牌！很好！	
TUTORIAL02_JAINA_08	啊，我的法力值恢复了。	
TUTORIAL02_MILLHOUSE_01	啊？我想要先来的！	
TUTORIAL02_MILLHOUSE_02	吉安娜...准备好面对强大的米尔豪斯·法力风暴吧！	
TUTORIAL02_MILLHOUSE_03	那就是你的士兵？一个鱼人？哇哈哈哈哈！	
TUTORIAL02_MILLHOUSE_04	哦！哦！这张牌真厉害！	
TUTORIAL02_MILLHOUSE_05	等等，我需要更多的法力值！	
TUTORIAL02_MILLHOUSE_06	吉安娜，我希望你喜欢这招！！	
TUTORIAL02_MILLHOUSE_07	又来了一点法力值！这就够了！	
TUTORIAL02_MILLHOUSE_08	你知道这样感觉如何吗？	
TUTORIAL02_MILLHOUSE_09	必胜！哈哈！	
TUTORIAL02_MILLHOUSE_10	耶！看看小胡子的厉害！	
TUTORIAL02_MILLHOUSE_11	你会喜欢这个的！	
TUTORIAL02_MILLHOUSE_13	你等着，等到我有10点法力值的时候！	
TUTORIAL02_MILLHOUSE_15	快点儿！我等不及想要使用这张牌了！	
TUTORIAL02_MILLHOUSE_16	快点快点快点快点！	
TUTORIAL02_MILLHOUSE_17	别打我！我还要赢得这场比赛呢！	
TUTORIAL02_MILLHOUSE_19	我的律师会找你谈话的！	
TUTORIAL03_JAINA_01	是穆克拉！趁他孤立无援，消灭他！	
TUTORIAL03_JAINA_05	你就这点本事吗，穆克拉？就靠这些酒桶？	
TUTORIAL03_JAINA_07	杀了那只猩猩，我才能解决穆克拉！	
TUTORIAL03_JAINA_12	你听见什么声音了吗？	
TUTORIAL03_JAINA_13	怎么搞的？	
TUTORIAL03_JAINA_14	为什么这些猴子在朝我扔香蕉？	
TUTORIAL03_JAINA_15	你们这些疯狂的猴子！	
TUTORIAL03_JAINA_16	他太强了！去杀了穆克拉！	
TUTORIAL03_JAINA_17	我需要士兵来嘲讽那只大猩猩！	
TUTORIAL03_JAINA_18	我没有守卫了！	
TUTORIAL03_JAINA_19	那是个大块头...还好它不会嘲讽。	
TUTORIAL03_MUKLA_01	呜哇啊啊啊啊！	
TUTORIAL03_MUKLA_03	吼吼吼...	
TUTORIAL03_MUKLA_04	哦！哦！哦！	
TUTORIAL03_MUKLA_05	哈！哦 哦！	
TUTORIAL03_MUKLA_06	呜啊！哦！哦哦！	
TUTORIAL04_HEMET_01	真是个漂亮的小姑娘，不是吗？	
TUTORIAL04_HEMET_02	恩？没人敢这么和老赫米特说话！	
TUTORIAL04_HEMET_03	哈！我先来！	
TUTORIAL04_HEMET_04	哦，那很好，因为你会需要它的！	
TUTORIAL04_HEMET_06	也许你以前常和杂兵较量。	
TUTORIAL04_HEMET_07	赫米特亲自上阵啦！	
TUTORIAL04_HEMET_08	一只野兽！我要把它变成我的战利品！	
TUTORIAL04_HEMET_09	我要把这野兽的皮扒下来做条新围巾！	
TUTORIAL04_HEMET_10	哈哈，谢谢你为我送来了零食！	
TUTORIAL04_HEMET_11	哈哈，开始打猎了！	
TUTORIAL04_HEMET_12a	这不公平！	
TUTORIAL04_HEMET_12b	啊，真倒霉！	
TUTORIAL04_HEMET_13	也许我应该回去继续写东西。	
TUTORIAL04_HEMET_15	你知道吗？这让我想起了狩猎虎王邦加拉什的旧时光。	
TUTORIAL04_HEMET_16	你读过我写的书《荆棘谷的青山》吗？	
TUTORIAL04_HEMET_17	要是在荆棘谷，这绝不可能发生！	
TUTORIAL04_HEMET_18	你不过是个小黄毛丫头！	
TUTORIAL04_HEMET_19	在我巨大的泥沼野兽面前颤抖吧！	
TUTORIAL04_HEMET_20	射击！	
TUTORIAL04_JAINA_01	注意你的言辞。	
TUTORIAL04_JAINA_02	那我就多一张手牌了。	
TUTORIAL04_JAINA_03	我没有只需要一点法力值就可以使用的卡牌。	
TUTORIAL04_JAINA_04	我有的是应对的手段，矮人大叔。	
TUTORIAL04_JAINA_05	我应该对他的杂兵造成1点伤害，还是直接攻击奈辛瓦里呢？	
TUTORIAL04_JAINA_08	就1点生命值？完美的目标。	
TUTORIAL04_JAINA_09	我得找个办法消灭那个东西。	
TUTORIAL05_ILLIDAN_01	你们这是自寻死路！	All of Illidan's lines are iconic from WoW, please use the same translation if possible.
TUTORIAL05_ILLIDAN_02	感受这被囚禁了一万年的愤怒！	
TUTORIAL05_ILLIDAN_03	直视背叛者的双眼吧！	
TUTORIAL05_ILLIDAN_04	谁想成为下\n一个？	
TUTORIAL05_ILLIDAN_05	让埃辛诺斯的烈焰吞噬你们！	
TUTORIAL05_ILLIDAN_06	你们对力量一无所知！	
TUTORIAL05_ILLIDAN_08	感受我体内的恶魔之力吧！	
TUTORIAL05_ILLIDAN_09	你们这些乌合之众休想碰到我！	
TUTORIAL05_ILLIDAN_10	不自量力！	
TUTORIAL05_ILLIDAN_11	这一定很有趣！	
TUTORIAL05_JAINA_01	自寻死路？我只是完成了五个任务而已。	
TUTORIAL05_JAINA_02	他的英雄技能...真是强大！	
TUTORIAL05_JAINA_05	集中攻击伊利丹！	
TUTORIAL05_JAINA_06	不能再拖下去了！消灭他！	
TUTORIAL06_CHO_01	哦！吉安娜！很高兴看见你。	
TUTORIAL06_CHO_02	让我看看你是否学有所成。	
TUTORIAL06_CHO_03	很好！很好！	
TUTORIAL06_CHO_04	哦！打得很聪明。	
TUTORIAL06_CHO_05	战争只是不得已而为之。	
TUTORIAL06_CHO_06	也许吧。	
TUTORIAL06_CHO_07	啊！你碰不到我！	
TUTORIAL06_CHO_08	站在此处方能体会一览众山小的感觉！	
TUTORIAL06_CHO_09	哪怕只是一点伤害也足以决定一场比赛的胜负。	
TUTORIAL06_CHO_12	哦...你可真是强大。	
TUTORIAL06_CHO_15	我自己虽然不擅长舞刀弄剑，但是我倒是有不少朋友。	
TUTORIAL06_CHO_17	我认识了不少新朋友，他们擅长医术，拳脚功夫也相当了得！	
TUTORIAL06_CHO_20	你很强大，吉安娜！	
TUTORIAL06_CHO_21	恐惧会让人愤怒。愤怒会让人仇恨。而仇恨会让人肚子疼。	
TUTORIAL06_JAINA_01	游学者周卓。	
TUTORIAL06_JAINA_02	我不会退让的。	
TUTORIAL06_JAINA_03	你真是天真，游学者。	
TUTORIAL06_JAINA_04	一时之快。等我消灭了你的部队，就轮到你了。	
VO_ANNOUNCER_CM_HELP_DECK_50	我能给你些建议，希望能够帮到你。	
VO_ANNOUNCER_DISCONNECT_45	你的对手离开了游戏。	
VO_Aran_Male_Shade_AranBossCoin_02	什么，主人的房间里有派对客人？快滚出去！	
VO_Barnes_Male_Human_JulianneBossCoin_01	第一幕：禁忌的爱恋！	
VO_Barnes_Male_Human_OzBossCoin_02	终于到了最后一幕！邪恶的巫婆追逐迷途的少女！她能找到回家的路吗？	
VO_Barnes_Male_Human_WolfBossCoin_02	看似慈祥的老奶奶，背后却暗藏着不可告人的秘密！	
VO_BRANN_OPEN_WING_2_03	你好，探险者！我叫布莱恩·铜须，是探险者协会的创始人。法杖的头部组件有了线索，就在奥达曼的远古矿洞里。	
VO_BRANN_SCARVASH_PREGAME_ALT_06	穴居人占领了奥达曼！我们得经历一番恶战才能拿到头部组件。	
VO_Curator_Male_ArcaneGolem_IllhoofBossCoin_02	恶魔邪蹄是这里最危险的展品，请勿靠近！	
VO_Curator_Male_ArcaneGolem_NightbaneBossCoin_02	馆长很抱歉。请协助馆长捕捉这些\n生物。	
VO_DALA_BOSS_99h_Male_Human_AfterFreezing_01	下次的时候它们还会在这儿。	
VO_DALA_BOSS_99h_Male_Human_AfterSelling_01	用一个随从，换一枚铸币。	
VO_DALA_BOSS_99h_Male_Human_AfterShopUpgrade_01	太好了！现在你能找到更棒的随从了。	
VO_DALA_BOSS_99h_Male_Human_AfterShopUpgrade_02	很好，准备开始游戏吧！	
VO_DALA_BOSS_99h_Male_Human_AfterShopUpgrade_03	非常好！现在我能提供更强大的随从了。	
VO_DALA_BOSS_99h_Male_Human_AfterShopUpgrade_04	好了，重新\n开张！	
VO_DALA_BOSS_99h_Male_Human_AfterTriple_01	哦吼！你又前进了一大步！	
VO_DALA_BOSS_99h_Male_Human_AfterTriple_02	这就是你要找的那一个。	
VO_DALA_BOSS_99h_Male_Human_AfterTriple_03	绝妙的操作。看看接下来会发生什么。	
VO_DALA_BOSS_99h_Male_Human_CombatWin_03	干得漂亮！保持状态。	
VO_DALA_BOSS_99h_Male_Human_FirstBattle_01	战斗开始！你的随从会从左至右，自动攻击。	
VO_DALA_BOSS_99h_Male_Human_FirstVictory_01	这游戏就是这么玩儿的！你还真是个人才啊，朋友！	
VO_DALA_BOSS_99h_Male_Human_General_02	我给你物色了一些新人！	
VO_DALA_BOSS_99h_Male_Human_HeroSelection_01	你的随从会尽力奋战，但也需要一个强大的指挥官。	
VO_DALA_BOSS_99h_Male_Human_Hire_01	去吧，从这些人选里挑一位。	
VO_DALA_BOSS_99h_Male_Human_Hire_02	能招人的时候要尽量招揽。	
VO_DALA_BOSS_99h_Male_Human_Idle_02	花钱要慎重。但……你也得\n花呀！	
VO_DALA_BOSS_99h_Male_Human_Idle_03	看你打牌是种享受。	
VO_DALA_BOSS_99h_Male_Human_ModeSelect_01	欢迎来到酒馆战棋！八位参赛选手，只有一位可以胜出。	
VO_DALA_BOSS_99h_Male_Human_RecruitMediumMinion_03	我喜欢这个\n选择。	
VO_DALA_BOSS_99h_Male_Human_RecruitSmallMinion_02	大小搭配，战斗不累。	
VO_DALA_BOSS_99h_Male_Human_RecruitWork_01	现在，让随从们就位吧。	
VO_DALA_BOSS_99h_Male_Human_ShopFirstTime_01	你可以在这里招揽随从。好好\n选吧！	
VO_DALA_BOSS_99h_Male_Human_ShopUpgrade_01	你可以升级酒馆，以便招揽更强大的随从。	
VO_DALA_BOSS_99h_Male_Human_Triple_01	选那个随从，你就获得了一个\n三连。	
VO_DALA_BOSS_99h_Male_Human_Triple_02	你现在好像可以凑成三连。	
VO_DALA_BOSS_99h_Male_Human_Triple_03	哈，三连！这是你的奖励。	
VO_DALA_BOSS_99h_Male_Human_UpgradeShop_01	你可以在这儿升级酒馆。要是不升级的话，你就要落后了！	
VO_DEATH_KNIGHT_DECK_BUILDING_CAN_ADD_ANY_RUNE	现在，你可以将任意符文的卡牌添加到套牌中。	
VO_DEATH_KNIGHT_DECK_BUILDING_CANNOT_ADD_RUNES	你可以在构筑套牌时加入不匹配的符文，但必须在投入使用前加以调整，使之满足符文条件，否则套牌无效。	
VO_DEATH_KNIGHT_DECK_BUILDING_INTRO_1	我将我拥有的一切——愤怒，力量，意志——全部赐予你，我精心挑选的骑士。	
VO_DEATH_KNIGHT_DECK_BUILDING_INTRO_2	你将作为我不朽的勇士，为天灾军团开辟崭新的黑暗时代！	
VO_DEATH_KNIGHT_DECK_BUILDING_INTRO_3	创建你的第一副死亡骑士套牌，开启征程。	
VO_DEATH_KNIGHT_DECK_BUILDING_INTRO_4	大部分死亡骑士卡牌都标有符文：鲜血、冰霜或者邪恶。	
VO_DEATH_KNIGHT_DECK_BUILDING_INTRO_5	你的套牌有三个符文槽。你可以嵌入三个同种符文，也可以每种各一个，或者任意组合。	
VO_DEATH_KNIGHT_DECK_BUILDING_TRIPLE_RUNES	具有三个同种符文的卡牌异常强大，但如果你带上它，就不能在套牌中加入具有其他符文的牌。	
VO_ELISE_SLITHERSPEAR_PREGAME_ALT_04	纳迦要把芬利当成点心了！我们要快点把他救出来！	
VO_ELISE_STAFF_CLICK_DONE_65	源生法杖！多亏了你的英雄壮举，法杖得以在探险者大厅重现辉煌！	
VO_ELISE_STAFF_CLICK_EARLY_64	我们终于有了源生法杖的线索！它绝对会成为博物馆的镇馆之宝！	
VO_ELISE_WING_1_OPEN_06	第一块法杖组件位于古老的奥西斯神庙中。雷诺已经在里面了，他需要你的帮助！	
VO_ELISE_WING_3_OPEN_07	第三块法杖组件——潮汐宝珠，出现在荆棘丛林。芬利爵士在那里，可是我已跟他失去了联系。	
VO_ELISE_WING_4_OPEN_08	拉法姆偷走了法杖，还占领了博物馆。他复活了所有展品，并开始大肆掠夺！	
VO_ILLIDAN_RETURNING_PLAYER_MISSION_INTRO	这是大概一万年前的事情了……	
VO_ILLIDAN_RETURNING_PLAYER_QUEST1	回顾我的记忆，见证三场战斗，而你会获得奖励。	
VO_INNKEEPER_1ST_HUB_06	在练习模式下，你可以解锁新的英雄。	
VO_INNKEEPER_ARENA_1ST_REWARD	哦，干得不错！等你攒够了足够的金币，请随时再来竞技场打比赛！	
VO_INNKEEPER_ARENA_3RD_LOSS	你输掉了三场比赛。快使用奖励钥匙，看看你获得了哪些奖励！	
VO_INNKEEPER_BASIC_DONE1_11	你已经获得了这个职业的所有基本卡牌！	
VO_INNKEEPER_BASIC_DONE2_12	现在，你需要一些卡牌包来强化你的套牌！	
VO_INNKEEPER_CLASSIC_DECK_WARNING	这副套牌只能用于经典对战。	
VO_INNKEEPER_CLASSIC_PLAY_CLASSIC_MODE_ONLY	如果你构筑了一副经典套牌，那就只能在经典模式中使用！	
VO_INNKEEPER_CLASSIC_TAKES_YOU_BACK_ORIGINAL_HEARTHSTONE	经典模式能带你回到炉石传说刚刚发布的时候。	
VO_INNKEEPER_CM_DECK_FINISH_30	这副套牌看上去不错。带上它大干一场吧！	
VO_INNKEEPER_CM_LCLICK	右键点击卡牌查看详细信息。	
VO_INNKEEPER_CM_LCLICK_HERO	右键点击英雄进行查看。	
VO_INNKEEPER_CM_NEW_INNKEEPER_DECK	如果你想试试手，我这里有一副套牌，你可以拿去用！	
VO_INNKEEPER_CM_PAGEFLIP_28	点击牌册页面的边缘翻页浏览卡牌。	
VO_INNKEEPER_CM_UNOWNED_29	这些是你尚未拥有的卡牌。和玩家对战，你就有机会赢取它们！	
VO_INNKEEPER_CM_WELCOME	欢迎来到“我的收藏”！你可以在这里编辑你的\n套牌。	
VO_INNKEEPER_COIN_INTRO	由于你后手出牌，所以你获得了幸运币卡牌。好好利用它！	
VO_INNKEEPER_DISENCHANT_31	你可以分解你不需要的卡牌，然后制造出你需要的。	
VO_INNKEEPER_EXPERT_AI_10	你已经解锁了专家级的对手！但是，他们可不会对你手下留情…	
VO_INNKEEPER_FIRST_100_GOLD	你的金币已经足够购买卡牌包了！快去牌店\n看看吧！	
VO_INNKEEPER_FORGE_1ST_18	啊，没玩过竞技模式？那么，你的第一次竞技场之旅由我买单！	
VO_INNKEEPER_FORGE_1WIN	赢得漂亮！你每次赢得比赛，你的奖励钥匙都会升级！	
VO_INNKEEPER_FORGE_2LOSS_25	再输一场你就出局了！	
VO_INNKEEPER_FORGE_COMPLETE_22	现在，挑战其他竞技场玩家，看看你的套牌有多厉害！	
VO_INNKEEPER_FORGE_INST1_19	选择一个英雄！	
VO_INNKEEPER_FORGE_INST2_20	现在，挑选一张卡牌加入你的套牌。	
VO_INNKEEPER_FORGE_INST3_21	再接再厉！	
VO_INNKEEPER_FORGE_INTRO_17	啊…竞技模式！打造一副套牌，然后使用它为你征战！	
VO_INNKEEPER_HAVE_ONE_STANDARD_DECK	你已成功组建了一副标准套牌。当然你随时可以在“我的收藏”中组建更多套牌！	
VO_INNKEEPER_HAVE_STANDARD_DECKS	你已成功组建了一副标准套牌。当然你随时可以在“我的收藏”中组建更多套牌！	
VO_INNKEEPER_LEVEL3_TIP	再升一级，你又能解锁新的卡牌了！	
VO_INNKEEPER_MAX_ARENA_WINS_04	哦，你赢得了竞技场的最高奖励，光铸钥匙！	
VO_INNKEEPER_MULLIGAN_13	换掉高费的卡牌，以便在稍后的比赛中抽到它们。	
VO_INNKEEPER_NUDGE_CM_X	不错的奖励！浏览的你收藏，把它们加入你的套牌。	
VO_INNKEEPER_OUT_OF_QUESTS	你已经没有任务了！明天再来查看吧。	
VO_INNKEEPER_PLAY_STANDARD_TO_WILD	如果你组建一副狂野套牌，就只能在狂野模式中进行游戏！	
VO_INNKEEPER_PRACTICE_INST1_07	想要解锁某个英雄，你就先要打败他。先挑战你最喜欢的英雄吧！	
VO_INNKEEPER_PRACTICE_INST2_08	要我选的话，我肯定选圣骑士乌瑟尔！	
VO_INNKEEPER_RETURNING_PLAYER_INNKEEPER_CHALLENGE_INTRO	我们这里有三位挑战者想要跟你切磋一下！	
VO_INNKEEPER_RETURNING_PLAYER_QUEST1	我为你准备了三个任务，这是第一个！	
VO_INNKEEPER_STANDARD_DECK_WARNING	这副套牌仅适用于标准模式。	
VO_INNKEEPER_STEALTH_TAUNT3_22	当一个随从具有潜行，他就不能嘲讽。	
VO_INNKEEPER_TAVERNBRAWL_DESC1_29	在每个星期，乱斗模式都有不同的规则！	
VO_INNKEEPER_TAVERNBRAWL_DESC2_30	在每个星期，乱斗模式都有各种不同的、疯狂的\n规则！	
VO_INNKEEPER_TAVERNBRAWL_PUSH_32	伙计，你试过乱斗模式了吗？	
VO_INNKEEPER_TAVERNBRAWL_WELCOME1_27	欢迎来到乱斗\n模式！	
VO_INNKEEPER_TOURNY_END_15	每周对抗赛结束了！	
VO_INNKEEPER_TOURNY_END1_27	你的奖章已经重置，本周你又可以获得新的奖章和卡牌包了！	
VO_INNKEEPER_TWIST_DECK_WARNING	这副套牌仅适用于幻变模式。	
VO_INNKEEPER_UNLOCKED_ALL_HEROES	你已解锁了全部的九个英雄！真是可喜可贺！	
VO_INNKEEPER_UNRANKED_16	不计成绩的比赛不会影响到你的排名，但是你也无法获得免费的奖品！	
VO_INNKEEPER_WILD_DECK_WARNING	这副套牌仅适用于狂野模式。	
VO_INNKEEPER_WILD_GAME	狂野模式！请注意——在该模式中，你可以使用以往的历史卡牌！	
VO_KAR_WING_1_OPEN_MOROES_MALE_HUMAN	传送门的意外让塔里变得一团糟！我们要赶在客人抵达前，把麦迪文救回来！	
VO_KAR_WING_2_OPEN_BARNES_MALE_HUMAN	你刚好赶上我们的彩排！我叫巴内斯，是歌剧院的舞台管理员，你一定得看我们的演出。当心，我们可能会邀请你同台表演喔。可别怯场哟！	
VO_KAR_WING_3_OPEN_CURATOR_ANDRO_MECH	展览馆只对访客开放。访客应该待在笼子里，展品不得越过绳索。	
VO_KAR_WING_4_OPEN_MOROES_MALE_HUMAN	终于到塔顶了！找到正确的传送门，把麦迪文带回来！	
VO_KAR_WING_4_WIN_MEDIVH_MALE_HUMAN	冒险者，跟我们一起狂欢吧！	
VO_KAR_WING_4_WIN_MOROES_MALE_HUMAN	你做到了。我真不敢相信派对还能准时开始。你下周可以再过来吗？麦迪文的生日要到了……呃，我到时……需要一个帮手。	
VO_KT_ANUB1_42	阿努布雷坎是我最得力的蛛魔领主之一。祝你好运，入侵者。	
VO_KT_BARON1_63	天启四骑士是我最强大的死亡骑士们。他们一定不会让我失望的。	
VO_KT_FAERLINA1_44	法琳娜负责对崇拜我的侍僧进行训练。她的工作非常重要，你们不能打扰她！	
VO_KT_GLUTH1_72	格拉斯专吃那些劣等的僵尸。说起这个，你应该会成为一份很好的饲料。	
VO_KT_GOTHIK1_ALT_61	听着，如果你现在投降，我会让戈提克把你的灵魂放在一具漂亮点儿的尸体里。	
VO_KT_GROBBULUS1_70	格罗布鲁斯是我血肉巨人大军的原始模型。而你则是第一个测试目标。	
VO_KT_HEIGAN1_54	希尔盖让我告诉你，如果你在和他对战的时候不用牌的话，他可以饶你不死。	
VO_KT_INTRO_39	你来得太晚了！你已经无法阻止我的准备工作了。	
VO_KT_INTRO2_40	什么？？谁允许你进入纳克萨玛斯的？！	
VO_KT_KELTHUZAD1_ALT_90	接下来的战斗可不轻松。我听说，这个首领的实力无人能及……而且英俊帅气。	
VO_KT_LOATHEB1_56	只要稍微靠近洛欧塞布，你的血肉就会开始腐烂。所以我推荐你使用近战职业。	
VO_KT_MAEXXNA1_46	迈克斯纳是一只巨型蜘蛛！哦哈哈哈哈！	
VO_KT_MAEXXNA5_50	你认为这张牌会对你有用？别妄想了。	
VO_KT_NOTH1_52	想要挑战诺斯？	
VO_KT_PATCHWERK1_68	帕奇维克是由那些连游学者周卓都打不过的冒险者的尸体缝合起来的。	
VO_KT_RAZUVIOUS1_58	请无视拉苏维奥斯旁边的精神控制石。	
VO_KT_SAPPHIRON1_83	我的冰霜巨龙等着你们。多穿点衣服。	
VO_KT_THADDIUS1_80	它活了！！那么，你就活不长了。	
VO_KT_WINGOPENS_82	我会亲自找你们算账的，入侵者。	
VO_LOE_08_WIN_2	他们找到了第二块组件，我的计划就快实现了。	
VO_LOE_12_WIN_2	最后一块也到手了。	
VO_LOE_INTRO_1	时间刚好，冒险者，欢迎来到探险者大厅！	
VO_LOE_INTRO_2	如此之多目眩神迷的发现，我不得不承认，真是一场华丽的冒险……	
VO_LOE_INTRO_3	三块源生法杖组件的下落终于有了眉目！你能帮我们找回来吗？	
VO_LOE_INTRO_5	我叫伊莉斯·逐星，是一名绘图师。我们找到了有关三块源生法杖组件的线索，需要你的帮助！	
VO_LOE_INTRO_6	我会留在这做向导，其他探险者已经进去了，你能帮帮他们吗？	
VO_LOE_WING_1_WIN_2	这么说他们在找源生法杖……嘿嘿嘿。	
VO_LOE_WING_3_WIN_1	探险者！我们成功了！历经这么多年，源生法杖终于合而为一了！	
VO_LOE_WING_3_WIN_3	这是……什么？	
VO_LOE_WING_3_WIN_4	你好，探险者。我叫拉法姆，是最伟大的考古学家！	
VO_LOE_WING_3_WIN_5	多谢你们帮我找到源生法杖，我会让你们见识它真正的力量！	
VO_LOEA01_PHAERIX_PREGAME	我们进到神庙的宝库了！你去对付守卫，我来寻找宝物！	
VO_LOEA02_ZINAAR_PREGAME_ALT	雷诺就快找到炎日权杖了，但是他手痒，擦亮了神灯。	
VO_LOEA03_TEMPLE_PREGAME	第一块组件到手啦！现在我们得赶在被活埋前逃出去！	
VO_LOEA04_SCARVASH_PREGAME	你好，探险者！法杖的头部组件有了线索，就在奥达曼的什么地方。	
VO_LOEA07_MINECART_PREGAME	这矿井通往奥达曼的中心位置！	
VO_LOEA08_ARCHAEDAS_PREGAME	头部组件在石头巨人阿扎达斯手上，他可不会轻易地交给我们。	
VO_LOEA10_GIANTFIN_PREGAME	呃……我本想避而不战的。好吧，为了荣耀！	
VO_LOEA12_NAGA_PREGAME	宝珠在她手里！让我们速战速决吧。	
VO_LOEA13_SKELESAURUS_PREGAME	多棒的博物馆呀。来见见我的新朋友，骨龙海克斯！	
VO_LOEA14_STEELSENTINEL_PREGAME	哦，多么可爱的玩意儿，你们真是暴殄天物。	
VO_LOEA15_1_PREGAME_06	这是你的套牌吧？嘿嘿嘿……	
VO_LOEA16_RAFAAM2_PREGAME	够了！在源生法杖面前，你们都是尘埃！	
VO_Medivh_Male_Human_Intro_01	亲爱的客人，我诚挚地邀请你参加艾泽拉斯最盛大的派对。	test
VO_Medivh_Male_Human_Intro_02	快来卡拉赞吧。这里有音乐，有魔法，还有一点疯狂哟！	test
VO_Medivh_Male_Human_Intro_03	麦迪文敬上	test
VO_Medivh_Male_Human_PrologueBossCoin_02	莫罗斯，我的舞厅里为什么会有一个恶魔？	
VO_Moroes_Male_Human_ChessBossCoin_01	麦迪文又把国际象棋摆在外面了。这下可麻烦了……	
VO_Moroes_Male_Human_CuratorBossCoin_01	馆长把展品都放出来了！我们要\n修好它。	
VO_Moroes_Male_Human_FinalAltBossCoin_01	我们成功了！打开传送门，派对开\n始啦！	
VO_Moroes_Male_Human_MirrorBossCoin_01	麦迪文曾对镜子施法，让它称赞客人。但麦迪文现在不在，所以……待会儿你就知道了。	
VO_Moroes_Male_Human_NetherspiteBossCoin_01	虚空幽龙管理着卡拉赞的所有传送门。我们需要它的控制装置。	
VO_Moroes_Male_Human_SilverwareBossCoin_01	麦迪文不在，卡拉赞就会彻底失控！	
VO_Moroes_Male_Human_SilverwareWin_03	得要有人在派对开始前打扫干净才行。	test
VO_NAX15_01_GLOAT1_33	克尔苏加德必胜！！你听见了么，宝贝比格沃斯？！	
VO_NAX15_01_GLOAT2_34	左边的骷髅们！右边的女妖们！会唱的跟我一起唱！	
VO_NAX15_01_GLOAT3_35	完成了今天的每日任务，干掉一个入侵者！40金币到手了。	
VO_NAX15_01_GLOAT4_36	胜利的滋味如此甜美……就像一杯奶昔。不，也许更像是一大块巧克力。	
VO_NAX15_01_GLOAT5_37	我的力量无人能及！而且，我不需要付出生命的代价。	
VO_NEFARIAN_ATRAMEDES_75	虽然艾卓曼德斯的眼睛看不见，但他能听见你因为恐惧而颤抖。	
VO_NEFARIAN_BARON_GEDDON_39	迦顿男爵挡在我们前面。解决他。	
VO_NEFARIAN_CHROMAGGUS_INTRO_58	克洛玛古斯是我最伟大的杰作之一！瞧瞧它那七彩的龙鳞！	
VO_NEFARIAN_COREN_27	黑铁矮人们被拉格纳罗斯奴役着，只有打败他们，才能挑战炎魔之王。	
VO_NEFARIAN_DESCENT_OPEN_67	我在黑石山的烈焰中重生！我不可战胜！	
VO_NEFARIAN_DRAKKISATH_47	你是不是迷路了？你只要按屏幕下方的返回按钮就能回去了。	
VO_NEFARIAN_GARR_INTRO_34	加尔是拉格纳罗斯的副官之一。你已经离炎魔之王不远了。	
VO_NEFARIAN_GRIMSTONE_29	黑铁竞技场。在这里，也许你能知道自己到底有多少能力，凡人。	
VO_NEFARIAN_INTRO1_24	欢迎来到黑石山，我的私人领地。	
VO_NEFARIAN_INTRO3_25	呃，随你的便。不过我倒觉得，你应该去拜访一下熔火之心。	
VO_NEFARIAN_INTRO4_26	炎魔之王在这里不受欢迎。	
VO_NEFARIAN_MAJORDOMO_41	这是拉格纳罗斯最信任的仆从。我们应该逼他把炎魔之王召唤出来，对不对？	
VO_NEFARIAN_MAJORDOMO_DEAD_42	啊哈哈哈哈！你成功了！现在，黑石山就是我的，我的了！	
VO_NEFARIAN_MALORIAK_70	马洛拉克并非是我要塞中最擅长战斗的随从，但他会给你一些惊喜。	
VO_NEFARIAN_NEF_INTRO1_64	你本来有机会庆祝自己的胜利，但你不知道珍惜。没关系，你对我而言，一文不值。	
VO_NEFARIAN_OMNOTRON_68	我的内部庭院由最强大的防御系统守护，强大得令你无法想象！	
VO_NEFARIAN_OMOKK_INTRO_43	你好啊，炎魔杀手！唔……你在黑石塔里做什么呢？	
VO_NEFARIAN_RAZORGORE_54	你胆敢进入我的领地？很好。拉佐格尔，杀了这个不知好歹的混蛋。	
VO_NEFARIAN_REND_INTRO_51	悬崖勒马吧，凡人。你在挑战你无法理解的力量。	
VO_NEFARIAN_THAURISSAN_31	索瑞森大帝把炎魔之王召唤到了这个世界上。把他杀了。	
VO_NEFARIAN_VAEL_56	看见没有？即使如此强大的红龙，也被我掌控于股掌之间。	
VO_NEFARIAN_ZOMBIE_NEF_99	这次你就不会这么走运了。	
VO_RAGNAROS_INTRO2_64	你的领地？我要把你烤熟了，小龙！	
VO_RAGNAROS_INTRO5_65	哈哈哈，欢迎你来做客，小虫子！	
VO_RAGNAROS_MC_WELCOME_67	熔火之心是我的领地！我会碾碎你，可怜虫。	
VO_RAGNAROS_NEF_INTRO2_70	嘶……凡人。我可没有死。我会帮助你打倒奈法利安！	
VO_TIRION_INTRO_02	请你们做好准备：最顶尖的枪骑术对决，最令人瞩目的表演和最激动人心的战斗。	
VO_TUTORIAL_01_ANNOUNCER_01	哦！又一位挑战者！是大法师吉安娜•普罗德摩尔！	
VO_TUTORIAL_01_ANNOUNCER_02	谁会接受这次挑战？	
VO_TUTORIAL_01_ANNOUNCER_03	哦！艾尔文的灾星，豺狼人霍格！	
VO_TUTORIAL_01_ANNOUNCER_04	大家快来看！	
VO_TUTORIAL_01_ANNOUNCER_05	比赛开始！	
VO_TUTR_Garrosh_GarroshHellscream_Orc_InGame_Introduction_01	赢了我再说吧，可怜的人类。	
VO_TUTR_Garrosh_GarroshHellscream_Orc_InGame_Introduction_02	我会击败你，让大家知道我才是最强的！	
VO_TUTR_Garrosh_GarroshHellscream_Orc_InGame_OnArmorUp_01	哈！你的法术不如我的武器和护甲。	
VO_TUTR_Garrosh_GarroshHellscream_Orc_InGame_OnFieryWarAxePlayed_01	跟我的大斧子打个招呼。	
VO_TUTR_Garrosh_GarroshHellscream_Orc_InGame_OnSpellPlayed_01	我的护甲能抵挡一切法术。	
VO_TUTR_Garrosh_GarroshHellscream_Orc_InGame_Turn_01	打你用不了多久！	
VO_TUTR_Garrosh_GarroshHellscream_Orc_InGame_Turn_02	我，无可阻挡！	
VO_TUTR_Garrosh_GarroshHellscream_Orc_InGame_Turn_03	战士们！把她拿下！！	
VO_TUTR_Garrosh_GarroshHellscream_Orc_InGame_Turn_04	感受我的怒火！	
VO_TUTR_Garrosh_GarroshHellscream_Orc_InGame_Turn_05	为了部落！	
VO_TUTR_Jaina_JainaProudmoore_Human_ERROR_FULL_MINIONS_01	我的战场满了，现在不能再使用随从牌。	
VO_TUTR_Jaina_JainaProudmoore_Human_ERROR_GENERIC_01	我不能那么做。	
VO_TUTR_Jaina_JainaProudmoore_Human_ERROR_HEROPOWER_01	每回合我只能使用英雄技能一次。	
VO_TUTR_Jaina_JainaProudmoore_Human_ERROR_NEEDMANA_01	我没有足够的法力值。	
VO_TUTR_Jaina_JainaProudmoore_Human_ERROR_NOMANA_01	下个回合我的法力水晶还会恢复。我就能使用更多的卡牌。	
VO_TUTR_Jaina_JainaProudmoore_Human_ERROR_PLAY_01	我还不能使用它。	
VO_TUTR_Jaina_JainaProudmoore_Human_ERROR_SUMMON_SICKNESS_01	我需要给它一个回合准备一下。	
VO_TUTR_Jaina_JainaProudmoore_Human_ERROR_TARGET_01	需要有个目标，我才能使用那张牌。	
VO_TUTR_Jaina_JainaProudmoore_Human_ERROR_TAUNT_01	我必须率先攻击嘲讽随从。	
VO_TUTR_Jaina_JainaProudmoore_Human_HELPER_EMPTYBOARD_01	我现在需要用随从牌。	
VO_TUTR_Jaina_JainaProudmoore_Human_HELPER_EMPTYBOARD2_01	我没有守卫了！	
VO_TUTR_Jaina_JainaProudmoore_Human_HELPER_ENEMY_FULLBOARD_01	随从太多了！我得先想办法对付它们。	
VO_TUTR_Jaina_JainaProudmoore_Human_HELPER_ENEMY_SPECIALMINION_01	我必须得想办法尽快解决那个随从。	
VO_TUTR_Jaina_JainaProudmoore_Human_HELPER_HEROFOCUS_GARROSH_01	加尔鲁什有破绽！我应该集中精力击败他。	
VO_TUTR_Jaina_JainaProudmoore_Human_HELPER_HEROFOCUS_LICHKING_01	巫妖王太强了，我该先集中精力击败他。	
VO_TUTR_Jaina_JainaProudmoore_Human_HELPER_HEROFOCUS_REXXAR_01	我现在应该专心解决雷克萨……	
VO_TUTR_Jaina_JainaProudmoore_Human_HELPER_SECOND_MINION_01	又一张随从牌！我刚好需要。	
VO_TUTR_Jaina_JainaProudmoore_Human_HELPER_SPELL_01	法术牌！它只能使用一次，所以我应该好好利用……	
VO_TUTR_Jaina_JainaProudmoore_Human_InGame_Introduction_01	你有我所需的卡牌，雷克萨。	
VO_TUTR_Jaina_JainaProudmoore_Human_InGame_Introduction_02	我需要借助它们，击败巫妖王。	
VO_TUTR_Jaina_JainaProudmoore_Human_InGame_Introduction_03	雷克萨，我需要你的卡牌来击败巫妖王。	
VO_TUTR_Jaina_JainaProudmoore_Human_InGame_Introduction_04	巫妖王的实力不断增长。请你帮帮我。	
VO_TUTR_Jaina_JainaProudmoore_Human_InGame_Introduction_05	我没时间陪你耗，加尔鲁什。	
VO_TUTR_Jaina_JainaProudmoore_Human_InGame_Introduction_06	你的恐怖统治就此终结，巫妖王。	
VO_TUTR_Jaina_JainaProudmoore_Human_InGame_Introduction_07	那我就多一张牌了。	
VO_TUTR_Jaina_JainaProudmoore_Human_InGame_OnDrawAOESpell_01	这张牌刚好可以对付他的随从。	
VO_TUTR_Jaina_JainaProudmoore_Human_InGame_OnDrawFireball_01	火焰法术。正是我想要的。	
VO_TUTR_Jaina_JainaProudmoore_Human_InGame_OnDrawLegendary_01	传说卡牌！好强啊……	
VO_TUTR_Jaina_JainaProudmoore_Human_InGame_OnEnemyFullBoard_01	用那个法术，我就能清空战场。	
VO_TUTR_Jaina_JainaProudmoore_Human_InGame_OnEnemyMinionsFrozen_01	现在，他的随从不能攻击。	
VO_TUTR_Jaina_JainaProudmoore_Human_InGame_OnNoTauntMinions_01	我需要再找一个嘲讽随从。	
VO_TUTR_Jaina_JainaProudmoore_Human_InGame_OnPlayedHuffer_01	这么大。我应该多加注意。	
VO_TUTR_Jaina_JainaProudmoore_Human_InGame_OnPlayedKingKrush_01	这下麻烦了。	
VO_TUTR_Jaina_JainaProudmoore_Human_InGame_OnPlayToMySide_01	还有随从？他到底有多少……	
VO_TUTR_Jaina_JainaProudmoore_Human_InGame_Turn_01	随从牌！我应该使用这张牌，正式开始对战。	
VO_TUTR_Jaina_JainaProudmoore_Human_InGame_Turn_02	雷克萨的生命值不多了，我能解决他！	
VO_TUTR_Jaina_JainaProudmoore_Human_InGame_Turn_03	你的一举一动都在我掌握之中。	
VO_TUTR_Jaina_JainaProudmoore_Human_InGame_Turn_04	他的随从动作好快！	
VO_TUTR_Jaina_JainaProudmoore_Human_InGame_Turn_05	我有的是对付你的手段。	
VO_TUTR_Jaina_JainaProudmoore_Human_InGame_Turn_06	我应该拖住他……	
VO_TUTR_Jaina_JainaProudmoore_Human_InGame_Turn_07	该分出胜负了！	
VO_TUTR_Jaina_JainaProudmoore_Human_InGame_Turn_08	嘲讽随从！应该可以抵挡一阵。	
VO_TUTR_Jaina_JainaProudmoore_Human_InGame_Turn_09	我会用火焰净化你的随从！	
VO_TUTR_Jaina_JainaProudmoore_Human_InGame_Turn_10	现在还不行。	
VO_TUTR_Jaina_JainaProudmoore_Human_InGame_Turn_11	他怎么召唤出了这么多随从？	
VO_TUTR_Jaina_JainaProudmoore_Human_InGame_Turn_12	我只要再坚持一会儿……	
VO_TUTR_Jaina_JainaProudmoore_Human_InGame_VictoryPostExplosion_01	我赢了！开始下一场战斗吧。	
VO_TUTR_Jaina_JainaProudmoore_Human_InGame_VictoryPostExplosion_02	现在，决战的时候到了。	
VO_TUTR_Jaina_JainaProudmoore_Human_InGame_VictoryPostExplosion_03	结束了。不过，还有更多的战斗等着我……	
VO_TUTR_Jaina_JainaProudmoore_Human_InGame_VictoryPostExplosion_04	我赢了！终于可以好好玩游戏了。	
VO_TUTR_LichKing_LichKing_Undead_InGame_Introduction_01	你和你的套牌一样，脆弱不堪。	
VO_TUTR_LichKing_LichKing_Undead_InGame_Introduction_02	寒冷浸透了你的灵魂。这场战斗，由我先行。	
VO_TUTR_LichKing_LichKing_Undead_InGame_OnFrostmournePlayed_01	霜之哀伤饿了。	
VO_TUTR_LichKing_LichKing_Undead_InGame_OnFrostwyrmsFuryPlayed_01	我统御着冰霜的力量。	
VO_TUTR_LichKing_LichKing_Undead_InGame_Turn_01	你学了不少新的招数。可惜毫无用处。	
VO_TUTR_LichKing_LichKing_Undead_InGame_Turn_02	末日无可避免。	
VO_TUTR_LichKing_LichKing_Undead_InGame_Turn_03	你冻住了我的勇士。如此冷血。	
VO_TUTR_LichKing_LichKing_Undead_InGame_Turn_04	起来吧，我的随从！	
VO_TUTR_LichKing_LichKing_Undead_InGame_Turn_FirstHeroPower_01	起来吧，天灾军团。	
VO_TUTR_Rexxar_Rexxar_Orc_InGame_Introduction_01	这些牌属于荒野。	
VO_TUTR_Rexxar_Rexxar_Orc_InGame_Introduction_02	那么，狩猎开始了！	
VO_TUTR_Rexxar_Rexxar_Orc_InGame_Introduction_03	狩猎开始了。	
VO_TUTR_Rexxar_Rexxar_Orc_InGame_Introduction_04	我是猎人雷克萨。	
VO_TUTR_Rexxar_Rexxar_Orc_InGame_Introduction_05	我会用野兽和法术，全力快攻。	
VO_TUTR_Rexxar_Rexxar_Orc_InGame_OnPlayCharge_01	那个随从具有“冲锋”，可以在上场的当回合攻击任意敌人。	
VO_TUTR_Rexxar_Rexxar_Orc_InGame_OnPlayCompanion_01	米莎，雷欧克，霍弗，来我身边！	
VO_TUTR_Rexxar_Rexxar_Orc_InGame_OnPlayedArcaneShot_01	我瞄准你了。	
VO_TUTR_Rexxar_Rexxar_Orc_InGame_OnPlayedStonetuskBoar_01	我的小野猪能快速解决战斗。	
VO_TUTR_Rexxar_Rexxar_Orc_InGame_OnPlayRush_01	那个随从具有“突袭”，可以在上场的当回合攻击随从。	
VO_TUTR_Rexxar_Rexxar_Orc_InGame_OnPlayUnleash_01	把狗放出来！	
